Location_ID,Sensing_DateTime,Sensing_Date,Sensing_Time,Direction_1,Direction_2,Total_of_Directions
19,2025-05-25T04:41:00+02:00,2025-05-25,12:41,15,12,27
19,2025-05-25T04:46:00+02:00,2025-05-25,12:46,23,5,28
19,2025-05-25T04:48:00+02:00,2025-05-25,12:48,10,14,24
20,2025-05-25T04:43:00+02:00,2025-05-25,12:43,1,3,4
20,2025-05-25T04:44:00+02:00,2025-05-25,12:44,10,3,13
20,2025-05-25T04:47:00+02:00,2025-05-25,12:47,12,6,18
20,2025-05-25T04:49:00+02:00,2025-05-25,12:49,2,3,5
20,2025-05-25T04:50:00+02:00,2025-05-25,12:50,4,3,7
20,2025-05-25T04:52:00+02:00,2025-05-25,12:52,2,5,7
23,2025-05-25T04:40:00+02:00,2025-05-25,12:40,0,3,3
23,2025-05-25T04:44:00+02:00,2025-05-25,12:44,7,5,12
23,2025-05-25T04:45:00+02:00,2025-05-25,12:45,2,6,8
23,2025-05-25T04:47:00+02:00,2025-05-25,12:47,1,8,9
23,2025-05-25T04:50:00+02:00,2025-05-25,12:50,6,3,9
23,2025-05-25T04:52:00+02:00,2025-05-25,12:52,2,1,3
23,2025-05-25T04:53:00+02:00,2025-05-25,12:53,1,2,3
23,2025-05-25T04:54:00+02:00,2025-05-25,12:54,5,1,6
24,2025-05-25T04:44:00+02:00,2025-05-25,12:44,9,2,11
24,2025-05-25T04:46:00+02:00,2025-05-25,12:46,8,5,13
24,2025-05-25T04:48:00+02:00,2025-05-25,12:48,5,7,12
24,2025-05-25T04:50:00+02:00,2025-05-25,12:50,4,5,9
24,2025-05-25T04:52:00+02:00,2025-05-25,12:52,19,8,27
24,2025-05-25T04:54:00+02:00,2025-05-25,12:54,5,3,8
27,2025-05-25T04:41:00+02:00,2025-05-25,12:41,12,3,15
27,2025-05-25T04:43:00+02:00,2025-05-25,12:43,5,10,15
27,2025-05-25T04:44:00+02:00,2025-05-25,12:44,14,3,17
27,2025-05-25T04:45:00+02:00,2025-05-25,12:45,3,7,10
27,2025-05-25T04:49:00+02:00,2025-05-25,12:49,3,3,6
27,2025-05-25T04:50:00+02:00,2025-05-25,12:50,10,0,10
27,2025-05-25T04:51:00+02:00,2025-05-25,12:51,3,9,12
30,2025-05-25T04:43:00+02:00,2025-05-25,12:43,7,1,8
30,2025-05-25T04:44:00+02:00,2025-05-25,12:44,10,4,14
30,2025-05-25T04:50:00+02:00,2025-05-25,12:50,1,16,17
35,2025-05-25T04:41:00+02:00,2025-05-25,12:41,31,26,57
35,2025-05-25T04:42:00+02:00,2025-05-25,12:42,25,12,37
35,2025-05-25T04:48:00+02:00,2025-05-25,12:48,14,19,33
35,2025-05-25T04:49:00+02:00,2025-05-25,12:49,19,25,44
35,2025-05-25T04:52:00+02:00,2025-05-25,12:52,19,27,46
35,2025-05-25T04:53:00+02:00,2025-05-25,12:53,23,18,41
48,2025-05-25T04:43:00+02:00,2025-05-25,12:43,19,5,24
48,2025-05-25T04:48:00+02:00,2025-05-25,12:48,9,7,16
48,2025-05-25T04:53:00+02:00,2025-05-25,12:53,18,14,32
49,2025-05-25T04:47:00+02:00,2025-05-25,12:47,3,6,9
49,2025-05-25T04:50:00+02:00,2025-05-25,12:50,6,8,14
49,2025-05-25T04:52:00+02:00,2025-05-25,12:52,12,7,19
49,2025-05-25T04:54:00+02:00,2025-05-25,12:54,5,1,6
51,2025-05-25T04:43:00+02:00,2025-05-25,12:43,5,0,5
51,2025-05-25T04:47:00+02:00,2025-05-25,12:47,3,1,4
51,2025-05-25T04:53:00+02:00,2025-05-25,12:53,3,3,6
51,2025-05-25T04:54:00+02:00,2025-05-25,12:54,1,0,1
52,2025-05-25T04:44:00+02:00,2025-05-25,12:44,15,6,21
52,2025-05-25T04:45:00+02:00,2025-05-25,12:45,10,10,20
52,2025-05-25T04:46:00+02:00,2025-05-25,12:46,8,4,12
52,2025-05-25T04:48:00+02:00,2025-05-25,12:48,16,5,21
52,2025-05-25T04:49:00+02:00,2025-05-25,12:49,7,1,8
52,2025-05-25T04:51:00+02:00,2025-05-25,12:51,7,11,18
52,2025-05-25T04:54:00+02:00,2025-05-25,12:54,5,7,12
53,2025-05-25T04:41:00+02:00,2025-05-25,12:41,27,7,34
53,2025-05-25T04:42:00+02:00,2025-05-25,12:42,7,6,13
53,2025-05-25T04:45:00+02:00,2025-05-25,12:45,19,7,26
53,2025-05-25T04:48:00+02:00,2025-05-25,12:48,9,12,21
53,2025-05-25T04:52:00+02:00,2025-05-25,12:52,13,9,22
53,2025-05-25T04:53:00+02:00,2025-05-25,12:53,11,5,16
56,2025-05-25T04:42:00+02:00,2025-05-25,12:42,6,5,11
56,2025-05-25T04:53:00+02:00,2025-05-25,12:53,11,7,18
58,2025-05-25T04:46:00+02:00,2025-05-25,12:46,7,4,11
58,2025-05-25T04:49:00+02:00,2025-05-25,12:49,12,8,20
58,2025-05-25T04:54:00+02:00,2025-05-25,12:54,5,1,6
62,2025-05-25T04:44:00+02:00,2025-05-25,12:44,8,4,12
62,2025-05-25T04:46:00+02:00,2025-05-25,12:46,1,5,6
62,2025-05-25T04:47:00+02:00,2025-05-25,12:47,6,3,9
62,2025-05-25T04:50:00+02:00,2025-05-25,12:50,5,3,8
62,2025-05-25T04:52:00+02:00,2025-05-25,12:52,3,3,6
63,2025-05-25T04:41:00+02:00,2025-05-25,12:41,12,2,14
63,2025-05-25T04:43:00+02:00,2025-05-25,12:43,7,3,10
63,2025-05-25T04:44:00+02:00,2025-05-25,12:44,6,6,12
63,2025-05-25T04:48:00+02:00,2025-05-25,12:48,9,6,15
63,2025-05-25T04:53:00+02:00,2025-05-25,12:53,4,4,8
67,2025-05-25T04:44:00+02:00,2025-05-25,12:44,7,11,18
67,2025-05-25T04:45:00+02:00,2025-05-25,12:45,2,13,15
67,2025-05-25T04:48:00+02:00,2025-05-25,12:48,2,7,9
67,2025-05-25T04:54:00+02:00,2025-05-25,12:54,4,15,19
68,2025-05-25T04:44:00+02:00,2025-05-25,12:44,4,7,11
68,2025-05-25T04:45:00+02:00,2025-05-25,12:45,5,0,5
68,2025-05-25T04:50:00+02:00,2025-05-25,12:50,3,2,5
68,2025-05-25T04:51:00+02:00,2025-05-25,12:51,5,2,7
68,2025-05-25T04:52:00+02:00,2025-05-25,12:52,3,1,4
72,2025-05-25T04:42:00+02:00,2025-05-25,12:42,2,6,8
72,2025-05-25T04:43:00+02:00,2025-05-25,12:43,5,6,11
72,2025-05-25T04:45:00+02:00,2025-05-25,12:45,8,12,20
72,2025-05-25T04:48:00+02:00,2025-05-25,12:48,4,15,19
72,2025-05-25T04:49:00+02:00,2025-05-25,12:49,2,21,23
72,2025-05-25T04:51:00+02:00,2025-05-25,12:51,7,5,12
76,2025-05-25T04:46:00+02:00,2025-05-25,12:46,1,0,1
76,2025-05-25T04:47:00+02:00,2025-05-25,12:47,2,2,4
76,2025-05-25T04:48:00+02:00,2025-05-25,12:48,0,2,2
79,2025-05-25T04:47:00+02:00,2025-05-25,12:47,6,7,13
79,2025-05-25T04:50:00+02:00,2025-05-25,12:50,10,6,16
79,2025-05-25T04:53:00+02:00,2025-05-25,12:53,6,6,12
85,2025-05-25T04:42:00+02:00,2025-05-25,12:42,1,0,1
85,2025-05-25T04:48:00+02:00,2025-05-25,12:48,3,2,5
85,2025-05-25T04:49:00+02:00,2025-05-25,12:49,2,5,7
85,2025-05-25T04:52:00+02:00,2025-05-25,12:52,0,4,4
86,2025-05-25T04:40:00+02:00,2025-05-25,12:40,1,1,2
86,2025-05-25T04:45:00+02:00,2025-05-25,12:45,2,2,4
86,2025-05-25T04:47:00+02:00,2025-05-25,12:47,1,0,1
109,2025-05-25T04:40:00+02:00,2025-05-25,12:40,4,1,5
109,2025-05-25T04:50:00+02:00,2025-05-25,12:50,7,9,16
117,2025-05-25T04:40:00+02:00,2025-05-25,12:40,11,13,24
123,2025-05-25T04:45:00+02:00,2025-05-25,12:45,5,0,5
130,2025-05-25T04:40:00+02:00,2025-05-25,12:40,3,2,5
130,2025-05-25T04:50:00+02:00,2025-05-25,12:50,12,3,15
137,2025-05-25T04:40:00+02:00,2025-05-25,12:40,2,0,2
137,2025-05-25T04:45:00+02:00,2025-05-25,12:45,3,0,3
137,2025-05-25T04:50:00+02:00,2025-05-25,12:50,0,5,5
141,2025-05-25T04:40:00+02:00,2025-05-25,12:40,10,15,25
142,2025-05-25T04:45:00+02:00,2025-05-25,12:45,48,45,93
161,2025-05-25T04:40:00+02:00,2025-05-25,12:40,47,26,73
181,2025-05-25T04:42:00+02:00,2025-05-25,12:42,14,25,39
181,2025-05-25T04:43:00+02:00,2025-05-25,12:43,8,15,23
181,2025-05-25T04:44:00+02:00,2025-05-25,12:44,0,21,21
181,2025-05-25T04:50:00+02:00,2025-05-25,12:50,25,16,41
181,2025-05-25T04:52:00+02:00,2025-05-25,12:52,11,24,35
182,2025-05-25T04:45:00+02:00,2025-05-25,12:45,12,11,23
180,2025-05-25T04:42:00+02:00,2025-05-25,12:42,1,0,1
3,2025-05-25T02:11:00+02:00,2025-05-25,10:11,3,2,5
3,2025-05-25T02:13:00+02:00,2025-05-25,10:13,1,9,10
3,2025-05-25T02:23:00+02:00,2025-05-25,10:23,8,4,12
4,2025-05-25T02:10:00+02:00,2025-05-25,10:10,14,1,15
4,2025-05-25T02:22:00+02:00,2025-05-25,10:22,10,6,16
4,2025-05-25T02:24:00+02:00,2025-05-25,10:24,19,2,21
6,2025-05-25T02:11:00+02:00,2025-05-25,10:11,16,2,18
6,2025-05-25T02:12:00+02:00,2025-05-25,10:12,17,4,21
6,2025-05-25T02:13:00+02:00,2025-05-25,10:13,5,1,6
6,2025-05-25T02:14:00+02:00,2025-05-25,10:14,11,4,15
6,2025-05-25T02:15:00+02:00,2025-05-25,10:15,9,8,17
6,2025-05-25T02:16:00+02:00,2025-05-25,10:16,8,2,10
6,2025-05-25T02:21:00+02:00,2025-05-25,10:21,15,8,23
6,2025-05-25T02:22:00+02:00,2025-05-25,10:22,18,10,28
8,2025-05-25T02:12:00+02:00,2025-05-25,10:12,0,4,4
8,2025-05-25T02:14:00+02:00,2025-05-25,10:14,2,1,3
8,2025-05-25T02:15:00+02:00,2025-05-25,10:15,0,2,2
8,2025-05-25T02:16:00+02:00,2025-05-25,10:16,0,3,3
8,2025-05-25T02:17:00+02:00,2025-05-25,10:17,0,5,5
8,2025-05-25T02:20:00+02:00,2025-05-25,10:20,3,3,6
8,2025-05-25T02:22:00+02:00,2025-05-25,10:22,0,6,6
28,2025-05-25T02:11:00+02:00,2025-05-25,10:11,4,3,7
28,2025-05-25T02:15:00+02:00,2025-05-25,10:15,0,1,1
29,2025-05-25T02:11:00+02:00,2025-05-25,10:11,9,4,13
29,2025-05-25T02:12:00+02:00,2025-05-25,10:12,12,2,14
29,2025-05-25T02:20:00+02:00,2025-05-25,10:20,4,6,10
29,2025-05-25T02:23:00+02:00,2025-05-25,10:23,4,0,4
31,2025-05-25T02:13:00+02:00,2025-05-25,10:13,1,0,1
31,2025-05-25T02:14:00+02:00,2025-05-25,10:14,1,0,1
31,2025-05-25T02:15:00+02:00,2025-05-25,10:15,0,1,1
31,2025-05-25T02:17:00+02:00,2025-05-25,10:17,0,1,1
31,2025-05-25T02:20:00+02:00,2025-05-25,10:20,0,3,3
31,2025-05-25T02:22:00+02:00,2025-05-25,10:22,2,0,2
31,2025-05-25T02:23:00+02:00,2025-05-25,10:23,3,3,6
36,2025-05-25T02:10:00+02:00,2025-05-25,10:10,0,8,8
36,2025-05-25T02:12:00+02:00,2025-05-25,10:12,4,0,4
36,2025-05-25T02:13:00+02:00,2025-05-25,10:13,8,1,9
36,2025-05-25T02:15:00+02:00,2025-05-25,10:15,1,1,2
36,2025-05-25T02:16:00+02:00,2025-05-25,10:16,4,2,6
36,2025-05-25T02:17:00+02:00,2025-05-25,10:17,1,1,2
36,2025-05-25T02:23:00+02:00,2025-05-25,10:23,6,0,6
37,2025-05-25T02:12:00+02:00,2025-05-25,10:12,8,0,8
37,2025-05-25T02:14:00+02:00,2025-05-25,10:14,0,4,4
37,2025-05-25T02:16:00+02:00,2025-05-25,10:16,0,3,3
39,2025-05-25T02:10:00+02:00,2025-05-25,10:10,1,1,2
39,2025-05-25T02:14:00+02:00,2025-05-25,10:14,0,4,4
39,2025-05-25T02:16:00+02:00,2025-05-25,10:16,0,5,5
39,2025-05-25T02:20:00+02:00,2025-05-25,10:20,0,2,2
39,2025-05-25T02:24:00+02:00,2025-05-25,10:24,0,1,1
40,2025-05-25T02:13:00+02:00,2025-05-25,10:13,9,0,9
40,2025-05-25T02:17:00+02:00,2025-05-25,10:17,0,1,1
40,2025-05-25T02:18:00+02:00,2025-05-25,10:18,6,1,7
41,2025-05-25T02:14:00+02:00,2025-05-25,10:14,1,6,7
41,2025-05-25T02:15:00+02:00,2025-05-25,10:15,5,5,10
41,2025-05-25T02:16:00+02:00,2025-05-25,10:16,3,0,3
41,2025-05-25T02:20:00+02:00,2025-05-25,10:20,3,0,3
43,2025-05-25T02:15:00+02:00,2025-05-25,10:15,1,5,6
44,2025-05-25T02:10:00+02:00,2025-05-25,10:10,3,4,7
45,2025-05-25T02:11:00+02:00,2025-05-25,10:11,3,2,5
45,2025-05-25T02:12:00+02:00,2025-05-25,10:12,8,5,13
45,2025-05-25T02:15:00+02:00,2025-05-25,10:15,5,0,5
45,2025-05-25T02:16:00+02:00,2025-05-25,10:16,5,3,8
45,2025-05-25T02:23:00+02:00,2025-05-25,10:23,5,3,8
45,2025-05-25T02:24:00+02:00,2025-05-25,10:24,8,3,11
47,2025-05-25T02:12:00+02:00,2025-05-25,10:12,8,6,14
47,2025-05-25T02:15:00+02:00,2025-05-25,10:15,8,14,22
47,2025-05-25T02:16:00+02:00,2025-05-25,10:16,3,4,7
47,2025-05-25T02:17:00+02:00,2025-05-25,10:17,10,8,18
47,2025-05-25T02:20:00+02:00,2025-05-25,10:20,12,12,24
47,2025-05-25T02:23:00+02:00,2025-05-25,10:23,8,12,20
50,2025-05-25T02:11:00+02:00,2025-05-25,10:11,1,3,4
50,2025-05-25T02:13:00+02:00,2025-05-25,10:13,4,0,4
50,2025-05-25T02:15:00+02:00,2025-05-25,10:15,0,2,2
50,2025-05-25T02:16:00+02:00,2025-05-25,10:16,2,4,6
50,2025-05-25T02:20:00+02:00,2025-05-25,10:20,2,0,2
50,2025-05-25T02:24:00+02:00,2025-05-25,10:24,1,3,4
54,2025-05-25T02:13:00+02:00,2025-05-25,10:13,0,1,1
54,2025-05-25T02:19:00+02:00,2025-05-25,10:19,1,0,1
54,2025-05-25T02:23:00+02:00,2025-05-25,10:23,0,2,2
54,2025-05-25T02:24:00+02:00,2025-05-25,10:24,2,1,3
59,2025-05-25T02:10:00+02:00,2025-05-25,10:10,4,28,32
61,2025-05-25T02:13:00+02:00,2025-05-25,10:13,2,1,3
61,2025-05-25T02:16:00+02:00,2025-05-25,10:16,1,6,7
61,2025-05-25T02:17:00+02:00,2025-05-25,10:17,3,10,13
61,2025-05-25T02:22:00+02:00,2025-05-25,10:22,3,3,6
61,2025-05-25T02:23:00+02:00,2025-05-25,10:23,3,2,5
66,2025-05-25T02:10:00+02:00,2025-05-25,10:10,5,2,7
66,2025-05-25T02:12:00+02:00,2025-05-25,10:12,9,7,16
66,2025-05-25T02:20:00+02:00,2025-05-25,10:20,8,6,14
66,2025-05-25T02:21:00+02:00,2025-05-25,10:21,3,4,7
69,2025-05-25T02:13:00+02:00,2025-05-25,10:13,4,4,8
69,2025-05-25T02:15:00+02:00,2025-05-25,10:15,0,7,7
69,2025-05-25T02:17:00+02:00,2025-05-25,10:17,4,4,8
69,2025-05-25T02:19:00+02:00,2025-05-25,10:19,1,1,2
69,2025-05-25T02:21:00+02:00,2025-05-25,10:21,7,0,7
69,2025-05-25T02:23:00+02:00,2025-05-25,10:23,18,0,18
70,2025-05-25T02:20:00+02:00,2025-05-25,10:20,0,1,1
71,2025-05-25T02:11:00+02:00,2025-05-25,10:11,1,0,1
71,2025-05-25T02:22:00+02:00,2025-05-25,10:22,1,0,1
75,2025-05-25T02:11:00+02:00,2025-05-25,10:11,0,1,1
75,2025-05-25T02:13:00+02:00,2025-05-25,10:13,0,1,1
75,2025-05-25T02:22:00+02:00,2025-05-25,10:22,2,1,3
77,2025-05-25T02:15:00+02:00,2025-05-25,10:15,18,16,34
78,2025-05-25T02:11:00+02:00,2025-05-25,10:11,2,2,4
78,2025-05-25T02:12:00+02:00,2025-05-25,10:12,0,5,5
78,2025-05-25T02:15:00+02:00,2025-05-25,10:15,11,1,12
78,2025-05-25T02:22:00+02:00,2025-05-25,10:22,1,1,2
78,2025-05-25T02:24:00+02:00,2025-05-25,10:24,1,0,1
84,2025-05-25T02:10:00+02:00,2025-05-25,10:10,40,27,67
84,2025-05-25T02:15:00+02:00,2025-05-25,10:15,45,43,88
87,2025-05-25T02:13:00+02:00,2025-05-25,10:13,0,2,2
87,2025-05-25T02:20:00+02:00,2025-05-25,10:20,2,4,6
87,2025-05-25T02:21:00+02:00,2025-05-25,10:21,5,1,6
107,2025-05-25T02:20:00+02:00,2025-05-25,10:20,2,11,13
108,2025-05-25T02:10:00+02:00,2025-05-25,10:10,9,1,10
108,2025-05-25T02:11:00+02:00,2025-05-25,10:11,2,2,4
108,2025-05-25T02:12:00+02:00,2025-05-25,10:12,0,8,8
108,2025-05-25T02:14:00+02:00,2025-05-25,10:14,4,0,4
108,2025-05-25T02:23:00+02:00,2025-05-25,10:23,4,1,5
124,2025-05-25T02:10:00+02:00,2025-05-25,10:10,0,1,1
132,2025-05-25T02:10:00+02:00,2025-05-25,10:10,10,2,12
132,2025-05-25T02:20:00+02:00,2025-05-25,10:20,14,3,17
133,2025-05-25T02:10:00+02:00,2025-05-25,10:10,26,44,70
134,2025-05-25T02:10:00+02:00,2025-05-25,10:10,28,33,61
135,2025-05-25T02:20:00+02:00,2025-05-25,10:20,29,42,71
140,2025-05-25T02:20:00+02:00,2025-05-25,10:20,17,4,21
162,2025-05-25T02:15:00+02:00,2025-05-25,10:15,23,33,56
166,2025-05-25T02:20:00+02:00,2025-05-25,10:20,4,4,8
167,2025-05-25T02:10:00+02:00,2025-05-25,10:10,2,3,5
167,2025-05-25T02:20:00+02:00,2025-05-25,10:20,0,10,10
1,2025-05-25T02:11:00+02:00,2025-05-25,10:11,4,5,9
1,2025-05-25T02:17:00+02:00,2025-05-25,10:17,10,8,18
1,2025-05-25T02:18:00+02:00,2025-05-25,10:18,5,8,13
1,2025-05-25T02:20:00+02:00,2025-05-25,10:20,2,10,12
2,2025-05-25T02:11:00+02:00,2025-05-25,10:11,0,5,5
2,2025-05-25T02:13:00+02:00,2025-05-25,10:13,1,1,2
2,2025-05-25T02:14:00+02:00,2025-05-25,10:14,1,3,4
2,2025-05-25T02:15:00+02:00,2025-05-25,10:15,8,4,12
2,2025-05-25T02:16:00+02:00,2025-05-25,10:16,4,8,12
2,2025-05-25T02:20:00+02:00,2025-05-25,10:20,0,7,7
2,2025-05-25T02:21:00+02:00,2025-05-25,10:21,8,3,11
9,2025-05-25T02:10:00+02:00,2025-05-25,10:10,2,1,3
9,2025-05-25T02:13:00+02:00,2025-05-25,10:13,1,4,5
9,2025-05-25T02:15:00+02:00,2025-05-25,10:15,1,0,1
9,2025-05-25T02:17:00+02:00,2025-05-25,10:17,1,0,1
9,2025-05-25T02:18:00+02:00,2025-05-25,10:18,0,1,1
9,2025-05-25T02:20:00+02:00,2025-05-25,10:20,0,2,2
9,2025-05-25T02:23:00+02:00,2025-05-25,10:23,0,2,2
10,2025-05-25T02:10:00+02:00,2025-05-25,10:10,0,3,3
10,2025-05-25T02:19:00+02:00,2025-05-25,10:19,0,2,2
11,2025-05-25T02:10:00+02:00,2025-05-25,10:10,0,1,1
11,2025-05-25T02:12:00+02:00,2025-05-25,10:12,1,0,1
11,2025-05-25T02:13:00+02:00,2025-05-25,10:13,0,2,2
11,2025-05-25T02:14:00+02:00,2025-05-25,10:14,0,2,2
12,2025-05-25T02:10:00+02:00,2025-05-25,10:10,1,2,3
12,2025-05-25T02:13:00+02:00,2025-05-25,10:13,0,1,1
12,2025-05-25T02:16:00+02:00,2025-05-25,10:16,3,1,4
12,2025-05-25T02:18:00+02:00,2025-05-25,10:18,5,6,11
12,2025-05-25T02:19:00+02:00,2025-05-25,10:19,0,2,2
12,2025-05-25T02:20:00+02:00,2025-05-25,10:20,4,0,4
12,2025-05-25T02:22:00+02:00,2025-05-25,10:22,1,2,3
12,2025-05-25T02:23:00+02:00,2025-05-25,10:23,1,1,2
17,2025-05-25T02:15:00+02:00,2025-05-25,10:15,2,0,2
17,2025-05-25T02:17:00+02:00,2025-05-25,10:17,4,0,4
17,2025-05-25T02:18:00+02:00,2025-05-25,10:18,2,8,10
17,2025-05-25T02:20:00+02:00,2025-05-25,10:20,4,1,5
17,2025-05-25T02:21:00+02:00,2025-05-25,10:21,1,3,4
17,2025-05-25T02:23:00+02:00,2025-05-25,10:23,3,0,3
18,2025-05-25T02:15:00+02:00,2025-05-25,10:15,1,1,2
18,2025-05-25T02:16:00+02:00,2025-05-25,10:16,3,2,5
19,2025-05-25T02:15:00+02:00,2025-05-25,10:15,2,0,2
19,2025-05-25T02:17:00+02:00,2025-05-25,10:17,3,8,11
19,2025-05-25T02:23:00+02:00,2025-05-25,10:23,4,1,5
20,2025-05-25T02:13:00+02:00,2025-05-25,10:13,3,0,3
20,2025-05-25T02:19:00+02:00,2025-05-25,10:19,0,3,3
23,2025-05-25T02:10:00+02:00,2025-05-25,10:10,2,2,4
23,2025-05-25T02:12:00+02:00,2025-05-25,10:12,3,6,9
23,2025-05-25T02:14:00+02:00,2025-05-25,10:14,2,4,6
24,2025-05-25T02:14:00+02:00,2025-05-25,10:14,0,23,23
24,2025-05-25T02:15:00+02:00,2025-05-25,10:15,9,6,15
24,2025-05-25T02:18:00+02:00,2025-05-25,10:18,7,0,7
24,2025-05-25T02:23:00+02:00,2025-05-25,10:23,10,9,19
24,2025-05-25T02:24:00+02:00,2025-05-25,10:24,16,3,19
25,2025-05-25T02:20:00+02:00,2025-05-25,10:20,25,52,77
27,2025-05-25T02:13:00+02:00,2025-05-25,10:13,6,5,11
27,2025-05-25T02:14:00+02:00,2025-05-25,10:14,1,3,4
27,2025-05-25T02:15:00+02:00,2025-05-25,10:15,0,1,1
27,2025-05-25T02:19:00+02:00,2025-05-25,10:19,4,2,6
27,2025-05-25T02:21:00+02:00,2025-05-25,10:21,4,1,5
27,2025-05-25T02:22:00+02:00,2025-05-25,10:22,1,2,3
27,2025-05-25T02:24:00+02:00,2025-05-25,10:24,0,3,3
30,2025-05-25T02:10:00+02:00,2025-05-25,10:10,0,4,4
30,2025-05-25T02:11:00+02:00,2025-05-25,10:11,0,5,5
30,2025-05-25T02:13:00+02:00,2025-05-25,10:13,1,3,4
30,2025-05-25T02:16:00+02:00,2025-05-25,10:16,2,2,4
30,2025-05-25T02:18:00+02:00,2025-05-25,10:18,2,1,3
30,2025-05-25T02:19:00+02:00,2025-05-25,10:19,2,6,8
30,2025-05-25T02:20:00+02:00,2025-05-25,10:20,2,1,3
35,2025-05-25T02:11:00+02:00,2025-05-25,10:11,25,16,41
35,2025-05-25T02:17:00+02:00,2025-05-25,10:17,13,8,21
35,2025-05-25T02:19:00+02:00,2025-05-25,10:19,19,13,32
35,2025-05-25T02:23:00+02:00,2025-05-25,10:23,15,14,29
35,2025-05-25T02:24:00+02:00,2025-05-25,10:24,12,6,18
46,2025-05-25T02:10:00+02:00,2025-05-25,10:10,1,5,6
46,2025-05-25T02:20:00+02:00,2025-05-25,10:20,1,2,3
48,2025-05-25T02:12:00+02:00,2025-05-25,10:12,2,3,5
48,2025-05-25T02:15:00+02:00,2025-05-25,10:15,3,4,7
48,2025-05-25T02:18:00+02:00,2025-05-25,10:18,3,5,8
48,2025-05-25T02:19:00+02:00,2025-05-25,10:19,5,4,9
48,2025-05-25T02:22:00+02:00,2025-05-25,10:22,1,6,7
49,2025-05-25T02:10:00+02:00,2025-05-25,10:10,20,4,24
49,2025-05-25T02:21:00+02:00,2025-05-25,10:21,15,9,24
49,2025-05-25T02:22:00+02:00,2025-05-25,10:22,3,10,13
49,2025-05-25T02:23:00+02:00,2025-05-25,10:23,13,7,20
51,2025-05-25T02:11:00+02:00,2025-05-25,10:11,0,1,1
51,2025-05-25T02:14:00+02:00,2025-05-25,10:14,0,3,3
51,2025-05-25T02:16:00+02:00,2025-05-25,10:16,0,1,1
51,2025-05-25T02:21:00+02:00,2025-05-25,10:21,3,2,5
51,2025-05-25T02:24:00+02:00,2025-05-25,10:24,1,4,5
52,2025-05-25T02:11:00+02:00,2025-05-25,10:11,2,1,3
52,2025-05-25T02:13:00+02:00,2025-05-25,10:13,0,1,1
52,2025-05-25T02:17:00+02:00,2025-05-25,10:17,1,1,2
52,2025-05-25T02:18:00+02:00,2025-05-25,10:18,4,1,5
52,2025-05-25T02:19:00+02:00,2025-05-25,10:19,10,3,13
52,2025-05-25T02:22:00+02:00,2025-05-25,10:22,3,1,4
53,2025-05-25T02:10:00+02:00,2025-05-25,10:10,4,1,5
53,2025-05-25T02:14:00+02:00,2025-05-25,10:14,5,0,5
53,2025-05-25T02:15:00+02:00,2025-05-25,10:15,3,4,7
53,2025-05-25T02:18:00+02:00,2025-05-25,10:18,4,2,6
56,2025-05-25T02:11:00+02:00,2025-05-25,10:11,10,0,10
56,2025-05-25T02:13:00+02:00,2025-05-25,10:13,1,6,7
56,2025-05-25T02:14:00+02:00,2025-05-25,10:14,4,2,6
56,2025-05-25T02:19:00+02:00,2025-05-25,10:19,11,4,15
56,2025-05-25T02:20:00+02:00,2025-05-25,10:20,3,3,6
58,2025-05-25T02:12:00+02:00,2025-05-25,10:12,1,7,8
58,2025-05-25T02:13:00+02:00,2025-05-25,10:13,9,1,10
58,2025-05-25T02:16:00+02:00,2025-05-25,10:16,8,1,9
58,2025-05-25T02:19:00+02:00,2025-05-25,10:19,1,2,3
58,2025-05-25T02:20:00+02:00,2025-05-25,10:20,1,0,1
58,2025-05-25T02:22:00+02:00,2025-05-25,10:22,7,2,9
62,2025-05-25T02:13:00+02:00,2025-05-25,10:13,1,4,5
62,2025-05-25T02:15:00+02:00,2025-05-25,10:15,2,3,5
62,2025-05-25T02:19:00+02:00,2025-05-25,10:19,7,0,7
63,2025-05-25T02:12:00+02:00,2025-05-25,10:12,0,6,6
63,2025-05-25T02:16:00+02:00,2025-05-25,10:16,1,1,2
63,2025-05-25T02:20:00+02:00,2025-05-25,10:20,1,6,7
63,2025-05-25T02:23:00+02:00,2025-05-25,10:23,0,3,3
63,2025-05-25T02:24:00+02:00,2025-05-25,10:24,3,9,12
67,2025-05-25T02:13:00+02:00,2025-05-25,10:13,0,5,5
67,2025-05-25T02:15:00+02:00,2025-05-25,10:15,5,4,9
68,2025-05-25T02:11:00+02:00,2025-05-25,10:11,4,1,5
68,2025-05-25T02:13:00+02:00,2025-05-25,10:13,4,7,11
68,2025-05-25T02:15:00+02:00,2025-05-25,10:15,2,7,9
68,2025-05-25T02:16:00+02:00,2025-05-25,10:16,3,4,7
68,2025-05-25T02:18:00+02:00,2025-05-25,10:18,4,4,8
68,2025-05-25T02:19:00+02:00,2025-05-25,10:19,7,4,11
68,2025-05-25T02:21:00+02:00,2025-05-25,10:21,6,4,10
68,2025-05-25T02:23:00+02:00,2025-05-25,10:23,0,5,5
72,2025-05-25T02:10:00+02:00,2025-05-25,10:10,0,1,1
72,2025-05-25T02:12:00+02:00,2025-05-25,10:12,1,0,1
72,2025-05-25T02:16:00+02:00,2025-05-25,10:16,2,3,5
72,2025-05-25T02:17:00+02:00,2025-05-25,10:17,3,1,4
72,2025-05-25T02:19:00+02:00,2025-05-25,10:19,6,3,9
72,2025-05-25T02:24:00+02:00,2025-05-25,10:24,0,6,6
76,2025-05-25T02:11:00+02:00,2025-05-25,10:11,2,1,3
76,2025-05-25T02:17:00+02:00,2025-05-25,10:17,2,0,2
76,2025-05-25T02:22:00+02:00,2025-05-25,10:22,0,2,2
76,2025-05-25T02:24:00+02:00,2025-05-25,10:24,2,0,2
79,2025-05-25T02:18:00+02:00,2025-05-25,10:18,3,1,4
79,2025-05-25T02:22:00+02:00,2025-05-25,10:22,4,1,5
85,2025-05-25T02:13:00+02:00,2025-05-25,10:13,2,0,2
85,2025-05-25T02:15:00+02:00,2025-05-25,10:15,3,1,4
85,2025-05-25T02:16:00+02:00,2025-05-25,10:16,2,0,2
86,2025-05-25T02:10:00+02:00,2025-05-25,10:10,2,0,2
86,2025-05-25T02:11:00+02:00,2025-05-25,10:11,1,0,1
86,2025-05-25T02:13:00+02:00,2025-05-25,10:13,2,0,2
86,2025-05-25T02:14:00+02:00,2025-05-25,10:14,1,1,2
86,2025-05-25T02:20:00+02:00,2025-05-25,10:20,1,0,1
86,2025-05-25T02:21:00+02:00,2025-05-25,10:21,2,1,3
109,2025-05-25T02:10:00+02:00,2025-05-25,10:10,7,10,17
109,2025-05-25T02:15:00+02:00,2025-05-25,10:15,2,9,11
109,2025-05-25T02:20:00+02:00,2025-05-25,10:20,10,7,17
117,2025-05-25T02:10:00+02:00,2025-05-25,10:10,5,6,11
130,2025-05-25T02:20:00+02:00,2025-05-25,10:20,6,4,10
136,2025-05-25T02:10:00+02:00,2025-05-25,10:10,2,8,10
136,2025-05-25T02:15:00+02:00,2025-05-25,10:15,9,10,19
137,2025-05-25T02:15:00+02:00,2025-05-25,10:15,3,1,4
141,2025-05-25T02:10:00+02:00,2025-05-25,10:10,10,16,26
141,2025-05-25T02:20:00+02:00,2025-05-25,10:20,12,26,38
142,2025-05-25T02:15:00+02:00,2025-05-25,10:15,41,36,77
161,2025-05-25T02:10:00+02:00,2025-05-25,10:10,9,12,21
161,2025-05-25T02:15:00+02:00,2025-05-25,10:15,12,15,27
164,2025-05-25T02:20:00+02:00,2025-05-25,10:20,2,1,3
181,2025-05-25T02:25:00+02:00,2025-05-25,10:25,9,10,19
181,2025-05-25T02:28:00+02:00,2025-05-25,10:28,3,10,13
181,2025-05-25T02:31:00+02:00,2025-05-25,10:31,1,7,8
181,2025-05-25T02:36:00+02:00,2025-05-25,10:36,3,11,14
181,2025-05-25T02:38:00+02:00,2025-05-25,10:38,13,23,36
180,2025-05-25T02:34:00+02:00,2025-05-25,10:34,2,2,4
180,2025-05-25T02:38:00+02:00,2025-05-25,10:38,1,2,3
3,2025-05-25T01:40:00+02:00,2025-05-25,09:40,4,5,9
3,2025-05-25T01:46:00+02:00,2025-05-25,09:46,8,4,12
3,2025-05-25T01:49:00+02:00,2025-05-25,09:49,6,5,11
3,2025-05-25T01:54:00+02:00,2025-05-25,09:54,4,4,8
4,2025-05-25T01:42:00+02:00,2025-05-25,09:42,12,1,13
4,2025-05-25T01:44:00+02:00,2025-05-25,09:44,5,1,6
4,2025-05-25T01:48:00+02:00,2025-05-25,09:48,8,5,13
4,2025-05-25T01:49:00+02:00,2025-05-25,09:49,8,4,12
4,2025-05-25T01:51:00+02:00,2025-05-25,09:51,4,11,15
4,2025-05-25T01:52:00+02:00,2025-05-25,09:52,3,7,10
5,2025-05-25T01:50:00+02:00,2025-05-25,09:50,31,30,61
6,2025-05-25T01:42:00+02:00,2025-05-25,09:42,12,2,14
6,2025-05-25T01:43:00+02:00,2025-05-25,09:43,9,1,10
6,2025-05-25T01:44:00+02:00,2025-05-25,09:44,14,5,19
6,2025-05-25T01:45:00+02:00,2025-05-25,09:45,13,13,26
6,2025-05-25T01:51:00+02:00,2025-05-25,09:51,7,4,11
6,2025-05-25T01:52:00+02:00,2025-05-25,09:52,5,0,5
8,2025-05-25T01:40:00+02:00,2025-05-25,09:40,3,6,9
8,2025-05-25T01:44:00+02:00,2025-05-25,09:44,3,5,8
8,2025-05-25T01:47:00+02:00,2025-05-25,09:47,1,0,1
8,2025-05-25T01:49:00+02:00,2025-05-25,09:49,1,2,3
8,2025-05-25T01:50:00+02:00,2025-05-25,09:50,3,6,9
8,2025-05-25T01:54:00+02:00,2025-05-25,09:54,0,6,6
28,2025-05-25T01:40:00+02:00,2025-05-25,09:40,1,0,1
28,2025-05-25T01:43:00+02:00,2025-05-25,09:43,2,2,4
28,2025-05-25T01:45:00+02:00,2025-05-25,09:45,2,3,5
28,2025-05-25T01:49:00+02:00,2025-05-25,09:49,2,3,5
29,2025-05-25T01:40:00+02:00,2025-05-25,09:40,7,1,8
29,2025-05-25T01:41:00+02:00,2025-05-25,09:41,0,7,7
29,2025-05-25T01:44:00+02:00,2025-05-25,09:44,1,7,8
29,2025-05-25T01:47:00+02:00,2025-05-25,09:47,4,8,12
29,2025-05-25T01:52:00+02:00,2025-05-25,09:52,4,2,6
31,2025-05-25T01:40:00+02:00,2025-05-25,09:40,0,1,1
31,2025-05-25T01:41:00+02:00,2025-05-25,09:41,1,0,1
31,2025-05-25T01:48:00+02:00,2025-05-25,09:48,0,2,2
36,2025-05-25T01:47:00+02:00,2025-05-25,09:47,4,1,5
36,2025-05-25T01:52:00+02:00,2025-05-25,09:52,2,3,5
36,2025-05-25T01:54:00+02:00,2025-05-25,09:54,1,0,1
37,2025-05-25T01:54:00+02:00,2025-05-25,09:54,1,0,1
39,2025-05-25T01:47:00+02:00,2025-05-25,09:47,1,0,1
39,2025-05-25T01:48:00+02:00,2025-05-25,09:48,1,2,3
39,2025-05-25T01:51:00+02:00,2025-05-25,09:51,2,1,3
39,2025-05-25T01:52:00+02:00,2025-05-25,09:52,1,1,2
40,2025-05-25T01:41:00+02:00,2025-05-25,09:41,5,3,8
40,2025-05-25T01:42:00+02:00,2025-05-25,09:42,1,4,5
41,2025-05-25T01:41:00+02:00,2025-05-25,09:41,8,6,14
41,2025-05-25T01:44:00+02:00,2025-05-25,09:44,1,4,5
41,2025-05-25T01:48:00+02:00,2025-05-25,09:48,5,0,5
41,2025-05-25T01:53:00+02:00,2025-05-25,09:53,3,0,3
41,2025-05-25T01:54:00+02:00,2025-05-25,09:54,8,2,10
44,2025-05-25T01:45:00+02:00,2025-05-25,09:45,0,6,6
45,2025-05-25T01:43:00+02:00,2025-05-25,09:43,8,4,12
45,2025-05-25T01:46:00+02:00,2025-05-25,09:46,6,2,8
45,2025-05-25T01:47:00+02:00,2025-05-25,09:47,6,4,10
45,2025-05-25T01:49:00+02:00,2025-05-25,09:49,10,0,10
45,2025-05-25T01:52:00+02:00,2025-05-25,09:52,6,1,7
45,2025-05-25T01:54:00+02:00,2025-05-25,09:54,7,1,8
47,2025-05-25T01:40:00+02:00,2025-05-25,09:40,5,17,22
47,2025-05-25T01:45:00+02:00,2025-05-25,09:45,2,8,10
47,2025-05-25T01:46:00+02:00,2025-05-25,09:46,4,4,8
50,2025-05-25T01:47:00+02:00,2025-05-25,09:47,3,2,5
54,2025-05-25T01:40:00+02:00,2025-05-25,09:40,1,3,4
54,2025-05-25T01:52:00+02:00,2025-05-25,09:52,0,2,2
54,2025-05-25T01:54:00+02:00,2025-05-25,09:54,1,0,1
59,2025-05-25T01:40:00+02:00,2025-05-25,09:40,3,7,10
59,2025-05-25T01:45:00+02:00,2025-05-25,09:45,13,14,27
59,2025-05-25T01:50:00+02:00,2025-05-25,09:50,4,10,14
61,2025-05-25T01:41:00+02:00,2025-05-25,09:41,1,9,10
61,2025-05-25T01:44:00+02:00,2025-05-25,09:44,2,2,4
61,2025-05-25T01:46:00+02:00,2025-05-25,09:46,0,3,3
61,2025-05-25T01:48:00+02:00,2025-05-25,09:48,0,7,7
61,2025-05-25T01:49:00+02:00,2025-05-25,09:49,0,1,1
61,2025-05-25T01:51:00+02:00,2025-05-25,09:51,1,5,6
61,2025-05-25T01:53:00+02:00,2025-05-25,09:53,2,4,6
66,2025-05-25T01:45:00+02:00,2025-05-25,09:45,3,3,6
66,2025-05-25T01:46:00+02:00,2025-05-25,09:46,6,6,12
66,2025-05-25T01:47:00+02:00,2025-05-25,09:47,2,2,4
66,2025-05-25T01:51:00+02:00,2025-05-25,09:51,5,6,11
66,2025-05-25T01:52:00+02:00,2025-05-25,09:52,4,4,8
66,2025-05-25T01:53:00+02:00,2025-05-25,09:53,2,4,6
69,2025-05-25T01:40:00+02:00,2025-05-25,09:40,2,1,3
69,2025-05-25T01:42:00+02:00,2025-05-25,09:42,1,3,4
69,2025-05-25T01:45:00+02:00,2025-05-25,09:45,1,4,5
69,2025-05-25T01:46:00+02:00,2025-05-25,09:46,6,2,8
69,2025-05-25T01:51:00+02:00,2025-05-25,09:51,6,0,6
70,2025-05-25T01:45:00+02:00,2025-05-25,09:45,2,2,4
70,2025-05-25T01:47:00+02:00,2025-05-25,09:47,2,1,3
70,2025-05-25T01:51:00+02:00,2025-05-25,09:51,1,0,1
78,2025-05-25T01:46:00+02:00,2025-05-25,09:46,4,2,6
78,2025-05-25T01:47:00+02:00,2025-05-25,09:47,2,3,5
78,2025-05-25T01:49:00+02:00,2025-05-25,09:49,1,1,2
78,2025-05-25T01:50:00+02:00,2025-05-25,09:50,1,3,4
78,2025-05-25T01:51:00+02:00,2025-05-25,09:51,1,1,2
87,2025-05-25T01:40:00+02:00,2025-05-25,09:40,2,1,3
87,2025-05-25T01:42:00+02:00,2025-05-25,09:42,1,0,1
87,2025-05-25T01:53:00+02:00,2025-05-25,09:53,0,1,1
107,2025-05-25T01:50:00+02:00,2025-05-25,09:50,5,15,20
108,2025-05-25T01:41:00+02:00,2025-05-25,09:41,7,1,8
108,2025-05-25T01:51:00+02:00,2025-05-25,09:51,0,2,2
108,2025-05-25T01:54:00+02:00,2025-05-25,09:54,3,2,5
131,2025-05-25T01:45:00+02:00,2025-05-25,09:45,1,18,19
132,2025-05-25T01:45:00+02:00,2025-05-25,09:45,17,9,26
133,2025-05-25T01:40:00+02:00,2025-05-25,09:40,17,49,66
133,2025-05-25T01:45:00+02:00,2025-05-25,09:45,22,46,68
140,2025-05-25T01:50:00+02:00,2025-05-25,09:50,20,8,28
162,2025-05-25T01:40:00+02:00,2025-05-25,09:40,26,27,53
162,2025-05-25T01:50:00+02:00,2025-05-25,09:50,21,25,46
165,2025-05-25T01:40:00+02:00,2025-05-25,09:40,5,1,6
165,2025-05-25T01:50:00+02:00,2025-05-25,09:50,2,2,4
179,2025-05-25T01:40:00+02:00,2025-05-25,09:40,7,3,10
179,2025-05-25T01:50:00+02:00,2025-05-25,09:50,5,16,21
1,2025-05-25T01:40:00+02:00,2025-05-25,09:40,5,4,9
1,2025-05-25T01:42:00+02:00,2025-05-25,09:42,0,4,4
1,2025-05-25T01:44:00+02:00,2025-05-25,09:44,7,6,13
1,2025-05-25T01:45:00+02:00,2025-05-25,09:45,2,12,14
1,2025-05-25T01:53:00+02:00,2025-05-25,09:53,5,11,16
1,2025-05-25T01:54:00+02:00,2025-05-25,09:54,13,5,18
2,2025-05-25T01:43:00+02:00,2025-05-25,09:43,3,0,3
2,2025-05-25T01:49:00+02:00,2025-05-25,09:49,2,1,3
9,2025-05-25T01:40:00+02:00,2025-05-25,09:40,2,0,2
9,2025-05-25T01:41:00+02:00,2025-05-25,09:41,4,4,8
9,2025-05-25T01:47:00+02:00,2025-05-25,09:47,0,3,3
10,2025-05-25T01:51:00+02:00,2025-05-25,09:51,2,0,2
10,2025-05-25T01:53:00+02:00,2025-05-25,09:53,0,1,1
11,2025-05-25T01:41:00+02:00,2025-05-25,09:41,1,1,2
11,2025-05-25T01:43:00+02:00,2025-05-25,09:43,2,0,2
12,2025-05-25T01:41:00+02:00,2025-05-25,09:41,3,6,9
12,2025-05-25T01:44:00+02:00,2025-05-25,09:44,4,10,14
12,2025-05-25T01:45:00+02:00,2025-05-25,09:45,1,1,2
12,2025-05-25T01:46:00+02:00,2025-05-25,09:46,3,1,4
12,2025-05-25T01:47:00+02:00,2025-05-25,09:47,2,3,5
12,2025-05-25T01:51:00+02:00,2025-05-25,09:51,0,1,1
12,2025-05-25T01:52:00+02:00,2025-05-25,09:52,4,4,8
12,2025-05-25T01:53:00+02:00,2025-05-25,09:53,1,4,5
12,2025-05-25T01:54:00+02:00,2025-05-25,09:54,2,1,3
17,2025-05-25T01:43:00+02:00,2025-05-25,09:43,1,2,3
17,2025-05-25T01:44:00+02:00,2025-05-25,09:44,2,3,5
17,2025-05-25T01:45:00+02:00,2025-05-25,09:45,8,0,8
17,2025-05-25T01:46:00+02:00,2025-05-25,09:46,2,2,4
17,2025-05-25T01:47:00+02:00,2025-05-25,09:47,1,0,1
17,2025-05-25T01:48:00+02:00,2025-05-25,09:48,0,7,7
17,2025-05-25T01:52:00+02:00,2025-05-25,09:52,0,1,1
17,2025-05-25T01:54:00+02:00,2025-05-25,09:54,2,0,2
18,2025-05-25T01:41:00+02:00,2025-05-25,09:41,0,4,4
18,2025-05-25T01:47:00+02:00,2025-05-25,09:47,0,1,1
18,2025-05-25T01:52:00+02:00,2025-05-25,09:52,0,4,4
19,2025-05-25T01:41:00+02:00,2025-05-25,09:41,3,2,5
19,2025-05-25T01:44:00+02:00,2025-05-25,09:44,0,2,2
19,2025-05-25T01:48:00+02:00,2025-05-25,09:48,0,2,2
19,2025-05-25T01:53:00+02:00,2025-05-25,09:53,5,1,6
20,2025-05-25T01:42:00+02:00,2025-05-25,09:42,0,1,1
20,2025-05-25T01:43:00+02:00,2025-05-25,09:43,2,0,2
20,2025-05-25T01:45:00+02:00,2025-05-25,09:45,2,6,8
20,2025-05-25T01:47:00+02:00,2025-05-25,09:47,9,2,11
20,2025-05-25T01:48:00+02:00,2025-05-25,09:48,1,3,4
23,2025-05-25T01:42:00+02:00,2025-05-25,09:42,3,2,5
23,2025-05-25T01:43:00+02:00,2025-05-25,09:43,3,3,6
23,2025-05-25T01:44:00+02:00,2025-05-25,09:44,0,9,9
23,2025-05-25T01:47:00+02:00,2025-05-25,09:47,6,1,7
23,2025-05-25T01:49:00+02:00,2025-05-25,09:49,0,12,12
23,2025-05-25T01:50:00+02:00,2025-05-25,09:50,1,11,12
24,2025-05-25T01:41:00+02:00,2025-05-25,09:41,1,2,3
24,2025-05-25T01:44:00+02:00,2025-05-25,09:44,6,2,8
24,2025-05-25T01:46:00+02:00,2025-05-25,09:46,6,0,6
24,2025-05-25T01:49:00+02:00,2025-05-25,09:49,13,6,19
24,2025-05-25T01:52:00+02:00,2025-05-25,09:52,14,0,14
24,2025-05-25T01:53:00+02:00,2025-05-25,09:53,3,4,7
25,2025-05-25T01:45:00+02:00,2025-05-25,09:45,18,70,88
25,2025-05-25T01:50:00+02:00,2025-05-25,09:50,23,68,91
27,2025-05-25T01:41:00+02:00,2025-05-25,09:41,0,4,4
27,2025-05-25T01:45:00+02:00,2025-05-25,09:45,2,6,8
27,2025-05-25T01:47:00+02:00,2025-05-25,09:47,2,4,6
27,2025-05-25T01:48:00+02:00,2025-05-25,09:48,1,6,7
27,2025-05-25T01:49:00+02:00,2025-05-25,09:49,7,0,7
27,2025-05-25T01:51:00+02:00,2025-05-25,09:51,7,0,7
27,2025-05-25T01:52:00+02:00,2025-05-25,09:52,7,2,9
30,2025-05-25T01:48:00+02:00,2025-05-25,09:48,1,1,2
30,2025-05-25T01:52:00+02:00,2025-05-25,09:52,3,3,6
30,2025-05-25T01:53:00+02:00,2025-05-25,09:53,3,0,3
35,2025-05-25T01:43:00+02:00,2025-05-25,09:43,8,10,18
35,2025-05-25T01:48:00+02:00,2025-05-25,09:48,20,19,39
35,2025-05-25T01:51:00+02:00,2025-05-25,09:51,9,4,13
35,2025-05-25T01:52:00+02:00,2025-05-25,09:52,14,7,21
35,2025-05-25T01:54:00+02:00,2025-05-25,09:54,11,10,21
46,2025-05-25T01:40:00+02:00,2025-05-25,09:40,2,3,5
46,2025-05-25T01:45:00+02:00,2025-05-25,09:45,2,3,5
46,2025-05-25T01:50:00+02:00,2025-05-25,09:50,2,5,7
48,2025-05-25T01:41:00+02:00,2025-05-25,09:41,3,8,11
48,2025-05-25T01:43:00+02:00,2025-05-25,09:43,6,1,7
48,2025-05-25T01:44:00+02:00,2025-05-25,09:44,8,3,11
48,2025-05-25T01:45:00+02:00,2025-05-25,09:45,3,3,6
48,2025-05-25T01:46:00+02:00,2025-05-25,09:46,4,5,9
48,2025-05-25T01:48:00+02:00,2025-05-25,09:48,9,0,9
48,2025-05-25T01:49:00+02:00,2025-05-25,09:49,6,9,15
48,2025-05-25T01:51:00+02:00,2025-05-25,09:51,3,1,4
48,2025-05-25T01:53:00+02:00,2025-05-25,09:53,4,7,11
49,2025-05-25T01:40:00+02:00,2025-05-25,09:40,5,4,9
49,2025-05-25T01:41:00+02:00,2025-05-25,09:41,9,2,11
49,2025-05-25T01:43:00+02:00,2025-05-25,09:43,10,8,18
49,2025-05-25T01:44:00+02:00,2025-05-25,09:44,5,10,15
49,2025-05-25T01:45:00+02:00,2025-05-25,09:45,3,3,6
49,2025-05-25T01:46:00+02:00,2025-05-25,09:46,4,2,6
49,2025-05-25T01:47:00+02:00,2025-05-25,09:47,4,8,12
49,2025-05-25T01:48:00+02:00,2025-05-25,09:48,5,4,9
49,2025-05-25T01:54:00+02:00,2025-05-25,09:54,7,5,12
51,2025-05-25T01:42:00+02:00,2025-05-25,09:42,2,0,2
51,2025-05-25T01:47:00+02:00,2025-05-25,09:47,0,1,1
52,2025-05-25T01:42:00+02:00,2025-05-25,09:42,0,2,2
52,2025-05-25T01:46:00+02:00,2025-05-25,09:46,3,0,3
52,2025-05-25T01:47:00+02:00,2025-05-25,09:47,4,3,7
52,2025-05-25T01:48:00+02:00,2025-05-25,09:48,0,1,1
52,2025-05-25T01:49:00+02:00,2025-05-25,09:49,1,2,3
52,2025-05-25T01:53:00+02:00,2025-05-25,09:53,8,2,10
53,2025-05-25T01:42:00+02:00,2025-05-25,09:42,13,1,14
53,2025-05-25T01:43:00+02:00,2025-05-25,09:43,4,1,5
53,2025-05-25T01:44:00+02:00,2025-05-25,09:44,7,0,7
53,2025-05-25T01:47:00+02:00,2025-05-25,09:47,1,3,4
53,2025-05-25T01:48:00+02:00,2025-05-25,09:48,0,7,7
53,2025-05-25T01:50:00+02:00,2025-05-25,09:50,9,3,12
53,2025-05-25T01:52:00+02:00,2025-05-25,09:52,2,0,2
53,2025-05-25T01:53:00+02:00,2025-05-25,09:53,7,1,8
56,2025-05-25T01:40:00+02:00,2025-05-25,09:40,3,1,4
56,2025-05-25T01:41:00+02:00,2025-05-25,09:41,5,0,5
56,2025-05-25T01:43:00+02:00,2025-05-25,09:43,3,1,4
56,2025-05-25T01:46:00+02:00,2025-05-25,09:46,12,6,18
56,2025-05-25T01:48:00+02:00,2025-05-25,09:48,5,3,8
56,2025-05-25T01:49:00+02:00,2025-05-25,09:49,3,2,5
56,2025-05-25T01:50:00+02:00,2025-05-25,09:50,6,5,11
58,2025-05-25T01:46:00+02:00,2025-05-25,09:46,9,4,13
58,2025-05-25T01:49:00+02:00,2025-05-25,09:49,19,2,21
58,2025-05-25T01:51:00+02:00,2025-05-25,09:51,6,8,14
62,2025-05-25T01:41:00+02:00,2025-05-25,09:41,2,2,4
62,2025-05-25T01:42:00+02:00,2025-05-25,09:42,6,3,9
62,2025-05-25T01:43:00+02:00,2025-05-25,09:43,1,3,4
62,2025-05-25T01:49:00+02:00,2025-05-25,09:49,3,0,3
62,2025-05-25T01:52:00+02:00,2025-05-25,09:52,1,1,2
62,2025-05-25T01:54:00+02:00,2025-05-25,09:54,3,0,3
63,2025-05-25T01:41:00+02:00,2025-05-25,09:41,2,2,4
63,2025-05-25T01:47:00+02:00,2025-05-25,09:47,8,2,10
63,2025-05-25T01:50:00+02:00,2025-05-25,09:50,4,7,11
63,2025-05-25T01:54:00+02:00,2025-05-25,09:54,4,6,10
67,2025-05-25T01:40:00+02:00,2025-05-25,09:40,2,11,13
67,2025-05-25T01:41:00+02:00,2025-05-25,09:41,9,5,14
67,2025-05-25T01:42:00+02:00,2025-05-25,09:42,0,5,5
67,2025-05-25T01:43:00+02:00,2025-05-25,09:43,3,4,7
67,2025-05-25T01:45:00+02:00,2025-05-25,09:45,3,5,8
67,2025-05-25T01:47:00+02:00,2025-05-25,09:47,4,3,7
67,2025-05-25T01:48:00+02:00,2025-05-25,09:48,3,10,13
67,2025-05-25T01:49:00+02:00,2025-05-25,09:49,2,3,5
67,2025-05-25T01:50:00+02:00,2025-05-25,09:50,2,5,7
68,2025-05-25T01:49:00+02:00,2025-05-25,09:49,5,3,8
68,2025-05-25T01:52:00+02:00,2025-05-25,09:52,3,8,11
72,2025-05-25T01:44:00+02:00,2025-05-25,09:44,5,1,6
72,2025-05-25T01:47:00+02:00,2025-05-25,09:47,0,4,4
72,2025-05-25T01:54:00+02:00,2025-05-25,09:54,3,5,8
76,2025-05-25T01:43:00+02:00,2025-05-25,09:43,0,1,1
76,2025-05-25T01:48:00+02:00,2025-05-25,09:48,1,3,4
76,2025-05-25T01:49:00+02:00,2025-05-25,09:49,1,0,1
79,2025-05-25T01:41:00+02:00,2025-05-25,09:41,8,2,10
79,2025-05-25T01:46:00+02:00,2025-05-25,09:46,4,3,7
79,2025-05-25T01:48:00+02:00,2025-05-25,09:48,13,5,18
79,2025-05-25T01:49:00+02:00,2025-05-25,09:49,3,2,5
79,2025-05-25T01:51:00+02:00,2025-05-25,09:51,8,7,15
85,2025-05-25T01:41:00+02:00,2025-05-25,09:41,0,1,1
85,2025-05-25T01:42:00+02:00,2025-05-25,09:42,1,2,3
85,2025-05-25T01:43:00+02:00,2025-05-25,09:43,0,1,1
85,2025-05-25T01:46:00+02:00,2025-05-25,09:46,3,0,3
85,2025-05-25T01:47:00+02:00,2025-05-25,09:47,1,1,2
85,2025-05-25T01:48:00+02:00,2025-05-25,09:48,2,1,3
85,2025-05-25T01:50:00+02:00,2025-05-25,09:50,1,1,2
85,2025-05-25T01:54:00+02:00,2025-05-25,09:54,1,4,5
86,2025-05-25T01:40:00+02:00,2025-05-25,09:40,3,1,4
86,2025-05-25T01:43:00+02:00,2025-05-25,09:43,3,4,7
86,2025-05-25T01:45:00+02:00,2025-05-25,09:45,0,2,2
86,2025-05-25T01:46:00+02:00,2025-05-25,09:46,1,0,1
86,2025-05-25T01:47:00+02:00,2025-05-25,09:47,3,2,5
86,2025-05-25T01:52:00+02:00,2025-05-25,09:52,1,1,2
109,2025-05-25T01:50:00+02:00,2025-05-25,09:50,2,6,8
123,2025-05-25T01:45:00+02:00,2025-05-25,09:45,4,4,8
137,2025-05-25T01:40:00+02:00,2025-05-25,09:40,1,4,5
139,2025-05-25T01:40:00+02:00,2025-05-25,09:40,1,1,2
139,2025-05-25T01:45:00+02:00,2025-05-25,09:45,1,0,1
141,2025-05-25T01:40:00+02:00,2025-05-25,09:40,19,11,30
142,2025-05-25T01:45:00+02:00,2025-05-25,09:45,46,20,66
164,2025-05-25T01:40:00+02:00,2025-05-25,09:40,8,3,11
164,2025-05-25T01:45:00+02:00,2025-05-25,09:45,10,9,19
164,2025-05-25T01:50:00+02:00,2025-05-25,09:50,10,4,14
181,2025-05-25T01:41:00+02:00,2025-05-25,09:41,4,11,15
181,2025-05-25T01:44:00+02:00,2025-05-25,09:44,0,5,5
181,2025-05-25T01:46:00+02:00,2025-05-25,09:46,2,12,14
181,2025-05-25T01:48:00+02:00,2025-05-25,09:48,1,13,14
181,2025-05-25T01:49:00+02:00,2025-05-25,09:49,0,6,6
181,2025-05-25T01:54:00+02:00,2025-05-25,09:54,1,10,11
182,2025-05-25T01:40:00+02:00,2025-05-25,09:40,11,4,15
182,2025-05-25T01:50:00+02:00,2025-05-25,09:50,11,9,20
180,2025-05-25T01:40:00+02:00,2025-05-25,09:40,1,0,1
180,2025-05-25T01:41:00+02:00,2025-05-25,09:41,4,0,4
180,2025-05-25T01:46:00+02:00,2025-05-25,09:46,0,2,2
180,2025-05-25T01:49:00+02:00,2025-05-25,09:49,1,0,1
180,2025-05-25T01:51:00+02:00,2025-05-25,09:51,2,0,2
181,2025-05-25T01:55:00+02:00,2025-05-25,09:55,5,15,20
181,2025-05-25T01:56:00+02:00,2025-05-25,09:56,6,5,11
181,2025-05-25T01:58:00+02:00,2025-05-25,09:58,3,14,17
181,2025-05-25T02:01:00+02:00,2025-05-25,10:01,3,17,20
181,2025-05-25T02:03:00+02:00,2025-05-25,10:03,7,4,11
181,2025-05-25T02:04:00+02:00,2025-05-25,10:04,1,10,11
181,2025-05-25T02:05:00+02:00,2025-05-25,10:05,7,15,22
181,2025-05-25T02:07:00+02:00,2025-05-25,10:07,1,22,23
181,2025-05-25T02:08:00+02:00,2025-05-25,10:08,3,8,11
180,2025-05-25T01:56:00+02:00,2025-05-25,09:56,2,1,3
3,2025-05-25T02:00:00+02:00,2025-05-25,10:00,1,6,7
3,2025-05-25T02:08:00+02:00,2025-05-25,10:08,4,10,14
4,2025-05-25T01:58:00+02:00,2025-05-25,09:58,14,5,19
4,2025-05-25T02:01:00+02:00,2025-05-25,10:01,10,15,25
4,2025-05-25T02:04:00+02:00,2025-05-25,10:04,13,2,15
4,2025-05-25T02:06:00+02:00,2025-05-25,10:06,8,5,13
6,2025-05-25T01:56:00+02:00,2025-05-25,09:56,7,18,25
6,2025-05-25T01:57:00+02:00,2025-05-25,09:57,11,9,20
6,2025-05-25T01:59:00+02:00,2025-05-25,09:59,10,10,20
8,2025-05-25T01:56:00+02:00,2025-05-25,09:56,3,7,10
8,2025-05-25T02:03:00+02:00,2025-05-25,10:03,5,2,7
8,2025-05-25T02:04:00+02:00,2025-05-25,10:04,3,2,5
8,2025-05-25T02:07:00+02:00,2025-05-25,10:07,1,5,6
8,2025-05-25T02:08:00+02:00,2025-05-25,10:08,1,5,6
8,2025-05-25T02:09:00+02:00,2025-05-25,10:09,1,7,8
28,2025-05-25T01:55:00+02:00,2025-05-25,09:55,3,2,5
28,2025-05-25T02:00:00+02:00,2025-05-25,10:00,1,5,6
28,2025-05-25T02:05:00+02:00,2025-05-25,10:05,8,0,8
28,2025-05-25T02:08:00+02:00,2025-05-25,10:08,4,4,8
29,2025-05-25T01:56:00+02:00,2025-05-25,09:56,4,12,16
29,2025-05-25T02:01:00+02:00,2025-05-25,10:01,4,4,8
29,2025-05-25T02:02:00+02:00,2025-05-25,10:02,3,5,8
29,2025-05-25T02:06:00+02:00,2025-05-25,10:06,6,5,11
29,2025-05-25T02:09:00+02:00,2025-05-25,10:09,2,3,5
31,2025-05-25T01:59:00+02:00,2025-05-25,09:59,0,1,1
31,2025-05-25T02:05:00+02:00,2025-05-25,10:05,5,0,5
36,2025-05-25T01:55:00+02:00,2025-05-25,09:55,2,1,3
36,2025-05-25T02:00:00+02:00,2025-05-25,10:00,0,1,1
36,2025-05-25T02:01:00+02:00,2025-05-25,10:01,0,1,1
36,2025-05-25T02:05:00+02:00,2025-05-25,10:05,1,1,2
36,2025-05-25T02:07:00+02:00,2025-05-25,10:07,6,0,6
36,2025-05-25T02:08:00+02:00,2025-05-25,10:08,1,4,5
37,2025-05-25T01:58:00+02:00,2025-05-25,09:58,1,0,1
37,2025-05-25T02:00:00+02:00,2025-05-25,10:00,1,0,1
37,2025-05-25T02:02:00+02:00,2025-05-25,10:02,2,1,3
37,2025-05-25T02:03:00+02:00,2025-05-25,10:03,2,0,2
37,2025-05-25T02:04:00+02:00,2025-05-25,10:04,2,3,5
37,2025-05-25T02:07:00+02:00,2025-05-25,10:07,0,1,1
37,2025-05-25T02:09:00+02:00,2025-05-25,10:09,1,0,1
39,2025-05-25T01:56:00+02:00,2025-05-25,09:56,1,4,5
39,2025-05-25T02:05:00+02:00,2025-05-25,10:05,1,0,1
40,2025-05-25T01:55:00+02:00,2025-05-25,09:55,6,1,7
40,2025-05-25T02:03:00+02:00,2025-05-25,10:03,5,2,7
40,2025-05-25T02:09:00+02:00,2025-05-25,10:09,2,1,3
41,2025-05-25T01:57:00+02:00,2025-05-25,09:57,0,2,2
41,2025-05-25T01:58:00+02:00,2025-05-25,09:58,4,2,6
41,2025-05-25T02:00:00+02:00,2025-05-25,10:00,2,1,3
41,2025-05-25T02:01:00+02:00,2025-05-25,10:01,0,4,4
43,2025-05-25T02:00:00+02:00,2025-05-25,10:00,3,3,6
44,2025-05-25T02:00:00+02:00,2025-05-25,10:00,3,5,8
45,2025-05-25T01:57:00+02:00,2025-05-25,09:57,0,5,5
45,2025-05-25T02:00:00+02:00,2025-05-25,10:00,8,2,10
45,2025-05-25T02:01:00+02:00,2025-05-25,10:01,7,3,10
45,2025-05-25T02:02:00+02:00,2025-05-25,10:02,5,5,10
45,2025-05-25T02:03:00+02:00,2025-05-25,10:03,8,5,13
45,2025-05-25T02:05:00+02:00,2025-05-25,10:05,8,1,9
45,2025-05-25T02:06:00+02:00,2025-05-25,10:06,4,3,7
47,2025-05-25T01:55:00+02:00,2025-05-25,09:55,11,17,28
47,2025-05-25T01:56:00+02:00,2025-05-25,09:56,6,11,17
47,2025-05-25T02:01:00+02:00,2025-05-25,10:01,11,6,17
47,2025-05-25T02:04:00+02:00,2025-05-25,10:04,6,6,12
47,2025-05-25T02:07:00+02:00,2025-05-25,10:07,9,5,14
47,2025-05-25T02:08:00+02:00,2025-05-25,10:08,3,9,12
50,2025-05-25T01:57:00+02:00,2025-05-25,09:57,2,5,7
50,2025-05-25T01:59:00+02:00,2025-05-25,09:59,0,2,2
50,2025-05-25T02:01:00+02:00,2025-05-25,10:01,0,3,3
50,2025-05-25T02:06:00+02:00,2025-05-25,10:06,0,5,5
54,2025-05-25T01:56:00+02:00,2025-05-25,09:56,1,2,3
54,2025-05-25T02:00:00+02:00,2025-05-25,10:00,0,1,1
54,2025-05-25T02:01:00+02:00,2025-05-25,10:01,2,0,2
54,2025-05-25T02:09:00+02:00,2025-05-25,10:09,0,2,2
59,2025-05-25T01:55:00+02:00,2025-05-25,09:55,13,20,33
59,2025-05-25T02:00:00+02:00,2025-05-25,10:00,6,11,17
61,2025-05-25T01:55:00+02:00,2025-05-25,09:55,4,2,6
61,2025-05-25T01:56:00+02:00,2025-05-25,09:56,7,7,14
61,2025-05-25T01:59:00+02:00,2025-05-25,09:59,0,9,9
61,2025-05-25T02:00:00+02:00,2025-05-25,10:00,1,2,3
61,2025-05-25T02:01:00+02:00,2025-05-25,10:01,0,4,4
61,2025-05-25T02:03:00+02:00,2025-05-25,10:03,3,1,4
61,2025-05-25T02:04:00+02:00,2025-05-25,10:04,0,6,6
61,2025-05-25T02:05:00+02:00,2025-05-25,10:05,3,5,8
61,2025-05-25T02:06:00+02:00,2025-05-25,10:06,0,2,2
61,2025-05-25T02:08:00+02:00,2025-05-25,10:08,2,5,7
66,2025-05-25T01:56:00+02:00,2025-05-25,09:56,3,10,13
66,2025-05-25T01:59:00+02:00,2025-05-25,09:59,5,5,10
66,2025-05-25T02:00:00+02:00,2025-05-25,10:00,8,6,14
66,2025-05-25T02:07:00+02:00,2025-05-25,10:07,3,5,8
66,2025-05-25T02:09:00+02:00,2025-05-25,10:09,6,4,10
69,2025-05-25T01:56:00+02:00,2025-05-25,09:56,4,3,7
69,2025-05-25T01:58:00+02:00,2025-05-25,09:58,5,0,5
69,2025-05-25T02:01:00+02:00,2025-05-25,10:01,4,0,4
69,2025-05-25T02:02:00+02:00,2025-05-25,10:02,4,0,4
69,2025-05-25T02:05:00+02:00,2025-05-25,10:05,5,2,7
69,2025-05-25T02:07:00+02:00,2025-05-25,10:07,4,1,5
70,2025-05-25T01:57:00+02:00,2025-05-25,09:57,1,0,1
70,2025-05-25T01:59:00+02:00,2025-05-25,09:59,1,1,2
70,2025-05-25T02:01:00+02:00,2025-05-25,10:01,1,1,2
70,2025-05-25T02:02:00+02:00,2025-05-25,10:02,6,0,6
70,2025-05-25T02:03:00+02:00,2025-05-25,10:03,1,1,2
70,2025-05-25T02:06:00+02:00,2025-05-25,10:06,2,1,3
71,2025-05-25T01:57:00+02:00,2025-05-25,09:57,0,1,1
75,2025-05-25T01:56:00+02:00,2025-05-25,09:56,0,2,2
75,2025-05-25T01:57:00+02:00,2025-05-25,09:57,1,1,2
75,2025-05-25T02:03:00+02:00,2025-05-25,10:03,2,1,3
75,2025-05-25T02:09:00+02:00,2025-05-25,10:09,0,1,1
77,2025-05-25T02:05:00+02:00,2025-05-25,10:05,8,8,16
78,2025-05-25T01:55:00+02:00,2025-05-25,09:55,1,0,1
78,2025-05-25T01:59:00+02:00,2025-05-25,09:59,0,2,2
78,2025-05-25T02:01:00+02:00,2025-05-25,10:01,0,2,2
78,2025-05-25T02:04:00+02:00,2025-05-25,10:04,0,3,3
87,2025-05-25T01:55:00+02:00,2025-05-25,09:55,0,1,1
87,2025-05-25T01:56:00+02:00,2025-05-25,09:56,1,3,4
87,2025-05-25T01:58:00+02:00,2025-05-25,09:58,1,0,1
87,2025-05-25T02:00:00+02:00,2025-05-25,10:00,0,1,1
87,2025-05-25T02:01:00+02:00,2025-05-25,10:01,0,2,2
87,2025-05-25T02:06:00+02:00,2025-05-25,10:06,2,2,4
87,2025-05-25T02:09:00+02:00,2025-05-25,10:09,1,1,2
108,2025-05-25T01:55:00+02:00,2025-05-25,09:55,2,0,2
108,2025-05-25T01:58:00+02:00,2025-05-25,09:58,3,2,5
108,2025-05-25T02:00:00+02:00,2025-05-25,10:00,1,0,1
108,2025-05-25T02:05:00+02:00,2025-05-25,10:05,1,1,2
108,2025-05-25T02:06:00+02:00,2025-05-25,10:06,1,0,1
108,2025-05-25T02:09:00+02:00,2025-05-25,10:09,0,1,1
118,2025-05-25T01:55:00+02:00,2025-05-25,09:55,0,2,2
124,2025-05-25T01:55:00+02:00,2025-05-25,09:55,0,1,1
135,2025-05-25T01:55:00+02:00,2025-05-25,09:55,20,28,48
135,2025-05-25T02:00:00+02:00,2025-05-25,10:00,39,13,52
140,2025-05-25T01:55:00+02:00,2025-05-25,09:55,12,3,15
140,2025-05-25T02:00:00+02:00,2025-05-25,10:00,9,6,15
162,2025-05-25T02:00:00+02:00,2025-05-25,10:00,28,32,60
166,2025-05-25T02:00:00+02:00,2025-05-25,10:00,4,3,7
167,2025-05-25T01:55:00+02:00,2025-05-25,09:55,3,4,7
179,2025-05-25T01:55:00+02:00,2025-05-25,09:55,1,1,2
179,2025-05-25T02:05:00+02:00,2025-05-25,10:05,3,0,3
1,2025-05-25T01:57:00+02:00,2025-05-25,09:57,2,21,23
1,2025-05-25T02:00:00+02:00,2025-05-25,10:00,3,10,13
1,2025-05-25T02:01:00+02:00,2025-05-25,10:01,4,1,5
1,2025-05-25T02:05:00+02:00,2025-05-25,10:05,9,12,21
1,2025-05-25T02:08:00+02:00,2025-05-25,10:08,6,8,14
1,2025-05-25T02:09:00+02:00,2025-05-25,10:09,3,3,6
2,2025-05-25T01:56:00+02:00,2025-05-25,09:56,1,8,9
2,2025-05-25T02:00:00+02:00,2025-05-25,10:00,5,3,8
2,2025-05-25T02:02:00+02:00,2025-05-25,10:02,2,3,5
2,2025-05-25T02:06:00+02:00,2025-05-25,10:06,1,2,3
2,2025-05-25T02:08:00+02:00,2025-05-25,10:08,1,0,1
9,2025-05-25T01:56:00+02:00,2025-05-25,09:56,1,2,3
9,2025-05-25T02:00:00+02:00,2025-05-25,10:00,1,1,2
9,2025-05-25T02:09:00+02:00,2025-05-25,10:09,2,0,2
10,2025-05-25T01:59:00+02:00,2025-05-25,09:59,0,3,3
10,2025-05-25T02:07:00+02:00,2025-05-25,10:07,1,0,1
11,2025-05-25T02:01:00+02:00,2025-05-25,10:01,0,2,2
11,2025-05-25T02:02:00+02:00,2025-05-25,10:02,2,0,2
11,2025-05-25T02:05:00+02:00,2025-05-25,10:05,3,8,11
11,2025-05-25T02:08:00+02:00,2025-05-25,10:08,0,2,2
12,2025-05-25T01:56:00+02:00,2025-05-25,09:56,4,2,6
12,2025-05-25T01:59:00+02:00,2025-05-25,09:59,1,4,5
12,2025-05-25T02:00:00+02:00,2025-05-25,10:00,1,2,3
12,2025-05-25T02:03:00+02:00,2025-05-25,10:03,3,3,6
12,2025-05-25T02:04:00+02:00,2025-05-25,10:04,2,1,3
12,2025-05-25T02:05:00+02:00,2025-05-25,10:05,3,5,8
12,2025-05-25T02:09:00+02:00,2025-05-25,10:09,3,3,6
17,2025-05-25T01:57:00+02:00,2025-05-25,09:57,3,2,5
17,2025-05-25T01:59:00+02:00,2025-05-25,09:59,2,2,4
17,2025-05-25T02:01:00+02:00,2025-05-25,10:01,2,4,6
17,2025-05-25T02:02:00+02:00,2025-05-25,10:02,0,2,2
17,2025-05-25T02:06:00+02:00,2025-05-25,10:06,1,0,1
17,2025-05-25T02:08:00+02:00,2025-05-25,10:08,7,1,8
19,2025-05-25T01:58:00+02:00,2025-05-25,09:58,2,5,7
19,2025-05-25T02:00:00+02:00,2025-05-25,10:00,4,8,12
19,2025-05-25T02:03:00+02:00,2025-05-25,10:03,0,1,1
20,2025-05-25T01:56:00+02:00,2025-05-25,09:56,0,3,3
20,2025-05-25T01:57:00+02:00,2025-05-25,09:57,0,1,1
20,2025-05-25T01:59:00+02:00,2025-05-25,09:59,3,2,5
20,2025-05-25T02:03:00+02:00,2025-05-25,10:03,6,0,6
20,2025-05-25T02:09:00+02:00,2025-05-25,10:09,9,2,11
23,2025-05-25T01:55:00+02:00,2025-05-25,09:55,3,1,4
23,2025-05-25T01:57:00+02:00,2025-05-25,09:57,3,5,8
23,2025-05-25T01:59:00+02:00,2025-05-25,09:59,2,4,6
23,2025-05-25T02:05:00+02:00,2025-05-25,10:05,2,6,8
23,2025-05-25T02:07:00+02:00,2025-05-25,10:07,3,1,4
24,2025-05-25T01:57:00+02:00,2025-05-25,09:57,9,3,12
24,2025-05-25T02:05:00+02:00,2025-05-25,10:05,12,14,26
24,2025-05-25T02:08:00+02:00,2025-05-25,10:08,7,8,15
25,2025-05-25T02:00:00+02:00,2025-05-25,10:00,26,47,73
27,2025-05-25T01:57:00+02:00,2025-05-25,09:57,3,4,7
27,2025-05-25T01:58:00+02:00,2025-05-25,09:58,7,0,7
27,2025-05-25T02:02:00+02:00,2025-05-25,10:02,3,7,10
27,2025-05-25T02:08:00+02:00,2025-05-25,10:08,8,0,8
27,2025-05-25T02:09:00+02:00,2025-05-25,10:09,6,3,9
30,2025-05-25T01:58:00+02:00,2025-05-25,09:58,0,11,11
30,2025-05-25T02:04:00+02:00,2025-05-25,10:04,0,5,5
30,2025-05-25T02:05:00+02:00,2025-05-25,10:05,0,5,5
35,2025-05-25T01:56:00+02:00,2025-05-25,09:56,17,4,21
35,2025-05-25T02:00:00+02:00,2025-05-25,10:00,14,20,34
35,2025-05-25T02:02:00+02:00,2025-05-25,10:02,17,8,25
35,2025-05-25T02:03:00+02:00,2025-05-25,10:03,10,5,15
35,2025-05-25T02:05:00+02:00,2025-05-25,10:05,21,16,37
35,2025-05-25T02:07:00+02:00,2025-05-25,10:07,13,6,19
46,2025-05-25T02:00:00+02:00,2025-05-25,10:00,4,5,9
46,2025-05-25T02:05:00+02:00,2025-05-25,10:05,4,2,6
48,2025-05-25T01:55:00+02:00,2025-05-25,09:55,6,3,9
48,2025-05-25T01:56:00+02:00,2025-05-25,09:56,4,9,13
48,2025-05-25T01:57:00+02:00,2025-05-25,09:57,5,5,10
48,2025-05-25T01:58:00+02:00,2025-05-25,09:58,8,7,15
48,2025-05-25T02:00:00+02:00,2025-05-25,10:00,3,1,4
48,2025-05-25T02:03:00+02:00,2025-05-25,10:03,3,3,6
48,2025-05-25T02:04:00+02:00,2025-05-25,10:04,5,7,12
48,2025-05-25T02:05:00+02:00,2025-05-25,10:05,6,13,19
48,2025-05-25T02:07:00+02:00,2025-05-25,10:07,14,10,24
48,2025-05-25T02:09:00+02:00,2025-05-25,10:09,2,2,4
49,2025-05-25T01:55:00+02:00,2025-05-25,09:55,7,6,13
49,2025-05-25T01:57:00+02:00,2025-05-25,09:57,4,5,9
49,2025-05-25T01:59:00+02:00,2025-05-25,09:59,12,4,16
49,2025-05-25T02:05:00+02:00,2025-05-25,10:05,4,8,12
49,2025-05-25T02:07:00+02:00,2025-05-25,10:07,9,6,15
49,2025-05-25T02:08:00+02:00,2025-05-25,10:08,4,8,12
51,2025-05-25T01:56:00+02:00,2025-05-25,09:56,3,2,5
51,2025-05-25T01:59:00+02:00,2025-05-25,09:59,2,1,3
51,2025-05-25T02:00:00+02:00,2025-05-25,10:00,4,1,5
51,2025-05-25T02:01:00+02:00,2025-05-25,10:01,1,3,4
51,2025-05-25T02:02:00+02:00,2025-05-25,10:02,0,1,1
51,2025-05-25T02:07:00+02:00,2025-05-25,10:07,0,4,4
51,2025-05-25T02:08:00+02:00,2025-05-25,10:08,4,0,4
52,2025-05-25T01:57:00+02:00,2025-05-25,09:57,3,1,4
52,2025-05-25T01:59:00+02:00,2025-05-25,09:59,3,3,6
52,2025-05-25T02:03:00+02:00,2025-05-25,10:03,4,0,4
52,2025-05-25T02:04:00+02:00,2025-05-25,10:04,1,1,2
52,2025-05-25T02:08:00+02:00,2025-05-25,10:08,0,2,2
53,2025-05-25T01:56:00+02:00,2025-05-25,09:56,6,13,19
53,2025-05-25T02:08:00+02:00,2025-05-25,10:08,2,3,5
53,2025-05-25T02:09:00+02:00,2025-05-25,10:09,3,2,5
56,2025-05-25T02:06:00+02:00,2025-05-25,10:06,9,3,12
58,2025-05-25T01:56:00+02:00,2025-05-25,09:56,7,5,12
58,2025-05-25T01:57:00+02:00,2025-05-25,09:57,2,2,4
58,2025-05-25T02:02:00+02:00,2025-05-25,10:02,17,3,20
58,2025-05-25T02:05:00+02:00,2025-05-25,10:05,14,3,17
58,2025-05-25T02:06:00+02:00,2025-05-25,10:06,3,1,4
58,2025-05-25T02:08:00+02:00,2025-05-25,10:08,9,3,12
58,2025-05-25T02:09:00+02:00,2025-05-25,10:09,4,2,6
62,2025-05-25T01:59:00+02:00,2025-05-25,09:59,2,2,4
62,2025-05-25T02:00:00+02:00,2025-05-25,10:00,1,0,1
62,2025-05-25T02:02:00+02:00,2025-05-25,10:02,1,2,3
62,2025-05-25T02:03:00+02:00,2025-05-25,10:03,6,1,7
62,2025-05-25T02:07:00+02:00,2025-05-25,10:07,0,2,2
63,2025-05-25T01:57:00+02:00,2025-05-25,09:57,5,0,5
63,2025-05-25T01:58:00+02:00,2025-05-25,09:58,2,1,3
67,2025-05-25T01:57:00+02:00,2025-05-25,09:57,4,1,5
67,2025-05-25T01:58:00+02:00,2025-05-25,09:58,4,8,12
67,2025-05-25T02:01:00+02:00,2025-05-25,10:01,3,0,3
67,2025-05-25T02:04:00+02:00,2025-05-25,10:04,2,3,5
67,2025-05-25T02:08:00+02:00,2025-05-25,10:08,3,0,3
67,2025-05-25T02:09:00+02:00,2025-05-25,10:09,3,9,12
68,2025-05-25T01:56:00+02:00,2025-05-25,09:56,3,2,5
68,2025-05-25T01:57:00+02:00,2025-05-25,09:57,1,0,1
72,2025-05-25T01:56:00+02:00,2025-05-25,09:56,0,4,4
72,2025-05-25T02:01:00+02:00,2025-05-25,10:01,2,1,3
72,2025-05-25T02:03:00+02:00,2025-05-25,10:03,0,2,2
72,2025-05-25T02:04:00+02:00,2025-05-25,10:04,5,1,6
72,2025-05-25T02:07:00+02:00,2025-05-25,10:07,0,1,1
76,2025-05-25T01:56:00+02:00,2025-05-25,09:56,2,3,5
76,2025-05-25T01:57:00+02:00,2025-05-25,09:57,1,2,3
76,2025-05-25T02:00:00+02:00,2025-05-25,10:00,2,0,2
76,2025-05-25T02:02:00+02:00,2025-05-25,10:02,2,3,5
76,2025-05-25T02:06:00+02:00,2025-05-25,10:06,1,2,3
79,2025-05-25T01:55:00+02:00,2025-05-25,09:55,2,0,2
79,2025-05-25T02:02:00+02:00,2025-05-25,10:02,6,2,8
79,2025-05-25T02:03:00+02:00,2025-05-25,10:03,2,2,4
79,2025-05-25T02:04:00+02:00,2025-05-25,10:04,8,3,11
79,2025-05-25T02:05:00+02:00,2025-05-25,10:05,5,1,6
79,2025-05-25T02:07:00+02:00,2025-05-25,10:07,4,3,7
79,2025-05-25T02:09:00+02:00,2025-05-25,10:09,3,11,14
85,2025-05-25T01:55:00+02:00,2025-05-25,09:55,2,1,3
85,2025-05-25T01:56:00+02:00,2025-05-25,09:56,6,1,7
85,2025-05-25T01:59:00+02:00,2025-05-25,09:59,3,1,4
85,2025-05-25T02:02:00+02:00,2025-05-25,10:02,1,0,1
85,2025-05-25T02:04:00+02:00,2025-05-25,10:04,1,1,2
86,2025-05-25T01:58:00+02:00,2025-05-25,09:58,2,0,2
86,2025-05-25T01:59:00+02:00,2025-05-25,09:59,2,1,3
86,2025-05-25T02:01:00+02:00,2025-05-25,10:01,2,0,2
86,2025-05-25T02:02:00+02:00,2025-05-25,10:02,2,0,2
86,2025-05-25T02:09:00+02:00,2025-05-25,10:09,1,2,3
117,2025-05-25T01:55:00+02:00,2025-05-25,09:55,9,11,20
123,2025-05-25T01:55:00+02:00,2025-05-25,09:55,4,1,5
137,2025-05-25T01:55:00+02:00,2025-05-25,09:55,2,3,5
137,2025-05-25T02:00:00+02:00,2025-05-25,10:00,0,1,1
137,2025-05-25T02:05:00+02:00,2025-05-25,10:05,2,1,3
138,2025-05-25T01:55:00+02:00,2025-05-25,09:55,0,1,1
139,2025-05-25T02:05:00+02:00,2025-05-25,10:05,2,2,4
141,2025-05-25T01:55:00+02:00,2025-05-25,09:55,6,10,16
141,2025-05-25T02:05:00+02:00,2025-05-25,10:05,19,20,39
142,2025-05-25T01:55:00+02:00,2025-05-25,09:55,33,18,51
142,2025-05-25T02:05:00+02:00,2025-05-25,10:05,36,47,83
181,2025-05-25T02:10:00+02:00,2025-05-25,10:10,5,9,14
181,2025-05-25T02:12:00+02:00,2025-05-25,10:12,4,23,27
181,2025-05-25T02:15:00+02:00,2025-05-25,10:15,5,11,16
181,2025-05-25T02:18:00+02:00,2025-05-25,10:18,10,10,20
181,2025-05-25T02:22:00+02:00,2025-05-25,10:22,3,12,15
181,2025-05-25T02:23:00+02:00,2025-05-25,10:23,3,13,16
182,2025-05-25T02:15:00+02:00,2025-05-25,10:15,9,7,16
180,2025-05-25T02:15:00+02:00,2025-05-25,10:15,2,1,3
3,2025-05-25T02:29:00+02:00,2025-05-25,10:29,4,10,14
3,2025-05-25T02:36:00+02:00,2025-05-25,10:36,14,9,23
3,2025-05-25T02:38:00+02:00,2025-05-25,10:38,3,3,6
3,2025-05-25T02:39:00+02:00,2025-05-25,10:39,9,7,16
4,2025-05-25T02:25:00+02:00,2025-05-25,10:25,7,21,28
4,2025-05-25T02:26:00+02:00,2025-05-25,10:26,10,8,18
4,2025-05-25T02:28:00+02:00,2025-05-25,10:28,9,6,15
4,2025-05-25T02:29:00+02:00,2025-05-25,10:29,14,1,15
4,2025-05-25T02:30:00+02:00,2025-05-25,10:30,16,4,20
4,2025-05-25T02:32:00+02:00,2025-05-25,10:32,10,6,16
4,2025-05-25T02:33:00+02:00,2025-05-25,10:33,17,6,23
4,2025-05-25T02:37:00+02:00,2025-05-25,10:37,8,5,13
4,2025-05-25T02:39:00+02:00,2025-05-25,10:39,12,4,16
5,2025-05-25T02:35:00+02:00,2025-05-25,10:35,46,35,81
6,2025-05-25T02:36:00+02:00,2025-05-25,10:36,9,2,11
6,2025-05-25T02:38:00+02:00,2025-05-25,10:38,6,6,12
8,2025-05-25T02:31:00+02:00,2025-05-25,10:31,1,11,12
8,2025-05-25T02:35:00+02:00,2025-05-25,10:35,0,5,5
8,2025-05-25T02:36:00+02:00,2025-05-25,10:36,3,3,6
28,2025-05-25T02:28:00+02:00,2025-05-25,10:28,12,6,18
28,2025-05-25T02:30:00+02:00,2025-05-25,10:30,3,1,4
28,2025-05-25T02:32:00+02:00,2025-05-25,10:32,7,2,9
28,2025-05-25T02:34:00+02:00,2025-05-25,10:34,9,2,11
28,2025-05-25T02:35:00+02:00,2025-05-25,10:35,15,2,17
28,2025-05-25T02:37:00+02:00,2025-05-25,10:37,8,1,9
29,2025-05-25T02:25:00+02:00,2025-05-25,10:25,6,9,15
29,2025-05-25T02:27:00+02:00,2025-05-25,10:27,2,4,6
29,2025-05-25T02:30:00+02:00,2025-05-25,10:30,12,4,16
29,2025-05-25T02:32:00+02:00,2025-05-25,10:32,7,9,16
29,2025-05-25T02:33:00+02:00,2025-05-25,10:33,9,3,12
29,2025-05-25T02:34:00+02:00,2025-05-25,10:34,6,3,9
29,2025-05-25T02:37:00+02:00,2025-05-25,10:37,5,5,10
29,2025-05-25T02:39:00+02:00,2025-05-25,10:39,4,5,9
31,2025-05-25T02:26:00+02:00,2025-05-25,10:26,1,0,1
31,2025-05-25T02:29:00+02:00,2025-05-25,10:29,5,2,7
31,2025-05-25T02:30:00+02:00,2025-05-25,10:30,1,2,3
31,2025-05-25T02:31:00+02:00,2025-05-25,10:31,3,0,3
31,2025-05-25T02:34:00+02:00,2025-05-25,10:34,0,2,2
31,2025-05-25T02:36:00+02:00,2025-05-25,10:36,1,1,2
31,2025-05-25T02:38:00+02:00,2025-05-25,10:38,1,1,2
31,2025-05-25T02:39:00+02:00,2025-05-25,10:39,0,2,2
36,2025-05-25T02:32:00+02:00,2025-05-25,10:32,2,1,3
36,2025-05-25T02:34:00+02:00,2025-05-25,10:34,1,1,2
36,2025-05-25T02:37:00+02:00,2025-05-25,10:37,0,2,2
36,2025-05-25T02:38:00+02:00,2025-05-25,10:38,2,0,2
37,2025-05-25T02:30:00+02:00,2025-05-25,10:30,0,1,1
37,2025-05-25T02:37:00+02:00,2025-05-25,10:37,2,0,2
39,2025-05-25T02:31:00+02:00,2025-05-25,10:31,2,0,2
39,2025-05-25T02:39:00+02:00,2025-05-25,10:39,1,3,4
40,2025-05-25T02:25:00+02:00,2025-05-25,10:25,2,4,6
40,2025-05-25T02:28:00+02:00,2025-05-25,10:28,1,0,1
40,2025-05-25T02:30:00+02:00,2025-05-25,10:30,1,3,4
40,2025-05-25T02:31:00+02:00,2025-05-25,10:31,5,0,5
40,2025-05-25T02:32:00+02:00,2025-05-25,10:32,2,2,4
40,2025-05-25T02:34:00+02:00,2025-05-25,10:34,3,3,6
40,2025-05-25T02:35:00+02:00,2025-05-25,10:35,1,5,6
41,2025-05-25T02:25:00+02:00,2025-05-25,10:25,1,0,1
41,2025-05-25T02:27:00+02:00,2025-05-25,10:27,3,1,4
41,2025-05-25T02:32:00+02:00,2025-05-25,10:32,1,2,3
41,2025-05-25T02:33:00+02:00,2025-05-25,10:33,3,1,4
41,2025-05-25T02:38:00+02:00,2025-05-25,10:38,3,1,4
43,2025-05-25T02:25:00+02:00,2025-05-25,10:25,4,5,9
43,2025-05-25T02:35:00+02:00,2025-05-25,10:35,5,1,6
44,2025-05-25T02:30:00+02:00,2025-05-25,10:30,1,4,5
45,2025-05-25T02:27:00+02:00,2025-05-25,10:27,18,7,25
45,2025-05-25T02:28:00+02:00,2025-05-25,10:28,9,2,11
45,2025-05-25T02:29:00+02:00,2025-05-25,10:29,12,1,13
45,2025-05-25T02:31:00+02:00,2025-05-25,10:31,2,6,8
45,2025-05-25T02:33:00+02:00,2025-05-25,10:33,5,5,10
45,2025-05-25T02:36:00+02:00,2025-05-25,10:36,12,9,21
45,2025-05-25T02:38:00+02:00,2025-05-25,10:38,7,8,15
47,2025-05-25T02:29:00+02:00,2025-05-25,10:29,15,10,25
47,2025-05-25T02:31:00+02:00,2025-05-25,10:31,6,12,18
47,2025-05-25T02:38:00+02:00,2025-05-25,10:38,12,3,15
50,2025-05-25T02:27:00+02:00,2025-05-25,10:27,1,3,4
50,2025-05-25T02:28:00+02:00,2025-05-25,10:28,6,0,6
50,2025-05-25T02:29:00+02:00,2025-05-25,10:29,3,0,3
50,2025-05-25T02:35:00+02:00,2025-05-25,10:35,2,2,4
50,2025-05-25T02:36:00+02:00,2025-05-25,10:36,2,3,5
54,2025-05-25T02:32:00+02:00,2025-05-25,10:32,4,0,4
54,2025-05-25T02:34:00+02:00,2025-05-25,10:34,1,1,2
54,2025-05-25T02:36:00+02:00,2025-05-25,10:36,0,2,2
59,2025-05-25T02:30:00+02:00,2025-05-25,10:30,7,21,28
61,2025-05-25T02:25:00+02:00,2025-05-25,10:25,4,11,15
61,2025-05-25T02:26:00+02:00,2025-05-25,10:26,7,3,10
61,2025-05-25T02:32:00+02:00,2025-05-25,10:32,1,6,7
61,2025-05-25T02:33:00+02:00,2025-05-25,10:33,1,3,4
66,2025-05-25T02:26:00+02:00,2025-05-25,10:26,8,4,12
66,2025-05-25T02:28:00+02:00,2025-05-25,10:28,6,7,13
66,2025-05-25T02:31:00+02:00,2025-05-25,10:31,4,12,16
66,2025-05-25T02:33:00+02:00,2025-05-25,10:33,8,5,13
66,2025-05-25T02:34:00+02:00,2025-05-25,10:34,6,7,13
66,2025-05-25T02:36:00+02:00,2025-05-25,10:36,13,14,27
66,2025-05-25T02:39:00+02:00,2025-05-25,10:39,8,7,15
69,2025-05-25T02:26:00+02:00,2025-05-25,10:26,4,0,4
69,2025-05-25T02:36:00+02:00,2025-05-25,10:36,5,3,8
69,2025-05-25T02:37:00+02:00,2025-05-25,10:37,4,7,11
69,2025-05-25T02:39:00+02:00,2025-05-25,10:39,3,0,3
70,2025-05-25T02:25:00+02:00,2025-05-25,10:25,1,2,3
70,2025-05-25T02:30:00+02:00,2025-05-25,10:30,1,0,1
71,2025-05-25T02:38:00+02:00,2025-05-25,10:38,1,0,1
75,2025-05-25T02:33:00+02:00,2025-05-25,10:33,1,4,5
77,2025-05-25T02:25:00+02:00,2025-05-25,10:25,17,27,44
77,2025-05-25T02:30:00+02:00,2025-05-25,10:30,7,8,15
77,2025-05-25T02:35:00+02:00,2025-05-25,10:35,14,5,19
78,2025-05-25T02:26:00+02:00,2025-05-25,10:26,0,2,2
78,2025-05-25T02:27:00+02:00,2025-05-25,10:27,1,1,2
78,2025-05-25T02:31:00+02:00,2025-05-25,10:31,3,1,4
78,2025-05-25T02:39:00+02:00,2025-05-25,10:39,2,0,2
84,2025-05-25T02:35:00+02:00,2025-05-25,10:35,63,27,90
87,2025-05-25T02:25:00+02:00,2025-05-25,10:25,0,2,2
87,2025-05-25T02:27:00+02:00,2025-05-25,10:27,3,3,6
87,2025-05-25T02:31:00+02:00,2025-05-25,10:31,2,0,2
87,2025-05-25T02:32:00+02:00,2025-05-25,10:32,7,0,7
87,2025-05-25T02:37:00+02:00,2025-05-25,10:37,0,2,2
107,2025-05-25T02:30:00+02:00,2025-05-25,10:30,4,17,21
108,2025-05-25T02:25:00+02:00,2025-05-25,10:25,0,7,7
108,2025-05-25T02:27:00+02:00,2025-05-25,10:27,2,1,3
108,2025-05-25T02:28:00+02:00,2025-05-25,10:28,3,2,5
108,2025-05-25T02:31:00+02:00,2025-05-25,10:31,0,1,1
108,2025-05-25T02:32:00+02:00,2025-05-25,10:32,2,2,4
108,2025-05-25T02:34:00+02:00,2025-05-25,10:34,0,2,2
108,2025-05-25T02:37:00+02:00,2025-05-25,10:37,1,1,2
108,2025-05-25T02:39:00+02:00,2025-05-25,10:39,2,1,3
118,2025-05-25T02:30:00+02:00,2025-05-25,10:30,4,2,6
131,2025-05-25T02:25:00+02:00,2025-05-25,10:25,10,9,19
131,2025-05-25T02:30:00+02:00,2025-05-25,10:30,2,2,4
131,2025-05-25T02:35:00+02:00,2025-05-25,10:35,6,9,15
133,2025-05-25T02:25:00+02:00,2025-05-25,10:25,27,35,62
134,2025-05-25T02:35:00+02:00,2025-05-25,10:35,23,27,50
135,2025-05-25T02:30:00+02:00,2025-05-25,10:30,16,24,40
135,2025-05-25T02:35:00+02:00,2025-05-25,10:35,29,32,61
140,2025-05-25T02:25:00+02:00,2025-05-25,10:25,8,0,8
162,2025-05-25T02:30:00+02:00,2025-05-25,10:30,40,44,84
165,2025-05-25T02:25:00+02:00,2025-05-25,10:25,1,1,2
166,2025-05-25T02:25:00+02:00,2025-05-25,10:25,6,6,12
167,2025-05-25T02:35:00+02:00,2025-05-25,10:35,5,9,14
179,2025-05-25T02:25:00+02:00,2025-05-25,10:25,6,6,12
1,2025-05-25T02:25:00+02:00,2025-05-25,10:25,5,5,10
1,2025-05-25T02:28:00+02:00,2025-05-25,10:28,14,15,29
1,2025-05-25T02:29:00+02:00,2025-05-25,10:29,3,15,18
1,2025-05-25T02:30:00+02:00,2025-05-25,10:30,6,3,9
1,2025-05-25T02:33:00+02:00,2025-05-25,10:33,9,13,22
1,2025-05-25T02:34:00+02:00,2025-05-25,10:34,11,6,17
2,2025-05-25T02:25:00+02:00,2025-05-25,10:25,2,11,13
2,2025-05-25T02:27:00+02:00,2025-05-25,10:27,6,4,10
2,2025-05-25T02:35:00+02:00,2025-05-25,10:35,0,10,10
2,2025-05-25T02:37:00+02:00,2025-05-25,10:37,6,3,9
2,2025-05-25T02:38:00+02:00,2025-05-25,10:38,3,7,10
9,2025-05-25T02:27:00+02:00,2025-05-25,10:27,1,0,1
9,2025-05-25T02:29:00+02:00,2025-05-25,10:29,0,2,2
9,2025-05-25T02:32:00+02:00,2025-05-25,10:32,2,2,4
9,2025-05-25T02:36:00+02:00,2025-05-25,10:36,0,2,2
10,2025-05-25T02:27:00+02:00,2025-05-25,10:27,1,2,3
10,2025-05-25T02:34:00+02:00,2025-05-25,10:34,1,0,1
10,2025-05-25T02:35:00+02:00,2025-05-25,10:35,2,0,2
11,2025-05-25T02:25:00+02:00,2025-05-25,10:25,2,0,2
11,2025-05-25T02:30:00+02:00,2025-05-25,10:30,3,2,5
11,2025-05-25T02:39:00+02:00,2025-05-25,10:39,0,4,4
12,2025-05-25T02:32:00+02:00,2025-05-25,10:32,2,1,3
12,2025-05-25T02:38:00+02:00,2025-05-25,10:38,2,3,5
12,2025-05-25T02:39:00+02:00,2025-05-25,10:39,3,2,5
17,2025-05-25T02:25:00+02:00,2025-05-25,10:25,1,1,2
17,2025-05-25T02:34:00+02:00,2025-05-25,10:34,5,1,6
17,2025-05-25T02:36:00+02:00,2025-05-25,10:36,1,0,1
17,2025-05-25T02:39:00+02:00,2025-05-25,10:39,2,2,4
18,2025-05-25T02:28:00+02:00,2025-05-25,10:28,2,0,2
18,2025-05-25T02:29:00+02:00,2025-05-25,10:29,0,1,1
18,2025-05-25T02:31:00+02:00,2025-05-25,10:31,1,1,2
18,2025-05-25T02:35:00+02:00,2025-05-25,10:35,4,0,4
19,2025-05-25T02:25:00+02:00,2025-05-25,10:25,8,9,17
19,2025-05-25T02:35:00+02:00,2025-05-25,10:35,0,8,8
20,2025-05-25T02:28:00+02:00,2025-05-25,10:28,1,5,6
20,2025-05-25T02:30:00+02:00,2025-05-25,10:30,1,0,1
20,2025-05-25T02:31:00+02:00,2025-05-25,10:31,1,4,5
20,2025-05-25T02:32:00+02:00,2025-05-25,10:32,4,4,8
20,2025-05-25T02:36:00+02:00,2025-05-25,10:36,2,0,2
20,2025-05-25T02:37:00+02:00,2025-05-25,10:37,1,1,2
23,2025-05-25T02:26:00+02:00,2025-05-25,10:26,1,4,5
23,2025-05-25T02:28:00+02:00,2025-05-25,10:28,1,1,2
23,2025-05-25T02:35:00+02:00,2025-05-25,10:35,2,0,2
24,2025-05-25T02:25:00+02:00,2025-05-25,10:25,0,4,4
24,2025-05-25T02:27:00+02:00,2025-05-25,10:27,1,3,4
24,2025-05-25T02:33:00+02:00,2025-05-25,10:33,2,2,4
24,2025-05-25T02:35:00+02:00,2025-05-25,10:35,11,11,22
24,2025-05-25T02:38:00+02:00,2025-05-25,10:38,6,18,24
25,2025-05-25T02:30:00+02:00,2025-05-25,10:30,50,53,103
27,2025-05-25T02:25:00+02:00,2025-05-25,10:25,1,3,4
27,2025-05-25T02:26:00+02:00,2025-05-25,10:26,5,1,6
27,2025-05-25T02:28:00+02:00,2025-05-25,10:28,4,3,7
27,2025-05-25T02:30:00+02:00,2025-05-25,10:30,2,4,6
27,2025-05-25T02:32:00+02:00,2025-05-25,10:32,13,0,13
27,2025-05-25T02:33:00+02:00,2025-05-25,10:33,7,5,12
27,2025-05-25T02:36:00+02:00,2025-05-25,10:36,7,14,21
27,2025-05-25T02:37:00+02:00,2025-05-25,10:37,5,3,8
30,2025-05-25T02:25:00+02:00,2025-05-25,10:25,0,3,3
30,2025-05-25T02:37:00+02:00,2025-05-25,10:37,1,4,5
30,2025-05-25T02:38:00+02:00,2025-05-25,10:38,7,4,11
30,2025-05-25T02:39:00+02:00,2025-05-25,10:39,1,0,1
35,2025-05-25T02:26:00+02:00,2025-05-25,10:26,22,9,31
35,2025-05-25T02:29:00+02:00,2025-05-25,10:29,14,5,19
35,2025-05-25T02:30:00+02:00,2025-05-25,10:30,15,16,31
35,2025-05-25T02:35:00+02:00,2025-05-25,10:35,21,8,29
35,2025-05-25T02:37:00+02:00,2025-05-25,10:37,21,11,32
35,2025-05-25T02:39:00+02:00,2025-05-25,10:39,22,10,32
46,2025-05-25T02:25:00+02:00,2025-05-25,10:25,7,3,10
46,2025-05-25T02:30:00+02:00,2025-05-25,10:30,6,1,7
48,2025-05-25T02:27:00+02:00,2025-05-25,10:27,11,3,14
48,2025-05-25T02:29:00+02:00,2025-05-25,10:29,2,4,6
48,2025-05-25T02:31:00+02:00,2025-05-25,10:31,7,6,13
48,2025-05-25T02:32:00+02:00,2025-05-25,10:32,9,5,14
48,2025-05-25T02:34:00+02:00,2025-05-25,10:34,7,2,9
48,2025-05-25T02:36:00+02:00,2025-05-25,10:36,7,5,12
48,2025-05-25T02:37:00+02:00,2025-05-25,10:37,6,4,10
48,2025-05-25T02:38:00+02:00,2025-05-25,10:38,3,5,8
49,2025-05-25T02:25:00+02:00,2025-05-25,10:25,5,0,5
49,2025-05-25T02:36:00+02:00,2025-05-25,10:36,11,6,17
49,2025-05-25T02:37:00+02:00,2025-05-25,10:37,5,6,11
51,2025-05-25T02:25:00+02:00,2025-05-25,10:25,3,3,6
51,2025-05-25T02:30:00+02:00,2025-05-25,10:30,1,3,4
51,2025-05-25T02:32:00+02:00,2025-05-25,10:32,3,2,5
51,2025-05-25T02:34:00+02:00,2025-05-25,10:34,4,0,4
51,2025-05-25T02:37:00+02:00,2025-05-25,10:37,2,2,4
51,2025-05-25T02:39:00+02:00,2025-05-25,10:39,1,1,2
52,2025-05-25T02:30:00+02:00,2025-05-25,10:30,2,2,4
52,2025-05-25T02:32:00+02:00,2025-05-25,10:32,1,6,7
52,2025-05-25T02:34:00+02:00,2025-05-25,10:34,2,2,4
52,2025-05-25T02:37:00+02:00,2025-05-25,10:37,6,6,12
52,2025-05-25T02:39:00+02:00,2025-05-25,10:39,6,0,6
53,2025-05-25T02:31:00+02:00,2025-05-25,10:31,4,1,5
53,2025-05-25T02:36:00+02:00,2025-05-25,10:36,3,12,15
53,2025-05-25T02:37:00+02:00,2025-05-25,10:37,9,3,12
53,2025-05-25T02:39:00+02:00,2025-05-25,10:39,11,4,15
56,2025-05-25T02:25:00+02:00,2025-05-25,10:25,4,5,9
56,2025-05-25T02:27:00+02:00,2025-05-25,10:27,8,8,16
56,2025-05-25T02:28:00+02:00,2025-05-25,10:28,2,4,6
56,2025-05-25T02:31:00+02:00,2025-05-25,10:31,3,9,12
56,2025-05-25T02:38:00+02:00,2025-05-25,10:38,8,7,15
56,2025-05-25T02:39:00+02:00,2025-05-25,10:39,8,1,9
58,2025-05-25T02:25:00+02:00,2025-05-25,10:25,14,8,22
58,2025-05-25T02:28:00+02:00,2025-05-25,10:28,15,0,15
58,2025-05-25T02:30:00+02:00,2025-05-25,10:30,8,7,15
58,2025-05-25T02:32:00+02:00,2025-05-25,10:32,4,0,4
58,2025-05-25T02:33:00+02:00,2025-05-25,10:33,9,0,9
58,2025-05-25T02:35:00+02:00,2025-05-25,10:35,5,4,9
62,2025-05-25T02:36:00+02:00,2025-05-25,10:36,0,2,2
62,2025-05-25T02:37:00+02:00,2025-05-25,10:37,2,3,5
62,2025-05-25T02:38:00+02:00,2025-05-25,10:38,0,4,4
63,2025-05-25T02:27:00+02:00,2025-05-25,10:27,2,0,2
63,2025-05-25T02:28:00+02:00,2025-05-25,10:28,1,1,2
63,2025-05-25T02:29:00+02:00,2025-05-25,10:29,1,6,7
63,2025-05-25T02:32:00+02:00,2025-05-25,10:32,2,0,2
67,2025-05-25T02:26:00+02:00,2025-05-25,10:26,2,2,4
67,2025-05-25T02:32:00+02:00,2025-05-25,10:32,0,21,21
67,2025-05-25T02:33:00+02:00,2025-05-25,10:33,8,13,21
67,2025-05-25T02:34:00+02:00,2025-05-25,10:34,3,12,15
67,2025-05-25T02:35:00+02:00,2025-05-25,10:35,5,4,9
67,2025-05-25T02:39:00+02:00,2025-05-25,10:39,3,12,15
68,2025-05-25T02:27:00+02:00,2025-05-25,10:27,5,1,6
68,2025-05-25T02:32:00+02:00,2025-05-25,10:32,1,5,6
68,2025-05-25T02:33:00+02:00,2025-05-25,10:33,2,5,7
68,2025-05-25T02:34:00+02:00,2025-05-25,10:34,7,2,9
68,2025-05-25T02:35:00+02:00,2025-05-25,10:35,12,3,15
72,2025-05-25T02:28:00+02:00,2025-05-25,10:28,2,3,5
72,2025-05-25T02:31:00+02:00,2025-05-25,10:31,3,3,6
72,2025-05-25T02:34:00+02:00,2025-05-25,10:34,3,4,7
72,2025-05-25T02:39:00+02:00,2025-05-25,10:39,0,2,2
76,2025-05-25T02:27:00+02:00,2025-05-25,10:27,0,6,6
76,2025-05-25T02:28:00+02:00,2025-05-25,10:28,1,2,3
76,2025-05-25T02:30:00+02:00,2025-05-25,10:30,0,1,1
76,2025-05-25T02:35:00+02:00,2025-05-25,10:35,1,0,1
79,2025-05-25T02:28:00+02:00,2025-05-25,10:28,18,6,24
79,2025-05-25T02:29:00+02:00,2025-05-25,10:29,12,5,17
79,2025-05-25T02:30:00+02:00,2025-05-25,10:30,10,4,14
79,2025-05-25T02:31:00+02:00,2025-05-25,10:31,3,13,16
79,2025-05-25T02:32:00+02:00,2025-05-25,10:32,2,1,3
79,2025-05-25T02:33:00+02:00,2025-05-25,10:33,4,3,7
79,2025-05-25T02:36:00+02:00,2025-05-25,10:36,6,3,9
79,2025-05-25T02:37:00+02:00,2025-05-25,10:37,3,2,5
79,2025-05-25T02:38:00+02:00,2025-05-25,10:38,11,13,24
79,2025-05-25T02:39:00+02:00,2025-05-25,10:39,18,4,22
85,2025-05-25T02:27:00+02:00,2025-05-25,10:27,1,0,1
85,2025-05-25T02:29:00+02:00,2025-05-25,10:29,2,1,3
85,2025-05-25T02:31:00+02:00,2025-05-25,10:31,0,1,1
86,2025-05-25T02:25:00+02:00,2025-05-25,10:25,1,0,1
86,2025-05-25T02:26:00+02:00,2025-05-25,10:26,1,5,6
86,2025-05-25T02:28:00+02:00,2025-05-25,10:28,0,2,2
86,2025-05-25T02:29:00+02:00,2025-05-25,10:29,2,0,2
86,2025-05-25T02:35:00+02:00,2025-05-25,10:35,1,0,1
86,2025-05-25T02:39:00+02:00,2025-05-25,10:39,2,0,2
123,2025-05-25T02:25:00+02:00,2025-05-25,10:25,2,2,4
136,2025-05-25T02:25:00+02:00,2025-05-25,10:25,15,9,24
136,2025-05-25T02:30:00+02:00,2025-05-25,10:30,11,11,22
137,2025-05-25T02:25:00+02:00,2025-05-25,10:25,2,0,2
137,2025-05-25T02:30:00+02:00,2025-05-25,10:30,1,3,4
138,2025-05-25T02:35:00+02:00,2025-05-25,10:35,2,0,2
141,2025-05-25T02:30:00+02:00,2025-05-25,10:30,2,4,6
142,2025-05-25T02:30:00+02:00,2025-05-25,10:30,54,36,90
142,2025-05-25T02:35:00+02:00,2025-05-25,10:35,31,32,63
161,2025-05-25T02:25:00+02:00,2025-05-25,10:25,12,9,21
164,2025-05-25T02:30:00+02:00,2025-05-25,10:30,10,6,16
181,2025-05-25T02:40:00+02:00,2025-05-25,10:40,1,5,6
181,2025-05-25T02:44:00+02:00,2025-05-25,10:44,8,10,18
181,2025-05-25T02:46:00+02:00,2025-05-25,10:46,8,14,22
181,2025-05-25T02:47:00+02:00,2025-05-25,10:47,9,13,22
181,2025-05-25T02:48:00+02:00,2025-05-25,10:48,3,15,18
181,2025-05-25T02:50:00+02:00,2025-05-25,10:50,0,4,4
181,2025-05-25T02:54:00+02:00,2025-05-25,10:54,4,11,15
180,2025-05-25T02:44:00+02:00,2025-05-25,10:44,2,1,3
180,2025-05-25T02:46:00+02:00,2025-05-25,10:46,2,1,3
180,2025-05-25T02:47:00+02:00,2025-05-25,10:47,1,1,2
180,2025-05-25T02:50:00+02:00,2025-05-25,10:50,1,1,2
3,2025-05-25T02:44:00+02:00,2025-05-25,10:44,3,6,9
3,2025-05-25T02:47:00+02:00,2025-05-25,10:47,3,10,13
3,2025-05-25T02:50:00+02:00,2025-05-25,10:50,5,10,15
3,2025-05-25T02:51:00+02:00,2025-05-25,10:51,9,7,16
3,2025-05-25T02:54:00+02:00,2025-05-25,10:54,10,2,12
4,2025-05-25T02:45:00+02:00,2025-05-25,10:45,10,17,27
4,2025-05-25T02:49:00+02:00,2025-05-25,10:49,19,7,26
4,2025-05-25T02:52:00+02:00,2025-05-25,10:52,19,10,29
5,2025-05-25T02:50:00+02:00,2025-05-25,10:50,53,67,120
6,2025-05-25T02:41:00+02:00,2025-05-25,10:41,7,10,17
6,2025-05-25T02:42:00+02:00,2025-05-25,10:42,9,16,25
6,2025-05-25T02:49:00+02:00,2025-05-25,10:49,9,5,14
6,2025-05-25T02:50:00+02:00,2025-05-25,10:50,2,14,16
6,2025-05-25T02:51:00+02:00,2025-05-25,10:51,12,4,16
6,2025-05-25T02:52:00+02:00,2025-05-25,10:52,13,4,17
8,2025-05-25T02:45:00+02:00,2025-05-25,10:45,1,4,5
8,2025-05-25T02:47:00+02:00,2025-05-25,10:47,1,7,8
8,2025-05-25T02:48:00+02:00,2025-05-25,10:48,3,9,12
8,2025-05-25T02:52:00+02:00,2025-05-25,10:52,1,2,3
28,2025-05-25T02:41:00+02:00,2025-05-25,10:41,8,8,16
28,2025-05-25T02:45:00+02:00,2025-05-25,10:45,5,5,10
28,2025-05-25T02:46:00+02:00,2025-05-25,10:46,6,12,18
28,2025-05-25T02:47:00+02:00,2025-05-25,10:47,6,4,10
28,2025-05-25T02:51:00+02:00,2025-05-25,10:51,3,6,9
28,2025-05-25T02:53:00+02:00,2025-05-25,10:53,9,8,17
29,2025-05-25T02:40:00+02:00,2025-05-25,10:40,2,8,10
29,2025-05-25T02:41:00+02:00,2025-05-25,10:41,2,12,14
29,2025-05-25T02:43:00+02:00,2025-05-25,10:43,3,9,12
29,2025-05-25T02:46:00+02:00,2025-05-25,10:46,1,12,13
29,2025-05-25T02:48:00+02:00,2025-05-25,10:48,8,9,17
29,2025-05-25T02:49:00+02:00,2025-05-25,10:49,4,7,11
31,2025-05-25T02:42:00+02:00,2025-05-25,10:42,4,0,4
31,2025-05-25T02:46:00+02:00,2025-05-25,10:46,1,1,2
31,2025-05-25T02:48:00+02:00,2025-05-25,10:48,1,0,1
31,2025-05-25T02:51:00+02:00,2025-05-25,10:51,2,1,3
36,2025-05-25T02:47:00+02:00,2025-05-25,10:47,0,1,1
37,2025-05-25T02:44:00+02:00,2025-05-25,10:44,0,3,3
37,2025-05-25T02:47:00+02:00,2025-05-25,10:47,0,4,4
37,2025-05-25T02:48:00+02:00,2025-05-25,10:48,0,2,2
37,2025-05-25T02:53:00+02:00,2025-05-25,10:53,3,2,5
37,2025-05-25T02:54:00+02:00,2025-05-25,10:54,1,0,1
39,2025-05-25T02:42:00+02:00,2025-05-25,10:42,1,0,1
39,2025-05-25T02:45:00+02:00,2025-05-25,10:45,1,0,1
39,2025-05-25T02:49:00+02:00,2025-05-25,10:49,1,4,5
39,2025-05-25T02:50:00+02:00,2025-05-25,10:50,5,0,5
39,2025-05-25T02:52:00+02:00,2025-05-25,10:52,1,0,1
40,2025-05-25T02:40:00+02:00,2025-05-25,10:40,2,1,3
40,2025-05-25T02:42:00+02:00,2025-05-25,10:42,2,1,3
40,2025-05-25T02:48:00+02:00,2025-05-25,10:48,1,4,5
40,2025-05-25T02:54:00+02:00,2025-05-25,10:54,1,0,1
41,2025-05-25T02:43:00+02:00,2025-05-25,10:43,4,4,8
41,2025-05-25T02:44:00+02:00,2025-05-25,10:44,1,1,2
41,2025-05-25T02:47:00+02:00,2025-05-25,10:47,4,2,6
41,2025-05-25T02:49:00+02:00,2025-05-25,10:49,4,5,9
41,2025-05-25T02:51:00+02:00,2025-05-25,10:51,2,3,5
41,2025-05-25T02:52:00+02:00,2025-05-25,10:52,2,0,2
41,2025-05-25T02:53:00+02:00,2025-05-25,10:53,8,5,13
43,2025-05-25T02:40:00+02:00,2025-05-25,10:40,11,2,13
43,2025-05-25T02:45:00+02:00,2025-05-25,10:45,5,2,7
44,2025-05-25T02:40:00+02:00,2025-05-25,10:40,10,2,12
44,2025-05-25T02:50:00+02:00,2025-05-25,10:50,0,6,6
45,2025-05-25T02:41:00+02:00,2025-05-25,10:41,11,5,16
45,2025-05-25T02:43:00+02:00,2025-05-25,10:43,16,7,23
45,2025-05-25T02:45:00+02:00,2025-05-25,10:45,12,5,17
45,2025-05-25T02:47:00+02:00,2025-05-25,10:47,21,8,29
45,2025-05-25T02:51:00+02:00,2025-05-25,10:51,7,2,9
47,2025-05-25T02:44:00+02:00,2025-05-25,10:44,3,2,5
47,2025-05-25T02:48:00+02:00,2025-05-25,10:48,17,17,34
47,2025-05-25T02:53:00+02:00,2025-05-25,10:53,16,1,17
50,2025-05-25T02:41:00+02:00,2025-05-25,10:41,2,2,4
54,2025-05-25T02:40:00+02:00,2025-05-25,10:40,2,2,4
54,2025-05-25T02:43:00+02:00,2025-05-25,10:43,3,2,5
54,2025-05-25T02:45:00+02:00,2025-05-25,10:45,2,0,2
54,2025-05-25T02:47:00+02:00,2025-05-25,10:47,4,0,4
54,2025-05-25T02:48:00+02:00,2025-05-25,10:48,0,1,1
54,2025-05-25T02:51:00+02:00,2025-05-25,10:51,0,2,2
54,2025-05-25T02:52:00+02:00,2025-05-25,10:52,5,0,5
59,2025-05-25T02:40:00+02:00,2025-05-25,10:40,13,20,33
59,2025-05-25T02:45:00+02:00,2025-05-25,10:45,9,20,29
59,2025-05-25T02:50:00+02:00,2025-05-25,10:50,10,13,23
61,2025-05-25T02:41:00+02:00,2025-05-25,10:41,4,0,4
61,2025-05-25T02:43:00+02:00,2025-05-25,10:43,9,0,9
61,2025-05-25T02:46:00+02:00,2025-05-25,10:46,7,5,12
61,2025-05-25T02:48:00+02:00,2025-05-25,10:48,13,6,19
61,2025-05-25T02:50:00+02:00,2025-05-25,10:50,3,4,7
66,2025-05-25T02:40:00+02:00,2025-05-25,10:40,6,9,15
66,2025-05-25T02:42:00+02:00,2025-05-25,10:42,13,5,18
66,2025-05-25T02:43:00+02:00,2025-05-25,10:43,9,12,21
66,2025-05-25T02:45:00+02:00,2025-05-25,10:45,13,8,21
66,2025-05-25T02:47:00+02:00,2025-05-25,10:47,10,2,12
66,2025-05-25T02:50:00+02:00,2025-05-25,10:50,6,6,12
66,2025-05-25T02:52:00+02:00,2025-05-25,10:52,6,13,19
69,2025-05-25T02:43:00+02:00,2025-05-25,10:43,5,6,11
69,2025-05-25T02:44:00+02:00,2025-05-25,10:44,9,1,10
69,2025-05-25T02:46:00+02:00,2025-05-25,10:46,2,1,3
69,2025-05-25T02:49:00+02:00,2025-05-25,10:49,2,3,5
69,2025-05-25T02:51:00+02:00,2025-05-25,10:51,6,2,8
70,2025-05-25T02:47:00+02:00,2025-05-25,10:47,7,3,10
70,2025-05-25T02:48:00+02:00,2025-05-25,10:48,3,2,5
70,2025-05-25T02:49:00+02:00,2025-05-25,10:49,2,5,7
70,2025-05-25T02:52:00+02:00,2025-05-25,10:52,4,4,8
75,2025-05-25T02:46:00+02:00,2025-05-25,10:46,0,1,1
77,2025-05-25T02:40:00+02:00,2025-05-25,10:40,14,14,28
78,2025-05-25T02:43:00+02:00,2025-05-25,10:43,1,1,2
78,2025-05-25T02:45:00+02:00,2025-05-25,10:45,1,0,1
78,2025-05-25T02:47:00+02:00,2025-05-25,10:47,0,5,5
78,2025-05-25T02:48:00+02:00,2025-05-25,10:48,0,1,1
78,2025-05-25T02:54:00+02:00,2025-05-25,10:54,0,5,5
87,2025-05-25T02:41:00+02:00,2025-05-25,10:41,1,0,1
107,2025-05-25T02:40:00+02:00,2025-05-25,10:40,5,8,13
107,2025-05-25T02:50:00+02:00,2025-05-25,10:50,6,20,26
108,2025-05-25T02:41:00+02:00,2025-05-25,10:41,3,1,4
108,2025-05-25T02:42:00+02:00,2025-05-25,10:42,1,5,6
108,2025-05-25T02:43:00+02:00,2025-05-25,10:43,2,1,3
108,2025-05-25T02:47:00+02:00,2025-05-25,10:47,11,3,14
108,2025-05-25T02:48:00+02:00,2025-05-25,10:48,0,1,1
108,2025-05-25T02:49:00+02:00,2025-05-25,10:49,2,3,5
108,2025-05-25T02:52:00+02:00,2025-05-25,10:52,1,3,4
108,2025-05-25T02:54:00+02:00,2025-05-25,10:54,2,0,2
118,2025-05-25T02:45:00+02:00,2025-05-25,10:45,5,2,7
118,2025-05-25T02:50:00+02:00,2025-05-25,10:50,0,5,5
132,2025-05-25T02:40:00+02:00,2025-05-25,10:40,19,3,22
133,2025-05-25T02:50:00+02:00,2025-05-25,10:50,35,33,68
135,2025-05-25T02:40:00+02:00,2025-05-25,10:40,39,36,75
162,2025-05-25T02:45:00+02:00,2025-05-25,10:45,25,55,80
165,2025-05-25T02:40:00+02:00,2025-05-25,10:40,0,6,6
165,2025-05-25T02:45:00+02:00,2025-05-25,10:45,1,1,2
166,2025-05-25T02:40:00+02:00,2025-05-25,10:40,3,3,6
1,2025-05-25T02:40:00+02:00,2025-05-25,10:40,11,13,24
1,2025-05-25T02:41:00+02:00,2025-05-25,10:41,9,19,28
1,2025-05-25T02:48:00+02:00,2025-05-25,10:48,9,7,16
1,2025-05-25T02:49:00+02:00,2025-05-25,10:49,7,5,12
1,2025-05-25T02:52:00+02:00,2025-05-25,10:52,14,13,27
1,2025-05-25T02:54:00+02:00,2025-05-25,10:54,23,8,31
2,2025-05-25T02:45:00+02:00,2025-05-25,10:45,5,8,13
2,2025-05-25T02:46:00+02:00,2025-05-25,10:46,6,5,11
2,2025-05-25T02:52:00+02:00,2025-05-25,10:52,1,8,9
2,2025-05-25T02:53:00+02:00,2025-05-25,10:53,11,3,14
10,2025-05-25T02:43:00+02:00,2025-05-25,10:43,0,1,1
10,2025-05-25T02:52:00+02:00,2025-05-25,10:52,0,1,1
11,2025-05-25T02:42:00+02:00,2025-05-25,10:42,2,0,2
11,2025-05-25T02:45:00+02:00,2025-05-25,10:45,8,2,10
11,2025-05-25T02:48:00+02:00,2025-05-25,10:48,0,1,1
11,2025-05-25T02:49:00+02:00,2025-05-25,10:49,1,1,2
11,2025-05-25T02:50:00+02:00,2025-05-25,10:50,0,4,4
11,2025-05-25T02:53:00+02:00,2025-05-25,10:53,0,2,2
12,2025-05-25T02:41:00+02:00,2025-05-25,10:41,2,0,2
12,2025-05-25T02:44:00+02:00,2025-05-25,10:44,0,1,1
12,2025-05-25T02:46:00+02:00,2025-05-25,10:46,0,1,1
12,2025-05-25T02:47:00+02:00,2025-05-25,10:47,5,3,8
12,2025-05-25T02:52:00+02:00,2025-05-25,10:52,4,2,6
17,2025-05-25T02:41:00+02:00,2025-05-25,10:41,5,2,7
17,2025-05-25T02:46:00+02:00,2025-05-25,10:46,3,5,8
17,2025-05-25T02:47:00+02:00,2025-05-25,10:47,2,2,4
17,2025-05-25T02:49:00+02:00,2025-05-25,10:49,2,1,3
17,2025-05-25T02:53:00+02:00,2025-05-25,10:53,4,1,5
18,2025-05-25T02:41:00+02:00,2025-05-25,10:41,0,2,2
18,2025-05-25T02:42:00+02:00,2025-05-25,10:42,1,4,5
18,2025-05-25T02:48:00+02:00,2025-05-25,10:48,2,1,3
18,2025-05-25T02:51:00+02:00,2025-05-25,10:51,2,1,3
18,2025-05-25T02:53:00+02:00,2025-05-25,10:53,0,2,2
18,2025-05-25T02:54:00+02:00,2025-05-25,10:54,1,0,1
19,2025-05-25T02:40:00+02:00,2025-05-25,10:40,5,1,6
19,2025-05-25T02:41:00+02:00,2025-05-25,10:41,3,2,5
19,2025-05-25T02:43:00+02:00,2025-05-25,10:43,2,1,3
19,2025-05-25T02:48:00+02:00,2025-05-25,10:48,0,2,2
19,2025-05-25T02:51:00+02:00,2025-05-25,10:51,4,3,7
20,2025-05-25T02:40:00+02:00,2025-05-25,10:40,1,3,4
20,2025-05-25T02:41:00+02:00,2025-05-25,10:41,0,2,2
20,2025-05-25T02:44:00+02:00,2025-05-25,10:44,5,0,5
20,2025-05-25T02:51:00+02:00,2025-05-25,10:51,3,0,3
20,2025-05-25T02:54:00+02:00,2025-05-25,10:54,8,0,8
23,2025-05-25T02:41:00+02:00,2025-05-25,10:41,2,0,2
23,2025-05-25T02:43:00+02:00,2025-05-25,10:43,0,5,5
23,2025-05-25T02:51:00+02:00,2025-05-25,10:51,3,2,5
24,2025-05-25T02:46:00+02:00,2025-05-25,10:46,15,9,24
24,2025-05-25T02:49:00+02:00,2025-05-25,10:49,10,0,10
24,2025-05-25T02:51:00+02:00,2025-05-25,10:51,16,12,28
24,2025-05-25T02:52:00+02:00,2025-05-25,10:52,9,4,13
25,2025-05-25T02:45:00+02:00,2025-05-25,10:45,35,78,113
27,2025-05-25T02:40:00+02:00,2025-05-25,10:40,1,4,5
27,2025-05-25T02:43:00+02:00,2025-05-25,10:43,3,12,15
27,2025-05-25T02:45:00+02:00,2025-05-25,10:45,0,3,3
27,2025-05-25T02:53:00+02:00,2025-05-25,10:53,0,4,4
27,2025-05-25T02:54:00+02:00,2025-05-25,10:54,1,3,4
30,2025-05-25T02:41:00+02:00,2025-05-25,10:41,1,17,18
30,2025-05-25T02:46:00+02:00,2025-05-25,10:46,6,8,14
30,2025-05-25T02:47:00+02:00,2025-05-25,10:47,2,1,3
35,2025-05-25T02:41:00+02:00,2025-05-25,10:41,23,16,39
35,2025-05-25T02:42:00+02:00,2025-05-25,10:42,13,22,35
35,2025-05-25T02:43:00+02:00,2025-05-25,10:43,46,18,64
35,2025-05-25T02:44:00+02:00,2025-05-25,10:44,13,16,29
35,2025-05-25T02:47:00+02:00,2025-05-25,10:47,20,21,41
35,2025-05-25T02:51:00+02:00,2025-05-25,10:51,10,14,24
35,2025-05-25T02:52:00+02:00,2025-05-25,10:52,20,19,39
35,2025-05-25T02:53:00+02:00,2025-05-25,10:53,15,14,29
35,2025-05-25T02:54:00+02:00,2025-05-25,10:54,16,12,28
46,2025-05-25T02:45:00+02:00,2025-05-25,10:45,3,3,6
48,2025-05-25T02:41:00+02:00,2025-05-25,10:41,4,5,9
48,2025-05-25T02:42:00+02:00,2025-05-25,10:42,9,1,10
48,2025-05-25T02:44:00+02:00,2025-05-25,10:44,4,5,9
48,2025-05-25T02:47:00+02:00,2025-05-25,10:47,12,4,16
48,2025-05-25T02:50:00+02:00,2025-05-25,10:50,11,4,15
48,2025-05-25T02:52:00+02:00,2025-05-25,10:52,7,2,9
48,2025-05-25T02:53:00+02:00,2025-05-25,10:53,7,3,10
49,2025-05-25T02:40:00+02:00,2025-05-25,10:40,7,9,16
49,2025-05-25T02:47:00+02:00,2025-05-25,10:47,1,10,11
51,2025-05-25T02:40:00+02:00,2025-05-25,10:40,3,4,7
51,2025-05-25T02:45:00+02:00,2025-05-25,10:45,0,3,3
51,2025-05-25T02:48:00+02:00,2025-05-25,10:48,2,2,4
51,2025-05-25T02:50:00+02:00,2025-05-25,10:50,3,3,6
52,2025-05-25T02:41:00+02:00,2025-05-25,10:41,1,2,3
52,2025-05-25T02:44:00+02:00,2025-05-25,10:44,4,2,6
52,2025-05-25T02:52:00+02:00,2025-05-25,10:52,5,0,5
52,2025-05-25T02:53:00+02:00,2025-05-25,10:53,3,5,8
52,2025-05-25T02:54:00+02:00,2025-05-25,10:54,2,3,5
53,2025-05-25T02:40:00+02:00,2025-05-25,10:40,10,4,14
53,2025-05-25T02:41:00+02:00,2025-05-25,10:41,8,1,9
53,2025-05-25T02:44:00+02:00,2025-05-25,10:44,10,10,20
53,2025-05-25T02:45:00+02:00,2025-05-25,10:45,2,4,6
53,2025-05-25T02:50:00+02:00,2025-05-25,10:50,7,4,11
53,2025-05-25T02:52:00+02:00,2025-05-25,10:52,7,6,13
56,2025-05-25T02:40:00+02:00,2025-05-25,10:40,4,4,8
56,2025-05-25T02:43:00+02:00,2025-05-25,10:43,1,2,3
56,2025-05-25T02:44:00+02:00,2025-05-25,10:44,5,5,10
56,2025-05-25T02:48:00+02:00,2025-05-25,10:48,3,1,4
58,2025-05-25T02:43:00+02:00,2025-05-25,10:43,10,1,11
58,2025-05-25T02:45:00+02:00,2025-05-25,10:45,4,1,5
58,2025-05-25T02:47:00+02:00,2025-05-25,10:47,14,0,14
58,2025-05-25T02:48:00+02:00,2025-05-25,10:48,6,2,8
58,2025-05-25T02:50:00+02:00,2025-05-25,10:50,11,11,22
58,2025-05-25T02:54:00+02:00,2025-05-25,10:54,14,3,17
62,2025-05-25T02:40:00+02:00,2025-05-25,10:40,0,1,1
62,2025-05-25T02:44:00+02:00,2025-05-25,10:44,4,1,5
62,2025-05-25T02:45:00+02:00,2025-05-25,10:45,0,3,3
62,2025-05-25T02:49:00+02:00,2025-05-25,10:49,1,1,2
62,2025-05-25T02:50:00+02:00,2025-05-25,10:50,2,0,2
62,2025-05-25T02:52:00+02:00,2025-05-25,10:52,2,3,5
62,2025-05-25T02:53:00+02:00,2025-05-25,10:53,0,3,3
63,2025-05-25T02:42:00+02:00,2025-05-25,10:42,2,4,6
63,2025-05-25T02:44:00+02:00,2025-05-25,10:44,5,5,10
63,2025-05-25T02:47:00+02:00,2025-05-25,10:47,2,1,3
63,2025-05-25T02:52:00+02:00,2025-05-25,10:52,5,6,11
67,2025-05-25T02:42:00+02:00,2025-05-25,10:42,3,10,13
67,2025-05-25T02:53:00+02:00,2025-05-25,10:53,11,7,18
67,2025-05-25T02:54:00+02:00,2025-05-25,10:54,2,5,7
68,2025-05-25T02:41:00+02:00,2025-05-25,10:41,7,3,10
68,2025-05-25T02:43:00+02:00,2025-05-25,10:43,2,1,3
68,2025-05-25T02:49:00+02:00,2025-05-25,10:49,2,9,11
68,2025-05-25T02:50:00+02:00,2025-05-25,10:50,1,8,9
68,2025-05-25T02:51:00+02:00,2025-05-25,10:51,3,3,6
68,2025-05-25T02:54:00+02:00,2025-05-25,10:54,9,9,18
72,2025-05-25T02:44:00+02:00,2025-05-25,10:44,4,10,14
72,2025-05-25T02:49:00+02:00,2025-05-25,10:49,4,12,16
76,2025-05-25T02:40:00+02:00,2025-05-25,10:40,2,2,4
76,2025-05-25T02:42:00+02:00,2025-05-25,10:42,1,0,1
76,2025-05-25T02:46:00+02:00,2025-05-25,10:46,0,1,1
76,2025-05-25T02:47:00+02:00,2025-05-25,10:47,0,3,3
76,2025-05-25T02:49:00+02:00,2025-05-25,10:49,2,1,3
76,2025-05-25T02:52:00+02:00,2025-05-25,10:52,3,0,3
79,2025-05-25T02:40:00+02:00,2025-05-25,10:40,4,3,7
79,2025-05-25T02:41:00+02:00,2025-05-25,10:41,2,5,7
79,2025-05-25T02:45:00+02:00,2025-05-25,10:45,6,9,15
79,2025-05-25T02:46:00+02:00,2025-05-25,10:46,20,2,22
79,2025-05-25T02:47:00+02:00,2025-05-25,10:47,27,4,31
79,2025-05-25T02:52:00+02:00,2025-05-25,10:52,4,10,14
79,2025-05-25T02:54:00+02:00,2025-05-25,10:54,2,2,4
85,2025-05-25T02:42:00+02:00,2025-05-25,10:42,1,0,1
85,2025-05-25T02:44:00+02:00,2025-05-25,10:44,3,2,5
86,2025-05-25T02:52:00+02:00,2025-05-25,10:52,0,3,3
86,2025-05-25T02:53:00+02:00,2025-05-25,10:53,0,1,1
86,2025-05-25T02:54:00+02:00,2025-05-25,10:54,2,0,2
109,2025-05-25T02:50:00+02:00,2025-05-25,10:50,5,2,7
123,2025-05-25T02:45:00+02:00,2025-05-25,10:45,5,0,5
130,2025-05-25T02:40:00+02:00,2025-05-25,10:40,2,1,3
130,2025-05-25T02:50:00+02:00,2025-05-25,10:50,6,6,12
137,2025-05-25T02:45:00+02:00,2025-05-25,10:45,2,0,2
141,2025-05-25T02:45:00+02:00,2025-05-25,10:45,5,8,13
142,2025-05-25T02:45:00+02:00,2025-05-25,10:45,64,32,96
142,2025-05-25T02:50:00+02:00,2025-05-25,10:50,45,24,69
161,2025-05-25T02:45:00+02:00,2025-05-25,10:45,18,14,32
181,2025-05-25T02:57:00+02:00,2025-05-25,10:57,4,15,19
181,2025-05-25T02:59:00+02:00,2025-05-25,10:59,4,13,17
181,2025-05-25T03:00:00+02:00,2025-05-25,11:00,7,9,16
181,2025-05-25T03:02:00+02:00,2025-05-25,11:02,6,24,30
181,2025-05-25T03:05:00+02:00,2025-05-25,11:05,6,13,19
181,2025-05-25T03:07:00+02:00,2025-05-25,11:07,7,13,20
180,2025-05-25T02:58:00+02:00,2025-05-25,10:58,2,2,4
180,2025-05-25T03:08:00+02:00,2025-05-25,11:08,2,0,2
3,2025-05-25T03:01:00+02:00,2025-05-25,11:01,6,9,15
3,2025-05-25T03:06:00+02:00,2025-05-25,11:06,17,8,25
3,2025-05-25T03:07:00+02:00,2025-05-25,11:07,8,15,23
4,2025-05-25T02:57:00+02:00,2025-05-25,10:57,20,9,29
4,2025-05-25T02:58:00+02:00,2025-05-25,10:58,6,15,21
4,2025-05-25T03:00:00+02:00,2025-05-25,11:00,16,5,21
4,2025-05-25T03:08:00+02:00,2025-05-25,11:08,12,12,24
4,2025-05-25T03:09:00+02:00,2025-05-25,11:09,33,15,48
5,2025-05-25T02:55:00+02:00,2025-05-25,10:55,49,42,91
5,2025-05-25T03:00:00+02:00,2025-05-25,11:00,30,59,89
5,2025-05-25T03:05:00+02:00,2025-05-25,11:05,54,54,108
6,2025-05-25T02:57:00+02:00,2025-05-25,10:57,11,11,22
6,2025-05-25T02:58:00+02:00,2025-05-25,10:58,11,0,11
6,2025-05-25T02:59:00+02:00,2025-05-25,10:59,15,13,28
6,2025-05-25T03:00:00+02:00,2025-05-25,11:00,11,11,22
6,2025-05-25T03:01:00+02:00,2025-05-25,11:01,7,2,9
6,2025-05-25T03:02:00+02:00,2025-05-25,11:02,13,19,32
6,2025-05-25T03:06:00+02:00,2025-05-25,11:06,7,7,14
6,2025-05-25T03:09:00+02:00,2025-05-25,11:09,12,13,25
8,2025-05-25T03:00:00+02:00,2025-05-25,11:00,0,4,4
28,2025-05-25T02:56:00+02:00,2025-05-25,10:56,13,10,23
28,2025-05-25T02:58:00+02:00,2025-05-25,10:58,3,5,8
28,2025-05-25T03:02:00+02:00,2025-05-25,11:02,5,3,8
28,2025-05-25T03:03:00+02:00,2025-05-25,11:03,6,8,14
28,2025-05-25T03:07:00+02:00,2025-05-25,11:07,9,2,11
29,2025-05-25T02:57:00+02:00,2025-05-25,10:57,10,3,13
29,2025-05-25T02:59:00+02:00,2025-05-25,10:59,3,7,10
29,2025-05-25T03:01:00+02:00,2025-05-25,11:01,3,1,4
29,2025-05-25T03:04:00+02:00,2025-05-25,11:04,1,10,11
29,2025-05-25T03:07:00+02:00,2025-05-25,11:07,6,3,9
29,2025-05-25T03:09:00+02:00,2025-05-25,11:09,10,3,13
31,2025-05-25T02:55:00+02:00,2025-05-25,10:55,1,8,9
31,2025-05-25T02:59:00+02:00,2025-05-25,10:59,2,0,2
31,2025-05-25T03:03:00+02:00,2025-05-25,11:03,2,0,2
31,2025-05-25T03:07:00+02:00,2025-05-25,11:07,5,0,5
36,2025-05-25T03:01:00+02:00,2025-05-25,11:01,1,1,2
37,2025-05-25T02:58:00+02:00,2025-05-25,10:58,2,0,2
37,2025-05-25T02:59:00+02:00,2025-05-25,10:59,0,1,1
37,2025-05-25T03:01:00+02:00,2025-05-25,11:01,3,3,6
37,2025-05-25T03:05:00+02:00,2025-05-25,11:05,0,1,1
37,2025-05-25T03:08:00+02:00,2025-05-25,11:08,1,0,1
39,2025-05-25T02:58:00+02:00,2025-05-25,10:58,2,0,2
39,2025-05-25T02:59:00+02:00,2025-05-25,10:59,9,1,10
39,2025-05-25T03:02:00+02:00,2025-05-25,11:02,2,2,4
40,2025-05-25T02:55:00+02:00,2025-05-25,10:55,5,4,9
40,2025-05-25T03:00:00+02:00,2025-05-25,11:00,7,5,12
40,2025-05-25T03:06:00+02:00,2025-05-25,11:06,2,2,4
41,2025-05-25T02:59:00+02:00,2025-05-25,10:59,7,1,8
41,2025-05-25T03:00:00+02:00,2025-05-25,11:00,5,9,14
41,2025-05-25T03:04:00+02:00,2025-05-25,11:04,1,2,3
41,2025-05-25T03:06:00+02:00,2025-05-25,11:06,8,11,19
41,2025-05-25T03:07:00+02:00,2025-05-25,11:07,7,2,9
43,2025-05-25T02:55:00+02:00,2025-05-25,10:55,4,1,5
43,2025-05-25T03:05:00+02:00,2025-05-25,11:05,7,10,17
44,2025-05-25T02:55:00+02:00,2025-05-25,10:55,4,2,6
45,2025-05-25T02:56:00+02:00,2025-05-25,10:56,12,12,24
45,2025-05-25T02:58:00+02:00,2025-05-25,10:58,16,6,22
45,2025-05-25T02:59:00+02:00,2025-05-25,10:59,5,13,18
45,2025-05-25T03:05:00+02:00,2025-05-25,11:05,12,5,17
45,2025-05-25T03:09:00+02:00,2025-05-25,11:09,10,2,12
47,2025-05-25T02:59:00+02:00,2025-05-25,10:59,18,5,23
47,2025-05-25T03:02:00+02:00,2025-05-25,11:02,11,5,16
47,2025-05-25T03:05:00+02:00,2025-05-25,11:05,6,10,16
47,2025-05-25T03:09:00+02:00,2025-05-25,11:09,9,36,45
50,2025-05-25T02:55:00+02:00,2025-05-25,10:55,5,3,8
50,2025-05-25T02:59:00+02:00,2025-05-25,10:59,2,5,7
50,2025-05-25T03:03:00+02:00,2025-05-25,11:03,3,10,13
50,2025-05-25T03:04:00+02:00,2025-05-25,11:04,2,3,5
50,2025-05-25T03:05:00+02:00,2025-05-25,11:05,3,5,8
50,2025-05-25T03:07:00+02:00,2025-05-25,11:07,5,3,8
50,2025-05-25T03:08:00+02:00,2025-05-25,11:08,3,7,10
54,2025-05-25T02:56:00+02:00,2025-05-25,10:56,4,0,4
54,2025-05-25T03:02:00+02:00,2025-05-25,11:02,1,0,1
54,2025-05-25T03:07:00+02:00,2025-05-25,11:07,3,1,4
54,2025-05-25T03:09:00+02:00,2025-05-25,11:09,2,1,3
59,2025-05-25T03:00:00+02:00,2025-05-25,11:00,8,19,27
61,2025-05-25T02:56:00+02:00,2025-05-25,10:56,4,8,12
61,2025-05-25T02:58:00+02:00,2025-05-25,10:58,5,2,7
61,2025-05-25T03:01:00+02:00,2025-05-25,11:01,5,12,17
61,2025-05-25T03:02:00+02:00,2025-05-25,11:02,2,9,11
61,2025-05-25T03:04:00+02:00,2025-05-25,11:04,8,6,14
61,2025-05-25T03:06:00+02:00,2025-05-25,11:06,5,15,20
61,2025-05-25T03:07:00+02:00,2025-05-25,11:07,9,14,23
66,2025-05-25T02:57:00+02:00,2025-05-25,10:57,8,9,17
66,2025-05-25T03:00:00+02:00,2025-05-25,11:00,7,10,17
66,2025-05-25T03:03:00+02:00,2025-05-25,11:03,3,9,12
66,2025-05-25T03:05:00+02:00,2025-05-25,11:05,7,14,21
66,2025-05-25T03:07:00+02:00,2025-05-25,11:07,9,18,27
66,2025-05-25T03:09:00+02:00,2025-05-25,11:09,14,6,20
69,2025-05-25T02:55:00+02:00,2025-05-25,10:55,5,7,12
69,2025-05-25T02:57:00+02:00,2025-05-25,10:57,9,1,10
69,2025-05-25T03:03:00+02:00,2025-05-25,11:03,12,3,15
69,2025-05-25T03:04:00+02:00,2025-05-25,11:04,3,2,5
70,2025-05-25T02:57:00+02:00,2025-05-25,10:57,4,1,5
70,2025-05-25T03:06:00+02:00,2025-05-25,11:06,3,0,3
70,2025-05-25T03:07:00+02:00,2025-05-25,11:07,2,2,4
75,2025-05-25T02:55:00+02:00,2025-05-25,10:55,2,0,2
75,2025-05-25T02:57:00+02:00,2025-05-25,10:57,3,0,3
75,2025-05-25T02:59:00+02:00,2025-05-25,10:59,1,1,2
75,2025-05-25T03:00:00+02:00,2025-05-25,11:00,1,0,1
75,2025-05-25T03:04:00+02:00,2025-05-25,11:04,1,0,1
77,2025-05-25T03:05:00+02:00,2025-05-25,11:05,14,13,27
78,2025-05-25T02:55:00+02:00,2025-05-25,10:55,5,2,7
78,2025-05-25T03:03:00+02:00,2025-05-25,11:03,1,2,3
78,2025-05-25T03:06:00+02:00,2025-05-25,11:06,2,1,3
78,2025-05-25T03:07:00+02:00,2025-05-25,11:07,0,2,2
87,2025-05-25T03:01:00+02:00,2025-05-25,11:01,3,0,3
87,2025-05-25T03:08:00+02:00,2025-05-25,11:08,1,1,2
107,2025-05-25T02:55:00+02:00,2025-05-25,10:55,4,6,10
108,2025-05-25T02:55:00+02:00,2025-05-25,10:55,4,2,6
108,2025-05-25T02:56:00+02:00,2025-05-25,10:56,1,4,5
108,2025-05-25T03:00:00+02:00,2025-05-25,11:00,1,3,4
108,2025-05-25T03:04:00+02:00,2025-05-25,11:04,0,6,6
108,2025-05-25T03:09:00+02:00,2025-05-25,11:09,2,2,4
131,2025-05-25T03:05:00+02:00,2025-05-25,11:05,1,17,18
133,2025-05-25T02:55:00+02:00,2025-05-25,10:55,46,28,74
133,2025-05-25T03:05:00+02:00,2025-05-25,11:05,27,43,70
134,2025-05-25T03:05:00+02:00,2025-05-25,11:05,44,23,67
140,2025-05-25T03:00:00+02:00,2025-05-25,11:00,6,6,12
140,2025-05-25T03:05:00+02:00,2025-05-25,11:05,17,4,21
162,2025-05-25T02:55:00+02:00,2025-05-25,10:55,49,53,102
162,2025-05-25T03:00:00+02:00,2025-05-25,11:00,52,46,98
162,2025-05-25T03:05:00+02:00,2025-05-25,11:05,50,37,87
166,2025-05-25T03:00:00+02:00,2025-05-25,11:00,6,5,11
167,2025-05-25T03:00:00+02:00,2025-05-25,11:00,3,10,13
179,2025-05-25T02:55:00+02:00,2025-05-25,10:55,9,1,10
179,2025-05-25T03:05:00+02:00,2025-05-25,11:05,3,4,7
1,2025-05-25T02:56:00+02:00,2025-05-25,10:56,13,7,20
1,2025-05-25T02:58:00+02:00,2025-05-25,10:58,8,11,19
1,2025-05-25T03:07:00+02:00,2025-05-25,11:07,18,9,27
1,2025-05-25T03:09:00+02:00,2025-05-25,11:09,8,27,35
2,2025-05-25T02:56:00+02:00,2025-05-25,10:56,4,8,12
2,2025-05-25T03:07:00+02:00,2025-05-25,11:07,1,6,7
9,2025-05-25T02:55:00+02:00,2025-05-25,10:55,0,1,1
9,2025-05-25T03:00:00+02:00,2025-05-25,11:00,0,1,1
9,2025-05-25T03:01:00+02:00,2025-05-25,11:01,0,1,1
9,2025-05-25T03:04:00+02:00,2025-05-25,11:04,0,1,1
9,2025-05-25T03:07:00+02:00,2025-05-25,11:07,1,0,1
9,2025-05-25T03:08:00+02:00,2025-05-25,11:08,0,1,1
10,2025-05-25T02:58:00+02:00,2025-05-25,10:58,4,0,4
10,2025-05-25T02:59:00+02:00,2025-05-25,10:59,2,0,2
10,2025-05-25T03:04:00+02:00,2025-05-25,11:04,0,1,1
10,2025-05-25T03:05:00+02:00,2025-05-25,11:05,5,8,13
10,2025-05-25T03:07:00+02:00,2025-05-25,11:07,0,1,1
10,2025-05-25T03:09:00+02:00,2025-05-25,11:09,0,1,1
11,2025-05-25T03:04:00+02:00,2025-05-25,11:04,1,1,2
11,2025-05-25T03:09:00+02:00,2025-05-25,11:09,0,2,2
12,2025-05-25T02:57:00+02:00,2025-05-25,10:57,4,4,8
12,2025-05-25T03:01:00+02:00,2025-05-25,11:01,1,2,3
12,2025-05-25T03:02:00+02:00,2025-05-25,11:02,0,3,3
12,2025-05-25T03:03:00+02:00,2025-05-25,11:03,6,2,8
12,2025-05-25T03:05:00+02:00,2025-05-25,11:05,2,1,3
12,2025-05-25T03:09:00+02:00,2025-05-25,11:09,1,1,2
17,2025-05-25T02:56:00+02:00,2025-05-25,10:56,3,1,4
17,2025-05-25T02:58:00+02:00,2025-05-25,10:58,5,1,6
17,2025-05-25T03:01:00+02:00,2025-05-25,11:01,1,1,2
17,2025-05-25T03:03:00+02:00,2025-05-25,11:03,3,1,4
17,2025-05-25T03:08:00+02:00,2025-05-25,11:08,2,0,2
17,2025-05-25T03:09:00+02:00,2025-05-25,11:09,1,0,1
18,2025-05-25T02:55:00+02:00,2025-05-25,10:55,3,1,4
18,2025-05-25T03:05:00+02:00,2025-05-25,11:05,0,1,1
19,2025-05-25T02:55:00+02:00,2025-05-25,10:55,15,4,19
19,2025-05-25T02:56:00+02:00,2025-05-25,10:56,8,4,12
19,2025-05-25T02:58:00+02:00,2025-05-25,10:58,7,3,10
19,2025-05-25T03:04:00+02:00,2025-05-25,11:04,11,7,18
19,2025-05-25T03:05:00+02:00,2025-05-25,11:05,3,6,9
19,2025-05-25T03:08:00+02:00,2025-05-25,11:08,4,2,6
19,2025-05-25T03:09:00+02:00,2025-05-25,11:09,11,3,14
20,2025-05-25T02:57:00+02:00,2025-05-25,10:57,2,1,3
20,2025-05-25T02:59:00+02:00,2025-05-25,10:59,1,7,8
20,2025-05-25T03:01:00+02:00,2025-05-25,11:01,8,3,11
20,2025-05-25T03:06:00+02:00,2025-05-25,11:06,0,3,3
20,2025-05-25T03:08:00+02:00,2025-05-25,11:08,4,3,7
20,2025-05-25T03:09:00+02:00,2025-05-25,11:09,0,3,3
23,2025-05-25T03:04:00+02:00,2025-05-25,11:04,2,2,4
23,2025-05-25T03:05:00+02:00,2025-05-25,11:05,4,1,5
24,2025-05-25T02:56:00+02:00,2025-05-25,10:56,9,24,33
24,2025-05-25T02:57:00+02:00,2025-05-25,10:57,14,19,33
24,2025-05-25T03:01:00+02:00,2025-05-25,11:01,2,3,5
24,2025-05-25T03:02:00+02:00,2025-05-25,11:02,18,5,23
24,2025-05-25T03:04:00+02:00,2025-05-25,11:04,9,16,25
24,2025-05-25T03:05:00+02:00,2025-05-25,11:05,2,12,14
24,2025-05-25T03:07:00+02:00,2025-05-25,11:07,22,8,30
25,2025-05-25T03:05:00+02:00,2025-05-25,11:05,27,114,141
27,2025-05-25T02:56:00+02:00,2025-05-25,10:56,2,2,4
27,2025-05-25T02:57:00+02:00,2025-05-25,10:57,2,5,7
27,2025-05-25T03:00:00+02:00,2025-05-25,11:00,3,9,12
27,2025-05-25T03:01:00+02:00,2025-05-25,11:01,1,5,6
27,2025-05-25T03:02:00+02:00,2025-05-25,11:02,0,5,5
27,2025-05-25T03:03:00+02:00,2025-05-25,11:03,0,2,2
27,2025-05-25T03:04:00+02:00,2025-05-25,11:04,0,3,3
27,2025-05-25T03:05:00+02:00,2025-05-25,11:05,3,1,4
27,2025-05-25T03:08:00+02:00,2025-05-25,11:08,7,8,15
27,2025-05-25T03:09:00+02:00,2025-05-25,11:09,6,8,14
30,2025-05-25T03:01:00+02:00,2025-05-25,11:01,1,6,7
30,2025-05-25T03:03:00+02:00,2025-05-25,11:03,3,1,4
35,2025-05-25T02:56:00+02:00,2025-05-25,10:56,16,20,36
35,2025-05-25T03:00:00+02:00,2025-05-25,11:00,15,7,22
35,2025-05-25T03:06:00+02:00,2025-05-25,11:06,25,13,38
48,2025-05-25T02:56:00+02:00,2025-05-25,10:56,8,4,12
48,2025-05-25T03:01:00+02:00,2025-05-25,11:01,6,5,11
48,2025-05-25T03:04:00+02:00,2025-05-25,11:04,8,7,15
48,2025-05-25T03:07:00+02:00,2025-05-25,11:07,7,4,11
48,2025-05-25T03:08:00+02:00,2025-05-25,11:08,4,19,23
48,2025-05-25T03:09:00+02:00,2025-05-25,11:09,6,8,14
49,2025-05-25T02:56:00+02:00,2025-05-25,10:56,5,9,14
49,2025-05-25T02:57:00+02:00,2025-05-25,10:57,4,9,13
49,2025-05-25T02:58:00+02:00,2025-05-25,10:58,4,24,28
49,2025-05-25T03:02:00+02:00,2025-05-25,11:02,9,5,14
49,2025-05-25T03:06:00+02:00,2025-05-25,11:06,6,8,14
51,2025-05-25T02:57:00+02:00,2025-05-25,10:57,0,5,5
51,2025-05-25T03:00:00+02:00,2025-05-25,11:00,3,0,3
51,2025-05-25T03:02:00+02:00,2025-05-25,11:02,1,1,2
51,2025-05-25T03:04:00+02:00,2025-05-25,11:04,0,6,6
51,2025-05-25T03:05:00+02:00,2025-05-25,11:05,1,1,2
51,2025-05-25T03:06:00+02:00,2025-05-25,11:06,4,7,11
51,2025-05-25T03:07:00+02:00,2025-05-25,11:07,2,3,5
52,2025-05-25T02:55:00+02:00,2025-05-25,10:55,3,2,5
52,2025-05-25T02:56:00+02:00,2025-05-25,10:56,5,2,7
52,2025-05-25T02:57:00+02:00,2025-05-25,10:57,6,1,7
52,2025-05-25T03:00:00+02:00,2025-05-25,11:00,2,0,2
52,2025-05-25T03:01:00+02:00,2025-05-25,11:01,9,2,11
52,2025-05-25T03:03:00+02:00,2025-05-25,11:03,9,0,9
52,2025-05-25T03:04:00+02:00,2025-05-25,11:04,9,2,11
52,2025-05-25T03:06:00+02:00,2025-05-25,11:06,2,0,2
52,2025-05-25T03:09:00+02:00,2025-05-25,11:09,2,2,4
53,2025-05-25T02:59:00+02:00,2025-05-25,10:59,8,3,11
53,2025-05-25T03:05:00+02:00,2025-05-25,11:05,15,14,29
53,2025-05-25T03:08:00+02:00,2025-05-25,11:08,9,3,12
56,2025-05-25T02:58:00+02:00,2025-05-25,10:58,6,2,8
56,2025-05-25T03:09:00+02:00,2025-05-25,11:09,6,5,11
58,2025-05-25T02:55:00+02:00,2025-05-25,10:55,8,3,11
58,2025-05-25T02:57:00+02:00,2025-05-25,10:57,21,0,21
58,2025-05-25T02:59:00+02:00,2025-05-25,10:59,8,5,13
58,2025-05-25T03:02:00+02:00,2025-05-25,11:02,20,2,22
58,2025-05-25T03:04:00+02:00,2025-05-25,11:04,12,3,15
58,2025-05-25T03:07:00+02:00,2025-05-25,11:07,5,0,5
62,2025-05-25T02:56:00+02:00,2025-05-25,10:56,5,4,9
62,2025-05-25T02:58:00+02:00,2025-05-25,10:58,2,3,5
62,2025-05-25T02:59:00+02:00,2025-05-25,10:59,2,1,3
62,2025-05-25T03:00:00+02:00,2025-05-25,11:00,8,1,9
62,2025-05-25T03:01:00+02:00,2025-05-25,11:01,2,0,2
62,2025-05-25T03:05:00+02:00,2025-05-25,11:05,2,1,3
63,2025-05-25T02:58:00+02:00,2025-05-25,10:58,1,1,2
63,2025-05-25T03:03:00+02:00,2025-05-25,11:03,1,3,4
63,2025-05-25T03:05:00+02:00,2025-05-25,11:05,3,6,9
63,2025-05-25T03:07:00+02:00,2025-05-25,11:07,0,2,2
67,2025-05-25T02:57:00+02:00,2025-05-25,10:57,1,11,12
67,2025-05-25T02:58:00+02:00,2025-05-25,10:58,8,7,15
67,2025-05-25T03:02:00+02:00,2025-05-25,11:02,5,15,20
67,2025-05-25T03:04:00+02:00,2025-05-25,11:04,4,4,8
67,2025-05-25T03:05:00+02:00,2025-05-25,11:05,5,7,12
67,2025-05-25T03:08:00+02:00,2025-05-25,11:08,11,4,15
67,2025-05-25T03:09:00+02:00,2025-05-25,11:09,7,14,21
68,2025-05-25T02:56:00+02:00,2025-05-25,10:56,0,6,6
68,2025-05-25T03:00:00+02:00,2025-05-25,11:00,7,3,10
68,2025-05-25T03:01:00+02:00,2025-05-25,11:01,7,5,12
68,2025-05-25T03:02:00+02:00,2025-05-25,11:02,7,8,15
68,2025-05-25T03:03:00+02:00,2025-05-25,11:03,8,3,11
68,2025-05-25T03:04:00+02:00,2025-05-25,11:04,3,9,12
68,2025-05-25T03:06:00+02:00,2025-05-25,11:06,3,6,9
68,2025-05-25T03:09:00+02:00,2025-05-25,11:09,1,7,8
72,2025-05-25T02:55:00+02:00,2025-05-25,10:55,7,5,12
72,2025-05-25T02:56:00+02:00,2025-05-25,10:56,4,0,4
72,2025-05-25T02:58:00+02:00,2025-05-25,10:58,2,0,2
72,2025-05-25T02:59:00+02:00,2025-05-25,10:59,2,3,5
72,2025-05-25T03:02:00+02:00,2025-05-25,11:02,1,9,10
76,2025-05-25T02:55:00+02:00,2025-05-25,10:55,2,0,2
76,2025-05-25T02:58:00+02:00,2025-05-25,10:58,2,0,2
76,2025-05-25T03:05:00+02:00,2025-05-25,11:05,2,0,2
76,2025-05-25T03:06:00+02:00,2025-05-25,11:06,2,4,6
76,2025-05-25T03:08:00+02:00,2025-05-25,11:08,0,2,2
79,2025-05-25T02:55:00+02:00,2025-05-25,10:55,4,3,7
79,2025-05-25T02:57:00+02:00,2025-05-25,10:57,18,8,26
79,2025-05-25T02:58:00+02:00,2025-05-25,10:58,11,2,13
79,2025-05-25T03:00:00+02:00,2025-05-25,11:00,8,3,11
79,2025-05-25T03:03:00+02:00,2025-05-25,11:03,0,1,1
79,2025-05-25T03:04:00+02:00,2025-05-25,11:04,9,2,11
79,2025-05-25T03:06:00+02:00,2025-05-25,11:06,1,5,6
79,2025-05-25T03:07:00+02:00,2025-05-25,11:07,8,5,13
79,2025-05-25T03:08:00+02:00,2025-05-25,11:08,23,6,29
85,2025-05-25T02:56:00+02:00,2025-05-25,10:56,2,1,3
85,2025-05-25T02:58:00+02:00,2025-05-25,10:58,2,1,3
85,2025-05-25T03:05:00+02:00,2025-05-25,11:05,1,0,1
85,2025-05-25T03:07:00+02:00,2025-05-25,11:07,1,0,1
86,2025-05-25T02:58:00+02:00,2025-05-25,10:58,1,0,1
86,2025-05-25T03:05:00+02:00,2025-05-25,11:05,2,1,3
86,2025-05-25T03:06:00+02:00,2025-05-25,11:06,3,0,3
86,2025-05-25T03:07:00+02:00,2025-05-25,11:07,2,2,4
109,2025-05-25T02:55:00+02:00,2025-05-25,10:55,6,3,9
117,2025-05-25T03:00:00+02:00,2025-05-25,11:00,10,9,19
123,2025-05-25T03:00:00+02:00,2025-05-25,11:00,2,6,8
136,2025-05-25T02:55:00+02:00,2025-05-25,10:55,12,6,18
137,2025-05-25T03:00:00+02:00,2025-05-25,11:00,0,2,2
139,2025-05-25T02:55:00+02:00,2025-05-25,10:55,1,2,3
139,2025-05-25T03:00:00+02:00,2025-05-25,11:00,5,5,10
139,2025-05-25T03:05:00+02:00,2025-05-25,11:05,3,7,10
161,2025-05-25T03:00:00+02:00,2025-05-25,11:00,10,9,19
164,2025-05-25T02:55:00+02:00,2025-05-25,10:55,9,1,10
164,2025-05-25T03:00:00+02:00,2025-05-25,11:00,12,1,13
3,2025-05-25T03:16:00+02:00,2025-05-25,11:16,9,7,16
3,2025-05-25T03:18:00+02:00,2025-05-25,11:18,5,7,12
3,2025-05-25T03:23:00+02:00,2025-05-25,11:23,1,13,14
3,2025-05-25T03:24:00+02:00,2025-05-25,11:24,12,8,20
4,2025-05-25T03:10:00+02:00,2025-05-25,11:10,18,11,29
4,2025-05-25T03:11:00+02:00,2025-05-25,11:11,19,11,30
4,2025-05-25T03:12:00+02:00,2025-05-25,11:12,30,18,48
4,2025-05-25T03:21:00+02:00,2025-05-25,11:21,21,19,40
5,2025-05-25T03:15:00+02:00,2025-05-25,11:15,71,68,139
6,2025-05-25T03:11:00+02:00,2025-05-25,11:11,14,1,15
6,2025-05-25T03:18:00+02:00,2025-05-25,11:18,3,12,15
6,2025-05-25T03:19:00+02:00,2025-05-25,11:19,16,10,26
8,2025-05-25T03:10:00+02:00,2025-05-25,11:10,3,10,13
8,2025-05-25T03:11:00+02:00,2025-05-25,11:11,0,2,2
8,2025-05-25T03:14:00+02:00,2025-05-25,11:14,3,3,6
8,2025-05-25T03:16:00+02:00,2025-05-25,11:16,1,5,6
8,2025-05-25T03:19:00+02:00,2025-05-25,11:19,2,3,5
8,2025-05-25T03:20:00+02:00,2025-05-25,11:20,0,2,2
8,2025-05-25T03:21:00+02:00,2025-05-25,11:21,3,5,8
8,2025-05-25T03:22:00+02:00,2025-05-25,11:22,6,9,15
8,2025-05-25T03:24:00+02:00,2025-05-25,11:24,3,1,4
28,2025-05-25T03:11:00+02:00,2025-05-25,11:11,7,10,17
28,2025-05-25T03:12:00+02:00,2025-05-25,11:12,8,5,13
28,2025-05-25T03:13:00+02:00,2025-05-25,11:13,7,5,12
28,2025-05-25T03:14:00+02:00,2025-05-25,11:14,4,9,13
28,2025-05-25T03:15:00+02:00,2025-05-25,11:15,5,6,11
28,2025-05-25T03:20:00+02:00,2025-05-25,11:20,11,11,22
28,2025-05-25T03:22:00+02:00,2025-05-25,11:22,5,2,7
28,2025-05-25T03:23:00+02:00,2025-05-25,11:23,5,9,14
28,2025-05-25T03:24:00+02:00,2025-05-25,11:24,9,8,17
29,2025-05-25T03:10:00+02:00,2025-05-25,11:10,1,7,8
29,2025-05-25T03:11:00+02:00,2025-05-25,11:11,5,3,8
29,2025-05-25T03:21:00+02:00,2025-05-25,11:21,2,8,10
29,2025-05-25T03:22:00+02:00,2025-05-25,11:22,3,3,6
29,2025-05-25T03:23:00+02:00,2025-05-25,11:23,4,8,12
31,2025-05-25T03:12:00+02:00,2025-05-25,11:12,4,4,8
31,2025-05-25T03:15:00+02:00,2025-05-25,11:15,6,2,8
31,2025-05-25T03:17:00+02:00,2025-05-25,11:17,0,7,7
31,2025-05-25T03:19:00+02:00,2025-05-25,11:19,3,1,4
31,2025-05-25T03:20:00+02:00,2025-05-25,11:20,2,3,5
31,2025-05-25T03:23:00+02:00,2025-05-25,11:23,4,1,5
36,2025-05-25T03:13:00+02:00,2025-05-25,11:13,1,2,3
36,2025-05-25T03:15:00+02:00,2025-05-25,11:15,4,0,4
36,2025-05-25T03:20:00+02:00,2025-05-25,11:20,1,1,2
36,2025-05-25T03:21:00+02:00,2025-05-25,11:21,2,2,4
36,2025-05-25T03:24:00+02:00,2025-05-25,11:24,3,2,5
37,2025-05-25T03:22:00+02:00,2025-05-25,11:22,3,0,3
39,2025-05-25T03:11:00+02:00,2025-05-25,11:11,2,0,2
39,2025-05-25T03:16:00+02:00,2025-05-25,11:16,2,0,2
39,2025-05-25T03:19:00+02:00,2025-05-25,11:19,0,1,1
39,2025-05-25T03:21:00+02:00,2025-05-25,11:21,2,1,3
39,2025-05-25T03:23:00+02:00,2025-05-25,11:23,2,0,2
40,2025-05-25T03:10:00+02:00,2025-05-25,11:10,3,0,3
40,2025-05-25T03:13:00+02:00,2025-05-25,11:13,0,1,1
40,2025-05-25T03:16:00+02:00,2025-05-25,11:16,1,1,2
40,2025-05-25T03:22:00+02:00,2025-05-25,11:22,5,0,5
40,2025-05-25T03:23:00+02:00,2025-05-25,11:23,2,4,6
40,2025-05-25T03:24:00+02:00,2025-05-25,11:24,3,7,10
41,2025-05-25T03:15:00+02:00,2025-05-25,11:15,4,0,4
41,2025-05-25T03:18:00+02:00,2025-05-25,11:18,4,4,8
41,2025-05-25T03:21:00+02:00,2025-05-25,11:21,0,3,3
45,2025-05-25T03:10:00+02:00,2025-05-25,11:10,9,21,30
45,2025-05-25T03:11:00+02:00,2025-05-25,11:11,8,4,12
45,2025-05-25T03:12:00+02:00,2025-05-25,11:12,10,3,13
45,2025-05-25T03:16:00+02:00,2025-05-25,11:16,14,16,30
45,2025-05-25T03:19:00+02:00,2025-05-25,11:19,13,7,20
45,2025-05-25T03:21:00+02:00,2025-05-25,11:21,20,5,25
47,2025-05-25T03:12:00+02:00,2025-05-25,11:12,4,3,7
47,2025-05-25T03:13:00+02:00,2025-05-25,11:13,17,9,26
47,2025-05-25T03:14:00+02:00,2025-05-25,11:14,9,4,13
47,2025-05-25T03:17:00+02:00,2025-05-25,11:17,11,9,20
47,2025-05-25T03:20:00+02:00,2025-05-25,11:20,7,3,10
47,2025-05-25T03:22:00+02:00,2025-05-25,11:22,13,17,30
47,2025-05-25T03:24:00+02:00,2025-05-25,11:24,12,4,16
50,2025-05-25T03:13:00+02:00,2025-05-25,11:13,4,2,6
50,2025-05-25T03:14:00+02:00,2025-05-25,11:14,0,9,9
50,2025-05-25T03:16:00+02:00,2025-05-25,11:16,5,1,6
50,2025-05-25T03:17:00+02:00,2025-05-25,11:17,5,3,8
50,2025-05-25T03:20:00+02:00,2025-05-25,11:20,1,6,7
50,2025-05-25T03:21:00+02:00,2025-05-25,11:21,1,1,2
50,2025-05-25T03:22:00+02:00,2025-05-25,11:22,4,7,11
50,2025-05-25T03:23:00+02:00,2025-05-25,11:23,5,2,7
54,2025-05-25T03:12:00+02:00,2025-05-25,11:12,0,1,1
54,2025-05-25T03:13:00+02:00,2025-05-25,11:13,2,3,5
54,2025-05-25T03:14:00+02:00,2025-05-25,11:14,3,2,5
54,2025-05-25T03:16:00+02:00,2025-05-25,11:16,0,3,3
54,2025-05-25T03:18:00+02:00,2025-05-25,11:18,2,2,4
61,2025-05-25T03:13:00+02:00,2025-05-25,11:13,7,9,16
61,2025-05-25T03:14:00+02:00,2025-05-25,11:14,2,5,7
61,2025-05-25T03:16:00+02:00,2025-05-25,11:16,2,0,2
61,2025-05-25T03:17:00+02:00,2025-05-25,11:17,7,4,11
66,2025-05-25T03:10:00+02:00,2025-05-25,11:10,12,20,32
66,2025-05-25T03:11:00+02:00,2025-05-25,11:11,11,17,28
66,2025-05-25T03:13:00+02:00,2025-05-25,11:13,12,7,19
66,2025-05-25T03:15:00+02:00,2025-05-25,11:15,11,6,17
66,2025-05-25T03:16:00+02:00,2025-05-25,11:16,16,9,25
66,2025-05-25T03:17:00+02:00,2025-05-25,11:17,10,10,20
66,2025-05-25T03:18:00+02:00,2025-05-25,11:18,13,12,25
66,2025-05-25T03:19:00+02:00,2025-05-25,11:19,21,5,26
69,2025-05-25T03:12:00+02:00,2025-05-25,11:12,9,4,13
69,2025-05-25T03:17:00+02:00,2025-05-25,11:17,0,1,1
69,2025-05-25T03:24:00+02:00,2025-05-25,11:24,1,6,7
70,2025-05-25T03:12:00+02:00,2025-05-25,11:12,3,2,5
70,2025-05-25T03:13:00+02:00,2025-05-25,11:13,3,0,3
70,2025-05-25T03:14:00+02:00,2025-05-25,11:14,2,0,2
70,2025-05-25T03:17:00+02:00,2025-05-25,11:17,1,5,6
70,2025-05-25T03:19:00+02:00,2025-05-25,11:19,3,2,5
70,2025-05-25T03:20:00+02:00,2025-05-25,11:20,6,4,10
70,2025-05-25T03:22:00+02:00,2025-05-25,11:22,9,1,10
70,2025-05-25T03:23:00+02:00,2025-05-25,11:23,2,2,4
70,2025-05-25T03:24:00+02:00,2025-05-25,11:24,3,1,4
71,2025-05-25T03:10:00+02:00,2025-05-25,11:10,0,1,1
75,2025-05-25T03:10:00+02:00,2025-05-25,11:10,1,0,1
75,2025-05-25T03:12:00+02:00,2025-05-25,11:12,0,3,3
77,2025-05-25T03:10:00+02:00,2025-05-25,11:10,32,18,50
78,2025-05-25T03:14:00+02:00,2025-05-25,11:14,0,2,2
78,2025-05-25T03:17:00+02:00,2025-05-25,11:17,0,2,2
78,2025-05-25T03:23:00+02:00,2025-05-25,11:23,1,0,1
84,2025-05-25T03:10:00+02:00,2025-05-25,11:10,71,74,145
84,2025-05-25T03:15:00+02:00,2025-05-25,11:15,79,61,140
87,2025-05-25T03:23:00+02:00,2025-05-25,11:23,0,7,7
107,2025-05-25T03:10:00+02:00,2025-05-25,11:10,6,11,17
107,2025-05-25T03:15:00+02:00,2025-05-25,11:15,6,24,30
107,2025-05-25T03:20:00+02:00,2025-05-25,11:20,4,9,13
108,2025-05-25T03:11:00+02:00,2025-05-25,11:11,3,7,10
108,2025-05-25T03:13:00+02:00,2025-05-25,11:13,3,6,9
108,2025-05-25T03:16:00+02:00,2025-05-25,11:16,9,3,12
108,2025-05-25T03:19:00+02:00,2025-05-25,11:19,1,4,5
108,2025-05-25T03:20:00+02:00,2025-05-25,11:20,8,1,9
118,2025-05-25T03:10:00+02:00,2025-05-25,11:10,5,0,5
131,2025-05-25T03:20:00+02:00,2025-05-25,11:20,9,12,21
132,2025-05-25T03:20:00+02:00,2025-05-25,11:20,12,7,19
133,2025-05-25T03:15:00+02:00,2025-05-25,11:15,15,31,46
134,2025-05-25T03:20:00+02:00,2025-05-25,11:20,22,40,62
135,2025-05-25T03:15:00+02:00,2025-05-25,11:15,27,38,65
140,2025-05-25T03:10:00+02:00,2025-05-25,11:10,18,4,22
140,2025-05-25T03:15:00+02:00,2025-05-25,11:15,25,5,30
162,2025-05-25T03:15:00+02:00,2025-05-25,11:15,50,49,99
165,2025-05-25T03:15:00+02:00,2025-05-25,11:15,1,7,8
165,2025-05-25T03:20:00+02:00,2025-05-25,11:20,2,1,3
166,2025-05-25T03:15:00+02:00,2025-05-25,11:15,4,6,10
166,2025-05-25T03:20:00+02:00,2025-05-25,11:20,4,0,4
179,2025-05-25T03:10:00+02:00,2025-05-25,11:10,7,11,18
1,2025-05-25T03:12:00+02:00,2025-05-25,11:12,4,29,33
1,2025-05-25T03:13:00+02:00,2025-05-25,11:13,15,12,27
1,2025-05-25T03:16:00+02:00,2025-05-25,11:16,13,14,27
1,2025-05-25T03:17:00+02:00,2025-05-25,11:17,16,23,39
1,2025-05-25T03:18:00+02:00,2025-05-25,11:18,15,27,42
2,2025-05-25T03:11:00+02:00,2025-05-25,11:11,4,20,24
2,2025-05-25T03:17:00+02:00,2025-05-25,11:17,11,5,16
9,2025-05-25T03:14:00+02:00,2025-05-25,11:14,0,3,3
9,2025-05-25T03:19:00+02:00,2025-05-25,11:19,1,0,1
10,2025-05-25T03:13:00+02:00,2025-05-25,11:13,3,0,3
10,2025-05-25T03:23:00+02:00,2025-05-25,11:23,0,1,1
11,2025-05-25T03:10:00+02:00,2025-05-25,11:10,3,3,6
12,2025-05-25T03:19:00+02:00,2025-05-25,11:19,1,1,2
17,2025-05-25T03:10:00+02:00,2025-05-25,11:10,5,3,8
17,2025-05-25T03:20:00+02:00,2025-05-25,11:20,2,9,11
17,2025-05-25T03:23:00+02:00,2025-05-25,11:23,5,0,5
17,2025-05-25T03:24:00+02:00,2025-05-25,11:24,7,2,9
18,2025-05-25T03:10:00+02:00,2025-05-25,11:10,3,2,5
18,2025-05-25T03:19:00+02:00,2025-05-25,11:19,8,0,8
18,2025-05-25T03:20:00+02:00,2025-05-25,11:20,2,2,4
19,2025-05-25T03:13:00+02:00,2025-05-25,11:13,5,4,9
19,2025-05-25T03:14:00+02:00,2025-05-25,11:14,5,0,5
19,2025-05-25T03:22:00+02:00,2025-05-25,11:22,2,2,4
20,2025-05-25T03:13:00+02:00,2025-05-25,11:13,2,0,2
20,2025-05-25T03:14:00+02:00,2025-05-25,11:14,0,3,3
20,2025-05-25T03:21:00+02:00,2025-05-25,11:21,2,0,2
20,2025-05-25T03:22:00+02:00,2025-05-25,11:22,4,2,6
23,2025-05-25T03:10:00+02:00,2025-05-25,11:10,3,8,11
23,2025-05-25T03:17:00+02:00,2025-05-25,11:17,0,5,5
23,2025-05-25T03:21:00+02:00,2025-05-25,11:21,0,2,2
23,2025-05-25T03:24:00+02:00,2025-05-25,11:24,8,1,9
24,2025-05-25T03:12:00+02:00,2025-05-25,11:12,4,18,22
24,2025-05-25T03:13:00+02:00,2025-05-25,11:13,3,6,9
24,2025-05-25T03:14:00+02:00,2025-05-25,11:14,2,6,8
24,2025-05-25T03:15:00+02:00,2025-05-25,11:15,4,3,7
24,2025-05-25T03:16:00+02:00,2025-05-25,11:16,5,4,9
24,2025-05-25T03:19:00+02:00,2025-05-25,11:19,13,3,16
24,2025-05-25T03:21:00+02:00,2025-05-25,11:21,3,5,8
25,2025-05-25T03:10:00+02:00,2025-05-25,11:10,42,55,97
27,2025-05-25T03:10:00+02:00,2025-05-25,11:10,5,1,6
27,2025-05-25T03:12:00+02:00,2025-05-25,11:12,13,4,17
27,2025-05-25T03:14:00+02:00,2025-05-25,11:14,6,1,7
27,2025-05-25T03:15:00+02:00,2025-05-25,11:15,5,1,6
27,2025-05-25T03:23:00+02:00,2025-05-25,11:23,8,2,10
30,2025-05-25T03:12:00+02:00,2025-05-25,11:12,1,4,5
30,2025-05-25T03:13:00+02:00,2025-05-25,11:13,0,5,5
35,2025-05-25T03:11:00+02:00,2025-05-25,11:11,25,12,37
35,2025-05-25T03:15:00+02:00,2025-05-25,11:15,19,21,40
35,2025-05-25T03:17:00+02:00,2025-05-25,11:17,25,18,43
35,2025-05-25T03:18:00+02:00,2025-05-25,11:18,18,12,30
35,2025-05-25T03:19:00+02:00,2025-05-25,11:19,11,20,31
35,2025-05-25T03:22:00+02:00,2025-05-25,11:22,24,29,53
35,2025-05-25T03:23:00+02:00,2025-05-25,11:23,18,14,32
35,2025-05-25T03:24:00+02:00,2025-05-25,11:24,20,13,33
46,2025-05-25T03:20:00+02:00,2025-05-25,11:20,9,1,10
48,2025-05-25T03:10:00+02:00,2025-05-25,11:10,8,12,20
48,2025-05-25T03:12:00+02:00,2025-05-25,11:12,2,6,8
48,2025-05-25T03:20:00+02:00,2025-05-25,11:20,12,7,19
48,2025-05-25T03:21:00+02:00,2025-05-25,11:21,7,3,10
49,2025-05-25T03:12:00+02:00,2025-05-25,11:12,4,8,12
49,2025-05-25T03:17:00+02:00,2025-05-25,11:17,4,15,19
49,2025-05-25T03:19:00+02:00,2025-05-25,11:19,10,4,14
49,2025-05-25T03:21:00+02:00,2025-05-25,11:21,7,11,18
49,2025-05-25T03:23:00+02:00,2025-05-25,11:23,5,8,13
51,2025-05-25T03:11:00+02:00,2025-05-25,11:11,1,1,2
51,2025-05-25T03:16:00+02:00,2025-05-25,11:16,3,2,5
51,2025-05-25T03:17:00+02:00,2025-05-25,11:17,1,6,7
51,2025-05-25T03:21:00+02:00,2025-05-25,11:21,10,1,11
51,2025-05-25T03:22:00+02:00,2025-05-25,11:22,20,1,21
51,2025-05-25T03:24:00+02:00,2025-05-25,11:24,4,10,14
52,2025-05-25T03:11:00+02:00,2025-05-25,11:11,4,1,5
52,2025-05-25T03:12:00+02:00,2025-05-25,11:12,7,6,13
52,2025-05-25T03:13:00+02:00,2025-05-25,11:13,0,3,3
52,2025-05-25T03:14:00+02:00,2025-05-25,11:14,1,7,8
52,2025-05-25T03:18:00+02:00,2025-05-25,11:18,6,2,8
52,2025-05-25T03:21:00+02:00,2025-05-25,11:21,2,4,6
53,2025-05-25T03:10:00+02:00,2025-05-25,11:10,10,12,22
53,2025-05-25T03:12:00+02:00,2025-05-25,11:12,9,3,12
53,2025-05-25T03:14:00+02:00,2025-05-25,11:14,9,10,19
53,2025-05-25T03:20:00+02:00,2025-05-25,11:20,21,4,25
56,2025-05-25T03:10:00+02:00,2025-05-25,11:10,11,9,20
56,2025-05-25T03:11:00+02:00,2025-05-25,11:11,9,3,12
56,2025-05-25T03:12:00+02:00,2025-05-25,11:12,5,8,13
56,2025-05-25T03:13:00+02:00,2025-05-25,11:13,4,2,6
56,2025-05-25T03:14:00+02:00,2025-05-25,11:14,4,5,9
56,2025-05-25T03:16:00+02:00,2025-05-25,11:16,4,1,5
56,2025-05-25T03:18:00+02:00,2025-05-25,11:18,4,1,5
56,2025-05-25T03:24:00+02:00,2025-05-25,11:24,8,1,9
58,2025-05-25T03:13:00+02:00,2025-05-25,11:13,9,3,12
58,2025-05-25T03:15:00+02:00,2025-05-25,11:15,6,3,9
58,2025-05-25T03:18:00+02:00,2025-05-25,11:18,4,1,5
58,2025-05-25T03:19:00+02:00,2025-05-25,11:19,7,4,11
58,2025-05-25T03:20:00+02:00,2025-05-25,11:20,7,14,21
58,2025-05-25T03:24:00+02:00,2025-05-25,11:24,8,10,18
62,2025-05-25T03:15:00+02:00,2025-05-25,11:15,0,3,3
62,2025-05-25T03:20:00+02:00,2025-05-25,11:20,3,4,7
62,2025-05-25T03:24:00+02:00,2025-05-25,11:24,1,0,1
63,2025-05-25T03:10:00+02:00,2025-05-25,11:10,0,1,1
63,2025-05-25T03:14:00+02:00,2025-05-25,11:14,2,6,8
63,2025-05-25T03:19:00+02:00,2025-05-25,11:19,2,2,4
63,2025-05-25T03:20:00+02:00,2025-05-25,11:20,5,10,15
63,2025-05-25T03:24:00+02:00,2025-05-25,11:24,2,1,3
67,2025-05-25T03:10:00+02:00,2025-05-25,11:10,5,16,21
67,2025-05-25T03:11:00+02:00,2025-05-25,11:11,8,2,10
67,2025-05-25T03:20:00+02:00,2025-05-25,11:20,4,2,6
67,2025-05-25T03:21:00+02:00,2025-05-25,11:21,5,4,9
67,2025-05-25T03:22:00+02:00,2025-05-25,11:22,10,6,16
67,2025-05-25T03:24:00+02:00,2025-05-25,11:24,10,1,11
68,2025-05-25T03:11:00+02:00,2025-05-25,11:11,1,3,4
68,2025-05-25T03:12:00+02:00,2025-05-25,11:12,0,6,6
68,2025-05-25T03:13:00+02:00,2025-05-25,11:13,3,4,7
68,2025-05-25T03:16:00+02:00,2025-05-25,11:16,17,3,20
68,2025-05-25T03:19:00+02:00,2025-05-25,11:19,5,4,9
72,2025-05-25T03:11:00+02:00,2025-05-25,11:11,6,12,18
72,2025-05-25T03:12:00+02:00,2025-05-25,11:12,3,9,12
72,2025-05-25T03:15:00+02:00,2025-05-25,11:15,2,5,7
72,2025-05-25T03:16:00+02:00,2025-05-25,11:16,0,2,2
72,2025-05-25T03:17:00+02:00,2025-05-25,11:17,2,2,4
72,2025-05-25T03:18:00+02:00,2025-05-25,11:18,5,13,18
72,2025-05-25T03:21:00+02:00,2025-05-25,11:21,5,22,27
72,2025-05-25T03:22:00+02:00,2025-05-25,11:22,1,8,9
72,2025-05-25T03:23:00+02:00,2025-05-25,11:23,4,6,10
76,2025-05-25T03:20:00+02:00,2025-05-25,11:20,2,1,3
76,2025-05-25T03:22:00+02:00,2025-05-25,11:22,1,0,1
79,2025-05-25T03:13:00+02:00,2025-05-25,11:13,6,2,8
79,2025-05-25T03:20:00+02:00,2025-05-25,11:20,11,1,12
79,2025-05-25T03:23:00+02:00,2025-05-25,11:23,8,10,18
85,2025-05-25T03:13:00+02:00,2025-05-25,11:13,0,2,2
85,2025-05-25T03:16:00+02:00,2025-05-25,11:16,1,3,4
85,2025-05-25T03:17:00+02:00,2025-05-25,11:17,6,3,9
85,2025-05-25T03:18:00+02:00,2025-05-25,11:18,4,2,6
85,2025-05-25T03:19:00+02:00,2025-05-25,11:19,2,2,4
85,2025-05-25T03:20:00+02:00,2025-05-25,11:20,0,2,2
85,2025-05-25T03:21:00+02:00,2025-05-25,11:21,5,4,9
86,2025-05-25T03:14:00+02:00,2025-05-25,11:14,3,3,6
86,2025-05-25T03:19:00+02:00,2025-05-25,11:19,0,1,1
86,2025-05-25T03:24:00+02:00,2025-05-25,11:24,2,0,2
123,2025-05-25T03:10:00+02:00,2025-05-25,11:10,4,3,7
123,2025-05-25T03:20:00+02:00,2025-05-25,11:20,4,1,5
130,2025-05-25T03:15:00+02:00,2025-05-25,11:15,0,4,4
130,2025-05-25T03:20:00+02:00,2025-05-25,11:20,3,2,5
136,2025-05-25T03:10:00+02:00,2025-05-25,11:10,17,9,26
136,2025-05-25T03:20:00+02:00,2025-05-25,11:20,14,11,25
137,2025-05-25T03:15:00+02:00,2025-05-25,11:15,0,1,1
138,2025-05-25T03:15:00+02:00,2025-05-25,11:15,1,0,1
139,2025-05-25T03:20:00+02:00,2025-05-25,11:20,3,6,9
141,2025-05-25T03:15:00+02:00,2025-05-25,11:15,11,9,20
142,2025-05-25T03:15:00+02:00,2025-05-25,11:15,40,52,92
161,2025-05-25T03:15:00+02:00,2025-05-25,11:15,18,9,27
164,2025-05-25T03:15:00+02:00,2025-05-25,11:15,11,2,13
181,2025-05-25T03:13:00+02:00,2025-05-25,11:13,6,7,13
181,2025-05-25T03:17:00+02:00,2025-05-25,11:17,3,9,12
181,2025-05-25T03:18:00+02:00,2025-05-25,11:18,5,0,5
181,2025-05-25T03:20:00+02:00,2025-05-25,11:20,8,12,20
181,2025-05-25T03:23:00+02:00,2025-05-25,11:23,4,15,19
182,2025-05-25T03:10:00+02:00,2025-05-25,11:10,27,11,38
182,2025-05-25T03:15:00+02:00,2025-05-25,11:15,23,13,36
180,2025-05-25T03:13:00+02:00,2025-05-25,11:13,5,0,5
180,2025-05-25T03:15:00+02:00,2025-05-25,11:15,1,0,1
180,2025-05-25T03:17:00+02:00,2025-05-25,11:17,0,1,1
180,2025-05-25T03:20:00+02:00,2025-05-25,11:20,4,0,4
180,2025-05-25T03:24:00+02:00,2025-05-25,11:24,1,0,1
181,2025-05-25T03:27:00+02:00,2025-05-25,11:27,3,9,12
181,2025-05-25T03:30:00+02:00,2025-05-25,11:30,6,13,19
181,2025-05-25T03:32:00+02:00,2025-05-25,11:32,0,19,19
181,2025-05-25T03:34:00+02:00,2025-05-25,11:34,10,9,19
181,2025-05-25T03:39:00+02:00,2025-05-25,11:39,12,17,29
182,2025-05-25T03:25:00+02:00,2025-05-25,11:25,8,14,22
182,2025-05-25T03:30:00+02:00,2025-05-25,11:30,16,9,25
180,2025-05-25T03:25:00+02:00,2025-05-25,11:25,0,3,3
180,2025-05-25T03:26:00+02:00,2025-05-25,11:26,0,4,4
3,2025-05-25T03:30:00+02:00,2025-05-25,11:30,14,22,36
3,2025-05-25T03:31:00+02:00,2025-05-25,11:31,8,11,19
3,2025-05-25T03:32:00+02:00,2025-05-25,11:32,0,7,7
3,2025-05-25T03:39:00+02:00,2025-05-25,11:39,6,14,20
4,2025-05-25T03:27:00+02:00,2025-05-25,11:27,3,2,5
4,2025-05-25T03:32:00+02:00,2025-05-25,11:32,23,10,33
4,2025-05-25T03:33:00+02:00,2025-05-25,11:33,21,14,35
4,2025-05-25T03:35:00+02:00,2025-05-25,11:35,19,20,39
5,2025-05-25T03:25:00+02:00,2025-05-25,11:25,43,58,101
6,2025-05-25T03:27:00+02:00,2025-05-25,11:27,25,8,33
6,2025-05-25T03:29:00+02:00,2025-05-25,11:29,9,9,18
6,2025-05-25T03:31:00+02:00,2025-05-25,11:31,14,16,30
6,2025-05-25T03:34:00+02:00,2025-05-25,11:34,15,7,22
6,2025-05-25T03:37:00+02:00,2025-05-25,11:37,12,22,34
8,2025-05-25T03:30:00+02:00,2025-05-25,11:30,2,13,15
8,2025-05-25T03:35:00+02:00,2025-05-25,11:35,3,10,13
8,2025-05-25T03:36:00+02:00,2025-05-25,11:36,10,1,11
28,2025-05-25T03:26:00+02:00,2025-05-25,11:26,8,11,19
28,2025-05-25T03:34:00+02:00,2025-05-25,11:34,10,8,18
28,2025-05-25T03:35:00+02:00,2025-05-25,11:35,3,7,10
29,2025-05-25T03:25:00+02:00,2025-05-25,11:25,14,5,19
29,2025-05-25T03:26:00+02:00,2025-05-25,11:26,11,3,14
29,2025-05-25T03:27:00+02:00,2025-05-25,11:27,10,10,20
29,2025-05-25T03:28:00+02:00,2025-05-25,11:28,12,6,18
29,2025-05-25T03:29:00+02:00,2025-05-25,11:29,6,6,12
29,2025-05-25T03:38:00+02:00,2025-05-25,11:38,9,4,13
31,2025-05-25T03:25:00+02:00,2025-05-25,11:25,1,1,2
31,2025-05-25T03:28:00+02:00,2025-05-25,11:28,0,4,4
31,2025-05-25T03:31:00+02:00,2025-05-25,11:31,4,0,4
31,2025-05-25T03:32:00+02:00,2025-05-25,11:32,2,0,2
31,2025-05-25T03:33:00+02:00,2025-05-25,11:33,1,1,2
31,2025-05-25T03:34:00+02:00,2025-05-25,11:34,2,1,3
31,2025-05-25T03:38:00+02:00,2025-05-25,11:38,2,3,5
36,2025-05-25T03:27:00+02:00,2025-05-25,11:27,0,1,1
36,2025-05-25T03:28:00+02:00,2025-05-25,11:28,1,4,5
36,2025-05-25T03:29:00+02:00,2025-05-25,11:29,4,0,4
36,2025-05-25T03:31:00+02:00,2025-05-25,11:31,5,0,5
36,2025-05-25T03:37:00+02:00,2025-05-25,11:37,1,2,3
37,2025-05-25T03:27:00+02:00,2025-05-25,11:27,2,0,2
37,2025-05-25T03:28:00+02:00,2025-05-25,11:28,6,0,6
37,2025-05-25T03:29:00+02:00,2025-05-25,11:29,4,0,4
37,2025-05-25T03:31:00+02:00,2025-05-25,11:31,0,1,1
37,2025-05-25T03:34:00+02:00,2025-05-25,11:34,1,1,2
39,2025-05-25T03:28:00+02:00,2025-05-25,11:28,0,2,2
39,2025-05-25T03:34:00+02:00,2025-05-25,11:34,1,0,1
39,2025-05-25T03:37:00+02:00,2025-05-25,11:37,0,2,2
40,2025-05-25T03:25:00+02:00,2025-05-25,11:25,1,4,5
40,2025-05-25T03:27:00+02:00,2025-05-25,11:27,2,0,2
40,2025-05-25T03:37:00+02:00,2025-05-25,11:37,1,0,1
40,2025-05-25T03:38:00+02:00,2025-05-25,11:38,0,1,1
41,2025-05-25T03:26:00+02:00,2025-05-25,11:26,7,5,12
41,2025-05-25T03:27:00+02:00,2025-05-25,11:27,3,4,7
41,2025-05-25T03:28:00+02:00,2025-05-25,11:28,0,3,3
41,2025-05-25T03:31:00+02:00,2025-05-25,11:31,2,8,10
41,2025-05-25T03:33:00+02:00,2025-05-25,11:33,1,1,2
41,2025-05-25T03:35:00+02:00,2025-05-25,11:35,2,2,4
41,2025-05-25T03:38:00+02:00,2025-05-25,11:38,4,4,8
43,2025-05-25T03:25:00+02:00,2025-05-25,11:25,0,1,1
43,2025-05-25T03:30:00+02:00,2025-05-25,11:30,5,3,8
44,2025-05-25T03:35:00+02:00,2025-05-25,11:35,0,5,5
45,2025-05-25T03:26:00+02:00,2025-05-25,11:26,7,10,17
45,2025-05-25T03:34:00+02:00,2025-05-25,11:34,17,8,25
45,2025-05-25T03:35:00+02:00,2025-05-25,11:35,20,10,30
47,2025-05-25T03:29:00+02:00,2025-05-25,11:29,11,15,26
47,2025-05-25T03:31:00+02:00,2025-05-25,11:31,20,15,35
47,2025-05-25T03:32:00+02:00,2025-05-25,11:32,20,3,23
47,2025-05-25T03:33:00+02:00,2025-05-25,11:33,16,18,34
47,2025-05-25T03:34:00+02:00,2025-05-25,11:34,14,20,34
50,2025-05-25T03:26:00+02:00,2025-05-25,11:26,4,8,12
50,2025-05-25T03:27:00+02:00,2025-05-25,11:27,4,5,9
50,2025-05-25T03:35:00+02:00,2025-05-25,11:35,6,7,13
50,2025-05-25T03:38:00+02:00,2025-05-25,11:38,2,8,10
54,2025-05-25T03:27:00+02:00,2025-05-25,11:27,2,3,5
54,2025-05-25T03:28:00+02:00,2025-05-25,11:28,0,1,1
54,2025-05-25T03:29:00+02:00,2025-05-25,11:29,4,1,5
54,2025-05-25T03:31:00+02:00,2025-05-25,11:31,1,2,3
54,2025-05-25T03:36:00+02:00,2025-05-25,11:36,1,2,3
54,2025-05-25T03:37:00+02:00,2025-05-25,11:37,0,2,2
54,2025-05-25T03:38:00+02:00,2025-05-25,11:38,0,1,1
59,2025-05-25T03:30:00+02:00,2025-05-25,11:30,8,36,44
61,2025-05-25T03:26:00+02:00,2025-05-25,11:26,6,15,21
61,2025-05-25T03:27:00+02:00,2025-05-25,11:27,11,4,15
61,2025-05-25T03:28:00+02:00,2025-05-25,11:28,4,2,6
61,2025-05-25T03:30:00+02:00,2025-05-25,11:30,2,5,7
61,2025-05-25T03:34:00+02:00,2025-05-25,11:34,5,7,12
61,2025-05-25T03:35:00+02:00,2025-05-25,11:35,5,5,10
61,2025-05-25T03:37:00+02:00,2025-05-25,11:37,5,10,15
61,2025-05-25T03:38:00+02:00,2025-05-25,11:38,5,12,17
69,2025-05-25T03:27:00+02:00,2025-05-25,11:27,0,3,3
69,2025-05-25T03:33:00+02:00,2025-05-25,11:33,8,0,8
69,2025-05-25T03:36:00+02:00,2025-05-25,11:36,2,1,3
69,2025-05-25T03:37:00+02:00,2025-05-25,11:37,3,4,7
70,2025-05-25T03:25:00+02:00,2025-05-25,11:25,2,2,4
70,2025-05-25T03:28:00+02:00,2025-05-25,11:28,2,0,2
70,2025-05-25T03:29:00+02:00,2025-05-25,11:29,7,5,12
70,2025-05-25T03:34:00+02:00,2025-05-25,11:34,2,0,2
70,2025-05-25T03:35:00+02:00,2025-05-25,11:35,2,2,4
70,2025-05-25T03:36:00+02:00,2025-05-25,11:36,1,3,4
71,2025-05-25T03:29:00+02:00,2025-05-25,11:29,1,1,2
71,2025-05-25T03:39:00+02:00,2025-05-25,11:39,1,0,1
75,2025-05-25T03:27:00+02:00,2025-05-25,11:27,1,2,3
75,2025-05-25T03:36:00+02:00,2025-05-25,11:36,1,1,2
75,2025-05-25T03:37:00+02:00,2025-05-25,11:37,0,3,3
77,2025-05-25T03:35:00+02:00,2025-05-25,11:35,22,20,42
78,2025-05-25T03:25:00+02:00,2025-05-25,11:25,1,0,1
78,2025-05-25T03:26:00+02:00,2025-05-25,11:26,1,1,2
78,2025-05-25T03:30:00+02:00,2025-05-25,11:30,1,7,8
78,2025-05-25T03:32:00+02:00,2025-05-25,11:32,1,5,6
78,2025-05-25T03:33:00+02:00,2025-05-25,11:33,1,5,6
78,2025-05-25T03:36:00+02:00,2025-05-25,11:36,2,1,3
87,2025-05-25T03:25:00+02:00,2025-05-25,11:25,2,7,9
87,2025-05-25T03:26:00+02:00,2025-05-25,11:26,3,2,5
87,2025-05-25T03:27:00+02:00,2025-05-25,11:27,2,7,9
87,2025-05-25T03:29:00+02:00,2025-05-25,11:29,2,3,5
87,2025-05-25T03:35:00+02:00,2025-05-25,11:35,1,2,3
87,2025-05-25T03:36:00+02:00,2025-05-25,11:36,3,3,6
87,2025-05-25T03:38:00+02:00,2025-05-25,11:38,2,3,5
107,2025-05-25T03:30:00+02:00,2025-05-25,11:30,2,5,7
108,2025-05-25T03:29:00+02:00,2025-05-25,11:29,1,4,5
108,2025-05-25T03:32:00+02:00,2025-05-25,11:32,5,1,6
108,2025-05-25T03:35:00+02:00,2025-05-25,11:35,1,0,1
108,2025-05-25T03:36:00+02:00,2025-05-25,11:36,4,0,4
108,2025-05-25T03:39:00+02:00,2025-05-25,11:39,5,2,7
118,2025-05-25T03:35:00+02:00,2025-05-25,11:35,3,2,5
131,2025-05-25T03:25:00+02:00,2025-05-25,11:25,7,2,9
133,2025-05-25T03:30:00+02:00,2025-05-25,11:30,38,46,84
133,2025-05-25T03:35:00+02:00,2025-05-25,11:35,41,40,81
135,2025-05-25T03:25:00+02:00,2025-05-25,11:25,34,25,59
140,2025-05-25T03:30:00+02:00,2025-05-25,11:30,15,3,18
162,2025-05-25T03:30:00+02:00,2025-05-25,11:30,51,76,127
162,2025-05-25T03:35:00+02:00,2025-05-25,11:35,58,54,112
166,2025-05-25T03:30:00+02:00,2025-05-25,11:30,6,4,10
167,2025-05-25T03:35:00+02:00,2025-05-25,11:35,4,8,12
1,2025-05-25T03:28:00+02:00,2025-05-25,11:28,16,19,35
1,2025-05-25T03:33:00+02:00,2025-05-25,11:33,12,16,28
1,2025-05-25T03:34:00+02:00,2025-05-25,11:34,23,18,41
1,2025-05-25T03:35:00+02:00,2025-05-25,11:35,12,18,30
1,2025-05-25T03:36:00+02:00,2025-05-25,11:36,39,7,46
1,2025-05-25T03:37:00+02:00,2025-05-25,11:37,28,28,56
1,2025-05-25T03:38:00+02:00,2025-05-25,11:38,26,16,42
2,2025-05-25T03:30:00+02:00,2025-05-25,11:30,10,7,17
2,2025-05-25T03:34:00+02:00,2025-05-25,11:34,21,5,26
2,2025-05-25T03:35:00+02:00,2025-05-25,11:35,13,13,26
2,2025-05-25T03:38:00+02:00,2025-05-25,11:38,12,16,28
9,2025-05-25T03:32:00+02:00,2025-05-25,11:32,1,2,3
9,2025-05-25T03:34:00+02:00,2025-05-25,11:34,0,3,3
9,2025-05-25T03:35:00+02:00,2025-05-25,11:35,0,2,2
10,2025-05-25T03:27:00+02:00,2025-05-25,11:27,0,3,3
10,2025-05-25T03:33:00+02:00,2025-05-25,11:33,0,2,2
10,2025-05-25T03:35:00+02:00,2025-05-25,11:35,1,0,1
10,2025-05-25T03:38:00+02:00,2025-05-25,11:38,1,0,1
11,2025-05-25T03:25:00+02:00,2025-05-25,11:25,3,6,9
11,2025-05-25T03:26:00+02:00,2025-05-25,11:26,2,1,3
11,2025-05-25T03:29:00+02:00,2025-05-25,11:29,2,1,3
11,2025-05-25T03:32:00+02:00,2025-05-25,11:32,2,1,3
11,2025-05-25T03:33:00+02:00,2025-05-25,11:33,1,3,4
11,2025-05-25T03:34:00+02:00,2025-05-25,11:34,2,3,5
11,2025-05-25T03:39:00+02:00,2025-05-25,11:39,1,0,1
12,2025-05-25T03:25:00+02:00,2025-05-25,11:25,4,3,7
12,2025-05-25T03:27:00+02:00,2025-05-25,11:27,5,7,12
12,2025-05-25T03:28:00+02:00,2025-05-25,11:28,5,6,11
12,2025-05-25T03:29:00+02:00,2025-05-25,11:29,0,2,2
12,2025-05-25T03:31:00+02:00,2025-05-25,11:31,1,7,8
12,2025-05-25T03:32:00+02:00,2025-05-25,11:32,4,2,6
12,2025-05-25T03:35:00+02:00,2025-05-25,11:35,3,0,3
12,2025-05-25T03:38:00+02:00,2025-05-25,11:38,1,4,5
17,2025-05-25T03:32:00+02:00,2025-05-25,11:32,2,1,3
17,2025-05-25T03:33:00+02:00,2025-05-25,11:33,2,0,2
18,2025-05-25T03:37:00+02:00,2025-05-25,11:37,4,0,4
19,2025-05-25T03:28:00+02:00,2025-05-25,11:28,1,4,5
19,2025-05-25T03:30:00+02:00,2025-05-25,11:30,4,4,8
19,2025-05-25T03:31:00+02:00,2025-05-25,11:31,9,2,11
19,2025-05-25T03:32:00+02:00,2025-05-25,11:32,4,2,6
19,2025-05-25T03:35:00+02:00,2025-05-25,11:35,6,0,6
19,2025-05-25T03:39:00+02:00,2025-05-25,11:39,5,6,11
20,2025-05-25T03:25:00+02:00,2025-05-25,11:25,4,1,5
20,2025-05-25T03:27:00+02:00,2025-05-25,11:27,4,5,9
20,2025-05-25T03:30:00+02:00,2025-05-25,11:30,3,0,3
23,2025-05-25T03:25:00+02:00,2025-05-25,11:25,5,9,14
23,2025-05-25T03:29:00+02:00,2025-05-25,11:29,0,4,4
23,2025-05-25T03:33:00+02:00,2025-05-25,11:33,6,4,10
23,2025-05-25T03:37:00+02:00,2025-05-25,11:37,3,7,10
23,2025-05-25T03:39:00+02:00,2025-05-25,11:39,1,1,2
24,2025-05-25T03:29:00+02:00,2025-05-25,11:29,14,14,28
24,2025-05-25T03:30:00+02:00,2025-05-25,11:30,1,7,8
24,2025-05-25T03:34:00+02:00,2025-05-25,11:34,11,8,19
24,2025-05-25T03:35:00+02:00,2025-05-25,11:35,16,19,35
24,2025-05-25T03:36:00+02:00,2025-05-25,11:36,7,2,9
24,2025-05-25T03:39:00+02:00,2025-05-25,11:39,22,2,24
25,2025-05-25T03:30:00+02:00,2025-05-25,11:30,65,107,172
27,2025-05-25T03:27:00+02:00,2025-05-25,11:27,4,8,12
27,2025-05-25T03:29:00+02:00,2025-05-25,11:29,2,4,6
27,2025-05-25T03:31:00+02:00,2025-05-25,11:31,4,3,7
27,2025-05-25T03:36:00+02:00,2025-05-25,11:36,7,4,11
27,2025-05-25T03:37:00+02:00,2025-05-25,11:37,6,3,9
30,2025-05-25T03:25:00+02:00,2025-05-25,11:25,0,4,4
30,2025-05-25T03:29:00+02:00,2025-05-25,11:29,1,7,8
30,2025-05-25T03:32:00+02:00,2025-05-25,11:32,4,4,8
30,2025-05-25T03:33:00+02:00,2025-05-25,11:33,2,1,3
30,2025-05-25T03:34:00+02:00,2025-05-25,11:34,3,2,5
30,2025-05-25T03:38:00+02:00,2025-05-25,11:38,4,12,16
30,2025-05-25T03:39:00+02:00,2025-05-25,11:39,5,9,14
35,2025-05-25T03:25:00+02:00,2025-05-25,11:25,25,5,30
35,2025-05-25T03:28:00+02:00,2025-05-25,11:28,10,30,40
35,2025-05-25T03:29:00+02:00,2025-05-25,11:29,26,18,44
35,2025-05-25T03:33:00+02:00,2025-05-25,11:33,19,24,43
35,2025-05-25T03:35:00+02:00,2025-05-25,11:35,24,25,49
35,2025-05-25T03:38:00+02:00,2025-05-25,11:38,17,14,31
35,2025-05-25T03:39:00+02:00,2025-05-25,11:39,17,24,41
46,2025-05-25T03:30:00+02:00,2025-05-25,11:30,2,6,8
46,2025-05-25T03:35:00+02:00,2025-05-25,11:35,6,6,12
48,2025-05-25T03:25:00+02:00,2025-05-25,11:25,11,10,21
48,2025-05-25T03:28:00+02:00,2025-05-25,11:28,11,6,17
48,2025-05-25T03:31:00+02:00,2025-05-25,11:31,6,14,20
49,2025-05-25T03:25:00+02:00,2025-05-25,11:25,4,23,27
49,2025-05-25T03:27:00+02:00,2025-05-25,11:27,4,10,14
49,2025-05-25T03:31:00+02:00,2025-05-25,11:31,8,8,16
49,2025-05-25T03:32:00+02:00,2025-05-25,11:32,6,21,27
49,2025-05-25T03:38:00+02:00,2025-05-25,11:38,10,10,20
51,2025-05-25T03:25:00+02:00,2025-05-25,11:25,3,0,3
51,2025-05-25T03:27:00+02:00,2025-05-25,11:27,0,2,2
51,2025-05-25T03:34:00+02:00,2025-05-25,11:34,2,2,4
52,2025-05-25T03:27:00+02:00,2025-05-25,11:27,5,1,6
52,2025-05-25T03:29:00+02:00,2025-05-25,11:29,5,1,6
52,2025-05-25T03:32:00+02:00,2025-05-25,11:32,2,4,6
52,2025-05-25T03:33:00+02:00,2025-05-25,11:33,3,2,5
52,2025-05-25T03:34:00+02:00,2025-05-25,11:34,5,1,6
52,2025-05-25T03:37:00+02:00,2025-05-25,11:37,3,0,3
52,2025-05-25T03:38:00+02:00,2025-05-25,11:38,3,8,11
53,2025-05-25T03:25:00+02:00,2025-05-25,11:25,1,2,3
53,2025-05-25T03:29:00+02:00,2025-05-25,11:29,10,8,18
53,2025-05-25T03:32:00+02:00,2025-05-25,11:32,18,6,24
56,2025-05-25T03:26:00+02:00,2025-05-25,11:26,9,9,18
56,2025-05-25T03:30:00+02:00,2025-05-25,11:30,11,1,12
56,2025-05-25T03:32:00+02:00,2025-05-25,11:32,9,3,12
56,2025-05-25T03:37:00+02:00,2025-05-25,11:37,9,4,13
58,2025-05-25T03:26:00+02:00,2025-05-25,11:26,18,4,22
58,2025-05-25T03:30:00+02:00,2025-05-25,11:30,4,3,7
58,2025-05-25T03:32:00+02:00,2025-05-25,11:32,9,4,13
58,2025-05-25T03:33:00+02:00,2025-05-25,11:33,6,7,13
58,2025-05-25T03:35:00+02:00,2025-05-25,11:35,3,4,7
58,2025-05-25T03:39:00+02:00,2025-05-25,11:39,26,16,42
62,2025-05-25T03:28:00+02:00,2025-05-25,11:28,2,7,9
62,2025-05-25T03:29:00+02:00,2025-05-25,11:29,3,1,4
62,2025-05-25T03:36:00+02:00,2025-05-25,11:36,3,0,3
62,2025-05-25T03:37:00+02:00,2025-05-25,11:37,4,0,4
63,2025-05-25T03:29:00+02:00,2025-05-25,11:29,5,3,8
63,2025-05-25T03:32:00+02:00,2025-05-25,11:32,16,8,24
63,2025-05-25T03:35:00+02:00,2025-05-25,11:35,8,7,15
63,2025-05-25T03:37:00+02:00,2025-05-25,11:37,11,4,15
63,2025-05-25T03:38:00+02:00,2025-05-25,11:38,3,11,14
63,2025-05-25T03:39:00+02:00,2025-05-25,11:39,4,2,6
67,2025-05-25T03:25:00+02:00,2025-05-25,11:25,8,10,18
67,2025-05-25T03:27:00+02:00,2025-05-25,11:27,3,11,14
67,2025-05-25T03:30:00+02:00,2025-05-25,11:30,3,8,11
67,2025-05-25T03:31:00+02:00,2025-05-25,11:31,5,4,9
67,2025-05-25T03:35:00+02:00,2025-05-25,11:35,13,4,17
67,2025-05-25T03:37:00+02:00,2025-05-25,11:37,7,6,13
67,2025-05-25T03:39:00+02:00,2025-05-25,11:39,2,7,9
68,2025-05-25T03:25:00+02:00,2025-05-25,11:25,6,6,12
68,2025-05-25T03:29:00+02:00,2025-05-25,11:29,2,1,3
68,2025-05-25T03:34:00+02:00,2025-05-25,11:34,8,9,17
68,2025-05-25T03:35:00+02:00,2025-05-25,11:35,7,0,7
68,2025-05-25T03:38:00+02:00,2025-05-25,11:38,5,3,8
68,2025-05-25T03:39:00+02:00,2025-05-25,11:39,7,3,10
72,2025-05-25T03:26:00+02:00,2025-05-25,11:26,3,16,19
72,2025-05-25T03:31:00+02:00,2025-05-25,11:31,2,6,8
72,2025-05-25T03:32:00+02:00,2025-05-25,11:32,10,10,20
72,2025-05-25T03:33:00+02:00,2025-05-25,11:33,6,12,18
72,2025-05-25T03:38:00+02:00,2025-05-25,11:38,0,7,7
76,2025-05-25T03:27:00+02:00,2025-05-25,11:27,0,3,3
76,2025-05-25T03:30:00+02:00,2025-05-25,11:30,0,1,1
76,2025-05-25T03:31:00+02:00,2025-05-25,11:31,0,1,1
76,2025-05-25T03:34:00+02:00,2025-05-25,11:34,9,0,9
79,2025-05-25T03:25:00+02:00,2025-05-25,11:25,8,5,13
79,2025-05-25T03:27:00+02:00,2025-05-25,11:27,6,3,9
79,2025-05-25T03:29:00+02:00,2025-05-25,11:29,28,6,34
79,2025-05-25T03:30:00+02:00,2025-05-25,11:30,16,4,20
79,2025-05-25T03:31:00+02:00,2025-05-25,11:31,19,7,26
79,2025-05-25T03:33:00+02:00,2025-05-25,11:33,9,4,13
79,2025-05-25T03:35:00+02:00,2025-05-25,11:35,11,2,13
85,2025-05-25T03:29:00+02:00,2025-05-25,11:29,4,2,6
86,2025-05-25T03:25:00+02:00,2025-05-25,11:25,1,0,1
86,2025-05-25T03:27:00+02:00,2025-05-25,11:27,1,1,2
86,2025-05-25T03:31:00+02:00,2025-05-25,11:31,2,0,2
86,2025-05-25T03:33:00+02:00,2025-05-25,11:33,2,0,2
86,2025-05-25T03:37:00+02:00,2025-05-25,11:37,1,0,1
109,2025-05-25T03:25:00+02:00,2025-05-25,11:25,7,4,11
109,2025-05-25T03:30:00+02:00,2025-05-25,11:30,7,2,9
117,2025-05-25T03:30:00+02:00,2025-05-25,11:30,19,22,41
130,2025-05-25T03:30:00+02:00,2025-05-25,11:30,5,4,9
136,2025-05-25T03:25:00+02:00,2025-05-25,11:25,20,12,32
138,2025-05-25T03:25:00+02:00,2025-05-25,11:25,1,0,1
138,2025-05-25T03:35:00+02:00,2025-05-25,11:35,2,0,2
139,2025-05-25T03:30:00+02:00,2025-05-25,11:30,1,4,5
142,2025-05-25T03:25:00+02:00,2025-05-25,11:25,63,37,100
142,2025-05-25T03:30:00+02:00,2025-05-25,11:30,51,35,86
142,2025-05-25T03:35:00+02:00,2025-05-25,11:35,64,43,107
164,2025-05-25T03:35:00+02:00,2025-05-25,11:35,5,6,11
181,2025-05-25T03:42:00+02:00,2025-05-25,11:42,1,21,22
181,2025-05-25T03:44:00+02:00,2025-05-25,11:44,15,10,25
181,2025-05-25T03:47:00+02:00,2025-05-25,11:47,6,23,29
181,2025-05-25T03:48:00+02:00,2025-05-25,11:48,11,11,22
181,2025-05-25T03:50:00+02:00,2025-05-25,11:50,11,23,34
181,2025-05-25T03:53:00+02:00,2025-05-25,11:53,8,15,23
182,2025-05-25T03:40:00+02:00,2025-05-25,11:40,13,10,23
180,2025-05-25T03:52:00+02:00,2025-05-25,11:52,1,0,1
3,2025-05-25T03:40:00+02:00,2025-05-25,11:40,10,11,21
3,2025-05-25T03:44:00+02:00,2025-05-25,11:44,6,12,18
3,2025-05-25T03:45:00+02:00,2025-05-25,11:45,17,9,26
3,2025-05-25T03:48:00+02:00,2025-05-25,11:48,7,24,31
3,2025-05-25T03:51:00+02:00,2025-05-25,11:51,20,10,30
4,2025-05-25T03:43:00+02:00,2025-05-25,11:43,20,29,49
4,2025-05-25T03:44:00+02:00,2025-05-25,11:44,20,12,32
4,2025-05-25T03:46:00+02:00,2025-05-25,11:46,19,13,32
4,2025-05-25T03:47:00+02:00,2025-05-25,11:47,21,11,32
4,2025-05-25T03:49:00+02:00,2025-05-25,11:49,33,36,69
4,2025-05-25T03:50:00+02:00,2025-05-25,11:50,16,18,34
4,2025-05-25T03:54:00+02:00,2025-05-25,11:54,34,22,56
6,2025-05-25T03:41:00+02:00,2025-05-25,11:41,9,14,23
6,2025-05-25T03:43:00+02:00,2025-05-25,11:43,5,7,12
6,2025-05-25T03:49:00+02:00,2025-05-25,11:49,16,11,27
8,2025-05-25T03:42:00+02:00,2025-05-25,11:42,3,1,4
8,2025-05-25T03:45:00+02:00,2025-05-25,11:45,1,12,13
8,2025-05-25T03:50:00+02:00,2025-05-25,11:50,1,6,7
28,2025-05-25T03:41:00+02:00,2025-05-25,11:41,7,15,22
28,2025-05-25T03:43:00+02:00,2025-05-25,11:43,4,11,15
28,2025-05-25T03:44:00+02:00,2025-05-25,11:44,10,1,11
28,2025-05-25T03:46:00+02:00,2025-05-25,11:46,3,10,13
28,2025-05-25T03:47:00+02:00,2025-05-25,11:47,2,14,16
28,2025-05-25T03:49:00+02:00,2025-05-25,11:49,4,6,10
28,2025-05-25T03:50:00+02:00,2025-05-25,11:50,12,7,19
28,2025-05-25T03:54:00+02:00,2025-05-25,11:54,19,12,31
29,2025-05-25T03:46:00+02:00,2025-05-25,11:46,17,8,25
29,2025-05-25T03:47:00+02:00,2025-05-25,11:47,17,5,22
29,2025-05-25T03:48:00+02:00,2025-05-25,11:48,5,7,12
29,2025-05-25T03:51:00+02:00,2025-05-25,11:51,16,8,24
29,2025-05-25T03:52:00+02:00,2025-05-25,11:52,12,15,27
31,2025-05-25T03:45:00+02:00,2025-05-25,11:45,3,1,4
31,2025-05-25T03:48:00+02:00,2025-05-25,11:48,0,4,4
31,2025-05-25T03:49:00+02:00,2025-05-25,11:49,4,0,4
31,2025-05-25T03:54:00+02:00,2025-05-25,11:54,4,1,5
36,2025-05-25T03:40:00+02:00,2025-05-25,11:40,1,0,1
36,2025-05-25T03:41:00+02:00,2025-05-25,11:41,0,2,2
37,2025-05-25T03:41:00+02:00,2025-05-25,11:41,4,4,8
37,2025-05-25T03:48:00+02:00,2025-05-25,11:48,2,4,6
37,2025-05-25T03:54:00+02:00,2025-05-25,11:54,1,0,1
39,2025-05-25T03:40:00+02:00,2025-05-25,11:40,2,1,3
39,2025-05-25T03:42:00+02:00,2025-05-25,11:42,0,2,2
40,2025-05-25T03:40:00+02:00,2025-05-25,11:40,0,4,4
40,2025-05-25T03:43:00+02:00,2025-05-25,11:43,2,3,5
40,2025-05-25T03:47:00+02:00,2025-05-25,11:47,4,6,10
40,2025-05-25T03:49:00+02:00,2025-05-25,11:49,5,4,9
40,2025-05-25T03:54:00+02:00,2025-05-25,11:54,2,2,4
41,2025-05-25T03:43:00+02:00,2025-05-25,11:43,6,5,11
41,2025-05-25T03:51:00+02:00,2025-05-25,11:51,31,5,36
41,2025-05-25T03:52:00+02:00,2025-05-25,11:52,16,3,19
41,2025-05-25T03:54:00+02:00,2025-05-25,11:54,1,5,6
43,2025-05-25T03:40:00+02:00,2025-05-25,11:40,7,3,10
43,2025-05-25T03:50:00+02:00,2025-05-25,11:50,4,6,10
45,2025-05-25T03:43:00+02:00,2025-05-25,11:43,19,5,24
45,2025-05-25T03:47:00+02:00,2025-05-25,11:47,14,13,27
45,2025-05-25T03:51:00+02:00,2025-05-25,11:51,18,5,23
45,2025-05-25T03:53:00+02:00,2025-05-25,11:53,16,8,24
47,2025-05-25T03:40:00+02:00,2025-05-25,11:40,13,19,32
47,2025-05-25T03:44:00+02:00,2025-05-25,11:44,13,6,19
47,2025-05-25T03:48:00+02:00,2025-05-25,11:48,10,24,34
47,2025-05-25T03:49:00+02:00,2025-05-25,11:49,13,9,22
47,2025-05-25T03:53:00+02:00,2025-05-25,11:53,16,9,25
47,2025-05-25T03:54:00+02:00,2025-05-25,11:54,5,27,32
50,2025-05-25T03:43:00+02:00,2025-05-25,11:43,4,2,6
50,2025-05-25T03:48:00+02:00,2025-05-25,11:48,7,8,15
50,2025-05-25T03:54:00+02:00,2025-05-25,11:54,8,7,15
54,2025-05-25T03:42:00+02:00,2025-05-25,11:42,1,1,2
54,2025-05-25T03:43:00+02:00,2025-05-25,11:43,2,0,2
54,2025-05-25T03:49:00+02:00,2025-05-25,11:49,2,0,2
54,2025-05-25T03:52:00+02:00,2025-05-25,11:52,3,1,4
54,2025-05-25T03:53:00+02:00,2025-05-25,11:53,0,1,1
59,2025-05-25T03:40:00+02:00,2025-05-25,11:40,13,14,27
61,2025-05-25T03:42:00+02:00,2025-05-25,11:42,6,1,7
61,2025-05-25T03:44:00+02:00,2025-05-25,11:44,8,7,15
61,2025-05-25T03:46:00+02:00,2025-05-25,11:46,11,4,15
61,2025-05-25T03:47:00+02:00,2025-05-25,11:47,6,11,17
61,2025-05-25T03:49:00+02:00,2025-05-25,11:49,3,3,6
61,2025-05-25T03:50:00+02:00,2025-05-25,11:50,5,10,15
61,2025-05-25T03:51:00+02:00,2025-05-25,11:51,7,9,16
66,2025-05-25T03:43:00+02:00,2025-05-25,11:43,1,16,17
66,2025-05-25T03:44:00+02:00,2025-05-25,11:44,16,13,29
66,2025-05-25T03:45:00+02:00,2025-05-25,11:45,14,14,28
66,2025-05-25T03:47:00+02:00,2025-05-25,11:47,10,12,22
66,2025-05-25T03:49:00+02:00,2025-05-25,11:49,7,17,24
66,2025-05-25T03:50:00+02:00,2025-05-25,11:50,17,14,31
66,2025-05-25T03:52:00+02:00,2025-05-25,11:52,21,16,37
66,2025-05-25T03:54:00+02:00,2025-05-25,11:54,14,17,31
69,2025-05-25T03:54:00+02:00,2025-05-25,11:54,3,1,4
70,2025-05-25T03:40:00+02:00,2025-05-25,11:40,1,0,1
70,2025-05-25T03:42:00+02:00,2025-05-25,11:42,6,2,8
70,2025-05-25T03:47:00+02:00,2025-05-25,11:47,7,3,10
70,2025-05-25T03:50:00+02:00,2025-05-25,11:50,1,2,3
70,2025-05-25T03:52:00+02:00,2025-05-25,11:52,4,4,8
75,2025-05-25T03:45:00+02:00,2025-05-25,11:45,2,0,2
75,2025-05-25T03:48:00+02:00,2025-05-25,11:48,0,1,1
75,2025-05-25T03:49:00+02:00,2025-05-25,11:49,1,0,1
75,2025-05-25T03:50:00+02:00,2025-05-25,11:50,1,0,1
78,2025-05-25T03:40:00+02:00,2025-05-25,11:40,0,3,3
78,2025-05-25T03:44:00+02:00,2025-05-25,11:44,2,3,5
78,2025-05-25T03:45:00+02:00,2025-05-25,11:45,1,5,6
78,2025-05-25T03:48:00+02:00,2025-05-25,11:48,0,4,4
78,2025-05-25T03:49:00+02:00,2025-05-25,11:49,3,0,3
78,2025-05-25T03:54:00+02:00,2025-05-25,11:54,0,1,1
84,2025-05-25T03:45:00+02:00,2025-05-25,11:45,97,68,165
84,2025-05-25T03:50:00+02:00,2025-05-25,11:50,72,83,155
87,2025-05-25T03:52:00+02:00,2025-05-25,11:52,1,4,5
87,2025-05-25T03:54:00+02:00,2025-05-25,11:54,2,2,4
107,2025-05-25T03:50:00+02:00,2025-05-25,11:50,8,4,12
108,2025-05-25T03:42:00+02:00,2025-05-25,11:42,1,3,4
108,2025-05-25T03:44:00+02:00,2025-05-25,11:44,3,2,5
108,2025-05-25T03:45:00+02:00,2025-05-25,11:45,0,3,3
108,2025-05-25T03:48:00+02:00,2025-05-25,11:48,1,0,1
108,2025-05-25T03:50:00+02:00,2025-05-25,11:50,4,1,5
108,2025-05-25T03:51:00+02:00,2025-05-25,11:51,0,4,4
108,2025-05-25T03:52:00+02:00,2025-05-25,11:52,2,7,9
108,2025-05-25T03:54:00+02:00,2025-05-25,11:54,1,3,4
134,2025-05-25T03:40:00+02:00,2025-05-25,11:40,33,53,86
134,2025-05-25T03:50:00+02:00,2025-05-25,11:50,37,14,51
135,2025-05-25T03:40:00+02:00,2025-05-25,11:40,48,85,133
135,2025-05-25T03:45:00+02:00,2025-05-25,11:45,49,38,87
135,2025-05-25T03:50:00+02:00,2025-05-25,11:50,28,37,65
140,2025-05-25T03:40:00+02:00,2025-05-25,11:40,6,0,6
140,2025-05-25T03:45:00+02:00,2025-05-25,11:45,11,3,14
162,2025-05-25T03:40:00+02:00,2025-05-25,11:40,51,60,111
162,2025-05-25T03:50:00+02:00,2025-05-25,11:50,37,78,115
165,2025-05-25T03:50:00+02:00,2025-05-25,11:50,2,4,6
166,2025-05-25T03:50:00+02:00,2025-05-25,11:50,3,8,11
179,2025-05-25T03:40:00+02:00,2025-05-25,11:40,1,4,5
179,2025-05-25T03:45:00+02:00,2025-05-25,11:45,14,4,18
1,2025-05-25T03:41:00+02:00,2025-05-25,11:41,20,13,33
1,2025-05-25T03:42:00+02:00,2025-05-25,11:42,34,5,39
1,2025-05-25T03:47:00+02:00,2025-05-25,11:47,20,6,26
1,2025-05-25T03:50:00+02:00,2025-05-25,11:50,21,23,44
1,2025-05-25T03:54:00+02:00,2025-05-25,11:54,24,22,46
2,2025-05-25T03:41:00+02:00,2025-05-25,11:41,3,5,8
2,2025-05-25T03:46:00+02:00,2025-05-25,11:46,17,6,23
2,2025-05-25T03:47:00+02:00,2025-05-25,11:47,8,3,11
2,2025-05-25T03:50:00+02:00,2025-05-25,11:50,1,7,8
2,2025-05-25T03:52:00+02:00,2025-05-25,11:52,13,9,22
2,2025-05-25T03:54:00+02:00,2025-05-25,11:54,6,15,21
9,2025-05-25T03:43:00+02:00,2025-05-25,11:43,0,1,1
9,2025-05-25T03:46:00+02:00,2025-05-25,11:46,2,7,9
9,2025-05-25T03:48:00+02:00,2025-05-25,11:48,1,1,2
9,2025-05-25T03:54:00+02:00,2025-05-25,11:54,1,0,1
10,2025-05-25T03:45:00+02:00,2025-05-25,11:45,0,2,2
10,2025-05-25T03:47:00+02:00,2025-05-25,11:47,0,1,1
10,2025-05-25T03:51:00+02:00,2025-05-25,11:51,2,0,2
10,2025-05-25T03:54:00+02:00,2025-05-25,11:54,1,0,1
11,2025-05-25T03:45:00+02:00,2025-05-25,11:45,6,7,13
11,2025-05-25T03:48:00+02:00,2025-05-25,11:48,1,0,1
12,2025-05-25T03:47:00+02:00,2025-05-25,11:47,4,2,6
12,2025-05-25T03:48:00+02:00,2025-05-25,11:48,1,9,10
12,2025-05-25T03:49:00+02:00,2025-05-25,11:49,3,3,6
12,2025-05-25T03:50:00+02:00,2025-05-25,11:50,2,2,4
12,2025-05-25T03:51:00+02:00,2025-05-25,11:51,1,9,10
12,2025-05-25T03:54:00+02:00,2025-05-25,11:54,0,3,3
17,2025-05-25T03:40:00+02:00,2025-05-25,11:40,6,2,8
17,2025-05-25T03:44:00+02:00,2025-05-25,11:44,4,0,4
17,2025-05-25T03:47:00+02:00,2025-05-25,11:47,3,0,3
17,2025-05-25T03:51:00+02:00,2025-05-25,11:51,1,2,3
17,2025-05-25T03:52:00+02:00,2025-05-25,11:52,0,1,1
18,2025-05-25T03:43:00+02:00,2025-05-25,11:43,3,0,3
18,2025-05-25T03:46:00+02:00,2025-05-25,11:46,3,1,4
19,2025-05-25T03:45:00+02:00,2025-05-25,11:45,5,2,7
19,2025-05-25T03:46:00+02:00,2025-05-25,11:46,7,3,10
19,2025-05-25T03:50:00+02:00,2025-05-25,11:50,12,6,18
20,2025-05-25T03:41:00+02:00,2025-05-25,11:41,4,9,13
20,2025-05-25T03:44:00+02:00,2025-05-25,11:44,6,7,13
20,2025-05-25T03:45:00+02:00,2025-05-25,11:45,14,5,19
20,2025-05-25T03:46:00+02:00,2025-05-25,11:46,15,5,20
20,2025-05-25T03:48:00+02:00,2025-05-25,11:48,11,7,18
20,2025-05-25T03:50:00+02:00,2025-05-25,11:50,5,6,11
20,2025-05-25T03:52:00+02:00,2025-05-25,11:52,5,5,10
23,2025-05-25T03:42:00+02:00,2025-05-25,11:42,1,12,13
23,2025-05-25T03:44:00+02:00,2025-05-25,11:44,0,5,5
23,2025-05-25T03:46:00+02:00,2025-05-25,11:46,1,0,1
23,2025-05-25T03:47:00+02:00,2025-05-25,11:47,5,4,9
23,2025-05-25T03:52:00+02:00,2025-05-25,11:52,0,2,2
23,2025-05-25T03:53:00+02:00,2025-05-25,11:53,2,2,4
23,2025-05-25T03:54:00+02:00,2025-05-25,11:54,7,9,16
24,2025-05-25T03:43:00+02:00,2025-05-25,11:43,16,23,39
24,2025-05-25T03:44:00+02:00,2025-05-25,11:44,13,3,16
24,2025-05-25T03:50:00+02:00,2025-05-25,11:50,6,4,10
24,2025-05-25T03:51:00+02:00,2025-05-25,11:51,25,4,29
24,2025-05-25T03:52:00+02:00,2025-05-25,11:52,6,3,9
25,2025-05-25T03:45:00+02:00,2025-05-25,11:45,54,64,118
27,2025-05-25T03:40:00+02:00,2025-05-25,11:40,8,3,11
27,2025-05-25T03:43:00+02:00,2025-05-25,11:43,4,6,10
27,2025-05-25T03:47:00+02:00,2025-05-25,11:47,8,2,10
27,2025-05-25T03:50:00+02:00,2025-05-25,11:50,4,6,10
30,2025-05-25T03:44:00+02:00,2025-05-25,11:44,3,11,14
30,2025-05-25T03:45:00+02:00,2025-05-25,11:45,2,1,3
30,2025-05-25T03:46:00+02:00,2025-05-25,11:46,1,6,7
30,2025-05-25T03:51:00+02:00,2025-05-25,11:51,4,2,6
30,2025-05-25T03:54:00+02:00,2025-05-25,11:54,5,0,5
35,2025-05-25T03:41:00+02:00,2025-05-25,11:41,27,16,43
35,2025-05-25T03:42:00+02:00,2025-05-25,11:42,14,16,30
35,2025-05-25T03:48:00+02:00,2025-05-25,11:48,29,22,51
35,2025-05-25T03:53:00+02:00,2025-05-25,11:53,27,14,41
48,2025-05-25T03:40:00+02:00,2025-05-25,11:40,4,5,9
48,2025-05-25T03:41:00+02:00,2025-05-25,11:41,18,4,22
48,2025-05-25T03:42:00+02:00,2025-05-25,11:42,8,11,19
48,2025-05-25T03:46:00+02:00,2025-05-25,11:46,7,6,13
48,2025-05-25T03:49:00+02:00,2025-05-25,11:49,7,2,9
48,2025-05-25T03:52:00+02:00,2025-05-25,11:52,5,5,10
49,2025-05-25T03:40:00+02:00,2025-05-25,11:40,6,7,13
49,2025-05-25T03:41:00+02:00,2025-05-25,11:41,6,6,12
49,2025-05-25T03:42:00+02:00,2025-05-25,11:42,2,6,8
49,2025-05-25T03:45:00+02:00,2025-05-25,11:45,7,12,19
49,2025-05-25T03:46:00+02:00,2025-05-25,11:46,6,11,17
49,2025-05-25T03:51:00+02:00,2025-05-25,11:51,1,13,14
49,2025-05-25T03:53:00+02:00,2025-05-25,11:53,3,7,10
51,2025-05-25T03:41:00+02:00,2025-05-25,11:41,5,1,6
51,2025-05-25T03:42:00+02:00,2025-05-25,11:42,0,1,1
51,2025-05-25T03:44:00+02:00,2025-05-25,11:44,7,5,12
51,2025-05-25T03:45:00+02:00,2025-05-25,11:45,0,2,2
51,2025-05-25T03:46:00+02:00,2025-05-25,11:46,4,3,7
51,2025-05-25T03:52:00+02:00,2025-05-25,11:52,2,5,7
51,2025-05-25T03:54:00+02:00,2025-05-25,11:54,2,2,4
52,2025-05-25T03:43:00+02:00,2025-05-25,11:43,0,2,2
52,2025-05-25T03:46:00+02:00,2025-05-25,11:46,4,1,5
52,2025-05-25T03:47:00+02:00,2025-05-25,11:47,3,3,6
52,2025-05-25T03:54:00+02:00,2025-05-25,11:54,6,8,14
53,2025-05-25T03:40:00+02:00,2025-05-25,11:40,11,6,17
53,2025-05-25T03:42:00+02:00,2025-05-25,11:42,10,8,18
53,2025-05-25T03:47:00+02:00,2025-05-25,11:47,20,10,30
53,2025-05-25T03:48:00+02:00,2025-05-25,11:48,6,9,15
53,2025-05-25T03:49:00+02:00,2025-05-25,11:49,11,6,17
53,2025-05-25T03:53:00+02:00,2025-05-25,11:53,16,3,19
56,2025-05-25T03:43:00+02:00,2025-05-25,11:43,2,0,2
56,2025-05-25T03:47:00+02:00,2025-05-25,11:47,6,14,20
56,2025-05-25T03:48:00+02:00,2025-05-25,11:48,15,2,17
56,2025-05-25T03:49:00+02:00,2025-05-25,11:49,5,7,12
56,2025-05-25T03:51:00+02:00,2025-05-25,11:51,10,6,16
56,2025-05-25T03:52:00+02:00,2025-05-25,11:52,6,2,8
56,2025-05-25T03:53:00+02:00,2025-05-25,11:53,13,7,20
58,2025-05-25T03:42:00+02:00,2025-05-25,11:42,7,13,20
58,2025-05-25T03:43:00+02:00,2025-05-25,11:43,7,6,13
58,2025-05-25T03:44:00+02:00,2025-05-25,11:44,23,2,25
58,2025-05-25T03:45:00+02:00,2025-05-25,11:45,17,7,24
58,2025-05-25T03:47:00+02:00,2025-05-25,11:47,17,2,19
58,2025-05-25T03:49:00+02:00,2025-05-25,11:49,16,2,18
58,2025-05-25T03:53:00+02:00,2025-05-25,11:53,1,14,15
62,2025-05-25T03:41:00+02:00,2025-05-25,11:41,5,5,10
62,2025-05-25T03:44:00+02:00,2025-05-25,11:44,3,1,4
62,2025-05-25T03:49:00+02:00,2025-05-25,11:49,4,1,5
63,2025-05-25T03:40:00+02:00,2025-05-25,11:40,5,6,11
63,2025-05-25T03:42:00+02:00,2025-05-25,11:42,6,4,10
63,2025-05-25T03:44:00+02:00,2025-05-25,11:44,0,1,1
63,2025-05-25T03:48:00+02:00,2025-05-25,11:48,9,5,14
67,2025-05-25T03:40:00+02:00,2025-05-25,11:40,17,13,30
67,2025-05-25T03:43:00+02:00,2025-05-25,11:43,5,6,11
67,2025-05-25T03:45:00+02:00,2025-05-25,11:45,3,6,9
67,2025-05-25T03:46:00+02:00,2025-05-25,11:46,9,10,19
67,2025-05-25T03:47:00+02:00,2025-05-25,11:47,4,7,11
67,2025-05-25T03:51:00+02:00,2025-05-25,11:51,0,9,9
67,2025-05-25T03:54:00+02:00,2025-05-25,11:54,4,9,13
68,2025-05-25T03:40:00+02:00,2025-05-25,11:40,7,4,11
68,2025-05-25T03:41:00+02:00,2025-05-25,11:41,9,9,18
68,2025-05-25T03:42:00+02:00,2025-05-25,11:42,1,6,7
68,2025-05-25T03:47:00+02:00,2025-05-25,11:47,5,5,10
72,2025-05-25T03:41:00+02:00,2025-05-25,11:41,4,18,22
72,2025-05-25T03:43:00+02:00,2025-05-25,11:43,6,16,22
72,2025-05-25T03:46:00+02:00,2025-05-25,11:46,8,4,12
72,2025-05-25T03:50:00+02:00,2025-05-25,11:50,16,10,26
72,2025-05-25T03:51:00+02:00,2025-05-25,11:51,3,10,13
76,2025-05-25T03:40:00+02:00,2025-05-25,11:40,1,2,3
76,2025-05-25T03:41:00+02:00,2025-05-25,11:41,3,0,3
76,2025-05-25T03:42:00+02:00,2025-05-25,11:42,1,3,4
76,2025-05-25T03:44:00+02:00,2025-05-25,11:44,3,2,5
76,2025-05-25T03:45:00+02:00,2025-05-25,11:45,1,0,1
76,2025-05-25T03:46:00+02:00,2025-05-25,11:46,0,1,1
76,2025-05-25T03:54:00+02:00,2025-05-25,11:54,1,0,1
79,2025-05-25T03:40:00+02:00,2025-05-25,11:40,12,2,14
79,2025-05-25T03:44:00+02:00,2025-05-25,11:44,11,7,18
79,2025-05-25T03:47:00+02:00,2025-05-25,11:47,27,4,31
79,2025-05-25T03:49:00+02:00,2025-05-25,11:49,5,8,13
79,2025-05-25T03:53:00+02:00,2025-05-25,11:53,11,2,13
85,2025-05-25T03:44:00+02:00,2025-05-25,11:44,1,1,2
85,2025-05-25T03:53:00+02:00,2025-05-25,11:53,0,2,2
86,2025-05-25T03:51:00+02:00,2025-05-25,11:51,2,0,2
109,2025-05-25T03:40:00+02:00,2025-05-25,11:40,10,1,11
123,2025-05-25T03:40:00+02:00,2025-05-25,11:40,2,4,6
130,2025-05-25T03:40:00+02:00,2025-05-25,11:40,10,8,18
130,2025-05-25T03:45:00+02:00,2025-05-25,11:45,9,2,11
136,2025-05-25T03:50:00+02:00,2025-05-25,11:50,18,10,28
137,2025-05-25T03:50:00+02:00,2025-05-25,11:50,1,0,1
141,2025-05-25T03:50:00+02:00,2025-05-25,11:50,15,11,26
142,2025-05-25T03:45:00+02:00,2025-05-25,11:45,47,50,97
142,2025-05-25T03:50:00+02:00,2025-05-25,11:50,70,50,120
164,2025-05-25T03:50:00+02:00,2025-05-25,11:50,6,2,8
3,2025-05-25T04:11:00+02:00,2025-05-25,12:11,9,5,14
3,2025-05-25T04:14:00+02:00,2025-05-25,12:14,5,16,21
3,2025-05-25T04:18:00+02:00,2025-05-25,12:18,20,18,38
3,2025-05-25T04:20:00+02:00,2025-05-25,12:20,10,12,22
4,2025-05-25T04:12:00+02:00,2025-05-25,12:12,21,19,40
4,2025-05-25T04:14:00+02:00,2025-05-25,12:14,32,11,43
4,2025-05-25T04:16:00+02:00,2025-05-25,12:16,35,21,56
4,2025-05-25T04:17:00+02:00,2025-05-25,12:17,31,24,55
4,2025-05-25T04:19:00+02:00,2025-05-25,12:19,26,29,55
4,2025-05-25T04:23:00+02:00,2025-05-25,12:23,30,27,57
6,2025-05-25T04:13:00+02:00,2025-05-25,12:13,8,3,11
6,2025-05-25T04:15:00+02:00,2025-05-25,12:15,17,14,31
6,2025-05-25T04:18:00+02:00,2025-05-25,12:18,13,16,29
6,2025-05-25T04:19:00+02:00,2025-05-25,12:19,7,11,18
6,2025-05-25T04:20:00+02:00,2025-05-25,12:20,9,25,34
6,2025-05-25T04:21:00+02:00,2025-05-25,12:21,15,6,21
6,2025-05-25T04:23:00+02:00,2025-05-25,12:23,6,8,14
8,2025-05-25T04:12:00+02:00,2025-05-25,12:12,1,6,7
8,2025-05-25T04:13:00+02:00,2025-05-25,12:13,3,0,3
8,2025-05-25T04:14:00+02:00,2025-05-25,12:14,15,4,19
8,2025-05-25T04:15:00+02:00,2025-05-25,12:15,5,0,5
8,2025-05-25T04:18:00+02:00,2025-05-25,12:18,0,4,4
8,2025-05-25T04:19:00+02:00,2025-05-25,12:19,3,3,6
8,2025-05-25T04:20:00+02:00,2025-05-25,12:20,5,5,10
8,2025-05-25T04:22:00+02:00,2025-05-25,12:22,2,0,2
28,2025-05-25T04:10:00+02:00,2025-05-25,12:10,4,8,12
28,2025-05-25T04:12:00+02:00,2025-05-25,12:12,0,5,5
28,2025-05-25T04:19:00+02:00,2025-05-25,12:19,1,7,8
28,2025-05-25T04:23:00+02:00,2025-05-25,12:23,4,8,12
29,2025-05-25T04:11:00+02:00,2025-05-25,12:11,16,13,29
29,2025-05-25T04:17:00+02:00,2025-05-25,12:17,5,14,19
31,2025-05-25T04:12:00+02:00,2025-05-25,12:12,5,2,7
31,2025-05-25T04:13:00+02:00,2025-05-25,12:13,2,2,4
31,2025-05-25T04:15:00+02:00,2025-05-25,12:15,0,2,2
31,2025-05-25T04:21:00+02:00,2025-05-25,12:21,3,1,4
31,2025-05-25T04:22:00+02:00,2025-05-25,12:22,1,5,6
36,2025-05-25T04:10:00+02:00,2025-05-25,12:10,1,2,3
36,2025-05-25T04:12:00+02:00,2025-05-25,12:12,0,1,1
36,2025-05-25T04:18:00+02:00,2025-05-25,12:18,3,0,3
36,2025-05-25T04:20:00+02:00,2025-05-25,12:20,0,3,3
36,2025-05-25T04:21:00+02:00,2025-05-25,12:21,2,0,2
37,2025-05-25T04:10:00+02:00,2025-05-25,12:10,1,2,3
37,2025-05-25T04:12:00+02:00,2025-05-25,12:12,4,1,5
37,2025-05-25T04:15:00+02:00,2025-05-25,12:15,2,2,4
37,2025-05-25T04:19:00+02:00,2025-05-25,12:19,4,1,5
39,2025-05-25T04:10:00+02:00,2025-05-25,12:10,7,0,7
39,2025-05-25T04:18:00+02:00,2025-05-25,12:18,3,0,3
39,2025-05-25T04:19:00+02:00,2025-05-25,12:19,0,6,6
39,2025-05-25T04:21:00+02:00,2025-05-25,12:21,0,1,1
40,2025-05-25T04:14:00+02:00,2025-05-25,12:14,4,5,9
40,2025-05-25T04:15:00+02:00,2025-05-25,12:15,2,7,9
40,2025-05-25T04:16:00+02:00,2025-05-25,12:16,2,7,9
40,2025-05-25T04:17:00+02:00,2025-05-25,12:17,2,4,6
40,2025-05-25T04:19:00+02:00,2025-05-25,12:19,3,5,8
40,2025-05-25T04:20:00+02:00,2025-05-25,12:20,4,2,6
40,2025-05-25T04:22:00+02:00,2025-05-25,12:22,8,4,12
41,2025-05-25T04:14:00+02:00,2025-05-25,12:14,6,3,9
41,2025-05-25T04:15:00+02:00,2025-05-25,12:15,8,9,17
41,2025-05-25T04:20:00+02:00,2025-05-25,12:20,2,4,6
41,2025-05-25T04:22:00+02:00,2025-05-25,12:22,4,16,20
41,2025-05-25T04:23:00+02:00,2025-05-25,12:23,6,1,7
44,2025-05-25T04:15:00+02:00,2025-05-25,12:15,1,10,11
44,2025-05-25T04:20:00+02:00,2025-05-25,12:20,3,0,3
45,2025-05-25T04:12:00+02:00,2025-05-25,12:12,16,11,27
45,2025-05-25T04:15:00+02:00,2025-05-25,12:15,21,22,43
45,2025-05-25T04:21:00+02:00,2025-05-25,12:21,17,20,37
45,2025-05-25T04:23:00+02:00,2025-05-25,12:23,16,10,26
47,2025-05-25T04:10:00+02:00,2025-05-25,12:10,18,34,52
47,2025-05-25T04:18:00+02:00,2025-05-25,12:18,9,28,37
47,2025-05-25T04:21:00+02:00,2025-05-25,12:21,2,31,33
47,2025-05-25T04:23:00+02:00,2025-05-25,12:23,14,9,23
47,2025-05-25T04:24:00+02:00,2025-05-25,12:24,12,21,33
50,2025-05-25T04:11:00+02:00,2025-05-25,12:11,4,12,16
50,2025-05-25T04:13:00+02:00,2025-05-25,12:13,1,5,6
50,2025-05-25T04:17:00+02:00,2025-05-25,12:17,2,1,3
50,2025-05-25T04:21:00+02:00,2025-05-25,12:21,0,1,1
50,2025-05-25T04:24:00+02:00,2025-05-25,12:24,1,10,11
54,2025-05-25T04:11:00+02:00,2025-05-25,12:11,0,1,1
54,2025-05-25T04:13:00+02:00,2025-05-25,12:13,4,1,5
54,2025-05-25T04:17:00+02:00,2025-05-25,12:17,1,3,4
54,2025-05-25T04:20:00+02:00,2025-05-25,12:20,6,4,10
54,2025-05-25T04:23:00+02:00,2025-05-25,12:23,2,0,2
61,2025-05-25T04:11:00+02:00,2025-05-25,12:11,3,3,6
61,2025-05-25T04:20:00+02:00,2025-05-25,12:20,4,0,4
66,2025-05-25T04:14:00+02:00,2025-05-25,12:14,10,10,20
66,2025-05-25T04:15:00+02:00,2025-05-25,12:15,11,17,28
66,2025-05-25T04:16:00+02:00,2025-05-25,12:16,17,16,33
66,2025-05-25T04:17:00+02:00,2025-05-25,12:17,18,28,46
66,2025-05-25T04:20:00+02:00,2025-05-25,12:20,25,25,50
66,2025-05-25T04:23:00+02:00,2025-05-25,12:23,12,23,35
66,2025-05-25T04:24:00+02:00,2025-05-25,12:24,15,20,35
69,2025-05-25T04:13:00+02:00,2025-05-25,12:13,6,4,10
69,2025-05-25T04:14:00+02:00,2025-05-25,12:14,4,6,10
69,2025-05-25T04:15:00+02:00,2025-05-25,12:15,4,3,7
69,2025-05-25T04:21:00+02:00,2025-05-25,12:21,6,1,7
69,2025-05-25T04:24:00+02:00,2025-05-25,12:24,0,1,1
70,2025-05-25T04:10:00+02:00,2025-05-25,12:10,0,6,6
70,2025-05-25T04:20:00+02:00,2025-05-25,12:20,2,3,5
70,2025-05-25T04:23:00+02:00,2025-05-25,12:23,3,1,4
70,2025-05-25T04:24:00+02:00,2025-05-25,12:24,0,3,3
75,2025-05-25T04:10:00+02:00,2025-05-25,12:10,5,0,5
75,2025-05-25T04:12:00+02:00,2025-05-25,12:12,2,4,6
75,2025-05-25T04:15:00+02:00,2025-05-25,12:15,0,1,1
75,2025-05-25T04:19:00+02:00,2025-05-25,12:19,2,1,3
75,2025-05-25T04:22:00+02:00,2025-05-25,12:22,2,2,4
75,2025-05-25T04:24:00+02:00,2025-05-25,12:24,0,3,3
77,2025-05-25T04:10:00+02:00,2025-05-25,12:10,14,15,29
78,2025-05-25T04:13:00+02:00,2025-05-25,12:13,0,6,6
78,2025-05-25T04:14:00+02:00,2025-05-25,12:14,0,3,3
78,2025-05-25T04:16:00+02:00,2025-05-25,12:16,2,2,4
78,2025-05-25T04:18:00+02:00,2025-05-25,12:18,0,2,2
78,2025-05-25T04:21:00+02:00,2025-05-25,12:21,1,0,1
78,2025-05-25T04:23:00+02:00,2025-05-25,12:23,1,1,2
84,2025-05-25T04:10:00+02:00,2025-05-25,12:10,83,92,175
87,2025-05-25T04:15:00+02:00,2025-05-25,12:15,4,0,4
87,2025-05-25T04:16:00+02:00,2025-05-25,12:16,2,1,3
87,2025-05-25T04:17:00+02:00,2025-05-25,12:17,1,2,3
87,2025-05-25T04:18:00+02:00,2025-05-25,12:18,0,2,2
107,2025-05-25T04:15:00+02:00,2025-05-25,12:15,2,12,14
108,2025-05-25T04:19:00+02:00,2025-05-25,12:19,0,1,1
108,2025-05-25T04:21:00+02:00,2025-05-25,12:21,2,1,3
108,2025-05-25T04:23:00+02:00,2025-05-25,12:23,6,6,12
108,2025-05-25T04:24:00+02:00,2025-05-25,12:24,1,3,4
131,2025-05-25T04:10:00+02:00,2025-05-25,12:10,6,9,15
133,2025-05-25T04:20:00+02:00,2025-05-25,12:20,60,38,98
135,2025-05-25T04:15:00+02:00,2025-05-25,12:15,25,48,73
162,2025-05-25T04:15:00+02:00,2025-05-25,12:15,53,66,119
165,2025-05-25T04:10:00+02:00,2025-05-25,12:10,1,4,5
166,2025-05-25T04:10:00+02:00,2025-05-25,12:10,4,4,8
166,2025-05-25T04:20:00+02:00,2025-05-25,12:20,2,3,5
167,2025-05-25T04:10:00+02:00,2025-05-25,12:10,2,11,13
167,2025-05-25T04:15:00+02:00,2025-05-25,12:15,3,7,10
167,2025-05-25T04:20:00+02:00,2025-05-25,12:20,1,9,10
1,2025-05-25T04:10:00+02:00,2025-05-25,12:10,31,21,52
1,2025-05-25T04:11:00+02:00,2025-05-25,12:11,16,17,33
1,2025-05-25T04:14:00+02:00,2025-05-25,12:14,13,22,35
1,2025-05-25T04:18:00+02:00,2025-05-25,12:18,33,13,46
1,2025-05-25T04:20:00+02:00,2025-05-25,12:20,28,18,46
2,2025-05-25T04:10:00+02:00,2025-05-25,12:10,19,3,22
2,2025-05-25T04:12:00+02:00,2025-05-25,12:12,3,11,14
2,2025-05-25T04:18:00+02:00,2025-05-25,12:18,20,10,30
2,2025-05-25T04:19:00+02:00,2025-05-25,12:19,26,14,40
2,2025-05-25T04:21:00+02:00,2025-05-25,12:21,13,6,19
2,2025-05-25T04:24:00+02:00,2025-05-25,12:24,3,5,8
9,2025-05-25T04:11:00+02:00,2025-05-25,12:11,0,2,2
9,2025-05-25T04:18:00+02:00,2025-05-25,12:18,4,2,6
10,2025-05-25T04:12:00+02:00,2025-05-25,12:12,0,1,1
11,2025-05-25T04:20:00+02:00,2025-05-25,12:20,3,7,10
11,2025-05-25T04:21:00+02:00,2025-05-25,12:21,0,8,8
11,2025-05-25T04:22:00+02:00,2025-05-25,12:22,2,2,4
11,2025-05-25T04:23:00+02:00,2025-05-25,12:23,1,1,2
12,2025-05-25T04:16:00+02:00,2025-05-25,12:16,5,4,9
12,2025-05-25T04:17:00+02:00,2025-05-25,12:17,2,1,3
12,2025-05-25T04:20:00+02:00,2025-05-25,12:20,1,12,13
12,2025-05-25T04:21:00+02:00,2025-05-25,12:21,2,6,8
17,2025-05-25T04:12:00+02:00,2025-05-25,12:12,15,3,18
17,2025-05-25T04:13:00+02:00,2025-05-25,12:13,7,2,9
17,2025-05-25T04:14:00+02:00,2025-05-25,12:14,12,5,17
17,2025-05-25T04:15:00+02:00,2025-05-25,12:15,6,1,7
17,2025-05-25T04:17:00+02:00,2025-05-25,12:17,11,0,11
17,2025-05-25T04:18:00+02:00,2025-05-25,12:18,32,2,34
17,2025-05-25T04:20:00+02:00,2025-05-25,12:20,7,2,9
17,2025-05-25T04:23:00+02:00,2025-05-25,12:23,11,1,12
18,2025-05-25T04:10:00+02:00,2025-05-25,12:10,0,3,3
19,2025-05-25T04:11:00+02:00,2025-05-25,12:11,8,9,17
19,2025-05-25T04:14:00+02:00,2025-05-25,12:14,10,3,13
19,2025-05-25T04:16:00+02:00,2025-05-25,12:16,3,1,4
19,2025-05-25T04:17:00+02:00,2025-05-25,12:17,13,18,31
19,2025-05-25T04:23:00+02:00,2025-05-25,12:23,10,19,29
19,2025-05-25T04:24:00+02:00,2025-05-25,12:24,11,10,21
20,2025-05-25T04:12:00+02:00,2025-05-25,12:12,3,3,6
20,2025-05-25T04:13:00+02:00,2025-05-25,12:13,4,2,6
20,2025-05-25T04:15:00+02:00,2025-05-25,12:15,4,3,7
20,2025-05-25T04:16:00+02:00,2025-05-25,12:16,5,2,7
20,2025-05-25T04:17:00+02:00,2025-05-25,12:17,13,4,17
20,2025-05-25T04:23:00+02:00,2025-05-25,12:23,5,8,13
23,2025-05-25T04:23:00+02:00,2025-05-25,12:23,1,8,9
24,2025-05-25T04:11:00+02:00,2025-05-25,12:11,7,2,9
24,2025-05-25T04:12:00+02:00,2025-05-25,12:12,5,8,13
24,2025-05-25T04:21:00+02:00,2025-05-25,12:21,12,16,28
24,2025-05-25T04:22:00+02:00,2025-05-25,12:22,17,7,24
24,2025-05-25T04:24:00+02:00,2025-05-25,12:24,15,7,22
27,2025-05-25T04:10:00+02:00,2025-05-25,12:10,4,4,8
27,2025-05-25T04:16:00+02:00,2025-05-25,12:16,1,10,11
27,2025-05-25T04:17:00+02:00,2025-05-25,12:17,2,1,3
30,2025-05-25T04:12:00+02:00,2025-05-25,12:12,3,2,5
30,2025-05-25T04:13:00+02:00,2025-05-25,12:13,4,1,5
30,2025-05-25T04:15:00+02:00,2025-05-25,12:15,5,2,7
30,2025-05-25T04:17:00+02:00,2025-05-25,12:17,8,2,10
30,2025-05-25T04:18:00+02:00,2025-05-25,12:18,3,4,7
30,2025-05-25T04:21:00+02:00,2025-05-25,12:21,8,9,17
35,2025-05-25T04:11:00+02:00,2025-05-25,12:11,29,31,60
35,2025-05-25T04:16:00+02:00,2025-05-25,12:16,24,18,42
46,2025-05-25T04:20:00+02:00,2025-05-25,12:20,0,1,1
48,2025-05-25T04:10:00+02:00,2025-05-25,12:10,7,4,11
48,2025-05-25T04:16:00+02:00,2025-05-25,12:16,11,6,17
48,2025-05-25T04:19:00+02:00,2025-05-25,12:19,6,8,14
48,2025-05-25T04:21:00+02:00,2025-05-25,12:21,11,13,24
48,2025-05-25T04:24:00+02:00,2025-05-25,12:24,9,15,24
49,2025-05-25T04:11:00+02:00,2025-05-25,12:11,12,3,15
49,2025-05-25T04:13:00+02:00,2025-05-25,12:13,7,13,20
49,2025-05-25T04:17:00+02:00,2025-05-25,12:17,7,17,24
49,2025-05-25T04:21:00+02:00,2025-05-25,12:21,9,5,14
51,2025-05-25T04:10:00+02:00,2025-05-25,12:10,2,7,9
51,2025-05-25T04:12:00+02:00,2025-05-25,12:12,1,4,5
51,2025-05-25T04:17:00+02:00,2025-05-25,12:17,2,4,6
51,2025-05-25T04:21:00+02:00,2025-05-25,12:21,3,1,4
51,2025-05-25T04:24:00+02:00,2025-05-25,12:24,6,1,7
52,2025-05-25T04:10:00+02:00,2025-05-25,12:10,7,2,9
52,2025-05-25T04:17:00+02:00,2025-05-25,12:17,6,1,7
52,2025-05-25T04:18:00+02:00,2025-05-25,12:18,9,9,18
52,2025-05-25T04:19:00+02:00,2025-05-25,12:19,2,2,4
52,2025-05-25T04:20:00+02:00,2025-05-25,12:20,2,3,5
52,2025-05-25T04:21:00+02:00,2025-05-25,12:21,0,10,10
52,2025-05-25T04:23:00+02:00,2025-05-25,12:23,3,7,10
53,2025-05-25T04:17:00+02:00,2025-05-25,12:17,16,7,23
53,2025-05-25T04:18:00+02:00,2025-05-25,12:18,25,1,26
56,2025-05-25T04:11:00+02:00,2025-05-25,12:11,13,6,19
56,2025-05-25T04:15:00+02:00,2025-05-25,12:15,7,8,15
56,2025-05-25T04:20:00+02:00,2025-05-25,12:20,10,10,20
56,2025-05-25T04:22:00+02:00,2025-05-25,12:22,9,4,13
56,2025-05-25T04:24:00+02:00,2025-05-25,12:24,9,14,23
58,2025-05-25T04:10:00+02:00,2025-05-25,12:10,1,3,4
58,2025-05-25T04:21:00+02:00,2025-05-25,12:21,6,4,10
62,2025-05-25T04:10:00+02:00,2025-05-25,12:10,1,11,12
62,2025-05-25T04:24:00+02:00,2025-05-25,12:24,1,2,3
63,2025-05-25T04:15:00+02:00,2025-05-25,12:15,6,5,11
63,2025-05-25T04:19:00+02:00,2025-05-25,12:19,5,6,11
63,2025-05-25T04:20:00+02:00,2025-05-25,12:20,9,5,14
63,2025-05-25T04:21:00+02:00,2025-05-25,12:21,6,7,13
63,2025-05-25T04:22:00+02:00,2025-05-25,12:22,7,2,9
67,2025-05-25T04:11:00+02:00,2025-05-25,12:11,7,11,18
67,2025-05-25T04:14:00+02:00,2025-05-25,12:14,8,13,21
67,2025-05-25T04:16:00+02:00,2025-05-25,12:16,8,14,22
67,2025-05-25T04:21:00+02:00,2025-05-25,12:21,14,6,20
67,2025-05-25T04:22:00+02:00,2025-05-25,12:22,6,12,18
67,2025-05-25T04:23:00+02:00,2025-05-25,12:23,5,10,15
67,2025-05-25T04:24:00+02:00,2025-05-25,12:24,2,5,7
68,2025-05-25T04:12:00+02:00,2025-05-25,12:12,5,14,19
68,2025-05-25T04:14:00+02:00,2025-05-25,12:14,7,11,18
68,2025-05-25T04:18:00+02:00,2025-05-25,12:18,3,4,7
68,2025-05-25T04:22:00+02:00,2025-05-25,12:22,4,1,5
68,2025-05-25T04:23:00+02:00,2025-05-25,12:23,10,6,16
68,2025-05-25T04:24:00+02:00,2025-05-25,12:24,1,3,4
72,2025-05-25T04:10:00+02:00,2025-05-25,12:10,4,6,10
72,2025-05-25T04:12:00+02:00,2025-05-25,12:12,3,8,11
72,2025-05-25T04:14:00+02:00,2025-05-25,12:14,5,7,12
72,2025-05-25T04:16:00+02:00,2025-05-25,12:16,1,4,5
72,2025-05-25T04:17:00+02:00,2025-05-25,12:17,1,8,9
72,2025-05-25T04:21:00+02:00,2025-05-25,12:21,5,6,11
72,2025-05-25T04:23:00+02:00,2025-05-25,12:23,5,0,5
76,2025-05-25T04:19:00+02:00,2025-05-25,12:19,3,0,3
76,2025-05-25T04:21:00+02:00,2025-05-25,12:21,0,2,2
79,2025-05-25T04:10:00+02:00,2025-05-25,12:10,17,4,21
79,2025-05-25T04:14:00+02:00,2025-05-25,12:14,15,5,20
79,2025-05-25T04:18:00+02:00,2025-05-25,12:18,22,8,30
79,2025-05-25T04:19:00+02:00,2025-05-25,12:19,17,1,18
79,2025-05-25T04:23:00+02:00,2025-05-25,12:23,4,7,11
79,2025-05-25T04:24:00+02:00,2025-05-25,12:24,10,12,22
85,2025-05-25T04:14:00+02:00,2025-05-25,12:14,3,0,3
85,2025-05-25T04:19:00+02:00,2025-05-25,12:19,0,1,1
85,2025-05-25T04:22:00+02:00,2025-05-25,12:22,4,2,6
86,2025-05-25T04:11:00+02:00,2025-05-25,12:11,0,5,5
86,2025-05-25T04:13:00+02:00,2025-05-25,12:13,9,0,9
86,2025-05-25T04:14:00+02:00,2025-05-25,12:14,2,0,2
86,2025-05-25T04:15:00+02:00,2025-05-25,12:15,3,0,3
86,2025-05-25T04:21:00+02:00,2025-05-25,12:21,3,2,5
109,2025-05-25T04:15:00+02:00,2025-05-25,12:15,5,13,18
130,2025-05-25T04:10:00+02:00,2025-05-25,12:10,7,1,8
136,2025-05-25T04:10:00+02:00,2025-05-25,12:10,22,9,31
136,2025-05-25T04:20:00+02:00,2025-05-25,12:20,60,17,77
138,2025-05-25T04:15:00+02:00,2025-05-25,12:15,2,0,2
139,2025-05-25T04:15:00+02:00,2025-05-25,12:15,9,4,13
141,2025-05-25T04:20:00+02:00,2025-05-25,12:20,5,10,15
142,2025-05-25T04:10:00+02:00,2025-05-25,12:10,71,32,103
161,2025-05-25T04:10:00+02:00,2025-05-25,12:10,53,17,70
164,2025-05-25T04:10:00+02:00,2025-05-25,12:10,15,5,20
164,2025-05-25T04:20:00+02:00,2025-05-25,12:20,4,6,10
3,2025-05-25T03:57:00+02:00,2025-05-25,11:57,15,24,39
3,2025-05-25T04:00:00+02:00,2025-05-25,12:00,15,11,26
3,2025-05-25T04:02:00+02:00,2025-05-25,12:02,13,15,28
3,2025-05-25T04:03:00+02:00,2025-05-25,12:03,18,15,33
3,2025-05-25T04:06:00+02:00,2025-05-25,12:06,15,25,40
4,2025-05-25T03:57:00+02:00,2025-05-25,11:57,36,15,51
4,2025-05-25T04:00:00+02:00,2025-05-25,12:00,29,23,52
4,2025-05-25T04:04:00+02:00,2025-05-25,12:04,19,19,38
4,2025-05-25T04:09:00+02:00,2025-05-25,12:09,18,17,35
6,2025-05-25T03:55:00+02:00,2025-05-25,11:55,8,7,15
6,2025-05-25T03:56:00+02:00,2025-05-25,11:56,11,11,22
6,2025-05-25T03:59:00+02:00,2025-05-25,11:59,15,28,43
6,2025-05-25T04:01:00+02:00,2025-05-25,12:01,9,7,16
6,2025-05-25T04:04:00+02:00,2025-05-25,12:04,14,11,25
6,2025-05-25T04:06:00+02:00,2025-05-25,12:06,13,13,26
8,2025-05-25T03:56:00+02:00,2025-05-25,11:56,3,3,6
8,2025-05-25T03:57:00+02:00,2025-05-25,11:57,0,13,13
8,2025-05-25T03:58:00+02:00,2025-05-25,11:58,7,5,12
8,2025-05-25T04:03:00+02:00,2025-05-25,12:03,2,11,13
8,2025-05-25T04:04:00+02:00,2025-05-25,12:04,0,8,8
8,2025-05-25T04:05:00+02:00,2025-05-25,12:05,1,1,2
8,2025-05-25T04:07:00+02:00,2025-05-25,12:07,4,3,7
8,2025-05-25T04:08:00+02:00,2025-05-25,12:08,2,8,10
28,2025-05-25T03:55:00+02:00,2025-05-25,11:55,12,10,22
28,2025-05-25T04:00:00+02:00,2025-05-25,12:00,6,14,20
28,2025-05-25T04:01:00+02:00,2025-05-25,12:01,7,11,18
28,2025-05-25T04:04:00+02:00,2025-05-25,12:04,15,3,18
28,2025-05-25T04:07:00+02:00,2025-05-25,12:07,4,5,9
29,2025-05-25T03:55:00+02:00,2025-05-25,11:55,15,4,19
29,2025-05-25T03:56:00+02:00,2025-05-25,11:56,12,8,20
29,2025-05-25T03:58:00+02:00,2025-05-25,11:58,12,6,18
29,2025-05-25T04:01:00+02:00,2025-05-25,12:01,12,16,28
29,2025-05-25T04:03:00+02:00,2025-05-25,12:03,9,13,22
29,2025-05-25T04:05:00+02:00,2025-05-25,12:05,18,12,30
29,2025-05-25T04:06:00+02:00,2025-05-25,12:06,21,6,27
31,2025-05-25T03:57:00+02:00,2025-05-25,11:57,13,3,16
31,2025-05-25T03:58:00+02:00,2025-05-25,11:58,9,2,11
31,2025-05-25T03:59:00+02:00,2025-05-25,11:59,2,8,10
31,2025-05-25T04:00:00+02:00,2025-05-25,12:00,5,0,5
31,2025-05-25T04:02:00+02:00,2025-05-25,12:02,6,8,14
31,2025-05-25T04:03:00+02:00,2025-05-25,12:03,3,2,5
36,2025-05-25T03:56:00+02:00,2025-05-25,11:56,2,1,3
36,2025-05-25T03:59:00+02:00,2025-05-25,11:59,2,0,2
36,2025-05-25T04:04:00+02:00,2025-05-25,12:04,2,1,3
36,2025-05-25T04:09:00+02:00,2025-05-25,12:09,5,3,8
37,2025-05-25T03:55:00+02:00,2025-05-25,11:55,2,0,2
37,2025-05-25T03:57:00+02:00,2025-05-25,11:57,0,2,2
37,2025-05-25T04:03:00+02:00,2025-05-25,12:03,5,4,9
37,2025-05-25T04:04:00+02:00,2025-05-25,12:04,4,1,5
37,2025-05-25T04:06:00+02:00,2025-05-25,12:06,1,0,1
39,2025-05-25T03:57:00+02:00,2025-05-25,11:57,1,3,4
40,2025-05-25T04:02:00+02:00,2025-05-25,12:02,0,2,2
40,2025-05-25T04:05:00+02:00,2025-05-25,12:05,2,4,6
40,2025-05-25T04:06:00+02:00,2025-05-25,12:06,1,4,5
40,2025-05-25T04:08:00+02:00,2025-05-25,12:08,4,3,7
41,2025-05-25T03:55:00+02:00,2025-05-25,11:55,6,5,11
41,2025-05-25T03:56:00+02:00,2025-05-25,11:56,5,11,16
41,2025-05-25T04:00:00+02:00,2025-05-25,12:00,5,8,13
41,2025-05-25T04:02:00+02:00,2025-05-25,12:02,10,7,17
41,2025-05-25T04:06:00+02:00,2025-05-25,12:06,8,4,12
43,2025-05-25T03:55:00+02:00,2025-05-25,11:55,3,19,22
43,2025-05-25T04:05:00+02:00,2025-05-25,12:05,9,9,18
44,2025-05-25T04:00:00+02:00,2025-05-25,12:00,3,9,12
45,2025-05-25T04:00:00+02:00,2025-05-25,12:00,18,2,20
45,2025-05-25T04:02:00+02:00,2025-05-25,12:02,8,8,16
45,2025-05-25T04:04:00+02:00,2025-05-25,12:04,18,12,30
47,2025-05-25T03:55:00+02:00,2025-05-25,11:55,17,15,32
47,2025-05-25T04:03:00+02:00,2025-05-25,12:03,26,25,51
47,2025-05-25T04:04:00+02:00,2025-05-25,12:04,11,25,36
50,2025-05-25T03:56:00+02:00,2025-05-25,11:56,5,1,6
50,2025-05-25T03:58:00+02:00,2025-05-25,11:58,2,1,3
50,2025-05-25T03:59:00+02:00,2025-05-25,11:59,4,8,12
50,2025-05-25T04:00:00+02:00,2025-05-25,12:00,5,2,7
50,2025-05-25T04:02:00+02:00,2025-05-25,12:02,2,9,11
54,2025-05-25T03:57:00+02:00,2025-05-25,11:57,3,5,8
54,2025-05-25T04:02:00+02:00,2025-05-25,12:02,1,3,4
54,2025-05-25T04:04:00+02:00,2025-05-25,12:04,5,1,6
54,2025-05-25T04:06:00+02:00,2025-05-25,12:06,2,0,2
54,2025-05-25T04:09:00+02:00,2025-05-25,12:09,6,0,6
59,2025-05-25T04:05:00+02:00,2025-05-25,12:05,6,43,49
61,2025-05-25T04:01:00+02:00,2025-05-25,12:01,9,1,10
61,2025-05-25T04:03:00+02:00,2025-05-25,12:03,7,8,15
61,2025-05-25T04:09:00+02:00,2025-05-25,12:09,8,6,14
66,2025-05-25T03:57:00+02:00,2025-05-25,11:57,18,20,38
66,2025-05-25T04:01:00+02:00,2025-05-25,12:01,11,11,22
66,2025-05-25T04:03:00+02:00,2025-05-25,12:03,13,20,33
66,2025-05-25T04:04:00+02:00,2025-05-25,12:04,19,23,42
66,2025-05-25T04:08:00+02:00,2025-05-25,12:08,25,19,44
69,2025-05-25T03:56:00+02:00,2025-05-25,11:56,2,0,2
69,2025-05-25T03:57:00+02:00,2025-05-25,11:57,10,10,20
69,2025-05-25T04:02:00+02:00,2025-05-25,12:02,9,1,10
69,2025-05-25T04:05:00+02:00,2025-05-25,12:05,10,4,14
69,2025-05-25T04:09:00+02:00,2025-05-25,12:09,4,2,6
70,2025-05-25T03:55:00+02:00,2025-05-25,11:55,3,10,13
70,2025-05-25T03:56:00+02:00,2025-05-25,11:56,5,5,10
70,2025-05-25T04:00:00+02:00,2025-05-25,12:00,0,1,1
70,2025-05-25T04:01:00+02:00,2025-05-25,12:01,1,0,1
70,2025-05-25T04:02:00+02:00,2025-05-25,12:02,5,3,8
70,2025-05-25T04:03:00+02:00,2025-05-25,12:03,1,0,1
75,2025-05-25T03:55:00+02:00,2025-05-25,11:55,1,0,1
75,2025-05-25T03:56:00+02:00,2025-05-25,11:56,5,0,5
75,2025-05-25T03:59:00+02:00,2025-05-25,11:59,0,1,1
75,2025-05-25T04:00:00+02:00,2025-05-25,12:00,0,1,1
78,2025-05-25T03:57:00+02:00,2025-05-25,11:57,1,3,4
78,2025-05-25T04:02:00+02:00,2025-05-25,12:02,1,0,1
78,2025-05-25T04:03:00+02:00,2025-05-25,12:03,2,1,3
78,2025-05-25T04:07:00+02:00,2025-05-25,12:07,0,1,1
84,2025-05-25T03:55:00+02:00,2025-05-25,11:55,58,91,149
87,2025-05-25T03:56:00+02:00,2025-05-25,11:56,0,2,2
87,2025-05-25T03:57:00+02:00,2025-05-25,11:57,3,4,7
87,2025-05-25T04:04:00+02:00,2025-05-25,12:04,1,1,2
87,2025-05-25T04:05:00+02:00,2025-05-25,12:05,4,1,5
108,2025-05-25T03:56:00+02:00,2025-05-25,11:56,1,1,2
108,2025-05-25T04:01:00+02:00,2025-05-25,12:01,1,4,5
108,2025-05-25T04:02:00+02:00,2025-05-25,12:02,2,1,3
108,2025-05-25T04:03:00+02:00,2025-05-25,12:03,2,3,5
108,2025-05-25T04:04:00+02:00,2025-05-25,12:04,0,2,2
108,2025-05-25T04:05:00+02:00,2025-05-25,12:05,2,2,4
108,2025-05-25T04:06:00+02:00,2025-05-25,12:06,1,1,2
108,2025-05-25T04:09:00+02:00,2025-05-25,12:09,4,4,8
118,2025-05-25T03:55:00+02:00,2025-05-25,11:55,0,7,7
131,2025-05-25T03:55:00+02:00,2025-05-25,11:55,2,8,10
131,2025-05-25T04:05:00+02:00,2025-05-25,12:05,8,10,18
133,2025-05-25T04:00:00+02:00,2025-05-25,12:00,35,31,66
133,2025-05-25T04:05:00+02:00,2025-05-25,12:05,42,35,77
134,2025-05-25T03:55:00+02:00,2025-05-25,11:55,26,25,51
135,2025-05-25T04:05:00+02:00,2025-05-25,12:05,23,36,59
162,2025-05-25T04:00:00+02:00,2025-05-25,12:00,64,67,131
165,2025-05-25T04:05:00+02:00,2025-05-25,12:05,2,4,6
166,2025-05-25T04:00:00+02:00,2025-05-25,12:00,9,7,16
166,2025-05-25T04:05:00+02:00,2025-05-25,12:05,3,1,4
179,2025-05-25T03:55:00+02:00,2025-05-25,11:55,4,4,8
179,2025-05-25T04:00:00+02:00,2025-05-25,12:00,5,3,8
179,2025-05-25T04:05:00+02:00,2025-05-25,12:05,3,4,7
1,2025-05-25T04:02:00+02:00,2025-05-25,12:02,18,24,42
1,2025-05-25T04:06:00+02:00,2025-05-25,12:06,19,10,29
1,2025-05-25T04:08:00+02:00,2025-05-25,12:08,19,24,43
2,2025-05-25T03:55:00+02:00,2025-05-25,11:55,18,12,30
2,2025-05-25T03:56:00+02:00,2025-05-25,11:56,5,7,12
2,2025-05-25T04:02:00+02:00,2025-05-25,12:02,4,2,6
2,2025-05-25T04:04:00+02:00,2025-05-25,12:04,15,5,20
9,2025-05-25T03:55:00+02:00,2025-05-25,11:55,1,0,1
9,2025-05-25T03:57:00+02:00,2025-05-25,11:57,0,2,2
9,2025-05-25T03:59:00+02:00,2025-05-25,11:59,1,1,2
9,2025-05-25T04:00:00+02:00,2025-05-25,12:00,3,2,5
9,2025-05-25T04:04:00+02:00,2025-05-25,12:04,1,0,1
9,2025-05-25T04:05:00+02:00,2025-05-25,12:05,1,2,3
9,2025-05-25T04:06:00+02:00,2025-05-25,12:06,0,2,2
9,2025-05-25T04:07:00+02:00,2025-05-25,12:07,0,6,6
9,2025-05-25T04:08:00+02:00,2025-05-25,12:08,3,9,12
10,2025-05-25T03:59:00+02:00,2025-05-25,11:59,1,0,1
10,2025-05-25T04:00:00+02:00,2025-05-25,12:00,5,0,5
10,2025-05-25T04:07:00+02:00,2025-05-25,12:07,2,2,4
11,2025-05-25T04:01:00+02:00,2025-05-25,12:01,0,1,1
11,2025-05-25T04:03:00+02:00,2025-05-25,12:03,0,1,1
12,2025-05-25T03:55:00+02:00,2025-05-25,11:55,1,2,3
12,2025-05-25T03:59:00+02:00,2025-05-25,11:59,2,4,6
12,2025-05-25T04:00:00+02:00,2025-05-25,12:00,6,13,19
12,2025-05-25T04:01:00+02:00,2025-05-25,12:01,2,18,20
12,2025-05-25T04:04:00+02:00,2025-05-25,12:04,1,0,1
12,2025-05-25T04:09:00+02:00,2025-05-25,12:09,6,8,14
17,2025-05-25T03:56:00+02:00,2025-05-25,11:56,4,0,4
17,2025-05-25T03:58:00+02:00,2025-05-25,11:58,3,1,4
17,2025-05-25T04:01:00+02:00,2025-05-25,12:01,5,2,7
17,2025-05-25T04:02:00+02:00,2025-05-25,12:02,6,2,8
17,2025-05-25T04:03:00+02:00,2025-05-25,12:03,2,6,8
18,2025-05-25T04:05:00+02:00,2025-05-25,12:05,0,2,2
18,2025-05-25T04:06:00+02:00,2025-05-25,12:06,0,1,1
18,2025-05-25T04:08:00+02:00,2025-05-25,12:08,3,1,4
19,2025-05-25T03:58:00+02:00,2025-05-25,11:58,11,2,13
19,2025-05-25T04:01:00+02:00,2025-05-25,12:01,3,8,11
19,2025-05-25T04:03:00+02:00,2025-05-25,12:03,9,8,17
20,2025-05-25T03:59:00+02:00,2025-05-25,11:59,7,2,9
20,2025-05-25T04:00:00+02:00,2025-05-25,12:00,5,3,8
20,2025-05-25T04:01:00+02:00,2025-05-25,12:01,3,2,5
20,2025-05-25T04:03:00+02:00,2025-05-25,12:03,15,3,18
20,2025-05-25T04:04:00+02:00,2025-05-25,12:04,2,4,6
20,2025-05-25T04:05:00+02:00,2025-05-25,12:05,1,3,4
20,2025-05-25T04:06:00+02:00,2025-05-25,12:06,20,0,20
20,2025-05-25T04:07:00+02:00,2025-05-25,12:07,0,4,4
20,2025-05-25T04:08:00+02:00,2025-05-25,12:08,6,4,10
20,2025-05-25T04:09:00+02:00,2025-05-25,12:09,10,3,13
23,2025-05-25T03:56:00+02:00,2025-05-25,11:56,3,1,4
23,2025-05-25T03:58:00+02:00,2025-05-25,11:58,3,7,10
23,2025-05-25T04:00:00+02:00,2025-05-25,12:00,2,5,7
23,2025-05-25T04:01:00+02:00,2025-05-25,12:01,1,1,2
23,2025-05-25T04:04:00+02:00,2025-05-25,12:04,3,2,5
23,2025-05-25T04:06:00+02:00,2025-05-25,12:06,2,1,3
23,2025-05-25T04:09:00+02:00,2025-05-25,12:09,2,4,6
24,2025-05-25T03:55:00+02:00,2025-05-25,11:55,14,19,33
24,2025-05-25T03:58:00+02:00,2025-05-25,11:58,6,9,15
24,2025-05-25T03:59:00+02:00,2025-05-25,11:59,16,10,26
24,2025-05-25T04:02:00+02:00,2025-05-25,12:02,13,5,18
24,2025-05-25T04:03:00+02:00,2025-05-25,12:03,1,3,4
24,2025-05-25T04:04:00+02:00,2025-05-25,12:04,10,1,11
24,2025-05-25T04:07:00+02:00,2025-05-25,12:07,9,2,11
24,2025-05-25T04:08:00+02:00,2025-05-25,12:08,8,4,12
25,2025-05-25T03:55:00+02:00,2025-05-25,11:55,54,69,123
27,2025-05-25T03:59:00+02:00,2025-05-25,11:59,3,10,13
27,2025-05-25T04:02:00+02:00,2025-05-25,12:02,6,6,12
27,2025-05-25T04:04:00+02:00,2025-05-25,12:04,0,6,6
27,2025-05-25T04:06:00+02:00,2025-05-25,12:06,5,0,5
30,2025-05-25T04:01:00+02:00,2025-05-25,12:01,7,2,9
30,2025-05-25T04:02:00+02:00,2025-05-25,12:02,2,4,6
30,2025-05-25T04:03:00+02:00,2025-05-25,12:03,3,1,4
30,2025-05-25T04:06:00+02:00,2025-05-25,12:06,4,3,7
30,2025-05-25T04:07:00+02:00,2025-05-25,12:07,3,4,7
30,2025-05-25T04:09:00+02:00,2025-05-25,12:09,4,4,8
35,2025-05-25T04:00:00+02:00,2025-05-25,12:00,30,13,43
35,2025-05-25T04:01:00+02:00,2025-05-25,12:01,20,25,45
35,2025-05-25T04:09:00+02:00,2025-05-25,12:09,33,14,47
46,2025-05-25T04:05:00+02:00,2025-05-25,12:05,3,7,10
48,2025-05-25T04:07:00+02:00,2025-05-25,12:07,5,7,12
48,2025-05-25T04:08:00+02:00,2025-05-25,12:08,6,10,16
49,2025-05-25T03:59:00+02:00,2025-05-25,11:59,9,11,20
49,2025-05-25T04:02:00+02:00,2025-05-25,12:02,9,9,18
49,2025-05-25T04:05:00+02:00,2025-05-25,12:05,5,8,13
52,2025-05-25T03:56:00+02:00,2025-05-25,11:56,5,7,12
52,2025-05-25T04:00:00+02:00,2025-05-25,12:00,6,3,9
52,2025-05-25T04:06:00+02:00,2025-05-25,12:06,3,6,9
52,2025-05-25T04:09:00+02:00,2025-05-25,12:09,5,6,11
53,2025-05-25T03:55:00+02:00,2025-05-25,11:55,13,13,26
53,2025-05-25T04:01:00+02:00,2025-05-25,12:01,4,3,7
53,2025-05-25T04:03:00+02:00,2025-05-25,12:03,8,6,14
53,2025-05-25T04:08:00+02:00,2025-05-25,12:08,11,4,15
56,2025-05-25T03:55:00+02:00,2025-05-25,11:55,10,6,16
56,2025-05-25T03:58:00+02:00,2025-05-25,11:58,9,9,18
56,2025-05-25T03:59:00+02:00,2025-05-25,11:59,5,6,11
58,2025-05-25T04:01:00+02:00,2025-05-25,12:01,7,6,13
58,2025-05-25T04:02:00+02:00,2025-05-25,12:02,12,4,16
58,2025-05-25T04:03:00+02:00,2025-05-25,12:03,5,9,14
58,2025-05-25T04:04:00+02:00,2025-05-25,12:04,31,3,34
58,2025-05-25T04:06:00+02:00,2025-05-25,12:06,12,4,16
58,2025-05-25T04:07:00+02:00,2025-05-25,12:07,18,4,22
58,2025-05-25T04:09:00+02:00,2025-05-25,12:09,12,10,22
62,2025-05-25T03:56:00+02:00,2025-05-25,11:56,0,2,2
62,2025-05-25T03:59:00+02:00,2025-05-25,11:59,1,5,6
62,2025-05-25T04:05:00+02:00,2025-05-25,12:05,1,0,1
62,2025-05-25T04:06:00+02:00,2025-05-25,12:06,4,7,11
62,2025-05-25T04:09:00+02:00,2025-05-25,12:09,2,1,3
63,2025-05-25T03:55:00+02:00,2025-05-25,11:55,4,9,13
63,2025-05-25T03:56:00+02:00,2025-05-25,11:56,4,6,10
63,2025-05-25T03:57:00+02:00,2025-05-25,11:57,4,4,8
63,2025-05-25T03:58:00+02:00,2025-05-25,11:58,5,5,10
63,2025-05-25T04:00:00+02:00,2025-05-25,12:00,16,3,19
63,2025-05-25T04:02:00+02:00,2025-05-25,12:02,0,6,6
63,2025-05-25T04:05:00+02:00,2025-05-25,12:05,3,4,7
63,2025-05-25T04:06:00+02:00,2025-05-25,12:06,10,2,12
63,2025-05-25T04:07:00+02:00,2025-05-25,12:07,9,4,13
63,2025-05-25T04:08:00+02:00,2025-05-25,12:08,8,4,12
67,2025-05-25T03:56:00+02:00,2025-05-25,11:56,5,4,9
67,2025-05-25T03:57:00+02:00,2025-05-25,11:57,4,7,11
67,2025-05-25T03:58:00+02:00,2025-05-25,11:58,7,11,18
67,2025-05-25T04:04:00+02:00,2025-05-25,12:04,4,3,7
67,2025-05-25T04:05:00+02:00,2025-05-25,12:05,7,11,18
67,2025-05-25T04:06:00+02:00,2025-05-25,12:06,3,17,20
67,2025-05-25T04:07:00+02:00,2025-05-25,12:07,6,2,8
67,2025-05-25T04:08:00+02:00,2025-05-25,12:08,12,6,18
67,2025-05-25T04:09:00+02:00,2025-05-25,12:09,7,10,17
68,2025-05-25T03:59:00+02:00,2025-05-25,11:59,8,7,15
68,2025-05-25T04:03:00+02:00,2025-05-25,12:03,5,5,10
68,2025-05-25T04:05:00+02:00,2025-05-25,12:05,8,5,13
68,2025-05-25T04:06:00+02:00,2025-05-25,12:06,11,18,29
68,2025-05-25T04:07:00+02:00,2025-05-25,12:07,5,6,11
72,2025-05-25T03:56:00+02:00,2025-05-25,11:56,1,7,8
72,2025-05-25T04:06:00+02:00,2025-05-25,12:06,8,8,16
72,2025-05-25T04:08:00+02:00,2025-05-25,12:08,10,2,12
76,2025-05-25T03:55:00+02:00,2025-05-25,11:55,0,1,1
76,2025-05-25T04:01:00+02:00,2025-05-25,12:01,2,0,2
76,2025-05-25T04:08:00+02:00,2025-05-25,12:08,1,0,1
79,2025-05-25T03:55:00+02:00,2025-05-25,11:55,10,4,14
79,2025-05-25T03:56:00+02:00,2025-05-25,11:56,24,3,27
79,2025-05-25T03:58:00+02:00,2025-05-25,11:58,20,6,26
79,2025-05-25T03:59:00+02:00,2025-05-25,11:59,11,11,22
79,2025-05-25T04:01:00+02:00,2025-05-25,12:01,22,0,22
79,2025-05-25T04:02:00+02:00,2025-05-25,12:02,28,6,34
79,2025-05-25T04:07:00+02:00,2025-05-25,12:07,36,8,44
85,2025-05-25T03:58:00+02:00,2025-05-25,11:58,3,1,4
85,2025-05-25T04:01:00+02:00,2025-05-25,12:01,4,2,6
85,2025-05-25T04:07:00+02:00,2025-05-25,12:07,1,1,2
85,2025-05-25T04:08:00+02:00,2025-05-25,12:08,0,1,1
85,2025-05-25T04:09:00+02:00,2025-05-25,12:09,0,2,2
86,2025-05-25T04:01:00+02:00,2025-05-25,12:01,1,0,1
86,2025-05-25T04:07:00+02:00,2025-05-25,12:07,1,2,3
109,2025-05-25T04:05:00+02:00,2025-05-25,12:05,3,8,11
130,2025-05-25T04:00:00+02:00,2025-05-25,12:00,11,1,12
130,2025-05-25T04:05:00+02:00,2025-05-25,12:05,4,0,4
136,2025-05-25T03:55:00+02:00,2025-05-25,11:55,18,7,25
139,2025-05-25T04:05:00+02:00,2025-05-25,12:05,13,1,14
141,2025-05-25T04:05:00+02:00,2025-05-25,12:05,13,19,32
142,2025-05-25T03:55:00+02:00,2025-05-25,11:55,53,66,119
161,2025-05-25T03:55:00+02:00,2025-05-25,11:55,47,10,57
161,2025-05-25T04:00:00+02:00,2025-05-25,12:00,48,15,63
181,2025-05-25T03:56:00+02:00,2025-05-25,11:56,5,28,33
181,2025-05-25T03:57:00+02:00,2025-05-25,11:57,7,25,32
181,2025-05-25T03:59:00+02:00,2025-05-25,11:59,8,22,30
181,2025-05-25T04:09:00+02:00,2025-05-25,12:09,6,29,35
182,2025-05-25T04:05:00+02:00,2025-05-25,12:05,20,10,30
180,2025-05-25T03:57:00+02:00,2025-05-25,11:57,1,1,2
181,2025-05-25T04:13:00+02:00,2025-05-25,12:13,13,35,48
181,2025-05-25T04:14:00+02:00,2025-05-25,12:14,8,34,42
181,2025-05-25T04:17:00+02:00,2025-05-25,12:17,11,24,35
181,2025-05-25T04:19:00+02:00,2025-05-25,12:19,11,19,30
181,2025-05-25T04:20:00+02:00,2025-05-25,12:20,2,21,23
181,2025-05-25T04:21:00+02:00,2025-05-25,12:21,8,7,15
182,2025-05-25T04:15:00+02:00,2025-05-25,12:15,14,11,25
182,2025-05-25T04:20:00+02:00,2025-05-25,12:20,18,10,28
180,2025-05-25T04:12:00+02:00,2025-05-25,12:12,2,0,2
180,2025-05-25T04:18:00+02:00,2025-05-25,12:18,0,2,2
180,2025-05-25T04:22:00+02:00,2025-05-25,12:22,0,2,2
3,2025-05-25T04:25:00+02:00,2025-05-25,12:25,16,13,29
3,2025-05-25T04:26:00+02:00,2025-05-25,12:26,9,9,18
3,2025-05-25T04:27:00+02:00,2025-05-25,12:27,17,17,34
3,2025-05-25T04:29:00+02:00,2025-05-25,12:29,5,14,19
3,2025-05-25T04:30:00+02:00,2025-05-25,12:30,20,14,34
3,2025-05-25T04:33:00+02:00,2025-05-25,12:33,22,27,49
4,2025-05-25T04:26:00+02:00,2025-05-25,12:26,33,9,42
4,2025-05-25T04:28:00+02:00,2025-05-25,12:28,24,26,50
4,2025-05-25T04:34:00+02:00,2025-05-25,12:34,35,22,57
4,2025-05-25T04:35:00+02:00,2025-05-25,12:35,18,29,47
6,2025-05-25T04:26:00+02:00,2025-05-25,12:26,14,3,17
6,2025-05-25T04:27:00+02:00,2025-05-25,12:27,12,24,36
6,2025-05-25T04:28:00+02:00,2025-05-25,12:28,11,9,20
6,2025-05-25T04:32:00+02:00,2025-05-25,12:32,5,9,14
6,2025-05-25T04:35:00+02:00,2025-05-25,12:35,8,27,35
6,2025-05-25T04:38:00+02:00,2025-05-25,12:38,10,15,25
8,2025-05-25T04:26:00+02:00,2025-05-25,12:26,0,2,2
8,2025-05-25T04:27:00+02:00,2025-05-25,12:27,6,4,10
8,2025-05-25T04:28:00+02:00,2025-05-25,12:28,3,7,10
8,2025-05-25T04:34:00+02:00,2025-05-25,12:34,1,4,5
28,2025-05-25T04:33:00+02:00,2025-05-25,12:33,3,9,12
28,2025-05-25T04:36:00+02:00,2025-05-25,12:36,10,9,19
28,2025-05-25T04:38:00+02:00,2025-05-25,12:38,18,11,29
29,2025-05-25T04:27:00+02:00,2025-05-25,12:27,8,3,11
29,2025-05-25T04:33:00+02:00,2025-05-25,12:33,11,10,21
29,2025-05-25T04:37:00+02:00,2025-05-25,12:37,12,6,18
31,2025-05-25T04:29:00+02:00,2025-05-25,12:29,10,3,13
31,2025-05-25T04:30:00+02:00,2025-05-25,12:30,1,3,4
31,2025-05-25T04:36:00+02:00,2025-05-25,12:36,0,2,2
31,2025-05-25T04:38:00+02:00,2025-05-25,12:38,3,2,5
36,2025-05-25T04:25:00+02:00,2025-05-25,12:25,1,4,5
36,2025-05-25T04:26:00+02:00,2025-05-25,12:26,3,0,3
36,2025-05-25T04:38:00+02:00,2025-05-25,12:38,2,1,3
37,2025-05-25T04:25:00+02:00,2025-05-25,12:25,0,2,2
37,2025-05-25T04:29:00+02:00,2025-05-25,12:29,1,0,1
39,2025-05-25T04:29:00+02:00,2025-05-25,12:29,2,1,3
39,2025-05-25T04:33:00+02:00,2025-05-25,12:33,1,0,1
39,2025-05-25T04:34:00+02:00,2025-05-25,12:34,0,2,2
39,2025-05-25T04:38:00+02:00,2025-05-25,12:38,2,0,2
40,2025-05-25T04:25:00+02:00,2025-05-25,12:25,2,7,9
40,2025-05-25T04:30:00+02:00,2025-05-25,12:30,2,4,6
40,2025-05-25T04:32:00+02:00,2025-05-25,12:32,0,4,4
40,2025-05-25T04:33:00+02:00,2025-05-25,12:33,10,9,19
40,2025-05-25T04:36:00+02:00,2025-05-25,12:36,5,0,5
40,2025-05-25T04:37:00+02:00,2025-05-25,12:37,0,18,18
40,2025-05-25T04:39:00+02:00,2025-05-25,12:39,6,5,11
41,2025-05-25T04:27:00+02:00,2025-05-25,12:27,6,6,12
41,2025-05-25T04:30:00+02:00,2025-05-25,12:30,3,2,5
41,2025-05-25T04:31:00+02:00,2025-05-25,12:31,5,6,11
41,2025-05-25T04:36:00+02:00,2025-05-25,12:36,13,2,15
41,2025-05-25T04:39:00+02:00,2025-05-25,12:39,4,4,8
43,2025-05-25T04:25:00+02:00,2025-05-25,12:25,5,8,13
43,2025-05-25T04:35:00+02:00,2025-05-25,12:35,4,2,6
44,2025-05-25T04:30:00+02:00,2025-05-25,12:30,1,4,5
45,2025-05-25T04:27:00+02:00,2025-05-25,12:27,12,13,25
45,2025-05-25T04:29:00+02:00,2025-05-25,12:29,9,14,23
45,2025-05-25T04:30:00+02:00,2025-05-25,12:30,23,21,44
45,2025-05-25T04:31:00+02:00,2025-05-25,12:31,26,24,50
45,2025-05-25T04:32:00+02:00,2025-05-25,12:32,20,7,27
45,2025-05-25T04:36:00+02:00,2025-05-25,12:36,18,15,33
45,2025-05-25T04:37:00+02:00,2025-05-25,12:37,14,22,36
47,2025-05-25T04:27:00+02:00,2025-05-25,12:27,7,25,32
47,2025-05-25T04:34:00+02:00,2025-05-25,12:34,10,18,28
50,2025-05-25T04:29:00+02:00,2025-05-25,12:29,1,10,11
50,2025-05-25T04:31:00+02:00,2025-05-25,12:31,4,5,9
50,2025-05-25T04:34:00+02:00,2025-05-25,12:34,8,4,12
50,2025-05-25T04:37:00+02:00,2025-05-25,12:37,5,5,10
54,2025-05-25T04:26:00+02:00,2025-05-25,12:26,3,2,5
54,2025-05-25T04:29:00+02:00,2025-05-25,12:29,2,0,2
54,2025-05-25T04:33:00+02:00,2025-05-25,12:33,1,2,3
54,2025-05-25T04:34:00+02:00,2025-05-25,12:34,1,0,1
54,2025-05-25T04:37:00+02:00,2025-05-25,12:37,4,1,5
59,2025-05-25T04:35:00+02:00,2025-05-25,12:35,26,13,39
61,2025-05-25T04:25:00+02:00,2025-05-25,12:25,7,10,17
61,2025-05-25T04:27:00+02:00,2025-05-25,12:27,6,19,25
61,2025-05-25T04:29:00+02:00,2025-05-25,12:29,9,3,12
61,2025-05-25T04:30:00+02:00,2025-05-25,12:30,5,10,15
61,2025-05-25T04:32:00+02:00,2025-05-25,12:32,15,3,18
61,2025-05-25T04:35:00+02:00,2025-05-25,12:35,14,11,25
66,2025-05-25T04:25:00+02:00,2025-05-25,12:25,25,4,29
66,2025-05-25T04:28:00+02:00,2025-05-25,12:28,13,16,29
66,2025-05-25T04:33:00+02:00,2025-05-25,12:33,9,29,38
66,2025-05-25T04:34:00+02:00,2025-05-25,12:34,18,16,34
69,2025-05-25T04:32:00+02:00,2025-05-25,12:32,9,6,15
69,2025-05-25T04:33:00+02:00,2025-05-25,12:33,12,4,16
69,2025-05-25T04:35:00+02:00,2025-05-25,12:35,6,6,12
69,2025-05-25T04:36:00+02:00,2025-05-25,12:36,2,1,3
69,2025-05-25T04:37:00+02:00,2025-05-25,12:37,5,0,5
70,2025-05-25T04:25:00+02:00,2025-05-25,12:25,3,3,6
70,2025-05-25T04:27:00+02:00,2025-05-25,12:27,1,2,3
70,2025-05-25T04:32:00+02:00,2025-05-25,12:32,1,3,4
70,2025-05-25T04:33:00+02:00,2025-05-25,12:33,5,1,6
70,2025-05-25T04:34:00+02:00,2025-05-25,12:34,1,0,1
75,2025-05-25T04:27:00+02:00,2025-05-25,12:27,0,1,1
75,2025-05-25T04:28:00+02:00,2025-05-25,12:28,1,1,2
75,2025-05-25T04:31:00+02:00,2025-05-25,12:31,3,3,6
77,2025-05-25T04:30:00+02:00,2025-05-25,12:30,28,15,43
78,2025-05-25T04:28:00+02:00,2025-05-25,12:28,0,1,1
78,2025-05-25T04:31:00+02:00,2025-05-25,12:31,2,1,3
78,2025-05-25T04:32:00+02:00,2025-05-25,12:32,1,1,2
78,2025-05-25T04:34:00+02:00,2025-05-25,12:34,0,2,2
78,2025-05-25T04:35:00+02:00,2025-05-25,12:35,3,0,3
84,2025-05-25T04:25:00+02:00,2025-05-25,12:25,71,72,143
84,2025-05-25T04:35:00+02:00,2025-05-25,12:35,80,75,155
87,2025-05-25T04:28:00+02:00,2025-05-25,12:28,3,1,4
87,2025-05-25T04:29:00+02:00,2025-05-25,12:29,3,2,5
87,2025-05-25T04:34:00+02:00,2025-05-25,12:34,5,0,5
87,2025-05-25T04:35:00+02:00,2025-05-25,12:35,1,1,2
107,2025-05-25T04:25:00+02:00,2025-05-25,12:25,10,7,17
107,2025-05-25T04:35:00+02:00,2025-05-25,12:35,5,12,17
108,2025-05-25T04:29:00+02:00,2025-05-25,12:29,1,4,5
108,2025-05-25T04:30:00+02:00,2025-05-25,12:30,1,0,1
108,2025-05-25T04:33:00+02:00,2025-05-25,12:33,5,2,7
108,2025-05-25T04:37:00+02:00,2025-05-25,12:37,5,1,6
118,2025-05-25T04:30:00+02:00,2025-05-25,12:30,1,5,6
132,2025-05-25T04:25:00+02:00,2025-05-25,12:25,19,8,27
133,2025-05-25T04:25:00+02:00,2025-05-25,12:25,50,36,86
134,2025-05-25T04:25:00+02:00,2025-05-25,12:25,40,35,75
135,2025-05-25T04:25:00+02:00,2025-05-25,12:25,40,42,82
140,2025-05-25T04:30:00+02:00,2025-05-25,12:30,10,4,14
140,2025-05-25T04:35:00+02:00,2025-05-25,12:35,21,3,24
162,2025-05-25T04:35:00+02:00,2025-05-25,12:35,61,99,160
166,2025-05-25T04:35:00+02:00,2025-05-25,12:35,3,3,6
167,2025-05-25T04:30:00+02:00,2025-05-25,12:30,0,3,3
1,2025-05-25T04:27:00+02:00,2025-05-25,12:27,32,16,48
1,2025-05-25T04:31:00+02:00,2025-05-25,12:31,20,25,45
1,2025-05-25T04:39:00+02:00,2025-05-25,12:39,35,17,52
2,2025-05-25T04:25:00+02:00,2025-05-25,12:25,8,15,23
2,2025-05-25T04:31:00+02:00,2025-05-25,12:31,14,4,18
2,2025-05-25T04:32:00+02:00,2025-05-25,12:32,5,5,10
2,2025-05-25T04:34:00+02:00,2025-05-25,12:34,14,6,20
2,2025-05-25T04:37:00+02:00,2025-05-25,12:37,8,11,19
9,2025-05-25T04:31:00+02:00,2025-05-25,12:31,2,2,4
9,2025-05-25T04:32:00+02:00,2025-05-25,12:32,1,0,1
9,2025-05-25T04:34:00+02:00,2025-05-25,12:34,1,2,3
9,2025-05-25T04:37:00+02:00,2025-05-25,12:37,3,1,4
9,2025-05-25T04:38:00+02:00,2025-05-25,12:38,1,0,1
9,2025-05-25T04:39:00+02:00,2025-05-25,12:39,0,2,2
10,2025-05-25T04:37:00+02:00,2025-05-25,12:37,0,1,1
11,2025-05-25T04:25:00+02:00,2025-05-25,12:25,4,4,8
11,2025-05-25T04:27:00+02:00,2025-05-25,12:27,4,0,4
11,2025-05-25T04:28:00+02:00,2025-05-25,12:28,0,1,1
11,2025-05-25T04:29:00+02:00,2025-05-25,12:29,0,4,4
11,2025-05-25T04:35:00+02:00,2025-05-25,12:35,7,7,14
12,2025-05-25T04:25:00+02:00,2025-05-25,12:25,1,0,1
12,2025-05-25T04:30:00+02:00,2025-05-25,12:30,2,3,5
12,2025-05-25T04:33:00+02:00,2025-05-25,12:33,5,3,8
12,2025-05-25T04:34:00+02:00,2025-05-25,12:34,7,0,7
12,2025-05-25T04:37:00+02:00,2025-05-25,12:37,1,1,2
17,2025-05-25T04:27:00+02:00,2025-05-25,12:27,2,1,3
17,2025-05-25T04:28:00+02:00,2025-05-25,12:28,2,4,6
17,2025-05-25T04:37:00+02:00,2025-05-25,12:37,1,4,5
17,2025-05-25T04:39:00+02:00,2025-05-25,12:39,3,0,3
18,2025-05-25T04:27:00+02:00,2025-05-25,12:27,7,0,7
18,2025-05-25T04:34:00+02:00,2025-05-25,12:34,1,0,1
18,2025-05-25T04:36:00+02:00,2025-05-25,12:36,0,2,2
19,2025-05-25T04:38:00+02:00,2025-05-25,12:38,6,9,15
20,2025-05-25T04:26:00+02:00,2025-05-25,12:26,0,5,5
20,2025-05-25T04:32:00+02:00,2025-05-25,12:32,2,6,8
20,2025-05-25T04:34:00+02:00,2025-05-25,12:34,1,1,2
20,2025-05-25T04:39:00+02:00,2025-05-25,12:39,6,9,15
23,2025-05-25T04:29:00+02:00,2025-05-25,12:29,1,3,4
23,2025-05-25T04:31:00+02:00,2025-05-25,12:31,3,7,10
23,2025-05-25T04:32:00+02:00,2025-05-25,12:32,4,1,5
24,2025-05-25T04:30:00+02:00,2025-05-25,12:30,8,11,19
24,2025-05-25T04:34:00+02:00,2025-05-25,12:34,18,3,21
24,2025-05-25T04:39:00+02:00,2025-05-25,12:39,13,22,35
25,2025-05-25T04:25:00+02:00,2025-05-25,12:25,67,40,107
27,2025-05-25T04:25:00+02:00,2025-05-25,12:25,9,3,12
27,2025-05-25T04:30:00+02:00,2025-05-25,12:30,10,7,17
27,2025-05-25T04:32:00+02:00,2025-05-25,12:32,2,2,4
27,2025-05-25T04:33:00+02:00,2025-05-25,12:33,9,4,13
27,2025-05-25T04:34:00+02:00,2025-05-25,12:34,1,5,6
30,2025-05-25T04:25:00+02:00,2025-05-25,12:25,5,13,18
30,2025-05-25T04:26:00+02:00,2025-05-25,12:26,3,4,7
30,2025-05-25T04:39:00+02:00,2025-05-25,12:39,7,9,16
35,2025-05-25T04:25:00+02:00,2025-05-25,12:25,26,21,47
35,2025-05-25T04:29:00+02:00,2025-05-25,12:29,14,34,48
35,2025-05-25T04:37:00+02:00,2025-05-25,12:37,23,27,50
46,2025-05-25T04:30:00+02:00,2025-05-25,12:30,3,4,7
46,2025-05-25T04:35:00+02:00,2025-05-25,12:35,4,2,6
48,2025-05-25T04:25:00+02:00,2025-05-25,12:25,11,0,11
48,2025-05-25T04:26:00+02:00,2025-05-25,12:26,7,6,13
48,2025-05-25T04:31:00+02:00,2025-05-25,12:31,2,14,16
48,2025-05-25T04:33:00+02:00,2025-05-25,12:33,9,1,10
48,2025-05-25T04:34:00+02:00,2025-05-25,12:34,8,16,24
48,2025-05-25T04:35:00+02:00,2025-05-25,12:35,9,0,9
48,2025-05-25T04:36:00+02:00,2025-05-25,12:36,7,10,17
48,2025-05-25T04:38:00+02:00,2025-05-25,12:38,14,18,32
48,2025-05-25T04:39:00+02:00,2025-05-25,12:39,16,2,18
49,2025-05-25T04:27:00+02:00,2025-05-25,12:27,8,5,13
49,2025-05-25T04:30:00+02:00,2025-05-25,12:30,9,9,18
49,2025-05-25T04:31:00+02:00,2025-05-25,12:31,5,13,18
49,2025-05-25T04:36:00+02:00,2025-05-25,12:36,7,12,19
49,2025-05-25T04:37:00+02:00,2025-05-25,12:37,15,9,24
49,2025-05-25T04:39:00+02:00,2025-05-25,12:39,15,12,27
51,2025-05-25T04:26:00+02:00,2025-05-25,12:26,5,1,6
51,2025-05-25T04:34:00+02:00,2025-05-25,12:34,3,1,4
51,2025-05-25T04:36:00+02:00,2025-05-25,12:36,6,0,6
52,2025-05-25T04:26:00+02:00,2025-05-25,12:26,4,3,7
52,2025-05-25T04:27:00+02:00,2025-05-25,12:27,4,3,7
52,2025-05-25T04:29:00+02:00,2025-05-25,12:29,4,6,10
52,2025-05-25T04:30:00+02:00,2025-05-25,12:30,5,2,7
52,2025-05-25T04:35:00+02:00,2025-05-25,12:35,3,11,14
52,2025-05-25T04:36:00+02:00,2025-05-25,12:36,2,2,4
53,2025-05-25T04:27:00+02:00,2025-05-25,12:27,23,7,30
53,2025-05-25T04:28:00+02:00,2025-05-25,12:28,23,6,29
53,2025-05-25T04:29:00+02:00,2025-05-25,12:29,10,9,19
53,2025-05-25T04:33:00+02:00,2025-05-25,12:33,14,4,18
53,2025-05-25T04:34:00+02:00,2025-05-25,12:34,7,6,13
53,2025-05-25T04:37:00+02:00,2025-05-25,12:37,9,6,15
56,2025-05-25T04:27:00+02:00,2025-05-25,12:27,11,2,13
56,2025-05-25T04:29:00+02:00,2025-05-25,12:29,3,4,7
56,2025-05-25T04:32:00+02:00,2025-05-25,12:32,1,5,6
56,2025-05-25T04:35:00+02:00,2025-05-25,12:35,7,5,12
56,2025-05-25T04:36:00+02:00,2025-05-25,12:36,8,3,11
58,2025-05-25T04:25:00+02:00,2025-05-25,12:25,11,6,17
58,2025-05-25T04:30:00+02:00,2025-05-25,12:30,14,3,17
58,2025-05-25T04:31:00+02:00,2025-05-25,12:31,5,5,10
58,2025-05-25T04:32:00+02:00,2025-05-25,12:32,15,1,16
58,2025-05-25T04:37:00+02:00,2025-05-25,12:37,8,5,13
62,2025-05-25T04:25:00+02:00,2025-05-25,12:25,5,4,9
62,2025-05-25T04:26:00+02:00,2025-05-25,12:26,2,3,5
62,2025-05-25T04:27:00+02:00,2025-05-25,12:27,2,2,4
62,2025-05-25T04:28:00+02:00,2025-05-25,12:28,6,0,6
62,2025-05-25T04:31:00+02:00,2025-05-25,12:31,3,2,5
62,2025-05-25T04:33:00+02:00,2025-05-25,12:33,7,1,8
62,2025-05-25T04:34:00+02:00,2025-05-25,12:34,0,3,3
62,2025-05-25T04:36:00+02:00,2025-05-25,12:36,0,5,5
63,2025-05-25T04:26:00+02:00,2025-05-25,12:26,5,0,5
63,2025-05-25T04:28:00+02:00,2025-05-25,12:28,13,6,19
63,2025-05-25T04:30:00+02:00,2025-05-25,12:30,4,5,9
63,2025-05-25T04:33:00+02:00,2025-05-25,12:33,7,0,7
63,2025-05-25T04:34:00+02:00,2025-05-25,12:34,1,0,1
63,2025-05-25T04:36:00+02:00,2025-05-25,12:36,8,4,12
63,2025-05-25T04:39:00+02:00,2025-05-25,12:39,3,4,7
67,2025-05-25T04:25:00+02:00,2025-05-25,12:25,15,4,19
67,2025-05-25T04:26:00+02:00,2025-05-25,12:26,3,13,16
67,2025-05-25T04:29:00+02:00,2025-05-25,12:29,5,8,13
67,2025-05-25T04:32:00+02:00,2025-05-25,12:32,5,9,14
67,2025-05-25T04:33:00+02:00,2025-05-25,12:33,6,9,15
67,2025-05-25T04:35:00+02:00,2025-05-25,12:35,11,3,14
68,2025-05-25T04:25:00+02:00,2025-05-25,12:25,7,11,18
68,2025-05-25T04:27:00+02:00,2025-05-25,12:27,9,3,12
68,2025-05-25T04:31:00+02:00,2025-05-25,12:31,8,2,10
68,2025-05-25T04:39:00+02:00,2025-05-25,12:39,6,12,18
72,2025-05-25T04:28:00+02:00,2025-05-25,12:28,3,6,9
72,2025-05-25T04:29:00+02:00,2025-05-25,12:29,15,7,22
72,2025-05-25T04:36:00+02:00,2025-05-25,12:36,7,10,17
72,2025-05-25T04:39:00+02:00,2025-05-25,12:39,6,6,12
76,2025-05-25T04:30:00+02:00,2025-05-25,12:30,3,2,5
76,2025-05-25T04:32:00+02:00,2025-05-25,12:32,5,1,6
76,2025-05-25T04:33:00+02:00,2025-05-25,12:33,0,2,2
79,2025-05-25T04:25:00+02:00,2025-05-25,12:25,14,9,23
79,2025-05-25T04:27:00+02:00,2025-05-25,12:27,9,6,15
79,2025-05-25T04:31:00+02:00,2025-05-25,12:31,20,6,26
79,2025-05-25T04:32:00+02:00,2025-05-25,12:32,17,5,22
79,2025-05-25T04:36:00+02:00,2025-05-25,12:36,16,3,19
79,2025-05-25T04:38:00+02:00,2025-05-25,12:38,2,7,9
79,2025-05-25T04:39:00+02:00,2025-05-25,12:39,18,3,21
85,2025-05-25T04:26:00+02:00,2025-05-25,12:26,4,0,4
85,2025-05-25T04:31:00+02:00,2025-05-25,12:31,1,1,2
85,2025-05-25T04:32:00+02:00,2025-05-25,12:32,1,2,3
85,2025-05-25T04:37:00+02:00,2025-05-25,12:37,3,0,3
85,2025-05-25T04:39:00+02:00,2025-05-25,12:39,0,1,1
86,2025-05-25T04:25:00+02:00,2025-05-25,12:25,0,3,3
86,2025-05-25T04:30:00+02:00,2025-05-25,12:30,1,0,1
86,2025-05-25T04:32:00+02:00,2025-05-25,12:32,0,1,1
86,2025-05-25T04:34:00+02:00,2025-05-25,12:34,4,0,4
86,2025-05-25T04:35:00+02:00,2025-05-25,12:35,1,0,1
109,2025-05-25T04:25:00+02:00,2025-05-25,12:25,4,7,11
109,2025-05-25T04:35:00+02:00,2025-05-25,12:35,2,5,7
130,2025-05-25T04:35:00+02:00,2025-05-25,12:35,11,6,17
136,2025-05-25T04:25:00+02:00,2025-05-25,12:25,50,3,53
136,2025-05-25T04:30:00+02:00,2025-05-25,12:30,20,5,25
137,2025-05-25T04:25:00+02:00,2025-05-25,12:25,0,2,2
139,2025-05-25T04:35:00+02:00,2025-05-25,12:35,4,5,9
141,2025-05-25T04:35:00+02:00,2025-05-25,12:35,12,19,31
161,2025-05-25T04:30:00+02:00,2025-05-25,12:30,40,8,48
181,2025-05-25T04:25:00+02:00,2025-05-25,12:25,5,16,21
181,2025-05-25T04:26:00+02:00,2025-05-25,12:26,16,6,22
181,2025-05-25T04:29:00+02:00,2025-05-25,12:29,3,18,21
181,2025-05-25T04:32:00+02:00,2025-05-25,12:32,17,24,41
181,2025-05-25T04:33:00+02:00,2025-05-25,12:33,11,19,30
181,2025-05-25T04:34:00+02:00,2025-05-25,12:34,2,14,16
182,2025-05-25T04:25:00+02:00,2025-05-25,12:25,17,18,35
182,2025-05-25T04:30:00+02:00,2025-05-25,12:30,15,14,29
180,2025-05-25T04:37:00+02:00,2025-05-25,12:37,0,1,1
3,2025-05-24T17:10:00+02:00,2025-05-25,01:10,0,9,9
3,2025-05-24T17:13:00+02:00,2025-05-25,01:13,6,0,6
3,2025-05-24T17:14:00+02:00,2025-05-25,01:14,2,12,14
3,2025-05-24T17:19:00+02:00,2025-05-25,01:19,8,1,9
3,2025-05-24T17:20:00+02:00,2025-05-25,01:20,10,3,13
3,2025-05-24T17:21:00+02:00,2025-05-25,01:21,4,2,6
4,2025-05-24T17:10:00+02:00,2025-05-25,01:10,5,2,7
4,2025-05-24T17:11:00+02:00,2025-05-25,01:11,0,15,15
4,2025-05-24T17:15:00+02:00,2025-05-25,01:15,0,1,1
4,2025-05-24T17:17:00+02:00,2025-05-25,01:17,5,7,12
4,2025-05-24T17:20:00+02:00,2025-05-25,01:20,0,1,1
4,2025-05-24T17:24:00+02:00,2025-05-25,01:24,15,5,20
5,2025-05-24T17:15:00+02:00,2025-05-25,01:15,3,6,9
6,2025-05-24T17:10:00+02:00,2025-05-25,01:10,11,3,14
6,2025-05-24T17:11:00+02:00,2025-05-25,01:11,3,1,4
6,2025-05-24T17:15:00+02:00,2025-05-25,01:15,3,0,3
6,2025-05-24T17:16:00+02:00,2025-05-25,01:16,6,2,8
6,2025-05-24T17:17:00+02:00,2025-05-25,01:17,8,1,9
6,2025-05-24T17:18:00+02:00,2025-05-25,01:18,4,0,4
28,2025-05-24T17:14:00+02:00,2025-05-25,01:14,2,0,2
28,2025-05-24T17:18:00+02:00,2025-05-25,01:18,1,0,1
29,2025-05-24T17:14:00+02:00,2025-05-25,01:14,0,2,2
29,2025-05-24T17:20:00+02:00,2025-05-25,01:20,3,2,5
29,2025-05-24T17:21:00+02:00,2025-05-25,01:21,0,3,3
29,2025-05-24T17:23:00+02:00,2025-05-25,01:23,0,2,2
31,2025-05-24T17:18:00+02:00,2025-05-25,01:18,0,2,2
31,2025-05-24T17:21:00+02:00,2025-05-25,01:21,0,1,1
36,2025-05-24T17:12:00+02:00,2025-05-25,01:12,4,1,5
36,2025-05-24T17:14:00+02:00,2025-05-25,01:14,11,8,19
36,2025-05-24T17:18:00+02:00,2025-05-25,01:18,4,5,9
36,2025-05-24T17:20:00+02:00,2025-05-25,01:20,2,8,10
37,2025-05-24T17:17:00+02:00,2025-05-25,01:17,2,0,2
37,2025-05-24T17:19:00+02:00,2025-05-25,01:19,0,3,3
37,2025-05-24T17:24:00+02:00,2025-05-25,01:24,1,0,1
40,2025-05-24T17:21:00+02:00,2025-05-25,01:21,1,0,1
41,2025-05-24T17:11:00+02:00,2025-05-25,01:11,0,3,3
41,2025-05-24T17:13:00+02:00,2025-05-25,01:13,1,7,8
41,2025-05-24T17:15:00+02:00,2025-05-25,01:15,0,3,3
41,2025-05-24T17:22:00+02:00,2025-05-25,01:22,1,5,6
43,2025-05-24T17:15:00+02:00,2025-05-25,01:15,1,1,2
45,2025-05-24T17:16:00+02:00,2025-05-25,01:16,0,1,1
45,2025-05-24T17:17:00+02:00,2025-05-25,01:17,0,5,5
45,2025-05-24T17:21:00+02:00,2025-05-25,01:21,2,2,4
47,2025-05-24T17:19:00+02:00,2025-05-25,01:19,3,1,4
47,2025-05-24T17:23:00+02:00,2025-05-25,01:23,0,7,7
50,2025-05-24T17:20:00+02:00,2025-05-25,01:20,2,0,2
54,2025-05-24T17:19:00+02:00,2025-05-25,01:19,0,2,2
54,2025-05-24T17:20:00+02:00,2025-05-25,01:20,2,0,2
59,2025-05-24T17:10:00+02:00,2025-05-25,01:10,4,4,8
59,2025-05-24T17:20:00+02:00,2025-05-25,01:20,9,10,19
61,2025-05-24T17:13:00+02:00,2025-05-25,01:13,1,0,1
61,2025-05-24T17:16:00+02:00,2025-05-25,01:16,1,1,2
61,2025-05-24T17:19:00+02:00,2025-05-25,01:19,2,0,2
61,2025-05-24T17:23:00+02:00,2025-05-25,01:23,2,0,2
66,2025-05-24T17:10:00+02:00,2025-05-25,01:10,0,2,2
66,2025-05-24T17:11:00+02:00,2025-05-25,01:11,0,3,3
66,2025-05-24T17:16:00+02:00,2025-05-25,01:16,2,4,6
66,2025-05-24T17:21:00+02:00,2025-05-25,01:21,5,0,5
69,2025-05-24T17:19:00+02:00,2025-05-25,01:19,0,5,5
70,2025-05-24T17:14:00+02:00,2025-05-25,01:14,0,2,2
75,2025-05-24T17:16:00+02:00,2025-05-25,01:16,0,2,2
84,2025-05-24T17:10:00+02:00,2025-05-25,01:10,15,13,28
84,2025-05-24T17:20:00+02:00,2025-05-25,01:20,10,10,20
107,2025-05-24T17:10:00+02:00,2025-05-25,01:10,0,2,2
132,2025-05-24T17:20:00+02:00,2025-05-25,01:20,5,3,8
135,2025-05-24T17:10:00+02:00,2025-05-25,01:10,2,5,7
162,2025-05-24T17:15:00+02:00,2025-05-25,01:15,2,1,3
165,2025-05-24T17:20:00+02:00,2025-05-25,01:20,3,0,3
1,2025-05-24T17:10:00+02:00,2025-05-25,01:10,2,2,4
1,2025-05-24T17:24:00+02:00,2025-05-25,01:24,1,1,2
2,2025-05-24T17:18:00+02:00,2025-05-25,01:18,0,6,6
2,2025-05-24T17:21:00+02:00,2025-05-25,01:21,1,0,1
2,2025-05-24T17:23:00+02:00,2025-05-25,01:23,0,5,5
9,2025-05-24T17:14:00+02:00,2025-05-25,01:14,1,0,1
9,2025-05-24T17:19:00+02:00,2025-05-25,01:19,1,0,1
11,2025-05-24T17:12:00+02:00,2025-05-25,01:12,0,3,3
17,2025-05-24T17:10:00+02:00,2025-05-25,01:10,0,2,2
17,2025-05-24T17:11:00+02:00,2025-05-25,01:11,2,0,2
17,2025-05-24T17:15:00+02:00,2025-05-25,01:15,2,0,2
18,2025-05-24T17:12:00+02:00,2025-05-25,01:12,2,0,2
19,2025-05-24T17:11:00+02:00,2025-05-25,01:11,4,4,8
19,2025-05-24T17:13:00+02:00,2025-05-25,01:13,1,1,2
19,2025-05-24T17:15:00+02:00,2025-05-25,01:15,2,12,14
19,2025-05-24T17:18:00+02:00,2025-05-25,01:18,3,4,7
19,2025-05-24T17:21:00+02:00,2025-05-25,01:21,2,5,7
20,2025-05-24T17:11:00+02:00,2025-05-25,01:11,3,8,11
20,2025-05-24T17:14:00+02:00,2025-05-25,01:14,4,9,13
20,2025-05-24T17:18:00+02:00,2025-05-25,01:18,1,1,2
20,2025-05-24T17:19:00+02:00,2025-05-25,01:19,4,0,4
23,2025-05-24T17:10:00+02:00,2025-05-25,01:10,0,2,2
23,2025-05-24T17:11:00+02:00,2025-05-25,01:11,0,1,1
23,2025-05-24T17:14:00+02:00,2025-05-25,01:14,4,0,4
23,2025-05-24T17:18:00+02:00,2025-05-25,01:18,1,0,1
23,2025-05-24T17:19:00+02:00,2025-05-25,01:19,0,5,5
23,2025-05-24T17:24:00+02:00,2025-05-25,01:24,0,1,1
24,2025-05-24T17:12:00+02:00,2025-05-25,01:12,4,0,4
24,2025-05-24T17:15:00+02:00,2025-05-25,01:15,1,0,1
24,2025-05-24T17:16:00+02:00,2025-05-25,01:16,0,4,4
24,2025-05-24T17:22:00+02:00,2025-05-25,01:22,2,1,3
25,2025-05-24T17:15:00+02:00,2025-05-25,01:15,0,4,4
27,2025-05-24T17:12:00+02:00,2025-05-25,01:12,0,1,1
27,2025-05-24T17:14:00+02:00,2025-05-25,01:14,1,0,1
27,2025-05-24T17:16:00+02:00,2025-05-25,01:16,1,0,1
30,2025-05-24T17:17:00+02:00,2025-05-25,01:17,7,3,10
30,2025-05-24T17:18:00+02:00,2025-05-25,01:18,5,2,7
30,2025-05-24T17:19:00+02:00,2025-05-25,01:19,6,5,11
30,2025-05-24T17:23:00+02:00,2025-05-25,01:23,1,4,5
30,2025-05-24T17:24:00+02:00,2025-05-25,01:24,3,8,11
35,2025-05-24T17:10:00+02:00,2025-05-25,01:10,3,1,4
35,2025-05-24T17:14:00+02:00,2025-05-25,01:14,1,3,4
35,2025-05-24T17:15:00+02:00,2025-05-25,01:15,2,1,3
35,2025-05-24T17:16:00+02:00,2025-05-25,01:16,11,0,11
35,2025-05-24T17:17:00+02:00,2025-05-25,01:17,1,0,1
35,2025-05-24T17:18:00+02:00,2025-05-25,01:18,0,1,1
35,2025-05-24T17:21:00+02:00,2025-05-25,01:21,0,3,3
35,2025-05-24T17:23:00+02:00,2025-05-25,01:23,0,6,6
35,2025-05-24T17:24:00+02:00,2025-05-25,01:24,0,5,5
49,2025-05-24T17:11:00+02:00,2025-05-25,01:11,2,0,2
49,2025-05-24T17:13:00+02:00,2025-05-25,01:13,0,1,1
49,2025-05-24T17:14:00+02:00,2025-05-25,01:14,7,0,7
49,2025-05-24T17:15:00+02:00,2025-05-25,01:15,2,1,3
49,2025-05-24T17:20:00+02:00,2025-05-25,01:20,8,3,11
49,2025-05-24T17:23:00+02:00,2025-05-25,01:23,1,0,1
51,2025-05-24T17:13:00+02:00,2025-05-25,01:13,1,3,4
52,2025-05-24T17:11:00+02:00,2025-05-25,01:11,4,5,9
52,2025-05-24T17:12:00+02:00,2025-05-25,01:12,4,1,5
52,2025-05-24T17:20:00+02:00,2025-05-25,01:20,0,5,5
52,2025-05-24T17:24:00+02:00,2025-05-25,01:24,6,5,11
53,2025-05-24T17:15:00+02:00,2025-05-25,01:15,0,1,1
56,2025-05-24T17:10:00+02:00,2025-05-25,01:10,5,0,5
56,2025-05-24T17:21:00+02:00,2025-05-25,01:21,2,1,3
56,2025-05-24T17:23:00+02:00,2025-05-25,01:23,0,2,2
56,2025-05-24T17:24:00+02:00,2025-05-25,01:24,0,2,2
58,2025-05-24T17:12:00+02:00,2025-05-25,01:12,5,0,5
58,2025-05-24T17:16:00+02:00,2025-05-25,01:16,0,2,2
58,2025-05-24T17:21:00+02:00,2025-05-25,01:21,0,1,1
58,2025-05-24T17:23:00+02:00,2025-05-25,01:23,0,4,4
62,2025-05-24T17:14:00+02:00,2025-05-25,01:14,3,0,3
62,2025-05-24T17:17:00+02:00,2025-05-25,01:17,3,0,3
62,2025-05-24T17:22:00+02:00,2025-05-25,01:22,0,1,1
62,2025-05-24T17:23:00+02:00,2025-05-25,01:23,0,1,1
62,2025-05-24T17:24:00+02:00,2025-05-25,01:24,1,0,1
63,2025-05-24T17:10:00+02:00,2025-05-25,01:10,0,3,3
63,2025-05-24T17:11:00+02:00,2025-05-25,01:11,0,1,1
63,2025-05-24T17:12:00+02:00,2025-05-25,01:12,0,2,2
63,2025-05-24T17:16:00+02:00,2025-05-25,01:16,0,3,3
63,2025-05-24T17:17:00+02:00,2025-05-25,01:17,0,1,1
63,2025-05-24T17:18:00+02:00,2025-05-25,01:18,0,1,1
63,2025-05-24T17:24:00+02:00,2025-05-25,01:24,0,2,2
67,2025-05-24T17:19:00+02:00,2025-05-25,01:19,1,0,1
72,2025-05-24T17:18:00+02:00,2025-05-25,01:18,0,1,1
72,2025-05-24T17:24:00+02:00,2025-05-25,01:24,3,0,3
79,2025-05-24T17:10:00+02:00,2025-05-25,01:10,1,0,1
79,2025-05-24T17:22:00+02:00,2025-05-25,01:22,1,0,1
79,2025-05-24T17:24:00+02:00,2025-05-25,01:24,2,5,7
109,2025-05-24T17:20:00+02:00,2025-05-25,01:20,0,3,3
117,2025-05-24T17:10:00+02:00,2025-05-25,01:10,4,0,4
117,2025-05-24T17:15:00+02:00,2025-05-25,01:15,6,2,8
117,2025-05-24T17:20:00+02:00,2025-05-25,01:20,0,1,1
181,2025-05-24T17:27:00+02:00,2025-05-25,01:27,0,2,2
181,2025-05-24T17:28:00+02:00,2025-05-25,01:28,1,0,1
182,2025-05-24T17:30:00+02:00,2025-05-25,01:30,13,3,16
182,2025-05-24T17:35:00+02:00,2025-05-25,01:35,6,8,14
3,2025-05-24T16:42:00+02:00,2025-05-25,00:42,0,17,17
3,2025-05-24T16:43:00+02:00,2025-05-25,00:43,4,13,17
3,2025-05-24T16:46:00+02:00,2025-05-25,00:46,7,9,16
3,2025-05-24T16:49:00+02:00,2025-05-25,00:49,9,4,13
4,2025-05-24T16:42:00+02:00,2025-05-25,00:42,7,0,7
4,2025-05-24T16:43:00+02:00,2025-05-25,00:43,4,1,5
4,2025-05-24T16:44:00+02:00,2025-05-25,00:44,4,4,8
4,2025-05-24T16:49:00+02:00,2025-05-25,00:49,2,6,8
6,2025-05-24T16:41:00+02:00,2025-05-25,00:41,11,2,13
6,2025-05-24T16:42:00+02:00,2025-05-25,00:42,9,2,11
6,2025-05-24T16:50:00+02:00,2025-05-25,00:50,3,2,5
6,2025-05-24T16:54:00+02:00,2025-05-25,00:54,1,4,5
28,2025-05-24T16:43:00+02:00,2025-05-25,00:43,1,0,1
28,2025-05-24T16:51:00+02:00,2025-05-25,00:51,1,0,1
28,2025-05-24T16:54:00+02:00,2025-05-25,00:54,1,0,1
29,2025-05-24T16:45:00+02:00,2025-05-25,00:45,0,3,3
29,2025-05-24T16:47:00+02:00,2025-05-25,00:47,1,5,6
29,2025-05-24T16:51:00+02:00,2025-05-25,00:51,0,14,14
31,2025-05-24T16:40:00+02:00,2025-05-25,00:40,1,2,3
31,2025-05-24T16:41:00+02:00,2025-05-25,00:41,7,1,8
31,2025-05-24T16:42:00+02:00,2025-05-25,00:42,2,3,5
31,2025-05-24T16:45:00+02:00,2025-05-25,00:45,0,1,1
31,2025-05-24T16:48:00+02:00,2025-05-25,00:48,0,2,2
31,2025-05-24T16:53:00+02:00,2025-05-25,00:53,0,2,2
36,2025-05-24T16:41:00+02:00,2025-05-25,00:41,1,1,2
36,2025-05-24T16:42:00+02:00,2025-05-25,00:42,4,1,5
36,2025-05-24T16:49:00+02:00,2025-05-25,00:49,0,1,1
36,2025-05-24T16:51:00+02:00,2025-05-25,00:51,3,6,9
36,2025-05-24T16:52:00+02:00,2025-05-25,00:52,0,1,1
37,2025-05-24T16:41:00+02:00,2025-05-25,00:41,3,0,3
37,2025-05-24T16:44:00+02:00,2025-05-25,00:44,0,1,1
37,2025-05-24T16:45:00+02:00,2025-05-25,00:45,2,0,2
37,2025-05-24T16:46:00+02:00,2025-05-25,00:46,2,0,2
40,2025-05-24T16:41:00+02:00,2025-05-25,00:41,0,1,1
40,2025-05-24T16:43:00+02:00,2025-05-25,00:43,2,0,2
40,2025-05-24T16:44:00+02:00,2025-05-25,00:44,2,0,2
40,2025-05-24T16:52:00+02:00,2025-05-25,00:52,0,1,1
41,2025-05-24T16:41:00+02:00,2025-05-25,00:41,2,5,7
41,2025-05-24T16:46:00+02:00,2025-05-25,00:46,2,2,4
45,2025-05-24T16:43:00+02:00,2025-05-25,00:43,7,2,9
45,2025-05-24T16:45:00+02:00,2025-05-25,00:45,4,3,7
45,2025-05-24T16:49:00+02:00,2025-05-25,00:49,2,2,4
45,2025-05-24T16:51:00+02:00,2025-05-25,00:51,1,3,4
45,2025-05-24T16:52:00+02:00,2025-05-25,00:52,1,10,11
45,2025-05-24T16:54:00+02:00,2025-05-25,00:54,0,3,3
47,2025-05-24T16:41:00+02:00,2025-05-25,00:41,2,3,5
47,2025-05-24T16:42:00+02:00,2025-05-25,00:42,4,1,5
47,2025-05-24T16:44:00+02:00,2025-05-25,00:44,0,3,3
47,2025-05-24T16:47:00+02:00,2025-05-25,00:47,2,5,7
47,2025-05-24T16:49:00+02:00,2025-05-25,00:49,2,2,4
47,2025-05-24T16:50:00+02:00,2025-05-25,00:50,1,4,5
50,2025-05-24T16:41:00+02:00,2025-05-25,00:41,5,0,5
50,2025-05-24T16:45:00+02:00,2025-05-25,00:45,1,0,1
54,2025-05-24T16:49:00+02:00,2025-05-25,00:49,0,4,4
54,2025-05-24T16:51:00+02:00,2025-05-25,00:51,0,2,2
54,2025-05-24T16:53:00+02:00,2025-05-25,00:53,0,2,2
61,2025-05-24T16:42:00+02:00,2025-05-25,00:42,1,3,4
61,2025-05-24T16:52:00+02:00,2025-05-25,00:52,0,1,1
66,2025-05-24T16:41:00+02:00,2025-05-25,00:41,4,11,15
66,2025-05-24T16:42:00+02:00,2025-05-25,00:42,5,11,16
66,2025-05-24T16:43:00+02:00,2025-05-25,00:43,0,4,4
66,2025-05-24T16:45:00+02:00,2025-05-25,00:45,9,13,22
66,2025-05-24T16:48:00+02:00,2025-05-25,00:48,4,6,10
66,2025-05-24T16:50:00+02:00,2025-05-25,00:50,4,0,4
66,2025-05-24T16:51:00+02:00,2025-05-25,00:51,1,8,9
66,2025-05-24T16:53:00+02:00,2025-05-25,00:53,5,6,11
75,2025-05-24T16:48:00+02:00,2025-05-25,00:48,1,0,1
78,2025-05-24T16:46:00+02:00,2025-05-25,00:46,1,0,1
84,2025-05-24T16:40:00+02:00,2025-05-25,00:40,9,27,36
84,2025-05-24T16:45:00+02:00,2025-05-25,00:45,14,17,31
84,2025-05-24T16:50:00+02:00,2025-05-25,00:50,3,3,6
87,2025-05-24T16:44:00+02:00,2025-05-25,00:44,5,0,5
108,2025-05-24T16:41:00+02:00,2025-05-25,00:41,1,1,2
108,2025-05-24T16:43:00+02:00,2025-05-25,00:43,4,0,4
108,2025-05-24T16:46:00+02:00,2025-05-25,00:46,0,2,2
108,2025-05-24T16:48:00+02:00,2025-05-25,00:48,1,2,3
131,2025-05-24T16:40:00+02:00,2025-05-25,00:40,5,8,13
132,2025-05-24T16:45:00+02:00,2025-05-25,00:45,8,0,8
133,2025-05-24T16:50:00+02:00,2025-05-25,00:50,4,2,6
134,2025-05-24T16:40:00+02:00,2025-05-25,00:40,12,6,18
135,2025-05-24T16:50:00+02:00,2025-05-25,00:50,2,1,3
167,2025-05-24T16:45:00+02:00,2025-05-25,00:45,2,0,2
1,2025-05-24T16:47:00+02:00,2025-05-25,00:47,0,1,1
2,2025-05-24T16:41:00+02:00,2025-05-25,00:41,0,2,2
2,2025-05-24T16:42:00+02:00,2025-05-25,00:42,0,6,6
2,2025-05-24T16:43:00+02:00,2025-05-25,00:43,0,1,1
2,2025-05-24T16:51:00+02:00,2025-05-25,00:51,0,2,2
9,2025-05-24T16:44:00+02:00,2025-05-25,00:44,9,0,9
9,2025-05-24T16:52:00+02:00,2025-05-25,00:52,1,0,1
9,2025-05-24T16:53:00+02:00,2025-05-25,00:53,1,0,1
12,2025-05-24T16:41:00+02:00,2025-05-25,00:41,1,0,1
17,2025-05-24T16:42:00+02:00,2025-05-25,00:42,0,1,1
17,2025-05-24T16:45:00+02:00,2025-05-25,00:45,1,0,1
17,2025-05-24T16:50:00+02:00,2025-05-25,00:50,1,0,1
19,2025-05-24T16:45:00+02:00,2025-05-25,00:45,3,0,3
19,2025-05-24T16:49:00+02:00,2025-05-25,00:49,0,12,12
19,2025-05-24T16:52:00+02:00,2025-05-25,00:52,4,1,5
19,2025-05-24T16:53:00+02:00,2025-05-25,00:53,5,6,11
20,2025-05-24T16:40:00+02:00,2025-05-25,00:40,2,3,5
20,2025-05-24T16:42:00+02:00,2025-05-25,00:42,1,1,2
20,2025-05-24T16:44:00+02:00,2025-05-25,00:44,7,6,13
20,2025-05-24T16:50:00+02:00,2025-05-25,00:50,2,5,7
24,2025-05-24T16:41:00+02:00,2025-05-25,00:41,1,4,5
24,2025-05-24T16:42:00+02:00,2025-05-25,00:42,5,1,6
24,2025-05-24T16:44:00+02:00,2025-05-25,00:44,0,1,1
24,2025-05-24T16:47:00+02:00,2025-05-25,00:47,0,1,1
24,2025-05-24T16:52:00+02:00,2025-05-25,00:52,3,1,4
27,2025-05-24T16:50:00+02:00,2025-05-25,00:50,1,0,1
30,2025-05-24T16:41:00+02:00,2025-05-25,00:41,4,20,24
30,2025-05-24T16:44:00+02:00,2025-05-25,00:44,4,17,21
30,2025-05-24T16:46:00+02:00,2025-05-25,00:46,10,15,25
30,2025-05-24T16:52:00+02:00,2025-05-25,00:52,0,10,10
30,2025-05-24T16:54:00+02:00,2025-05-25,00:54,2,3,5
35,2025-05-24T16:40:00+02:00,2025-05-25,00:40,6,4,10
35,2025-05-24T16:41:00+02:00,2025-05-25,00:41,5,1,6
35,2025-05-24T16:42:00+02:00,2025-05-25,00:42,1,2,3
35,2025-05-24T16:45:00+02:00,2025-05-25,00:45,6,0,6
35,2025-05-24T16:47:00+02:00,2025-05-25,00:47,2,8,10
35,2025-05-24T16:48:00+02:00,2025-05-25,00:48,0,4,4
35,2025-05-24T16:51:00+02:00,2025-05-25,00:51,0,4,4
49,2025-05-24T16:44:00+02:00,2025-05-25,00:44,0,2,2
49,2025-05-24T16:48:00+02:00,2025-05-25,00:48,1,0,1
49,2025-05-24T16:50:00+02:00,2025-05-25,00:50,1,2,3
49,2025-05-24T16:52:00+02:00,2025-05-25,00:52,0,1,1
49,2025-05-24T16:53:00+02:00,2025-05-25,00:53,4,2,6
49,2025-05-24T16:54:00+02:00,2025-05-25,00:54,2,1,3
51,2025-05-24T16:42:00+02:00,2025-05-25,00:42,0,1,1
51,2025-05-24T16:50:00+02:00,2025-05-25,00:50,1,0,1
52,2025-05-24T16:43:00+02:00,2025-05-25,00:43,3,0,3
52,2025-05-24T16:44:00+02:00,2025-05-25,00:44,2,0,2
52,2025-05-24T16:52:00+02:00,2025-05-25,00:52,2,4,6
53,2025-05-24T16:42:00+02:00,2025-05-25,00:42,0,4,4
53,2025-05-24T16:47:00+02:00,2025-05-25,00:47,3,0,3
53,2025-05-24T16:49:00+02:00,2025-05-25,00:49,3,2,5
53,2025-05-24T16:51:00+02:00,2025-05-25,00:51,8,2,10
53,2025-05-24T16:52:00+02:00,2025-05-25,00:52,0,1,1
53,2025-05-24T16:54:00+02:00,2025-05-25,00:54,0,1,1
56,2025-05-24T16:52:00+02:00,2025-05-25,00:52,4,3,7
56,2025-05-24T16:54:00+02:00,2025-05-25,00:54,0,2,2
58,2025-05-24T16:43:00+02:00,2025-05-25,00:43,2,5,7
58,2025-05-24T16:48:00+02:00,2025-05-25,00:48,3,5,8
62,2025-05-24T16:41:00+02:00,2025-05-25,00:41,0,1,1
62,2025-05-24T16:42:00+02:00,2025-05-25,00:42,11,0,11
62,2025-05-24T16:43:00+02:00,2025-05-25,00:43,2,0,2
62,2025-05-24T16:45:00+02:00,2025-05-25,00:45,0,3,3
62,2025-05-24T16:53:00+02:00,2025-05-25,00:53,1,0,1
67,2025-05-24T16:40:00+02:00,2025-05-25,00:40,2,1,3
67,2025-05-24T16:51:00+02:00,2025-05-25,00:51,2,1,3
72,2025-05-24T16:42:00+02:00,2025-05-25,00:42,0,1,1
72,2025-05-24T16:50:00+02:00,2025-05-25,00:50,0,4,4
79,2025-05-24T16:41:00+02:00,2025-05-25,00:41,0,1,1
79,2025-05-24T16:45:00+02:00,2025-05-25,00:45,4,15,19
79,2025-05-24T16:49:00+02:00,2025-05-25,00:49,1,2,3
79,2025-05-24T16:54:00+02:00,2025-05-25,00:54,1,2,3
86,2025-05-24T16:48:00+02:00,2025-05-25,00:48,1,0,1
86,2025-05-24T16:51:00+02:00,2025-05-25,00:51,1,0,1
109,2025-05-24T16:50:00+02:00,2025-05-25,00:50,1,4,5
117,2025-05-24T16:45:00+02:00,2025-05-25,00:45,1,0,1
117,2025-05-24T16:50:00+02:00,2025-05-25,00:50,2,0,2
139,2025-05-24T16:40:00+02:00,2025-05-25,00:40,0,4,4
164,2025-05-24T16:40:00+02:00,2025-05-25,00:40,3,0,3
164,2025-05-24T16:50:00+02:00,2025-05-25,00:50,0,3,3
181,2025-05-24T16:40:00+02:00,2025-05-25,00:40,11,2,13
181,2025-05-24T16:41:00+02:00,2025-05-25,00:41,4,18,22
181,2025-05-24T16:44:00+02:00,2025-05-25,00:44,1,0,1
181,2025-05-24T16:47:00+02:00,2025-05-25,00:47,11,2,13
181,2025-05-24T16:48:00+02:00,2025-05-25,00:48,2,3,5
181,2025-05-24T16:49:00+02:00,2025-05-25,00:49,3,4,7
181,2025-05-24T16:50:00+02:00,2025-05-25,00:50,3,2,5
181,2025-05-24T16:53:00+02:00,2025-05-25,00:53,4,0,4
182,2025-05-24T16:45:00+02:00,2025-05-25,00:45,9,17,26
181,2025-05-24T16:57:00+02:00,2025-05-25,00:57,2,1,3
181,2025-05-24T17:02:00+02:00,2025-05-25,01:02,5,5,10
181,2025-05-24T17:06:00+02:00,2025-05-25,01:06,2,1,3
182,2025-05-24T17:05:00+02:00,2025-05-25,01:05,11,8,19
3,2025-05-24T17:41:00+02:00,2025-05-25,01:41,0,3,3
3,2025-05-24T17:42:00+02:00,2025-05-25,01:42,1,6,7
3,2025-05-24T17:44:00+02:00,2025-05-25,01:44,8,5,13
3,2025-05-24T17:46:00+02:00,2025-05-25,01:46,3,1,4
3,2025-05-24T17:48:00+02:00,2025-05-25,01:48,3,2,5
3,2025-05-24T17:49:00+02:00,2025-05-25,01:49,5,2,7
3,2025-05-24T17:53:00+02:00,2025-05-25,01:53,1,7,8
3,2025-05-24T17:54:00+02:00,2025-05-25,01:54,0,1,1
4,2025-05-24T17:46:00+02:00,2025-05-25,01:46,1,8,9
4,2025-05-24T17:47:00+02:00,2025-05-25,01:47,1,1,2
4,2025-05-24T17:48:00+02:00,2025-05-25,01:48,1,4,5
4,2025-05-24T17:49:00+02:00,2025-05-25,01:49,0,6,6
4,2025-05-24T17:52:00+02:00,2025-05-25,01:52,4,4,8
5,2025-05-24T17:50:00+02:00,2025-05-25,01:50,3,4,7
6,2025-05-24T17:45:00+02:00,2025-05-25,01:45,3,5,8
6,2025-05-24T17:47:00+02:00,2025-05-25,01:47,1,2,3
6,2025-05-24T17:53:00+02:00,2025-05-25,01:53,2,1,3
28,2025-05-24T17:40:00+02:00,2025-05-25,01:40,1,0,1
28,2025-05-24T17:50:00+02:00,2025-05-25,01:50,0,1,1
29,2025-05-24T17:44:00+02:00,2025-05-25,01:44,3,3,6
29,2025-05-24T17:45:00+02:00,2025-05-25,01:45,0,6,6
29,2025-05-24T17:53:00+02:00,2025-05-25,01:53,0,1,1
31,2025-05-24T17:43:00+02:00,2025-05-25,01:43,0,1,1
31,2025-05-24T17:53:00+02:00,2025-05-25,01:53,0,3,3
36,2025-05-24T17:40:00+02:00,2025-05-25,01:40,3,2,5
36,2025-05-24T17:42:00+02:00,2025-05-25,01:42,1,6,7
36,2025-05-24T17:47:00+02:00,2025-05-25,01:47,3,1,4
36,2025-05-24T17:49:00+02:00,2025-05-25,01:49,5,7,12
37,2025-05-24T17:47:00+02:00,2025-05-25,01:47,0,1,1
40,2025-05-24T17:41:00+02:00,2025-05-25,01:41,0,1,1
40,2025-05-24T17:49:00+02:00,2025-05-25,01:49,2,0,2
41,2025-05-24T17:43:00+02:00,2025-05-25,01:43,0,2,2
41,2025-05-24T17:47:00+02:00,2025-05-25,01:47,2,2,4
41,2025-05-24T17:50:00+02:00,2025-05-25,01:50,0,2,2
43,2025-05-24T17:45:00+02:00,2025-05-25,01:45,3,0,3
45,2025-05-24T17:46:00+02:00,2025-05-25,01:46,1,1,2
45,2025-05-24T17:47:00+02:00,2025-05-25,01:47,4,5,9
47,2025-05-24T17:42:00+02:00,2025-05-25,01:42,1,4,5
47,2025-05-24T17:44:00+02:00,2025-05-25,01:44,2,2,4
47,2025-05-24T17:52:00+02:00,2025-05-25,01:52,2,10,12
47,2025-05-24T17:53:00+02:00,2025-05-25,01:53,2,3,5
50,2025-05-24T17:48:00+02:00,2025-05-25,01:48,1,0,1
50,2025-05-24T17:54:00+02:00,2025-05-25,01:54,1,0,1
54,2025-05-24T17:41:00+02:00,2025-05-25,01:41,0,1,1
54,2025-05-24T17:52:00+02:00,2025-05-25,01:52,4,0,4
59,2025-05-24T17:40:00+02:00,2025-05-25,01:40,5,1,6
61,2025-05-24T17:41:00+02:00,2025-05-25,01:41,2,0,2
61,2025-05-24T17:46:00+02:00,2025-05-25,01:46,2,2,4
61,2025-05-24T17:47:00+02:00,2025-05-25,01:47,0,2,2
66,2025-05-24T17:43:00+02:00,2025-05-25,01:43,0,2,2
66,2025-05-24T17:44:00+02:00,2025-05-25,01:44,3,1,4
66,2025-05-24T17:47:00+02:00,2025-05-25,01:47,3,5,8
70,2025-05-24T17:45:00+02:00,2025-05-25,01:45,0,1,1
75,2025-05-24T17:44:00+02:00,2025-05-25,01:44,0,1,1
84,2025-05-24T17:40:00+02:00,2025-05-25,01:40,13,9,22
108,2025-05-24T17:53:00+02:00,2025-05-25,01:53,1,0,1
118,2025-05-24T17:45:00+02:00,2025-05-25,01:45,0,1,1
131,2025-05-24T17:40:00+02:00,2025-05-25,01:40,30,6,36
132,2025-05-24T17:50:00+02:00,2025-05-25,01:50,2,3,5
133,2025-05-24T17:50:00+02:00,2025-05-25,01:50,3,1,4
134,2025-05-24T17:40:00+02:00,2025-05-25,01:40,11,3,14
134,2025-05-24T17:45:00+02:00,2025-05-25,01:45,16,1,17
179,2025-05-24T17:40:00+02:00,2025-05-25,01:40,5,0,5
179,2025-05-24T17:50:00+02:00,2025-05-25,01:50,1,2,3
1,2025-05-24T17:40:00+02:00,2025-05-25,01:40,0,6,6
1,2025-05-24T17:44:00+02:00,2025-05-25,01:44,1,2,3
1,2025-05-24T17:53:00+02:00,2025-05-25,01:53,3,0,3
1,2025-05-24T17:54:00+02:00,2025-05-25,01:54,6,0,6
2,2025-05-24T17:45:00+02:00,2025-05-25,01:45,0,3,3
2,2025-05-24T17:49:00+02:00,2025-05-25,01:49,0,1,1
2,2025-05-24T17:50:00+02:00,2025-05-25,01:50,0,2,2
2,2025-05-24T17:51:00+02:00,2025-05-25,01:51,1,4,5
9,2025-05-24T17:44:00+02:00,2025-05-25,01:44,2,1,3
11,2025-05-24T17:45:00+02:00,2025-05-25,01:45,0,1,1
12,2025-05-24T17:40:00+02:00,2025-05-25,01:40,0,1,1
17,2025-05-24T17:46:00+02:00,2025-05-25,01:46,0,1,1
17,2025-05-24T17:49:00+02:00,2025-05-25,01:49,0,2,2
18,2025-05-24T17:50:00+02:00,2025-05-25,01:50,0,1,1
19,2025-05-24T17:41:00+02:00,2025-05-25,01:41,1,0,1
19,2025-05-24T17:43:00+02:00,2025-05-25,01:43,5,0,5
19,2025-05-24T17:44:00+02:00,2025-05-25,01:44,2,6,8
19,2025-05-24T17:46:00+02:00,2025-05-25,01:46,1,1,2
19,2025-05-24T17:48:00+02:00,2025-05-25,01:48,0,8,8
19,2025-05-24T17:49:00+02:00,2025-05-25,01:49,1,12,13
19,2025-05-24T17:52:00+02:00,2025-05-25,01:52,7,3,10
20,2025-05-24T17:43:00+02:00,2025-05-25,01:43,4,5,9
20,2025-05-24T17:49:00+02:00,2025-05-25,01:49,6,0,6
20,2025-05-24T17:52:00+02:00,2025-05-25,01:52,5,6,11
20,2025-05-24T17:53:00+02:00,2025-05-25,01:53,7,0,7
23,2025-05-24T17:43:00+02:00,2025-05-25,01:43,0,5,5
23,2025-05-24T17:45:00+02:00,2025-05-25,01:45,1,0,1
24,2025-05-24T17:41:00+02:00,2025-05-25,01:41,2,5,7
24,2025-05-24T17:44:00+02:00,2025-05-25,01:44,0,3,3
24,2025-05-24T17:47:00+02:00,2025-05-25,01:47,6,3,9
24,2025-05-24T17:48:00+02:00,2025-05-25,01:48,6,1,7
25,2025-05-24T17:40:00+02:00,2025-05-25,01:40,3,1,4
27,2025-05-24T17:48:00+02:00,2025-05-25,01:48,3,0,3
30,2025-05-24T17:43:00+02:00,2025-05-25,01:43,3,7,10
30,2025-05-24T17:46:00+02:00,2025-05-25,01:46,1,3,4
35,2025-05-24T17:40:00+02:00,2025-05-25,01:40,2,1,3
35,2025-05-24T17:41:00+02:00,2025-05-25,01:41,1,0,1
35,2025-05-24T17:43:00+02:00,2025-05-25,01:43,2,1,3
35,2025-05-24T17:45:00+02:00,2025-05-25,01:45,4,3,7
35,2025-05-24T17:46:00+02:00,2025-05-25,01:46,0,1,1
35,2025-05-24T17:48:00+02:00,2025-05-25,01:48,6,0,6
35,2025-05-24T17:54:00+02:00,2025-05-25,01:54,0,3,3
49,2025-05-24T17:43:00+02:00,2025-05-25,01:43,0,2,2
49,2025-05-24T17:48:00+02:00,2025-05-25,01:48,3,0,3
51,2025-05-24T17:43:00+02:00,2025-05-25,01:43,0,1,1
52,2025-05-24T17:42:00+02:00,2025-05-25,01:42,5,0,5
52,2025-05-24T17:43:00+02:00,2025-05-25,01:43,2,0,2
52,2025-05-24T17:44:00+02:00,2025-05-25,01:44,6,5,11
52,2025-05-24T17:48:00+02:00,2025-05-25,01:48,0,9,9
52,2025-05-24T17:51:00+02:00,2025-05-25,01:51,0,1,1
53,2025-05-24T17:40:00+02:00,2025-05-25,01:40,1,1,2
53,2025-05-24T17:45:00+02:00,2025-05-25,01:45,2,1,3
53,2025-05-24T17:48:00+02:00,2025-05-25,01:48,0,2,2
56,2025-05-24T17:45:00+02:00,2025-05-25,01:45,0,1,1
56,2025-05-24T17:46:00+02:00,2025-05-25,01:46,1,0,1
58,2025-05-24T17:40:00+02:00,2025-05-25,01:40,0,1,1
62,2025-05-24T17:46:00+02:00,2025-05-25,01:46,2,0,2
63,2025-05-24T17:42:00+02:00,2025-05-25,01:42,0,1,1
63,2025-05-24T17:46:00+02:00,2025-05-25,01:46,0,2,2
63,2025-05-24T17:53:00+02:00,2025-05-25,01:53,0,1,1
67,2025-05-24T17:47:00+02:00,2025-05-25,01:47,1,0,1
68,2025-05-24T17:42:00+02:00,2025-05-25,01:42,2,0,2
72,2025-05-24T17:52:00+02:00,2025-05-25,01:52,0,2,2
72,2025-05-24T17:54:00+02:00,2025-05-25,01:54,0,1,1
79,2025-05-24T17:43:00+02:00,2025-05-25,01:43,3,0,3
79,2025-05-24T17:49:00+02:00,2025-05-25,01:49,1,1,2
79,2025-05-24T17:52:00+02:00,2025-05-25,01:52,3,1,4
79,2025-05-24T17:54:00+02:00,2025-05-25,01:54,0,3,3
109,2025-05-24T17:45:00+02:00,2025-05-25,01:45,1,11,12
117,2025-05-24T17:40:00+02:00,2025-05-25,01:40,0,3,3
117,2025-05-24T17:45:00+02:00,2025-05-25,01:45,3,0,3
117,2025-05-24T17:50:00+02:00,2025-05-25,01:50,2,0,2
139,2025-05-24T17:45:00+02:00,2025-05-25,01:45,3,5,8
141,2025-05-24T17:40:00+02:00,2025-05-25,01:40,4,13,17
141,2025-05-24T17:45:00+02:00,2025-05-25,01:45,4,4,8
141,2025-05-24T17:50:00+02:00,2025-05-25,01:50,6,5,11
164,2025-05-24T17:50:00+02:00,2025-05-25,01:50,0,1,1
3,2025-05-24T16:56:00+02:00,2025-05-25,00:56,7,5,12
3,2025-05-24T16:59:00+02:00,2025-05-25,00:59,0,2,2
3,2025-05-24T17:06:00+02:00,2025-05-25,01:06,7,1,8
4,2025-05-24T16:58:00+02:00,2025-05-25,00:58,2,10,12
4,2025-05-24T16:59:00+02:00,2025-05-25,00:59,5,0,5
4,2025-05-24T17:00:00+02:00,2025-05-25,01:00,2,10,12
4,2025-05-24T17:04:00+02:00,2025-05-25,01:04,0,7,7
4,2025-05-24T17:09:00+02:00,2025-05-25,01:09,0,4,4
5,2025-05-24T17:00:00+02:00,2025-05-25,01:00,10,14,24
5,2025-05-24T17:05:00+02:00,2025-05-25,01:05,7,4,11
6,2025-05-24T17:03:00+02:00,2025-05-25,01:03,6,3,9
6,2025-05-24T17:06:00+02:00,2025-05-25,01:06,8,0,8
6,2025-05-24T17:09:00+02:00,2025-05-25,01:09,9,0,9
29,2025-05-24T16:59:00+02:00,2025-05-25,00:59,0,1,1
29,2025-05-24T17:03:00+02:00,2025-05-25,01:03,1,2,3
29,2025-05-24T17:05:00+02:00,2025-05-25,01:05,0,1,1
29,2025-05-24T17:06:00+02:00,2025-05-25,01:06,0,1,1
31,2025-05-24T16:55:00+02:00,2025-05-25,00:55,0,3,3
31,2025-05-24T16:57:00+02:00,2025-05-25,00:57,0,2,2
31,2025-05-24T17:02:00+02:00,2025-05-25,01:02,0,1,1
31,2025-05-24T17:07:00+02:00,2025-05-25,01:07,0,3,3
36,2025-05-24T16:56:00+02:00,2025-05-25,00:56,0,1,1
36,2025-05-24T16:59:00+02:00,2025-05-25,00:59,1,10,11
36,2025-05-24T17:01:00+02:00,2025-05-25,01:01,3,6,9
36,2025-05-24T17:09:00+02:00,2025-05-25,01:09,3,4,7
37,2025-05-24T16:59:00+02:00,2025-05-25,00:59,0,1,1
37,2025-05-24T17:05:00+02:00,2025-05-25,01:05,0,2,2
37,2025-05-24T17:06:00+02:00,2025-05-25,01:06,0,4,4
37,2025-05-24T17:08:00+02:00,2025-05-25,01:08,3,0,3
41,2025-05-24T16:57:00+02:00,2025-05-25,00:57,0,4,4
41,2025-05-24T17:02:00+02:00,2025-05-25,01:02,2,2,4
41,2025-05-24T17:03:00+02:00,2025-05-25,01:03,4,3,7
41,2025-05-24T17:06:00+02:00,2025-05-25,01:06,2,8,10
41,2025-05-24T17:09:00+02:00,2025-05-25,01:09,0,3,3
45,2025-05-24T16:55:00+02:00,2025-05-25,00:55,10,6,16
45,2025-05-24T16:57:00+02:00,2025-05-25,00:57,0,1,1
45,2025-05-24T17:02:00+02:00,2025-05-25,01:02,0,9,9
45,2025-05-24T17:05:00+02:00,2025-05-25,01:05,1,4,5
45,2025-05-24T17:09:00+02:00,2025-05-25,01:09,4,1,5
47,2025-05-24T16:55:00+02:00,2025-05-25,00:55,0,7,7
47,2025-05-24T16:59:00+02:00,2025-05-25,00:59,3,0,3
47,2025-05-24T17:02:00+02:00,2025-05-25,01:02,4,10,14
47,2025-05-24T17:04:00+02:00,2025-05-25,01:04,4,0,4
47,2025-05-24T17:05:00+02:00,2025-05-25,01:05,2,3,5
50,2025-05-24T16:56:00+02:00,2025-05-25,00:56,1,0,1
50,2025-05-24T17:08:00+02:00,2025-05-25,01:08,0,1,1
54,2025-05-24T16:56:00+02:00,2025-05-25,00:56,0,1,1
54,2025-05-24T16:57:00+02:00,2025-05-25,00:57,0,2,2
54,2025-05-24T17:01:00+02:00,2025-05-25,01:01,0,3,3
61,2025-05-24T16:55:00+02:00,2025-05-25,00:55,2,1,3
61,2025-05-24T16:57:00+02:00,2025-05-25,00:57,0,1,1
61,2025-05-24T16:59:00+02:00,2025-05-25,00:59,6,1,7
61,2025-05-24T17:00:00+02:00,2025-05-25,01:00,0,1,1
61,2025-05-24T17:01:00+02:00,2025-05-25,01:01,1,1,2
66,2025-05-24T16:57:00+02:00,2025-05-25,00:57,0,1,1
66,2025-05-24T17:00:00+02:00,2025-05-25,01:00,2,0,2
66,2025-05-24T17:03:00+02:00,2025-05-25,01:03,6,8,14
66,2025-05-24T17:06:00+02:00,2025-05-25,01:06,5,10,15
66,2025-05-24T17:09:00+02:00,2025-05-25,01:09,3,1,4
69,2025-05-24T16:55:00+02:00,2025-05-25,00:55,0,1,1
69,2025-05-24T17:07:00+02:00,2025-05-25,01:07,0,2,2
70,2025-05-24T17:06:00+02:00,2025-05-25,01:06,1,1,2
75,2025-05-24T16:55:00+02:00,2025-05-25,00:55,1,0,1
77,2025-05-24T16:55:00+02:00,2025-05-25,00:55,2,0,2
107,2025-05-24T16:55:00+02:00,2025-05-25,00:55,1,1,2
108,2025-05-24T16:56:00+02:00,2025-05-25,00:56,2,2,4
131,2025-05-24T17:05:00+02:00,2025-05-25,01:05,10,5,15
132,2025-05-24T16:55:00+02:00,2025-05-25,00:55,1,2,3
133,2025-05-24T17:05:00+02:00,2025-05-25,01:05,5,1,6
134,2025-05-24T16:55:00+02:00,2025-05-25,00:55,8,9,17
134,2025-05-24T17:05:00+02:00,2025-05-25,01:05,3,7,10
135,2025-05-24T16:55:00+02:00,2025-05-25,00:55,2,2,4
135,2025-05-24T17:00:00+02:00,2025-05-25,01:00,8,8,16
179,2025-05-24T16:55:00+02:00,2025-05-25,00:55,0,1,1
179,2025-05-24T17:00:00+02:00,2025-05-25,01:00,7,0,7
1,2025-05-24T17:02:00+02:00,2025-05-25,01:02,0,2,2
1,2025-05-24T17:06:00+02:00,2025-05-25,01:06,0,2,2
2,2025-05-24T16:56:00+02:00,2025-05-25,00:56,0,2,2
2,2025-05-24T16:59:00+02:00,2025-05-25,00:59,1,1,2
2,2025-05-24T17:06:00+02:00,2025-05-25,01:06,1,3,4
9,2025-05-24T17:05:00+02:00,2025-05-25,01:05,0,1,1
9,2025-05-24T17:09:00+02:00,2025-05-25,01:09,0,2,2
10,2025-05-24T17:05:00+02:00,2025-05-25,01:05,1,0,1
11,2025-05-24T17:07:00+02:00,2025-05-25,01:07,0,1,1
17,2025-05-24T17:02:00+02:00,2025-05-25,01:02,1,0,1
18,2025-05-24T17:09:00+02:00,2025-05-25,01:09,0,1,1
19,2025-05-24T16:57:00+02:00,2025-05-25,00:57,2,3,5
19,2025-05-24T16:58:00+02:00,2025-05-25,00:58,2,4,6
19,2025-05-24T17:00:00+02:00,2025-05-25,01:00,8,11,19
19,2025-05-24T17:01:00+02:00,2025-05-25,01:01,3,12,15
19,2025-05-24T17:02:00+02:00,2025-05-25,01:02,2,7,9
19,2025-05-24T17:06:00+02:00,2025-05-25,01:06,3,5,8
19,2025-05-24T17:07:00+02:00,2025-05-25,01:07,2,3,5
20,2025-05-24T16:57:00+02:00,2025-05-25,00:57,4,4,8
20,2025-05-24T16:58:00+02:00,2025-05-25,00:58,6,12,18
20,2025-05-24T17:00:00+02:00,2025-05-25,01:00,8,7,15
20,2025-05-24T17:05:00+02:00,2025-05-25,01:05,6,1,7
20,2025-05-24T17:08:00+02:00,2025-05-25,01:08,0,11,11
23,2025-05-24T17:03:00+02:00,2025-05-25,01:03,4,1,5
24,2025-05-24T17:03:00+02:00,2025-05-25,01:03,0,2,2
24,2025-05-24T17:04:00+02:00,2025-05-25,01:04,1,3,4
24,2025-05-24T17:05:00+02:00,2025-05-25,01:05,6,4,10
24,2025-05-24T17:06:00+02:00,2025-05-25,01:06,4,4,8
25,2025-05-24T17:05:00+02:00,2025-05-25,01:05,1,1,2
27,2025-05-24T16:58:00+02:00,2025-05-25,00:58,0,1,1
27,2025-05-24T17:08:00+02:00,2025-05-25,01:08,1,2,3
27,2025-05-24T17:09:00+02:00,2025-05-25,01:09,1,0,1
30,2025-05-24T16:58:00+02:00,2025-05-25,00:58,7,1,8
30,2025-05-24T16:59:00+02:00,2025-05-25,00:59,8,9,17
30,2025-05-24T17:09:00+02:00,2025-05-25,01:09,0,11,11
35,2025-05-24T16:55:00+02:00,2025-05-25,00:55,3,1,4
35,2025-05-24T16:56:00+02:00,2025-05-25,00:56,1,4,5
35,2025-05-24T16:59:00+02:00,2025-05-25,00:59,0,4,4
35,2025-05-24T17:01:00+02:00,2025-05-25,01:01,1,0,1
49,2025-05-24T16:55:00+02:00,2025-05-25,00:55,0,1,1
49,2025-05-24T16:56:00+02:00,2025-05-25,00:56,1,1,2
49,2025-05-24T16:59:00+02:00,2025-05-25,00:59,1,1,2
49,2025-05-24T17:05:00+02:00,2025-05-25,01:05,0,1,1
51,2025-05-24T16:59:00+02:00,2025-05-25,00:59,2,0,2
51,2025-05-24T17:06:00+02:00,2025-05-25,01:06,1,0,1
52,2025-05-24T16:56:00+02:00,2025-05-25,00:56,0,2,2
52,2025-05-24T16:59:00+02:00,2025-05-25,00:59,5,4,9
52,2025-05-24T17:02:00+02:00,2025-05-25,01:02,5,0,5
52,2025-05-24T17:04:00+02:00,2025-05-25,01:04,4,0,4
52,2025-05-24T17:05:00+02:00,2025-05-25,01:05,17,0,17
52,2025-05-24T17:06:00+02:00,2025-05-25,01:06,0,4,4
52,2025-05-24T17:08:00+02:00,2025-05-25,01:08,2,0,2
53,2025-05-24T17:04:00+02:00,2025-05-25,01:04,1,0,1
53,2025-05-24T17:08:00+02:00,2025-05-25,01:08,3,3,6
53,2025-05-24T17:09:00+02:00,2025-05-25,01:09,2,2,4
56,2025-05-24T17:09:00+02:00,2025-05-25,01:09,0,3,3
58,2025-05-24T16:55:00+02:00,2025-05-25,00:55,0,3,3
58,2025-05-24T16:56:00+02:00,2025-05-25,00:56,0,4,4
58,2025-05-24T17:01:00+02:00,2025-05-25,01:01,1,1,2
58,2025-05-24T17:04:00+02:00,2025-05-25,01:04,1,3,4
58,2025-05-24T17:05:00+02:00,2025-05-25,01:05,1,4,5
58,2025-05-24T17:07:00+02:00,2025-05-25,01:07,3,2,5
58,2025-05-24T17:09:00+02:00,2025-05-25,01:09,1,1,2
62,2025-05-24T17:04:00+02:00,2025-05-25,01:04,1,1,2
63,2025-05-24T16:56:00+02:00,2025-05-25,00:56,0,4,4
63,2025-05-24T17:03:00+02:00,2025-05-25,01:03,0,1,1
67,2025-05-24T17:06:00+02:00,2025-05-25,01:06,0,1,1
67,2025-05-24T17:07:00+02:00,2025-05-25,01:07,0,1,1
68,2025-05-24T17:07:00+02:00,2025-05-25,01:07,0,1,1
72,2025-05-24T17:00:00+02:00,2025-05-25,01:00,0,1,1
72,2025-05-24T17:02:00+02:00,2025-05-25,01:02,3,0,3
72,2025-05-24T17:06:00+02:00,2025-05-25,01:06,0,1,1
79,2025-05-24T16:55:00+02:00,2025-05-25,00:55,0,3,3
79,2025-05-24T17:01:00+02:00,2025-05-25,01:01,0,2,2
79,2025-05-24T17:03:00+02:00,2025-05-25,01:03,1,0,1
79,2025-05-24T17:07:00+02:00,2025-05-25,01:07,0,6,6
79,2025-05-24T17:08:00+02:00,2025-05-25,01:08,2,3,5
79,2025-05-24T17:09:00+02:00,2025-05-25,01:09,0,3,3
109,2025-05-24T16:55:00+02:00,2025-05-25,00:55,2,14,16
109,2025-05-24T17:05:00+02:00,2025-05-25,01:05,1,1,2
123,2025-05-24T16:55:00+02:00,2025-05-25,00:55,1,0,1
130,2025-05-24T17:05:00+02:00,2025-05-25,01:05,1,0,1
139,2025-05-24T16:55:00+02:00,2025-05-25,00:55,2,2,4
142,2025-05-24T17:00:00+02:00,2025-05-25,01:00,1,0,1
164,2025-05-24T16:55:00+02:00,2025-05-25,00:55,0,1,1
164,2025-05-24T17:05:00+02:00,2025-05-25,01:05,0,4,4
181,2025-05-24T17:10:00+02:00,2025-05-25,01:10,5,1,6
181,2025-05-24T17:12:00+02:00,2025-05-25,01:12,0,4,4
181,2025-05-24T17:16:00+02:00,2025-05-25,01:16,3,0,3
181,2025-05-24T17:17:00+02:00,2025-05-25,01:17,1,2,3
181,2025-05-24T17:22:00+02:00,2025-05-25,01:22,0,1,1
181,2025-05-24T17:24:00+02:00,2025-05-25,01:24,5,8,13
182,2025-05-24T17:10:00+02:00,2025-05-25,01:10,11,8,19
3,2025-05-24T17:28:00+02:00,2025-05-25,01:28,5,0,5
3,2025-05-24T17:30:00+02:00,2025-05-25,01:30,2,1,3
3,2025-05-24T17:32:00+02:00,2025-05-25,01:32,0,3,3
3,2025-05-24T17:35:00+02:00,2025-05-25,01:35,13,2,15
3,2025-05-24T17:36:00+02:00,2025-05-25,01:36,1,7,8
3,2025-05-24T17:37:00+02:00,2025-05-25,01:37,2,4,6
3,2025-05-24T17:39:00+02:00,2025-05-25,01:39,2,10,12
4,2025-05-24T17:28:00+02:00,2025-05-25,01:28,1,6,7
4,2025-05-24T17:30:00+02:00,2025-05-25,01:30,2,1,3
4,2025-05-24T17:34:00+02:00,2025-05-25,01:34,2,4,6
4,2025-05-24T17:35:00+02:00,2025-05-25,01:35,0,3,3
4,2025-05-24T17:37:00+02:00,2025-05-25,01:37,0,2,2
4,2025-05-24T17:39:00+02:00,2025-05-25,01:39,0,1,1
6,2025-05-24T17:25:00+02:00,2025-05-25,01:25,1,3,4
6,2025-05-24T17:27:00+02:00,2025-05-25,01:27,2,3,5
6,2025-05-24T17:29:00+02:00,2025-05-25,01:29,5,0,5
6,2025-05-24T17:35:00+02:00,2025-05-25,01:35,7,0,7
6,2025-05-24T17:37:00+02:00,2025-05-25,01:37,6,5,11
6,2025-05-24T17:38:00+02:00,2025-05-25,01:38,1,0,1
6,2025-05-24T17:39:00+02:00,2025-05-25,01:39,10,2,12
28,2025-05-24T17:31:00+02:00,2025-05-25,01:31,2,0,2
28,2025-05-24T17:35:00+02:00,2025-05-25,01:35,1,0,1
29,2025-05-24T17:39:00+02:00,2025-05-25,01:39,0,1,1
31,2025-05-24T17:27:00+02:00,2025-05-25,01:27,1,0,1
36,2025-05-24T17:27:00+02:00,2025-05-25,01:27,1,3,4
36,2025-05-24T17:30:00+02:00,2025-05-25,01:30,1,2,3
36,2025-05-24T17:31:00+02:00,2025-05-25,01:31,0,2,2
36,2025-05-24T17:32:00+02:00,2025-05-25,01:32,0,2,2
36,2025-05-24T17:37:00+02:00,2025-05-25,01:37,0,2,2
37,2025-05-24T17:37:00+02:00,2025-05-25,01:37,0,1,1
39,2025-05-24T17:29:00+02:00,2025-05-25,01:29,0,1,1
41,2025-05-24T17:27:00+02:00,2025-05-25,01:27,0,2,2
41,2025-05-24T17:29:00+02:00,2025-05-25,01:29,0,2,2
41,2025-05-24T17:34:00+02:00,2025-05-25,01:34,0,1,1
44,2025-05-24T17:30:00+02:00,2025-05-25,01:30,1,0,1
45,2025-05-24T17:30:00+02:00,2025-05-25,01:30,0,2,2
45,2025-05-24T17:31:00+02:00,2025-05-25,01:31,1,2,3
45,2025-05-24T17:34:00+02:00,2025-05-25,01:34,0,4,4
45,2025-05-24T17:37:00+02:00,2025-05-25,01:37,1,3,4
47,2025-05-24T17:27:00+02:00,2025-05-25,01:27,3,6,9
47,2025-05-24T17:35:00+02:00,2025-05-25,01:35,1,0,1
47,2025-05-24T17:36:00+02:00,2025-05-25,01:36,2,2,4
47,2025-05-24T17:39:00+02:00,2025-05-25,01:39,4,3,7
50,2025-05-24T17:39:00+02:00,2025-05-25,01:39,1,0,1
61,2025-05-24T17:27:00+02:00,2025-05-25,01:27,1,2,3
61,2025-05-24T17:29:00+02:00,2025-05-25,01:29,2,0,2
61,2025-05-24T17:30:00+02:00,2025-05-25,01:30,2,1,3
61,2025-05-24T17:31:00+02:00,2025-05-25,01:31,2,0,2
61,2025-05-24T17:33:00+02:00,2025-05-25,01:33,1,0,1
61,2025-05-24T17:35:00+02:00,2025-05-25,01:35,6,0,6
61,2025-05-24T17:36:00+02:00,2025-05-25,01:36,2,0,2
61,2025-05-24T17:37:00+02:00,2025-05-25,01:37,2,0,2
66,2025-05-24T17:28:00+02:00,2025-05-25,01:28,4,3,7
66,2025-05-24T17:32:00+02:00,2025-05-25,01:32,8,1,9
70,2025-05-24T17:35:00+02:00,2025-05-25,01:35,0,1,1
78,2025-05-24T17:35:00+02:00,2025-05-25,01:35,1,0,1
84,2025-05-24T17:35:00+02:00,2025-05-25,01:35,13,12,25
108,2025-05-24T17:29:00+02:00,2025-05-25,01:29,0,2,2
108,2025-05-24T17:31:00+02:00,2025-05-25,01:31,2,0,2
108,2025-05-24T17:33:00+02:00,2025-05-25,01:33,0,1,1
131,2025-05-24T17:35:00+02:00,2025-05-25,01:35,11,18,29
132,2025-05-24T17:30:00+02:00,2025-05-25,01:30,5,2,7
133,2025-05-24T17:35:00+02:00,2025-05-25,01:35,6,5,11
134,2025-05-24T17:25:00+02:00,2025-05-25,01:25,5,2,7
134,2025-05-24T17:30:00+02:00,2025-05-25,01:30,7,7,14
135,2025-05-24T17:25:00+02:00,2025-05-25,01:25,4,3,7
135,2025-05-24T17:30:00+02:00,2025-05-25,01:30,2,4,6
162,2025-05-24T17:25:00+02:00,2025-05-25,01:25,6,7,13
162,2025-05-24T17:35:00+02:00,2025-05-25,01:35,1,5,6
167,2025-05-24T17:30:00+02:00,2025-05-25,01:30,1,0,1
1,2025-05-24T17:37:00+02:00,2025-05-25,01:37,1,0,1
1,2025-05-24T17:39:00+02:00,2025-05-25,01:39,0,5,5
9,2025-05-24T17:28:00+02:00,2025-05-25,01:28,0,1,1
9,2025-05-24T17:29:00+02:00,2025-05-25,01:29,0,1,1
11,2025-05-24T17:37:00+02:00,2025-05-25,01:37,0,1,1
12,2025-05-24T17:26:00+02:00,2025-05-25,01:26,1,0,1
12,2025-05-24T17:35:00+02:00,2025-05-25,01:35,1,0,1
18,2025-05-24T17:28:00+02:00,2025-05-25,01:28,1,0,1
19,2025-05-24T17:25:00+02:00,2025-05-25,01:25,8,5,13
19,2025-05-24T17:26:00+02:00,2025-05-25,01:26,0,5,5
19,2025-05-24T17:28:00+02:00,2025-05-25,01:28,0,8,8
19,2025-05-24T17:29:00+02:00,2025-05-25,01:29,0,5,5
19,2025-05-24T17:31:00+02:00,2025-05-25,01:31,0,1,1
19,2025-05-24T17:33:00+02:00,2025-05-25,01:33,2,2,4
19,2025-05-24T17:35:00+02:00,2025-05-25,01:35,3,0,3
19,2025-05-24T17:37:00+02:00,2025-05-25,01:37,1,1,2
20,2025-05-24T17:27:00+02:00,2025-05-25,01:27,7,1,8
20,2025-05-24T17:29:00+02:00,2025-05-25,01:29,0,5,5
20,2025-05-24T17:36:00+02:00,2025-05-25,01:36,8,1,9
20,2025-05-24T17:39:00+02:00,2025-05-25,01:39,7,1,8
23,2025-05-24T17:26:00+02:00,2025-05-25,01:26,0,1,1
23,2025-05-24T17:34:00+02:00,2025-05-25,01:34,0,1,1
23,2025-05-24T17:36:00+02:00,2025-05-25,01:36,2,0,2
24,2025-05-24T17:30:00+02:00,2025-05-25,01:30,2,0,2
24,2025-05-24T17:31:00+02:00,2025-05-25,01:31,0,3,3
24,2025-05-24T17:36:00+02:00,2025-05-25,01:36,2,2,4
27,2025-05-24T17:26:00+02:00,2025-05-25,01:26,1,2,3
27,2025-05-24T17:30:00+02:00,2025-05-25,01:30,4,0,4
27,2025-05-24T17:38:00+02:00,2025-05-25,01:38,1,0,1
30,2025-05-24T17:26:00+02:00,2025-05-25,01:26,1,8,9
30,2025-05-24T17:30:00+02:00,2025-05-25,01:30,1,5,6
30,2025-05-24T17:32:00+02:00,2025-05-25,01:32,3,2,5
30,2025-05-24T17:34:00+02:00,2025-05-25,01:34,1,4,5
30,2025-05-24T17:36:00+02:00,2025-05-25,01:36,4,0,4
35,2025-05-24T17:25:00+02:00,2025-05-25,01:25,2,2,4
35,2025-05-24T17:26:00+02:00,2025-05-25,01:26,2,0,2
35,2025-05-24T17:31:00+02:00,2025-05-25,01:31,1,0,1
35,2025-05-24T17:33:00+02:00,2025-05-25,01:33,4,4,8
35,2025-05-24T17:34:00+02:00,2025-05-25,01:34,0,2,2
35,2025-05-24T17:36:00+02:00,2025-05-25,01:36,4,0,4
35,2025-05-24T17:37:00+02:00,2025-05-25,01:37,1,0,1
49,2025-05-24T17:30:00+02:00,2025-05-25,01:30,1,1,2
49,2025-05-24T17:32:00+02:00,2025-05-25,01:32,4,0,4
49,2025-05-24T17:35:00+02:00,2025-05-25,01:35,1,0,1
49,2025-05-24T17:39:00+02:00,2025-05-25,01:39,1,0,1
51,2025-05-24T17:26:00+02:00,2025-05-25,01:26,0,1,1
51,2025-05-24T17:35:00+02:00,2025-05-25,01:35,0,1,1
51,2025-05-24T17:37:00+02:00,2025-05-25,01:37,0,1,1
51,2025-05-24T17:39:00+02:00,2025-05-25,01:39,3,1,4
52,2025-05-24T17:29:00+02:00,2025-05-25,01:29,0,2,2
52,2025-05-24T17:39:00+02:00,2025-05-25,01:39,1,0,1
56,2025-05-24T17:26:00+02:00,2025-05-25,01:26,0,3,3
56,2025-05-24T17:27:00+02:00,2025-05-25,01:27,0,1,1
56,2025-05-24T17:28:00+02:00,2025-05-25,01:28,1,0,1
58,2025-05-24T17:29:00+02:00,2025-05-25,01:29,4,4,8
58,2025-05-24T17:33:00+02:00,2025-05-25,01:33,0,1,1
58,2025-05-24T17:36:00+02:00,2025-05-25,01:36,1,0,1
58,2025-05-24T17:38:00+02:00,2025-05-25,01:38,1,0,1
62,2025-05-24T17:31:00+02:00,2025-05-25,01:31,2,0,2
62,2025-05-24T17:34:00+02:00,2025-05-25,01:34,1,1,2
62,2025-05-24T17:36:00+02:00,2025-05-25,01:36,1,1,2
63,2025-05-24T17:36:00+02:00,2025-05-25,01:36,0,2,2
67,2025-05-24T17:30:00+02:00,2025-05-25,01:30,1,0,1
67,2025-05-24T17:34:00+02:00,2025-05-25,01:34,1,0,1
79,2025-05-24T17:27:00+02:00,2025-05-25,01:27,2,0,2
79,2025-05-24T17:28:00+02:00,2025-05-25,01:28,0,2,2
79,2025-05-24T17:31:00+02:00,2025-05-25,01:31,2,2,4
79,2025-05-24T17:34:00+02:00,2025-05-25,01:34,1,1,2
79,2025-05-24T17:37:00+02:00,2025-05-25,01:37,2,4,6
79,2025-05-24T17:38:00+02:00,2025-05-25,01:38,0,2,2
109,2025-05-24T17:30:00+02:00,2025-05-25,01:30,8,1,9
109,2025-05-24T17:35:00+02:00,2025-05-25,01:35,2,0,2
117,2025-05-24T17:35:00+02:00,2025-05-25,01:35,3,0,3
141,2025-05-24T17:25:00+02:00,2025-05-25,01:25,11,7,18
141,2025-05-24T17:35:00+02:00,2025-05-25,01:35,9,9,18
142,2025-05-24T17:35:00+02:00,2025-05-25,01:35,1,0,1
164,2025-05-24T17:35:00+02:00,2025-05-25,01:35,0,1,1
181,2025-05-24T17:42:00+02:00,2025-05-25,01:42,4,3,7
181,2025-05-24T17:43:00+02:00,2025-05-25,01:43,3,2,5
181,2025-05-24T17:48:00+02:00,2025-05-25,01:48,1,5,6
181,2025-05-24T17:49:00+02:00,2025-05-25,01:49,3,2,5
181,2025-05-24T17:50:00+02:00,2025-05-25,01:50,1,1,2
181,2025-05-24T17:52:00+02:00,2025-05-25,01:52,1,1,2
181,2025-05-24T17:53:00+02:00,2025-05-25,01:53,1,0,1
182,2025-05-24T17:40:00+02:00,2025-05-25,01:40,8,11,19
182,2025-05-24T17:50:00+02:00,2025-05-25,01:50,9,7,16
3,2025-05-24T18:15:00+02:00,2025-05-25,02:15,0,1,1
3,2025-05-24T18:19:00+02:00,2025-05-25,02:19,4,7,11
3,2025-05-24T18:23:00+02:00,2025-05-25,02:23,1,1,2
4,2025-05-24T18:11:00+02:00,2025-05-25,02:11,2,2,4
4,2025-05-24T18:15:00+02:00,2025-05-25,02:15,0,10,10
4,2025-05-24T18:21:00+02:00,2025-05-25,02:21,1,4,5
4,2025-05-24T18:23:00+02:00,2025-05-25,02:23,0,6,6
5,2025-05-24T18:20:00+02:00,2025-05-25,02:20,4,1,5
6,2025-05-24T18:15:00+02:00,2025-05-25,02:15,0,4,4
6,2025-05-24T18:22:00+02:00,2025-05-25,02:22,0,2,2
6,2025-05-24T18:23:00+02:00,2025-05-25,02:23,0,3,3
29,2025-05-24T18:21:00+02:00,2025-05-25,02:21,0,1,1
36,2025-05-24T18:10:00+02:00,2025-05-25,02:10,3,3,6
36,2025-05-24T18:13:00+02:00,2025-05-25,02:13,1,4,5
36,2025-05-24T18:14:00+02:00,2025-05-25,02:14,2,10,12
36,2025-05-24T18:15:00+02:00,2025-05-25,02:15,1,2,3
36,2025-05-24T18:16:00+02:00,2025-05-25,02:16,3,0,3
36,2025-05-24T18:18:00+02:00,2025-05-25,02:18,1,7,8
36,2025-05-24T18:20:00+02:00,2025-05-25,02:20,0,2,2
36,2025-05-24T18:23:00+02:00,2025-05-25,02:23,14,0,14
37,2025-05-24T18:12:00+02:00,2025-05-25,02:12,1,0,1
37,2025-05-24T18:16:00+02:00,2025-05-25,02:16,0,1,1
40,2025-05-24T18:15:00+02:00,2025-05-25,02:15,0,1,1
40,2025-05-24T18:17:00+02:00,2025-05-25,02:17,0,1,1
40,2025-05-24T18:18:00+02:00,2025-05-25,02:18,1,0,1
40,2025-05-24T18:21:00+02:00,2025-05-25,02:21,1,0,1
41,2025-05-24T18:16:00+02:00,2025-05-25,02:16,3,2,5
41,2025-05-24T18:17:00+02:00,2025-05-25,02:17,6,9,15
41,2025-05-24T18:18:00+02:00,2025-05-25,02:18,1,1,2
41,2025-05-24T18:20:00+02:00,2025-05-25,02:20,0,2,2
41,2025-05-24T18:22:00+02:00,2025-05-25,02:22,0,2,2
41,2025-05-24T18:23:00+02:00,2025-05-25,02:23,1,2,3
45,2025-05-24T18:10:00+02:00,2025-05-25,02:10,2,0,2
45,2025-05-24T18:12:00+02:00,2025-05-25,02:12,9,1,10
45,2025-05-24T18:14:00+02:00,2025-05-25,02:14,0,2,2
45,2025-05-24T18:19:00+02:00,2025-05-25,02:19,0,3,3
45,2025-05-24T18:22:00+02:00,2025-05-25,02:22,1,0,1
47,2025-05-24T18:16:00+02:00,2025-05-25,02:16,3,3,6
47,2025-05-24T18:18:00+02:00,2025-05-25,02:18,2,0,2
47,2025-05-24T18:20:00+02:00,2025-05-25,02:20,0,6,6
54,2025-05-24T18:10:00+02:00,2025-05-25,02:10,0,1,1
54,2025-05-24T18:12:00+02:00,2025-05-25,02:12,1,0,1
59,2025-05-24T18:10:00+02:00,2025-05-25,02:10,1,0,1
61,2025-05-24T18:13:00+02:00,2025-05-25,02:13,3,1,4
61,2025-05-24T18:22:00+02:00,2025-05-25,02:22,1,0,1
66,2025-05-24T18:13:00+02:00,2025-05-25,02:13,5,4,9
66,2025-05-24T18:14:00+02:00,2025-05-25,02:14,5,1,6
66,2025-05-24T18:18:00+02:00,2025-05-25,02:18,5,2,7
70,2025-05-24T18:23:00+02:00,2025-05-25,02:23,1,0,1
71,2025-05-24T18:10:00+02:00,2025-05-25,02:10,1,0,1
71,2025-05-24T18:19:00+02:00,2025-05-25,02:19,0,2,2
75,2025-05-24T18:15:00+02:00,2025-05-25,02:15,1,0,1
77,2025-05-24T18:10:00+02:00,2025-05-25,02:10,0,1,1
84,2025-05-24T18:20:00+02:00,2025-05-25,02:20,8,8,16
108,2025-05-24T18:22:00+02:00,2025-05-25,02:22,3,0,3
131,2025-05-24T18:10:00+02:00,2025-05-25,02:10,5,7,12
132,2025-05-24T18:10:00+02:00,2025-05-25,02:10,5,1,6
133,2025-05-24T18:10:00+02:00,2025-05-25,02:10,2,1,3
134,2025-05-24T18:10:00+02:00,2025-05-25,02:10,2,4,6
134,2025-05-24T18:15:00+02:00,2025-05-25,02:15,8,3,11
134,2025-05-24T18:20:00+02:00,2025-05-25,02:20,7,8,15
162,2025-05-24T18:10:00+02:00,2025-05-25,02:10,12,5,17
162,2025-05-24T18:20:00+02:00,2025-05-25,02:20,6,5,11
1,2025-05-24T18:20:00+02:00,2025-05-25,02:20,2,0,2
2,2025-05-24T18:11:00+02:00,2025-05-25,02:11,1,0,1
9,2025-05-24T18:19:00+02:00,2025-05-25,02:19,0,1,1
17,2025-05-24T18:11:00+02:00,2025-05-25,02:11,1,0,1
19,2025-05-24T18:11:00+02:00,2025-05-25,02:11,0,4,4
19,2025-05-24T18:13:00+02:00,2025-05-25,02:13,0,6,6
19,2025-05-24T18:17:00+02:00,2025-05-25,02:17,0,5,5
19,2025-05-24T18:22:00+02:00,2025-05-25,02:22,0,5,5
19,2025-05-24T18:23:00+02:00,2025-05-25,02:23,0,2,2
20,2025-05-24T18:10:00+02:00,2025-05-25,02:10,0,3,3
20,2025-05-24T18:11:00+02:00,2025-05-25,02:11,1,6,7
20,2025-05-24T18:15:00+02:00,2025-05-25,02:15,6,2,8
20,2025-05-24T18:18:00+02:00,2025-05-25,02:18,1,2,3
20,2025-05-24T18:22:00+02:00,2025-05-25,02:22,1,0,1
20,2025-05-24T18:24:00+02:00,2025-05-25,02:24,1,3,4
23,2025-05-24T18:16:00+02:00,2025-05-25,02:16,0,5,5
23,2025-05-24T18:20:00+02:00,2025-05-25,02:20,0,2,2
23,2025-05-24T18:24:00+02:00,2025-05-25,02:24,0,3,3
24,2025-05-24T18:10:00+02:00,2025-05-25,02:10,0,2,2
24,2025-05-24T18:12:00+02:00,2025-05-25,02:12,1,1,2
24,2025-05-24T18:22:00+02:00,2025-05-25,02:22,3,0,3
24,2025-05-24T18:23:00+02:00,2025-05-25,02:23,7,3,10
30,2025-05-24T18:10:00+02:00,2025-05-25,02:10,11,7,18
30,2025-05-24T18:11:00+02:00,2025-05-25,02:11,5,2,7
30,2025-05-24T18:13:00+02:00,2025-05-25,02:13,2,6,8
30,2025-05-24T18:22:00+02:00,2025-05-25,02:22,1,2,3
35,2025-05-24T18:19:00+02:00,2025-05-25,02:19,0,3,3
49,2025-05-24T18:17:00+02:00,2025-05-25,02:17,2,0,2
52,2025-05-24T18:18:00+02:00,2025-05-25,02:18,5,0,5
52,2025-05-24T18:21:00+02:00,2025-05-25,02:21,0,2,2
53,2025-05-24T18:21:00+02:00,2025-05-25,02:21,0,1,1
56,2025-05-24T18:10:00+02:00,2025-05-25,02:10,0,3,3
56,2025-05-24T18:12:00+02:00,2025-05-25,02:12,2,0,2
56,2025-05-24T18:13:00+02:00,2025-05-25,02:13,0,2,2
56,2025-05-24T18:24:00+02:00,2025-05-25,02:24,4,1,5
58,2025-05-24T18:19:00+02:00,2025-05-25,02:19,1,3,4
63,2025-05-24T18:10:00+02:00,2025-05-25,02:10,0,1,1
63,2025-05-24T18:14:00+02:00,2025-05-25,02:14,1,4,5
63,2025-05-24T18:15:00+02:00,2025-05-25,02:15,0,3,3
63,2025-05-24T18:17:00+02:00,2025-05-25,02:17,0,1,1
63,2025-05-24T18:18:00+02:00,2025-05-25,02:18,0,5,5
63,2025-05-24T18:19:00+02:00,2025-05-25,02:19,0,2,2
63,2025-05-24T18:22:00+02:00,2025-05-25,02:22,0,4,4
63,2025-05-24T18:23:00+02:00,2025-05-25,02:23,0,4,4
68,2025-05-24T18:16:00+02:00,2025-05-25,02:16,1,1,2
68,2025-05-24T18:22:00+02:00,2025-05-25,02:22,1,0,1
72,2025-05-24T18:18:00+02:00,2025-05-25,02:18,0,2,2
79,2025-05-24T18:16:00+02:00,2025-05-25,02:16,1,1,2
79,2025-05-24T18:21:00+02:00,2025-05-25,02:21,2,0,2
79,2025-05-24T18:22:00+02:00,2025-05-25,02:22,4,4,8
3,2025-05-24T17:56:00+02:00,2025-05-25,01:56,2,1,3
3,2025-05-24T17:57:00+02:00,2025-05-25,01:57,0,3,3
3,2025-05-24T18:03:00+02:00,2025-05-25,02:03,0,1,1
3,2025-05-24T18:07:00+02:00,2025-05-25,02:07,2,12,14
3,2025-05-24T18:09:00+02:00,2025-05-25,02:09,1,1,2
4,2025-05-24T17:58:00+02:00,2025-05-25,01:58,0,7,7
4,2025-05-24T17:59:00+02:00,2025-05-25,01:59,1,4,5
4,2025-05-24T18:00:00+02:00,2025-05-25,02:00,1,0,1
4,2025-05-24T18:01:00+02:00,2025-05-25,02:01,1,7,8
4,2025-05-24T18:03:00+02:00,2025-05-25,02:03,0,9,9
4,2025-05-24T18:06:00+02:00,2025-05-25,02:06,0,10,10
4,2025-05-24T18:07:00+02:00,2025-05-25,02:07,2,1,3
5,2025-05-24T18:00:00+02:00,2025-05-25,02:00,2,4,6
5,2025-05-24T18:05:00+02:00,2025-05-25,02:05,2,3,5
6,2025-05-24T17:58:00+02:00,2025-05-25,01:58,5,0,5
6,2025-05-24T18:05:00+02:00,2025-05-25,02:05,2,7,9
6,2025-05-24T18:06:00+02:00,2025-05-25,02:06,8,1,9
6,2025-05-24T18:07:00+02:00,2025-05-25,02:07,4,0,4
6,2025-05-24T18:08:00+02:00,2025-05-25,02:08,0,5,5
28,2025-05-24T17:56:00+02:00,2025-05-25,01:56,1,0,1
28,2025-05-24T18:02:00+02:00,2025-05-25,02:02,1,0,1
28,2025-05-24T18:04:00+02:00,2025-05-25,02:04,0,1,1
28,2025-05-24T18:09:00+02:00,2025-05-25,02:09,3,0,3
29,2025-05-24T18:03:00+02:00,2025-05-25,02:03,0,2,2
36,2025-05-24T17:56:00+02:00,2025-05-25,01:56,3,2,5
36,2025-05-24T17:57:00+02:00,2025-05-25,01:57,3,7,10
36,2025-05-24T18:02:00+02:00,2025-05-25,02:02,1,3,4
36,2025-05-24T18:06:00+02:00,2025-05-25,02:06,3,4,7
36,2025-05-24T18:07:00+02:00,2025-05-25,02:07,1,3,4
36,2025-05-24T18:08:00+02:00,2025-05-25,02:08,1,2,3
36,2025-05-24T18:09:00+02:00,2025-05-25,02:09,3,4,7
40,2025-05-24T18:00:00+02:00,2025-05-25,02:00,1,0,1
41,2025-05-24T17:57:00+02:00,2025-05-25,01:57,4,2,6
41,2025-05-24T18:01:00+02:00,2025-05-25,02:01,0,2,2
41,2025-05-24T18:03:00+02:00,2025-05-25,02:03,0,2,2
41,2025-05-24T18:04:00+02:00,2025-05-25,02:04,0,8,8
41,2025-05-24T18:05:00+02:00,2025-05-25,02:05,0,5,5
41,2025-05-24T18:09:00+02:00,2025-05-25,02:09,1,0,1
45,2025-05-24T17:56:00+02:00,2025-05-25,01:56,0,3,3
45,2025-05-24T17:58:00+02:00,2025-05-25,01:58,0,2,2
45,2025-05-24T18:03:00+02:00,2025-05-25,02:03,1,2,3
45,2025-05-24T18:06:00+02:00,2025-05-25,02:06,1,1,2
47,2025-05-24T17:57:00+02:00,2025-05-25,01:57,3,6,9
47,2025-05-24T18:06:00+02:00,2025-05-25,02:06,1,1,2
54,2025-05-24T17:57:00+02:00,2025-05-25,01:57,1,0,1
59,2025-05-24T17:55:00+02:00,2025-05-25,01:55,22,2,24
59,2025-05-24T18:05:00+02:00,2025-05-25,02:05,1,3,4
61,2025-05-24T17:58:00+02:00,2025-05-25,01:58,0,4,4
61,2025-05-24T17:59:00+02:00,2025-05-25,01:59,3,0,3
61,2025-05-24T18:02:00+02:00,2025-05-25,02:02,0,2,2
61,2025-05-24T18:08:00+02:00,2025-05-25,02:08,4,0,4
66,2025-05-24T17:57:00+02:00,2025-05-25,01:57,1,1,2
66,2025-05-24T18:04:00+02:00,2025-05-25,02:04,0,2,2
66,2025-05-24T18:05:00+02:00,2025-05-25,02:05,3,4,7
66,2025-05-24T18:06:00+02:00,2025-05-25,02:06,3,3,6
66,2025-05-24T18:07:00+02:00,2025-05-25,02:07,3,0,3
84,2025-05-24T17:55:00+02:00,2025-05-25,01:55,2,18,20
84,2025-05-24T18:00:00+02:00,2025-05-25,02:00,9,12,21
87,2025-05-24T17:56:00+02:00,2025-05-25,01:56,0,1,1
107,2025-05-24T18:00:00+02:00,2025-05-25,02:00,1,0,1
108,2025-05-24T18:01:00+02:00,2025-05-25,02:01,2,0,2
108,2025-05-24T18:03:00+02:00,2025-05-25,02:03,1,1,2
108,2025-05-24T18:06:00+02:00,2025-05-25,02:06,0,1,1
118,2025-05-24T18:00:00+02:00,2025-05-25,02:00,0,1,1
131,2025-05-24T18:00:00+02:00,2025-05-25,02:00,1,11,12
131,2025-05-24T18:05:00+02:00,2025-05-25,02:05,4,7,11
132,2025-05-24T18:00:00+02:00,2025-05-25,02:00,4,1,5
133,2025-05-24T18:00:00+02:00,2025-05-25,02:00,3,3,6
134,2025-05-24T17:55:00+02:00,2025-05-25,01:55,6,3,9
134,2025-05-24T18:00:00+02:00,2025-05-25,02:00,4,3,7
135,2025-05-24T17:55:00+02:00,2025-05-25,01:55,10,7,17
135,2025-05-24T18:00:00+02:00,2025-05-25,02:00,11,3,14
162,2025-05-24T17:55:00+02:00,2025-05-25,01:55,7,3,10
162,2025-05-24T18:05:00+02:00,2025-05-25,02:05,15,4,19
179,2025-05-24T17:55:00+02:00,2025-05-25,01:55,2,0,2
1,2025-05-24T17:58:00+02:00,2025-05-25,01:58,1,1,2
1,2025-05-24T18:06:00+02:00,2025-05-25,02:06,0,6,6
1,2025-05-24T18:07:00+02:00,2025-05-25,02:07,0,1,1
2,2025-05-24T18:03:00+02:00,2025-05-25,02:03,1,0,1
10,2025-05-24T18:01:00+02:00,2025-05-25,02:01,0,1,1
10,2025-05-24T18:05:00+02:00,2025-05-25,02:05,1,0,1
19,2025-05-24T17:57:00+02:00,2025-05-25,01:57,5,3,8
19,2025-05-24T18:00:00+02:00,2025-05-25,02:00,0,9,9
19,2025-05-24T18:06:00+02:00,2025-05-25,02:06,6,3,9
20,2025-05-24T17:55:00+02:00,2025-05-25,01:55,0,5,5
20,2025-05-24T17:57:00+02:00,2025-05-25,01:57,1,8,9
20,2025-05-24T18:01:00+02:00,2025-05-25,02:01,2,1,3
20,2025-05-24T18:02:00+02:00,2025-05-25,02:02,3,3,6
20,2025-05-24T18:03:00+02:00,2025-05-25,02:03,0,2,2
20,2025-05-24T18:07:00+02:00,2025-05-25,02:07,4,4,8
20,2025-05-24T18:08:00+02:00,2025-05-25,02:08,2,1,3
20,2025-05-24T18:09:00+02:00,2025-05-25,02:09,6,4,10
23,2025-05-24T18:01:00+02:00,2025-05-25,02:01,0,1,1
23,2025-05-24T18:06:00+02:00,2025-05-25,02:06,1,0,1
24,2025-05-24T17:55:00+02:00,2025-05-25,01:55,3,6,9
24,2025-05-24T17:56:00+02:00,2025-05-25,01:56,0,6,6
24,2025-05-24T17:57:00+02:00,2025-05-25,01:57,6,6,12
24,2025-05-24T17:58:00+02:00,2025-05-25,01:58,0,2,2
24,2025-05-24T17:59:00+02:00,2025-05-25,01:59,0,2,2
24,2025-05-24T18:01:00+02:00,2025-05-25,02:01,0,1,1
24,2025-05-24T18:02:00+02:00,2025-05-25,02:02,0,1,1
24,2025-05-24T18:03:00+02:00,2025-05-25,02:03,0,1,1
24,2025-05-24T18:09:00+02:00,2025-05-25,02:09,3,0,3
30,2025-05-24T17:56:00+02:00,2025-05-25,01:56,4,6,10
30,2025-05-24T17:58:00+02:00,2025-05-25,01:58,2,3,5
30,2025-05-24T18:05:00+02:00,2025-05-25,02:05,1,4,5
35,2025-05-24T17:57:00+02:00,2025-05-25,01:57,1,1,2
35,2025-05-24T17:58:00+02:00,2025-05-25,01:58,0,1,1
35,2025-05-24T17:59:00+02:00,2025-05-25,01:59,0,2,2
35,2025-05-24T18:00:00+02:00,2025-05-25,02:00,3,1,4
35,2025-05-24T18:02:00+02:00,2025-05-25,02:02,2,0,2
35,2025-05-24T18:07:00+02:00,2025-05-25,02:07,1,1,2
49,2025-05-24T18:00:00+02:00,2025-05-25,02:00,0,4,4
49,2025-05-24T18:08:00+02:00,2025-05-25,02:08,1,2,3
52,2025-05-24T17:59:00+02:00,2025-05-25,01:59,0,1,1
52,2025-05-24T18:01:00+02:00,2025-05-25,02:01,1,1,2
52,2025-05-24T18:02:00+02:00,2025-05-25,02:02,0,5,5
52,2025-05-24T18:03:00+02:00,2025-05-25,02:03,1,4,5
53,2025-05-24T17:56:00+02:00,2025-05-25,01:56,2,0,2
53,2025-05-24T18:00:00+02:00,2025-05-25,02:00,0,2,2
53,2025-05-24T18:06:00+02:00,2025-05-25,02:06,1,0,1
56,2025-05-24T17:55:00+02:00,2025-05-25,01:55,0,2,2
56,2025-05-24T17:59:00+02:00,2025-05-25,01:59,0,4,4
56,2025-05-24T18:09:00+02:00,2025-05-25,02:09,0,5,5
58,2025-05-24T17:55:00+02:00,2025-05-25,01:55,0,5,5
58,2025-05-24T18:00:00+02:00,2025-05-25,02:00,3,3,6
58,2025-05-24T18:03:00+02:00,2025-05-25,02:03,1,0,1
58,2025-05-24T18:06:00+02:00,2025-05-25,02:06,3,2,5
58,2025-05-24T18:08:00+02:00,2025-05-25,02:08,1,0,1
58,2025-05-24T18:09:00+02:00,2025-05-25,02:09,0,3,3
62,2025-05-24T17:55:00+02:00,2025-05-25,01:55,1,0,1
62,2025-05-24T17:56:00+02:00,2025-05-25,01:56,3,2,5
62,2025-05-24T17:59:00+02:00,2025-05-25,01:59,1,0,1
63,2025-05-24T17:56:00+02:00,2025-05-25,01:56,0,1,1
63,2025-05-24T17:58:00+02:00,2025-05-25,01:58,0,5,5
63,2025-05-24T18:00:00+02:00,2025-05-25,02:00,2,1,3
67,2025-05-24T17:58:00+02:00,2025-05-25,01:58,0,1,1
67,2025-05-24T18:02:00+02:00,2025-05-25,02:02,0,2,2
67,2025-05-24T18:04:00+02:00,2025-05-25,02:04,0,2,2
72,2025-05-24T18:07:00+02:00,2025-05-25,02:07,0,1,1
79,2025-05-24T17:57:00+02:00,2025-05-25,01:57,3,2,5
79,2025-05-24T18:03:00+02:00,2025-05-25,02:03,1,0,1
79,2025-05-24T18:04:00+02:00,2025-05-25,02:04,1,1,2
79,2025-05-24T18:05:00+02:00,2025-05-25,02:05,0,5,5
79,2025-05-24T18:06:00+02:00,2025-05-25,02:06,0,1,1
79,2025-05-24T18:07:00+02:00,2025-05-25,02:07,1,1,2
79,2025-05-24T18:08:00+02:00,2025-05-25,02:08,0,1,1
79,2025-05-24T18:09:00+02:00,2025-05-25,02:09,1,1,2
85,2025-05-24T17:55:00+02:00,2025-05-25,01:55,1,0,1
109,2025-05-24T17:55:00+02:00,2025-05-25,01:55,2,1,3
109,2025-05-24T18:05:00+02:00,2025-05-25,02:05,0,1,1
117,2025-05-24T17:55:00+02:00,2025-05-25,01:55,6,0,6
117,2025-05-24T18:00:00+02:00,2025-05-25,02:00,1,1,2
117,2025-05-24T18:05:00+02:00,2025-05-25,02:05,11,7,18
137,2025-05-24T18:05:00+02:00,2025-05-25,02:05,0,1,1
141,2025-05-24T17:55:00+02:00,2025-05-25,01:55,5,1,6
181,2025-05-24T18:01:00+02:00,2025-05-25,02:01,3,2,5
181,2025-05-24T18:12:00+02:00,2025-05-25,02:12,2,1,3
181,2025-05-24T18:13:00+02:00,2025-05-25,02:13,1,2,3
181,2025-05-24T18:15:00+02:00,2025-05-25,02:15,3,1,4
181,2025-05-24T18:16:00+02:00,2025-05-25,02:16,4,5,9
182,2025-05-24T18:15:00+02:00,2025-05-25,02:15,11,13,24
3,2025-05-24T18:25:00+02:00,2025-05-25,02:25,5,0,5
3,2025-05-24T18:30:00+02:00,2025-05-25,02:30,5,1,6
3,2025-05-24T18:32:00+02:00,2025-05-25,02:32,2,0,2
3,2025-05-24T18:36:00+02:00,2025-05-25,02:36,1,5,6
3,2025-05-24T18:37:00+02:00,2025-05-25,02:37,3,5,8
4,2025-05-24T18:29:00+02:00,2025-05-25,02:29,0,1,1
4,2025-05-24T18:32:00+02:00,2025-05-25,02:32,5,4,9
4,2025-05-24T18:37:00+02:00,2025-05-25,02:37,5,1,6
5,2025-05-24T18:25:00+02:00,2025-05-25,02:25,5,4,9
6,2025-05-24T18:28:00+02:00,2025-05-25,02:28,0,1,1
6,2025-05-24T18:35:00+02:00,2025-05-25,02:35,3,1,4
6,2025-05-24T18:36:00+02:00,2025-05-25,02:36,4,0,4
6,2025-05-24T18:37:00+02:00,2025-05-25,02:37,0,2,2
28,2025-05-24T18:33:00+02:00,2025-05-25,02:33,3,0,3
28,2025-05-24T18:38:00+02:00,2025-05-25,02:38,0,1,1
29,2025-05-24T18:30:00+02:00,2025-05-25,02:30,0,1,1
29,2025-05-24T18:34:00+02:00,2025-05-25,02:34,0,3,3
36,2025-05-24T18:26:00+02:00,2025-05-25,02:26,2,0,2
36,2025-05-24T18:29:00+02:00,2025-05-25,02:29,2,0,2
40,2025-05-24T18:28:00+02:00,2025-05-25,02:28,2,0,2
41,2025-05-24T18:27:00+02:00,2025-05-25,02:27,1,5,6
41,2025-05-24T18:32:00+02:00,2025-05-25,02:32,0,3,3
45,2025-05-24T18:29:00+02:00,2025-05-25,02:29,3,2,5
45,2025-05-24T18:32:00+02:00,2025-05-25,02:32,1,1,2
45,2025-05-24T18:36:00+02:00,2025-05-25,02:36,0,1,1
45,2025-05-24T18:38:00+02:00,2025-05-25,02:38,0,2,2
45,2025-05-24T18:39:00+02:00,2025-05-25,02:39,0,4,4
47,2025-05-24T18:26:00+02:00,2025-05-25,02:26,1,2,3
47,2025-05-24T18:30:00+02:00,2025-05-25,02:30,3,1,4
47,2025-05-24T18:33:00+02:00,2025-05-25,02:33,2,0,2
47,2025-05-24T18:35:00+02:00,2025-05-25,02:35,4,2,6
47,2025-05-24T18:38:00+02:00,2025-05-25,02:38,6,0,6
54,2025-05-24T18:34:00+02:00,2025-05-25,02:34,1,0,1
54,2025-05-24T18:38:00+02:00,2025-05-25,02:38,0,2,2
59,2025-05-24T18:25:00+02:00,2025-05-25,02:25,3,4,7
59,2025-05-24T18:30:00+02:00,2025-05-25,02:30,1,2,3
59,2025-05-24T18:35:00+02:00,2025-05-25,02:35,6,1,7
61,2025-05-24T18:25:00+02:00,2025-05-25,02:25,2,0,2
61,2025-05-24T18:34:00+02:00,2025-05-25,02:34,2,0,2
61,2025-05-24T18:37:00+02:00,2025-05-25,02:37,2,0,2
66,2025-05-24T18:26:00+02:00,2025-05-25,02:26,1,0,1
66,2025-05-24T18:30:00+02:00,2025-05-25,02:30,0,2,2
66,2025-05-24T18:33:00+02:00,2025-05-25,02:33,5,0,5
66,2025-05-24T18:39:00+02:00,2025-05-25,02:39,3,0,3
69,2025-05-24T18:27:00+02:00,2025-05-25,02:27,1,0,1
69,2025-05-24T18:31:00+02:00,2025-05-25,02:31,4,0,4
70,2025-05-24T18:27:00+02:00,2025-05-25,02:27,1,0,1
75,2025-05-24T18:38:00+02:00,2025-05-25,02:38,0,1,1
77,2025-05-24T18:25:00+02:00,2025-05-25,02:25,1,0,1
84,2025-05-24T18:25:00+02:00,2025-05-25,02:25,1,17,18
107,2025-05-24T18:25:00+02:00,2025-05-25,02:25,0,3,3
108,2025-05-24T18:27:00+02:00,2025-05-25,02:27,0,2,2
108,2025-05-24T18:28:00+02:00,2025-05-25,02:28,2,0,2
108,2025-05-24T18:29:00+02:00,2025-05-25,02:29,0,2,2
133,2025-05-24T18:25:00+02:00,2025-05-25,02:25,1,1,2
134,2025-05-24T18:25:00+02:00,2025-05-25,02:25,4,2,6
134,2025-05-24T18:30:00+02:00,2025-05-25,02:30,5,4,9
135,2025-05-24T18:35:00+02:00,2025-05-25,02:35,4,3,7
162,2025-05-24T18:30:00+02:00,2025-05-25,02:30,7,3,10
179,2025-05-24T18:30:00+02:00,2025-05-25,02:30,1,0,1
179,2025-05-24T18:35:00+02:00,2025-05-25,02:35,0,2,2
1,2025-05-24T18:25:00+02:00,2025-05-25,02:25,5,1,6
1,2025-05-24T18:26:00+02:00,2025-05-25,02:26,0,2,2
1,2025-05-24T18:29:00+02:00,2025-05-25,02:29,0,4,4
1,2025-05-24T18:34:00+02:00,2025-05-25,02:34,4,1,5
1,2025-05-24T18:35:00+02:00,2025-05-25,02:35,1,2,3
2,2025-05-24T18:25:00+02:00,2025-05-25,02:25,0,3,3
2,2025-05-24T18:26:00+02:00,2025-05-25,02:26,3,0,3
2,2025-05-24T18:32:00+02:00,2025-05-25,02:32,0,3,3
9,2025-05-24T18:28:00+02:00,2025-05-25,02:28,0,1,1
10,2025-05-24T18:36:00+02:00,2025-05-25,02:36,0,1,1
12,2025-05-24T18:32:00+02:00,2025-05-25,02:32,1,1,2
19,2025-05-24T18:25:00+02:00,2025-05-25,02:25,1,4,5
19,2025-05-24T18:39:00+02:00,2025-05-25,02:39,0,2,2
20,2025-05-24T18:34:00+02:00,2025-05-25,02:34,1,2,3
20,2025-05-24T18:35:00+02:00,2025-05-25,02:35,1,5,6
20,2025-05-24T18:37:00+02:00,2025-05-25,02:37,3,3,6
20,2025-05-24T18:38:00+02:00,2025-05-25,02:38,2,7,9
20,2025-05-24T18:39:00+02:00,2025-05-25,02:39,2,1,3
23,2025-05-24T18:32:00+02:00,2025-05-25,02:32,0,1,1
24,2025-05-24T18:27:00+02:00,2025-05-25,02:27,1,4,5
24,2025-05-24T18:34:00+02:00,2025-05-25,02:34,0,1,1
27,2025-05-24T18:29:00+02:00,2025-05-25,02:29,2,0,2
30,2025-05-24T18:27:00+02:00,2025-05-25,02:27,5,3,8
30,2025-05-24T18:29:00+02:00,2025-05-25,02:29,2,0,2
30,2025-05-24T18:33:00+02:00,2025-05-25,02:33,1,9,10
30,2025-05-24T18:34:00+02:00,2025-05-25,02:34,0,2,2
30,2025-05-24T18:38:00+02:00,2025-05-25,02:38,2,9,11
30,2025-05-24T18:39:00+02:00,2025-05-25,02:39,2,3,5
35,2025-05-24T18:26:00+02:00,2025-05-25,02:26,0,1,1
35,2025-05-24T18:27:00+02:00,2025-05-25,02:27,4,3,7
35,2025-05-24T18:28:00+02:00,2025-05-25,02:28,2,0,2
35,2025-05-24T18:29:00+02:00,2025-05-25,02:29,1,0,1
35,2025-05-24T18:30:00+02:00,2025-05-25,02:30,1,0,1
35,2025-05-24T18:33:00+02:00,2025-05-25,02:33,3,0,3
35,2025-05-24T18:38:00+02:00,2025-05-25,02:38,0,4,4
35,2025-05-24T18:39:00+02:00,2025-05-25,02:39,0,1,1
49,2025-05-24T18:26:00+02:00,2025-05-25,02:26,1,0,1
49,2025-05-24T18:27:00+02:00,2025-05-25,02:27,0,2,2
49,2025-05-24T18:28:00+02:00,2025-05-25,02:28,0,2,2
49,2025-05-24T18:30:00+02:00,2025-05-25,02:30,2,5,7
49,2025-05-24T18:37:00+02:00,2025-05-25,02:37,0,1,1
49,2025-05-24T18:38:00+02:00,2025-05-25,02:38,6,2,8
49,2025-05-24T18:39:00+02:00,2025-05-25,02:39,3,1,4
52,2025-05-24T18:32:00+02:00,2025-05-25,02:32,0,2,2
52,2025-05-24T18:36:00+02:00,2025-05-25,02:36,2,3,5
52,2025-05-24T18:38:00+02:00,2025-05-25,02:38,1,9,10
52,2025-05-24T18:39:00+02:00,2025-05-25,02:39,1,2,3
53,2025-05-24T18:26:00+02:00,2025-05-25,02:26,0,1,1
53,2025-05-24T18:27:00+02:00,2025-05-25,02:27,1,1,2
56,2025-05-24T18:28:00+02:00,2025-05-25,02:28,6,1,7
58,2025-05-24T18:30:00+02:00,2025-05-25,02:30,4,0,4
58,2025-05-24T18:33:00+02:00,2025-05-25,02:33,4,0,4
58,2025-05-24T18:38:00+02:00,2025-05-25,02:38,1,0,1
62,2025-05-24T18:27:00+02:00,2025-05-25,02:27,1,0,1
62,2025-05-24T18:28:00+02:00,2025-05-25,02:28,0,1,1
62,2025-05-24T18:35:00+02:00,2025-05-25,02:35,3,0,3
62,2025-05-24T18:38:00+02:00,2025-05-25,02:38,0,1,1
63,2025-05-24T18:25:00+02:00,2025-05-25,02:25,0,2,2
63,2025-05-24T18:32:00+02:00,2025-05-25,02:32,0,2,2
63,2025-05-24T18:33:00+02:00,2025-05-25,02:33,0,1,1
63,2025-05-24T18:35:00+02:00,2025-05-25,02:35,0,2,2
67,2025-05-24T18:26:00+02:00,2025-05-25,02:26,3,0,3
67,2025-05-24T18:27:00+02:00,2025-05-25,02:27,0,3,3
67,2025-05-24T18:30:00+02:00,2025-05-25,02:30,0,3,3
67,2025-05-24T18:31:00+02:00,2025-05-25,02:31,0,1,1
67,2025-05-24T18:39:00+02:00,2025-05-25,02:39,1,0,1
79,2025-05-24T18:27:00+02:00,2025-05-25,02:27,6,0,6
79,2025-05-24T18:31:00+02:00,2025-05-25,02:31,1,0,1
79,2025-05-24T18:38:00+02:00,2025-05-25,02:38,5,2,7
86,2025-05-24T18:39:00+02:00,2025-05-25,02:39,0,1,1
109,2025-05-24T18:30:00+02:00,2025-05-25,02:30,7,0,7
117,2025-05-24T18:30:00+02:00,2025-05-25,02:30,2,0,2
117,2025-05-24T18:35:00+02:00,2025-05-25,02:35,2,0,2
141,2025-05-24T18:30:00+02:00,2025-05-25,02:30,11,0,11
142,2025-05-24T18:30:00+02:00,2025-05-25,02:30,1,0,1
181,2025-05-24T18:30:00+02:00,2025-05-25,02:30,3,3,6
181,2025-05-24T18:36:00+02:00,2025-05-25,02:36,2,3,5
182,2025-05-24T18:35:00+02:00,2025-05-25,02:35,5,7,12
3,2025-05-24T19:11:00+02:00,2025-05-25,03:11,4,0,4
3,2025-05-24T19:14:00+02:00,2025-05-25,03:14,1,3,4
3,2025-05-24T19:15:00+02:00,2025-05-25,03:15,0,2,2
3,2025-05-24T19:18:00+02:00,2025-05-25,03:18,5,3,8
3,2025-05-24T19:19:00+02:00,2025-05-25,03:19,1,9,10
4,2025-05-24T19:12:00+02:00,2025-05-25,03:12,0,4,4
4,2025-05-24T19:13:00+02:00,2025-05-25,03:13,2,1,3
4,2025-05-24T19:16:00+02:00,2025-05-25,03:16,0,2,2
4,2025-05-24T19:18:00+02:00,2025-05-25,03:18,0,4,4
4,2025-05-24T19:19:00+02:00,2025-05-25,03:19,0,3,3
4,2025-05-24T19:24:00+02:00,2025-05-25,03:24,0,1,1
5,2025-05-24T19:20:00+02:00,2025-05-25,03:20,0,8,8
6,2025-05-24T19:20:00+02:00,2025-05-25,03:20,1,1,2
6,2025-05-24T19:23:00+02:00,2025-05-25,03:23,1,2,3
28,2025-05-24T19:22:00+02:00,2025-05-25,03:22,1,0,1
28,2025-05-24T19:23:00+02:00,2025-05-25,03:23,0,1,1
29,2025-05-24T19:24:00+02:00,2025-05-25,03:24,0,1,1
31,2025-05-24T19:19:00+02:00,2025-05-25,03:19,0,1,1
36,2025-05-24T19:12:00+02:00,2025-05-25,03:12,2,3,5
36,2025-05-24T19:14:00+02:00,2025-05-25,03:14,0,3,3
36,2025-05-24T19:15:00+02:00,2025-05-25,03:15,3,1,4
36,2025-05-24T19:20:00+02:00,2025-05-25,03:20,4,0,4
36,2025-05-24T19:21:00+02:00,2025-05-25,03:21,12,4,16
41,2025-05-24T19:22:00+02:00,2025-05-25,03:22,0,3,3
43,2025-05-24T19:15:00+02:00,2025-05-25,03:15,1,0,1
45,2025-05-24T19:13:00+02:00,2025-05-25,03:13,0,2,2
45,2025-05-24T19:14:00+02:00,2025-05-25,03:14,2,3,5
45,2025-05-24T19:15:00+02:00,2025-05-25,03:15,2,6,8
45,2025-05-24T19:19:00+02:00,2025-05-25,03:19,1,1,2
45,2025-05-24T19:22:00+02:00,2025-05-25,03:22,0,2,2
45,2025-05-24T19:23:00+02:00,2025-05-25,03:23,0,3,3
47,2025-05-24T19:14:00+02:00,2025-05-25,03:14,2,0,2
47,2025-05-24T19:15:00+02:00,2025-05-25,03:15,3,1,4
54,2025-05-24T19:11:00+02:00,2025-05-25,03:11,1,0,1
54,2025-05-24T19:17:00+02:00,2025-05-25,03:17,4,1,5
54,2025-05-24T19:24:00+02:00,2025-05-25,03:24,4,0,4
59,2025-05-24T19:15:00+02:00,2025-05-25,03:15,19,2,21
61,2025-05-24T19:11:00+02:00,2025-05-25,03:11,1,0,1
61,2025-05-24T19:15:00+02:00,2025-05-25,03:15,3,0,3
61,2025-05-24T19:16:00+02:00,2025-05-25,03:16,1,1,2
61,2025-05-24T19:18:00+02:00,2025-05-25,03:18,1,0,1
66,2025-05-24T19:14:00+02:00,2025-05-25,03:14,0,5,5
66,2025-05-24T19:15:00+02:00,2025-05-25,03:15,3,6,9
66,2025-05-24T19:16:00+02:00,2025-05-25,03:16,5,9,14
66,2025-05-24T19:17:00+02:00,2025-05-25,03:17,0,2,2
66,2025-05-24T19:21:00+02:00,2025-05-25,03:21,3,0,3
66,2025-05-24T19:23:00+02:00,2025-05-25,03:23,1,2,3
69,2025-05-24T19:20:00+02:00,2025-05-25,03:20,0,3,3
75,2025-05-24T19:16:00+02:00,2025-05-25,03:16,0,1,1
84,2025-05-24T19:10:00+02:00,2025-05-25,03:10,3,5,8
87,2025-05-24T19:13:00+02:00,2025-05-25,03:13,0,1,1
107,2025-05-24T19:20:00+02:00,2025-05-25,03:20,3,0,3
132,2025-05-24T19:20:00+02:00,2025-05-25,03:20,2,4,6
133,2025-05-24T19:15:00+02:00,2025-05-25,03:15,4,2,6
134,2025-05-24T19:20:00+02:00,2025-05-25,03:20,6,8,14
135,2025-05-24T19:10:00+02:00,2025-05-25,03:10,3,1,4
162,2025-05-24T19:15:00+02:00,2025-05-25,03:15,1,2,3
165,2025-05-24T19:20:00+02:00,2025-05-25,03:20,1,0,1
179,2025-05-24T19:10:00+02:00,2025-05-25,03:10,0,1,1
1,2025-05-24T19:19:00+02:00,2025-05-25,03:19,0,2,2
1,2025-05-24T19:20:00+02:00,2025-05-25,03:20,1,3,4
2,2025-05-24T19:12:00+02:00,2025-05-25,03:12,0,4,4
2,2025-05-24T19:14:00+02:00,2025-05-25,03:14,0,1,1
2,2025-05-24T19:18:00+02:00,2025-05-25,03:18,1,0,1
9,2025-05-24T19:22:00+02:00,2025-05-25,03:22,0,1,1
11,2025-05-24T19:10:00+02:00,2025-05-25,03:10,2,0,2
12,2025-05-24T19:22:00+02:00,2025-05-25,03:22,1,0,1
19,2025-05-24T19:11:00+02:00,2025-05-25,03:11,0,3,3
19,2025-05-24T19:13:00+02:00,2025-05-25,03:13,1,3,4
20,2025-05-24T19:12:00+02:00,2025-05-25,03:12,0,11,11
20,2025-05-24T19:14:00+02:00,2025-05-25,03:14,1,5,6
20,2025-05-24T19:16:00+02:00,2025-05-25,03:16,0,5,5
20,2025-05-24T19:17:00+02:00,2025-05-25,03:17,1,7,8
20,2025-05-24T19:22:00+02:00,2025-05-25,03:22,9,2,11
20,2025-05-24T19:23:00+02:00,2025-05-25,03:23,2,4,6
20,2025-05-24T19:24:00+02:00,2025-05-25,03:24,2,5,7
23,2025-05-24T19:21:00+02:00,2025-05-25,03:21,0,1,1
24,2025-05-24T19:14:00+02:00,2025-05-25,03:14,0,1,1
25,2025-05-24T19:15:00+02:00,2025-05-25,03:15,1,3,4
25,2025-05-24T19:20:00+02:00,2025-05-25,03:20,0,1,1
27,2025-05-24T19:19:00+02:00,2025-05-25,03:19,1,0,1
27,2025-05-24T19:20:00+02:00,2025-05-25,03:20,1,0,1
30,2025-05-24T19:16:00+02:00,2025-05-25,03:16,8,0,8
30,2025-05-24T19:21:00+02:00,2025-05-25,03:21,2,1,3
35,2025-05-24T19:17:00+02:00,2025-05-25,03:17,1,0,1
35,2025-05-24T19:20:00+02:00,2025-05-25,03:20,3,1,4
35,2025-05-24T19:22:00+02:00,2025-05-25,03:22,2,1,3
35,2025-05-24T19:24:00+02:00,2025-05-25,03:24,1,0,1
49,2025-05-24T19:10:00+02:00,2025-05-25,03:10,7,3,10
49,2025-05-24T19:13:00+02:00,2025-05-25,03:13,3,3,6
49,2025-05-24T19:22:00+02:00,2025-05-25,03:22,0,1,1
49,2025-05-24T19:24:00+02:00,2025-05-25,03:24,2,5,7
51,2025-05-24T19:14:00+02:00,2025-05-25,03:14,1,0,1
52,2025-05-24T19:19:00+02:00,2025-05-25,03:19,1,0,1
52,2025-05-24T19:22:00+02:00,2025-05-25,03:22,1,1,2
52,2025-05-24T19:24:00+02:00,2025-05-25,03:24,7,1,8
53,2025-05-24T19:12:00+02:00,2025-05-25,03:12,2,0,2
56,2025-05-24T19:15:00+02:00,2025-05-25,03:15,1,0,1
58,2025-05-24T19:12:00+02:00,2025-05-25,03:12,1,1,2
58,2025-05-24T19:22:00+02:00,2025-05-25,03:22,2,0,2
62,2025-05-24T19:15:00+02:00,2025-05-25,03:15,1,0,1
63,2025-05-24T19:10:00+02:00,2025-05-25,03:10,0,2,2
63,2025-05-24T19:12:00+02:00,2025-05-25,03:12,0,2,2
63,2025-05-24T19:13:00+02:00,2025-05-25,03:13,0,1,1
67,2025-05-24T19:17:00+02:00,2025-05-25,03:17,1,1,2
67,2025-05-24T19:19:00+02:00,2025-05-25,03:19,0,2,2
68,2025-05-24T19:23:00+02:00,2025-05-25,03:23,1,1,2
72,2025-05-24T19:16:00+02:00,2025-05-25,03:16,0,1,1
79,2025-05-24T19:14:00+02:00,2025-05-25,03:14,2,2,4
79,2025-05-24T19:15:00+02:00,2025-05-25,03:15,0,2,2
79,2025-05-24T19:19:00+02:00,2025-05-25,03:19,1,0,1
109,2025-05-24T19:15:00+02:00,2025-05-25,03:15,0,1,1
117,2025-05-24T19:20:00+02:00,2025-05-25,03:20,0,2,2
139,2025-05-24T19:15:00+02:00,2025-05-25,03:15,1,0,1
3,2025-05-24T18:41:00+02:00,2025-05-25,02:41,0,1,1
3,2025-05-24T18:44:00+02:00,2025-05-25,02:44,1,4,5
3,2025-05-24T18:48:00+02:00,2025-05-25,02:48,4,0,4
3,2025-05-24T18:49:00+02:00,2025-05-25,02:49,4,0,4
4,2025-05-24T18:44:00+02:00,2025-05-25,02:44,1,0,1
4,2025-05-24T18:45:00+02:00,2025-05-25,02:45,0,4,4
4,2025-05-24T18:47:00+02:00,2025-05-25,02:47,1,13,14
4,2025-05-24T18:54:00+02:00,2025-05-25,02:54,2,2,4
5,2025-05-24T18:45:00+02:00,2025-05-25,02:45,3,4,7
5,2025-05-24T18:50:00+02:00,2025-05-25,02:50,3,1,4
6,2025-05-24T18:40:00+02:00,2025-05-25,02:40,0,3,3
6,2025-05-24T18:41:00+02:00,2025-05-25,02:41,7,0,7
6,2025-05-24T18:47:00+02:00,2025-05-25,02:47,1,1,2
6,2025-05-24T18:49:00+02:00,2025-05-25,02:49,0,1,1
6,2025-05-24T18:51:00+02:00,2025-05-25,02:51,0,1,1
6,2025-05-24T18:53:00+02:00,2025-05-25,02:53,0,2,2
28,2025-05-24T18:43:00+02:00,2025-05-25,02:43,2,0,2
28,2025-05-24T18:45:00+02:00,2025-05-25,02:45,1,0,1
28,2025-05-24T18:46:00+02:00,2025-05-25,02:46,3,0,3
28,2025-05-24T18:47:00+02:00,2025-05-25,02:47,0,2,2
28,2025-05-24T18:49:00+02:00,2025-05-25,02:49,1,0,1
31,2025-05-24T18:41:00+02:00,2025-05-25,02:41,1,0,1
31,2025-05-24T18:49:00+02:00,2025-05-25,02:49,1,0,1
31,2025-05-24T18:53:00+02:00,2025-05-25,02:53,0,1,1
36,2025-05-24T18:43:00+02:00,2025-05-25,02:43,2,0,2
36,2025-05-24T18:48:00+02:00,2025-05-25,02:48,1,0,1
36,2025-05-24T18:50:00+02:00,2025-05-25,02:50,2,5,7
36,2025-05-24T18:52:00+02:00,2025-05-25,02:52,5,0,5
36,2025-05-24T18:53:00+02:00,2025-05-25,02:53,0,2,2
41,2025-05-24T18:41:00+02:00,2025-05-25,02:41,0,1,1
41,2025-05-24T18:42:00+02:00,2025-05-25,02:42,0,2,2
41,2025-05-24T18:49:00+02:00,2025-05-25,02:49,2,4,6
41,2025-05-24T18:51:00+02:00,2025-05-25,02:51,0,2,2
41,2025-05-24T18:54:00+02:00,2025-05-25,02:54,0,4,4
45,2025-05-24T18:40:00+02:00,2025-05-25,02:40,0,2,2
45,2025-05-24T18:43:00+02:00,2025-05-25,02:43,3,1,4
45,2025-05-24T18:45:00+02:00,2025-05-25,02:45,0,2,2
47,2025-05-24T18:44:00+02:00,2025-05-25,02:44,0,2,2
47,2025-05-24T18:48:00+02:00,2025-05-25,02:48,2,4,6
54,2025-05-24T18:45:00+02:00,2025-05-25,02:45,1,0,1
54,2025-05-24T18:50:00+02:00,2025-05-25,02:50,1,0,1
59,2025-05-24T18:45:00+02:00,2025-05-25,02:45,1,0,1
61,2025-05-24T18:43:00+02:00,2025-05-25,02:43,1,4,5
61,2025-05-24T18:44:00+02:00,2025-05-25,02:44,2,0,2
66,2025-05-24T18:52:00+02:00,2025-05-25,02:52,1,0,1
66,2025-05-24T18:53:00+02:00,2025-05-25,02:53,0,4,4
84,2025-05-24T18:40:00+02:00,2025-05-25,02:40,4,9,13
84,2025-05-24T18:45:00+02:00,2025-05-25,02:45,2,21,23
84,2025-05-24T18:50:00+02:00,2025-05-25,02:50,1,5,6
107,2025-05-24T18:45:00+02:00,2025-05-25,02:45,4,1,5
108,2025-05-24T18:47:00+02:00,2025-05-25,02:47,1,2,3
108,2025-05-24T18:52:00+02:00,2025-05-25,02:52,3,0,3
131,2025-05-24T18:40:00+02:00,2025-05-25,02:40,6,2,8
131,2025-05-24T18:45:00+02:00,2025-05-25,02:45,5,29,34
131,2025-05-24T18:50:00+02:00,2025-05-25,02:50,4,11,15
132,2025-05-24T18:40:00+02:00,2025-05-25,02:40,2,2,4
134,2025-05-24T18:40:00+02:00,2025-05-25,02:40,2,3,5
134,2025-05-24T18:45:00+02:00,2025-05-25,02:45,5,5,10
134,2025-05-24T18:50:00+02:00,2025-05-25,02:50,4,3,7
135,2025-05-24T18:40:00+02:00,2025-05-25,02:40,0,1,1
162,2025-05-24T18:40:00+02:00,2025-05-25,02:40,1,6,7
179,2025-05-24T18:40:00+02:00,2025-05-25,02:40,0,1,1
1,2025-05-24T18:43:00+02:00,2025-05-25,02:43,1,0,1
1,2025-05-24T18:45:00+02:00,2025-05-25,02:45,0,2,2
1,2025-05-24T18:51:00+02:00,2025-05-25,02:51,0,1,1
1,2025-05-24T18:53:00+02:00,2025-05-25,02:53,1,3,4
2,2025-05-24T18:41:00+02:00,2025-05-25,02:41,0,3,3
2,2025-05-24T18:45:00+02:00,2025-05-25,02:45,2,0,2
9,2025-05-24T18:46:00+02:00,2025-05-25,02:46,1,0,1
10,2025-05-24T18:40:00+02:00,2025-05-25,02:40,0,2,2
10,2025-05-24T18:42:00+02:00,2025-05-25,02:42,0,4,4
10,2025-05-24T18:49:00+02:00,2025-05-25,02:49,0,2,2
10,2025-05-24T18:51:00+02:00,2025-05-25,02:51,0,1,1
12,2025-05-24T18:47:00+02:00,2025-05-25,02:47,0,2,2
17,2025-05-24T18:42:00+02:00,2025-05-25,02:42,1,0,1
19,2025-05-24T18:47:00+02:00,2025-05-25,02:47,0,3,3
19,2025-05-24T18:52:00+02:00,2025-05-25,02:52,0,5,5
20,2025-05-24T18:41:00+02:00,2025-05-25,02:41,1,1,2
20,2025-05-24T18:45:00+02:00,2025-05-25,02:45,1,2,3
20,2025-05-24T18:46:00+02:00,2025-05-25,02:46,5,3,8
20,2025-05-24T18:47:00+02:00,2025-05-25,02:47,2,6,8
20,2025-05-24T18:51:00+02:00,2025-05-25,02:51,1,10,11
23,2025-05-24T18:44:00+02:00,2025-05-25,02:44,1,1,2
23,2025-05-24T18:48:00+02:00,2025-05-25,02:48,0,1,1
24,2025-05-24T18:43:00+02:00,2025-05-25,02:43,3,2,5
24,2025-05-24T18:49:00+02:00,2025-05-25,02:49,0,2,2
24,2025-05-24T18:53:00+02:00,2025-05-25,02:53,0,7,7
30,2025-05-24T18:47:00+02:00,2025-05-25,02:47,0,7,7
30,2025-05-24T18:49:00+02:00,2025-05-25,02:49,2,9,11
30,2025-05-24T18:50:00+02:00,2025-05-25,02:50,5,6,11
35,2025-05-24T18:43:00+02:00,2025-05-25,02:43,2,0,2
35,2025-05-24T18:46:00+02:00,2025-05-25,02:46,0,2,2
35,2025-05-24T18:48:00+02:00,2025-05-25,02:48,1,9,10
35,2025-05-24T18:52:00+02:00,2025-05-25,02:52,0,1,1
49,2025-05-24T18:40:00+02:00,2025-05-25,02:40,0,3,3
49,2025-05-24T18:47:00+02:00,2025-05-25,02:47,1,6,7
49,2025-05-24T18:50:00+02:00,2025-05-25,02:50,0,2,2
52,2025-05-24T18:40:00+02:00,2025-05-25,02:40,1,0,1
52,2025-05-24T18:43:00+02:00,2025-05-25,02:43,0,8,8
52,2025-05-24T18:44:00+02:00,2025-05-25,02:44,1,0,1
52,2025-05-24T18:49:00+02:00,2025-05-25,02:49,0,4,4
52,2025-05-24T18:54:00+02:00,2025-05-25,02:54,0,4,4
53,2025-05-24T18:43:00+02:00,2025-05-25,02:43,3,1,4
53,2025-05-24T18:48:00+02:00,2025-05-25,02:48,1,0,1
53,2025-05-24T18:49:00+02:00,2025-05-25,02:49,0,1,1
56,2025-05-24T18:51:00+02:00,2025-05-25,02:51,1,2,3
58,2025-05-24T18:40:00+02:00,2025-05-25,02:40,2,5,7
58,2025-05-24T18:41:00+02:00,2025-05-25,02:41,3,7,10
58,2025-05-24T18:44:00+02:00,2025-05-25,02:44,0,1,1
58,2025-05-24T18:45:00+02:00,2025-05-25,02:45,1,0,1
58,2025-05-24T18:49:00+02:00,2025-05-25,02:49,2,2,4
58,2025-05-24T18:51:00+02:00,2025-05-25,02:51,2,4,6
62,2025-05-24T18:40:00+02:00,2025-05-25,02:40,0,1,1
62,2025-05-24T18:42:00+02:00,2025-05-25,02:42,0,5,5
62,2025-05-24T18:45:00+02:00,2025-05-25,02:45,0,3,3
62,2025-05-24T18:49:00+02:00,2025-05-25,02:49,1,0,1
62,2025-05-24T18:53:00+02:00,2025-05-25,02:53,2,0,2
63,2025-05-24T18:48:00+02:00,2025-05-25,02:48,0,1,1
63,2025-05-24T18:49:00+02:00,2025-05-25,02:49,2,6,8
67,2025-05-24T18:41:00+02:00,2025-05-25,02:41,1,0,1
67,2025-05-24T18:46:00+02:00,2025-05-25,02:46,0,3,3
68,2025-05-24T18:42:00+02:00,2025-05-25,02:42,1,0,1
79,2025-05-24T18:43:00+02:00,2025-05-25,02:43,1,0,1
79,2025-05-24T18:47:00+02:00,2025-05-25,02:47,1,0,1
79,2025-05-24T18:52:00+02:00,2025-05-25,02:52,0,1,1
141,2025-05-24T18:45:00+02:00,2025-05-25,02:45,7,1,8
141,2025-05-24T18:50:00+02:00,2025-05-25,02:50,4,3,7
181,2025-05-24T18:41:00+02:00,2025-05-25,02:41,4,11,15
181,2025-05-24T18:45:00+02:00,2025-05-25,02:45,0,3,3
182,2025-05-24T18:45:00+02:00,2025-05-25,02:45,15,19,34
181,2025-05-24T19:01:00+02:00,2025-05-25,03:01,0,1,1
181,2025-05-24T19:04:00+02:00,2025-05-25,03:04,1,0,1
182,2025-05-24T19:05:00+02:00,2025-05-25,03:05,7,9,16
3,2025-05-24T18:55:00+02:00,2025-05-25,02:55,4,0,4
3,2025-05-24T18:59:00+02:00,2025-05-25,02:59,0,4,4
3,2025-05-24T19:01:00+02:00,2025-05-25,03:01,3,1,4
3,2025-05-24T19:02:00+02:00,2025-05-25,03:02,1,3,4
3,2025-05-24T19:03:00+02:00,2025-05-25,03:03,4,0,4
3,2025-05-24T19:04:00+02:00,2025-05-25,03:04,1,1,2
3,2025-05-24T19:05:00+02:00,2025-05-25,03:05,5,4,9
3,2025-05-24T19:08:00+02:00,2025-05-25,03:08,3,0,3
3,2025-05-24T19:09:00+02:00,2025-05-25,03:09,1,2,3
4,2025-05-24T18:57:00+02:00,2025-05-25,02:57,0,2,2
4,2025-05-24T19:05:00+02:00,2025-05-25,03:05,0,1,1
4,2025-05-24T19:09:00+02:00,2025-05-25,03:09,5,1,6
6,2025-05-24T18:56:00+02:00,2025-05-25,02:56,3,3,6
6,2025-05-24T19:01:00+02:00,2025-05-25,03:01,0,3,3
6,2025-05-24T19:03:00+02:00,2025-05-25,03:03,2,0,2
6,2025-05-24T19:07:00+02:00,2025-05-25,03:07,3,5,8
28,2025-05-24T19:01:00+02:00,2025-05-25,03:01,0,1,1
28,2025-05-24T19:02:00+02:00,2025-05-25,03:02,1,0,1
28,2025-05-24T19:05:00+02:00,2025-05-25,03:05,2,0,2
28,2025-05-24T19:08:00+02:00,2025-05-25,03:08,1,0,1
29,2025-05-24T19:02:00+02:00,2025-05-25,03:02,0,3,3
36,2025-05-24T18:59:00+02:00,2025-05-25,02:59,3,3,6
36,2025-05-24T19:00:00+02:00,2025-05-25,03:00,4,3,7
36,2025-05-24T19:03:00+02:00,2025-05-25,03:03,1,4,5
37,2025-05-24T19:06:00+02:00,2025-05-25,03:06,0,4,4
40,2025-05-24T19:00:00+02:00,2025-05-25,03:00,1,1,2
40,2025-05-24T19:03:00+02:00,2025-05-25,03:03,1,0,1
41,2025-05-24T18:58:00+02:00,2025-05-25,02:58,0,1,1
41,2025-05-24T18:59:00+02:00,2025-05-25,02:59,0,2,2
41,2025-05-24T19:01:00+02:00,2025-05-25,03:01,0,2,2
45,2025-05-24T18:56:00+02:00,2025-05-25,02:56,1,1,2
45,2025-05-24T19:01:00+02:00,2025-05-25,03:01,0,2,2
47,2025-05-24T18:56:00+02:00,2025-05-25,02:56,0,5,5
47,2025-05-24T18:58:00+02:00,2025-05-25,02:58,1,1,2
47,2025-05-24T18:59:00+02:00,2025-05-25,02:59,0,2,2
47,2025-05-24T19:04:00+02:00,2025-05-25,03:04,3,0,3
59,2025-05-24T18:55:00+02:00,2025-05-25,02:55,2,2,4
61,2025-05-24T19:05:00+02:00,2025-05-25,03:05,0,1,1
61,2025-05-24T19:06:00+02:00,2025-05-25,03:06,2,0,2
61,2025-05-24T19:08:00+02:00,2025-05-25,03:08,7,1,8
66,2025-05-24T18:57:00+02:00,2025-05-25,02:57,3,0,3
66,2025-05-24T18:58:00+02:00,2025-05-25,02:58,2,1,3
66,2025-05-24T19:03:00+02:00,2025-05-25,03:03,4,3,7
66,2025-05-24T19:07:00+02:00,2025-05-25,03:07,0,6,6
69,2025-05-24T19:00:00+02:00,2025-05-25,03:00,0,3,3
77,2025-05-24T19:05:00+02:00,2025-05-25,03:05,1,0,1
84,2025-05-24T19:00:00+02:00,2025-05-25,03:00,4,14,18
108,2025-05-24T19:04:00+02:00,2025-05-25,03:04,2,2,4
108,2025-05-24T19:09:00+02:00,2025-05-25,03:09,0,1,1
132,2025-05-24T18:55:00+02:00,2025-05-25,02:55,12,0,12
133,2025-05-24T18:55:00+02:00,2025-05-25,02:55,1,0,1
133,2025-05-24T19:05:00+02:00,2025-05-25,03:05,1,1,2
134,2025-05-24T18:55:00+02:00,2025-05-25,02:55,2,4,6
135,2025-05-24T18:55:00+02:00,2025-05-25,02:55,0,3,3
135,2025-05-24T19:00:00+02:00,2025-05-25,03:00,1,3,4
135,2025-05-24T19:05:00+02:00,2025-05-25,03:05,2,2,4
162,2025-05-24T18:55:00+02:00,2025-05-25,02:55,3,4,7
162,2025-05-24T19:00:00+02:00,2025-05-25,03:00,9,2,11
179,2025-05-24T19:05:00+02:00,2025-05-25,03:05,0,4,4
1,2025-05-24T19:09:00+02:00,2025-05-25,03:09,3,0,3
2,2025-05-24T18:56:00+02:00,2025-05-25,02:56,0,2,2
2,2025-05-24T19:00:00+02:00,2025-05-25,03:00,4,0,4
2,2025-05-24T19:07:00+02:00,2025-05-25,03:07,0,7,7
10,2025-05-24T18:55:00+02:00,2025-05-25,02:55,0,1,1
19,2025-05-24T18:55:00+02:00,2025-05-25,02:55,0,6,6
19,2025-05-24T18:58:00+02:00,2025-05-25,02:58,0,4,4
19,2025-05-24T18:59:00+02:00,2025-05-25,02:59,0,6,6
19,2025-05-24T19:03:00+02:00,2025-05-25,03:03,0,3,3
19,2025-05-24T19:07:00+02:00,2025-05-25,03:07,3,1,4
19,2025-05-24T19:08:00+02:00,2025-05-25,03:08,0,2,2
20,2025-05-24T18:56:00+02:00,2025-05-25,02:56,3,3,6
20,2025-05-24T19:03:00+02:00,2025-05-25,03:03,2,12,14
24,2025-05-24T19:02:00+02:00,2025-05-25,03:02,1,0,1
24,2025-05-24T19:03:00+02:00,2025-05-25,03:03,0,1,1
24,2025-05-24T19:05:00+02:00,2025-05-25,03:05,1,1,2
24,2025-05-24T19:06:00+02:00,2025-05-25,03:06,1,0,1
25,2025-05-24T19:05:00+02:00,2025-05-25,03:05,1,0,1
27,2025-05-24T19:03:00+02:00,2025-05-25,03:03,4,1,5
30,2025-05-24T19:00:00+02:00,2025-05-25,03:00,2,3,5
30,2025-05-24T19:02:00+02:00,2025-05-25,03:02,1,10,11
30,2025-05-24T19:04:00+02:00,2025-05-25,03:04,0,8,8
30,2025-05-24T19:05:00+02:00,2025-05-25,03:05,0,5,5
30,2025-05-24T19:07:00+02:00,2025-05-25,03:07,0,1,1
30,2025-05-24T19:09:00+02:00,2025-05-25,03:09,0,2,2
35,2025-05-24T18:58:00+02:00,2025-05-25,02:58,1,2,3
35,2025-05-24T19:00:00+02:00,2025-05-25,03:00,1,2,3
35,2025-05-24T19:05:00+02:00,2025-05-25,03:05,2,9,11
35,2025-05-24T19:06:00+02:00,2025-05-25,03:06,2,1,3
35,2025-05-24T19:07:00+02:00,2025-05-25,03:07,1,0,1
35,2025-05-24T19:09:00+02:00,2025-05-25,03:09,0,1,1
49,2025-05-24T19:00:00+02:00,2025-05-25,03:00,7,0,7
51,2025-05-24T19:08:00+02:00,2025-05-25,03:08,2,0,2
52,2025-05-24T19:00:00+02:00,2025-05-25,03:00,0,8,8
53,2025-05-24T18:59:00+02:00,2025-05-25,02:59,4,0,4
53,2025-05-24T19:00:00+02:00,2025-05-25,03:00,0,1,1
53,2025-05-24T19:06:00+02:00,2025-05-25,03:06,4,0,4
58,2025-05-24T18:57:00+02:00,2025-05-25,02:57,0,1,1
58,2025-05-24T18:58:00+02:00,2025-05-25,02:58,1,5,6
58,2025-05-24T18:59:00+02:00,2025-05-25,02:59,2,1,3
58,2025-05-24T19:00:00+02:00,2025-05-25,03:00,4,1,5
58,2025-05-24T19:01:00+02:00,2025-05-25,03:01,1,1,2
58,2025-05-24T19:08:00+02:00,2025-05-25,03:08,0,2,2
58,2025-05-24T19:09:00+02:00,2025-05-25,03:09,1,0,1
62,2025-05-24T18:55:00+02:00,2025-05-25,02:55,1,1,2
62,2025-05-24T19:00:00+02:00,2025-05-25,03:00,2,0,2
62,2025-05-24T19:05:00+02:00,2025-05-25,03:05,0,3,3
62,2025-05-24T19:08:00+02:00,2025-05-25,03:08,0,2,2
63,2025-05-24T19:01:00+02:00,2025-05-25,03:01,0,2,2
63,2025-05-24T19:04:00+02:00,2025-05-25,03:04,0,3,3
63,2025-05-24T19:05:00+02:00,2025-05-25,03:05,1,5,6
67,2025-05-24T18:57:00+02:00,2025-05-25,02:57,0,1,1
67,2025-05-24T19:04:00+02:00,2025-05-25,03:04,1,0,1
67,2025-05-24T19:08:00+02:00,2025-05-25,03:08,2,1,3
72,2025-05-24T18:55:00+02:00,2025-05-25,02:55,0,1,1
72,2025-05-24T19:02:00+02:00,2025-05-25,03:02,0,1,1
76,2025-05-24T19:05:00+02:00,2025-05-25,03:05,1,0,1
79,2025-05-24T18:58:00+02:00,2025-05-25,02:58,1,4,5
79,2025-05-24T19:05:00+02:00,2025-05-25,03:05,1,0,1
79,2025-05-24T19:09:00+02:00,2025-05-25,03:09,0,2,2
141,2025-05-24T19:05:00+02:00,2025-05-25,03:05,2,2,4
181,2025-05-24T19:10:00+02:00,2025-05-25,03:10,2,0,2
181,2025-05-24T19:11:00+02:00,2025-05-25,03:11,6,0,6
181,2025-05-24T19:12:00+02:00,2025-05-25,03:12,1,1,2
181,2025-05-24T19:13:00+02:00,2025-05-25,03:13,4,0,4
181,2025-05-24T19:17:00+02:00,2025-05-25,03:17,2,0,2
181,2025-05-24T19:23:00+02:00,2025-05-25,03:23,2,2,4
182,2025-05-24T19:20:00+02:00,2025-05-25,03:20,6,17,23
181,2025-05-24T19:25:00+02:00,2025-05-25,03:25,8,1,9
181,2025-05-24T19:29:00+02:00,2025-05-25,03:29,2,0,2
181,2025-05-24T19:34:00+02:00,2025-05-25,03:34,0,2,2
181,2025-05-24T19:39:00+02:00,2025-05-25,03:39,0,8,8
182,2025-05-24T19:35:00+02:00,2025-05-25,03:35,13,7,20
3,2025-05-24T19:31:00+02:00,2025-05-25,03:31,5,1,6
3,2025-05-24T19:32:00+02:00,2025-05-25,03:32,0,6,6
3,2025-05-24T19:33:00+02:00,2025-05-25,03:33,3,3,6
3,2025-05-24T19:35:00+02:00,2025-05-25,03:35,9,2,11
4,2025-05-24T19:29:00+02:00,2025-05-25,03:29,2,0,2
4,2025-05-24T19:34:00+02:00,2025-05-25,03:34,0,5,5
4,2025-05-24T19:35:00+02:00,2025-05-25,03:35,3,5,8
5,2025-05-24T19:35:00+02:00,2025-05-25,03:35,1,3,4
6,2025-05-24T19:30:00+02:00,2025-05-25,03:30,1,0,1
6,2025-05-24T19:31:00+02:00,2025-05-25,03:31,1,0,1
6,2025-05-24T19:33:00+02:00,2025-05-25,03:33,2,0,2
6,2025-05-24T19:37:00+02:00,2025-05-25,03:37,0,1,1
28,2025-05-24T19:25:00+02:00,2025-05-25,03:25,5,0,5
28,2025-05-24T19:26:00+02:00,2025-05-25,03:26,1,0,1
31,2025-05-24T19:27:00+02:00,2025-05-25,03:27,0,2,2
31,2025-05-24T19:38:00+02:00,2025-05-25,03:38,0,1,1
36,2025-05-24T19:32:00+02:00,2025-05-25,03:32,1,0,1
36,2025-05-24T19:36:00+02:00,2025-05-25,03:36,5,5,10
39,2025-05-24T19:30:00+02:00,2025-05-25,03:30,1,0,1
41,2025-05-24T19:26:00+02:00,2025-05-25,03:26,1,0,1
41,2025-05-24T19:27:00+02:00,2025-05-25,03:27,0,2,2
41,2025-05-24T19:28:00+02:00,2025-05-25,03:28,0,2,2
41,2025-05-24T19:31:00+02:00,2025-05-25,03:31,0,2,2
41,2025-05-24T19:35:00+02:00,2025-05-25,03:35,0,1,1
41,2025-05-24T19:38:00+02:00,2025-05-25,03:38,0,4,4
45,2025-05-24T19:26:00+02:00,2025-05-25,03:26,0,1,1
45,2025-05-24T19:27:00+02:00,2025-05-25,03:27,0,1,1
45,2025-05-24T19:28:00+02:00,2025-05-25,03:28,3,3,6
45,2025-05-24T19:30:00+02:00,2025-05-25,03:30,4,4,8
45,2025-05-24T19:33:00+02:00,2025-05-25,03:33,0,1,1
45,2025-05-24T19:35:00+02:00,2025-05-25,03:35,2,0,2
45,2025-05-24T19:38:00+02:00,2025-05-25,03:38,0,1,1
47,2025-05-24T19:26:00+02:00,2025-05-25,03:26,2,5,7
47,2025-05-24T19:28:00+02:00,2025-05-25,03:28,7,0,7
47,2025-05-24T19:35:00+02:00,2025-05-25,03:35,4,0,4
47,2025-05-24T19:37:00+02:00,2025-05-25,03:37,0,1,1
50,2025-05-24T19:35:00+02:00,2025-05-25,03:35,0,1,1
54,2025-05-24T19:26:00+02:00,2025-05-25,03:26,0,1,1
54,2025-05-24T19:37:00+02:00,2025-05-25,03:37,1,0,1
59,2025-05-24T19:25:00+02:00,2025-05-25,03:25,4,4,8
59,2025-05-24T19:35:00+02:00,2025-05-25,03:35,0,2,2
61,2025-05-24T19:27:00+02:00,2025-05-25,03:27,6,0,6
61,2025-05-24T19:33:00+02:00,2025-05-25,03:33,1,0,1
61,2025-05-24T19:36:00+02:00,2025-05-25,03:36,4,0,4
66,2025-05-24T19:25:00+02:00,2025-05-25,03:25,4,0,4
66,2025-05-24T19:26:00+02:00,2025-05-25,03:26,2,3,5
66,2025-05-24T19:33:00+02:00,2025-05-25,03:33,3,0,3
66,2025-05-24T19:35:00+02:00,2025-05-25,03:35,1,0,1
66,2025-05-24T19:37:00+02:00,2025-05-25,03:37,0,4,4
84,2025-05-24T19:25:00+02:00,2025-05-25,03:25,1,4,5
84,2025-05-24T19:35:00+02:00,2025-05-25,03:35,8,14,22
132,2025-05-24T19:25:00+02:00,2025-05-25,03:25,0,2,2
132,2025-05-24T19:35:00+02:00,2025-05-25,03:35,4,0,4
133,2025-05-24T19:30:00+02:00,2025-05-25,03:30,2,3,5
134,2025-05-24T19:30:00+02:00,2025-05-25,03:30,4,5,9
135,2025-05-24T19:25:00+02:00,2025-05-25,03:25,5,5,10
135,2025-05-24T19:30:00+02:00,2025-05-25,03:30,2,4,6
162,2025-05-24T19:25:00+02:00,2025-05-25,03:25,6,3,9
162,2025-05-24T19:30:00+02:00,2025-05-25,03:30,5,3,8
2,2025-05-24T19:27:00+02:00,2025-05-25,03:27,1,0,1
2,2025-05-24T19:35:00+02:00,2025-05-25,03:35,0,1,1
2,2025-05-24T19:36:00+02:00,2025-05-25,03:36,1,0,1
9,2025-05-24T19:31:00+02:00,2025-05-25,03:31,0,3,3
17,2025-05-24T19:30:00+02:00,2025-05-25,03:30,0,2,2
19,2025-05-24T19:26:00+02:00,2025-05-25,03:26,0,1,1
19,2025-05-24T19:30:00+02:00,2025-05-25,03:30,0,1,1
19,2025-05-24T19:32:00+02:00,2025-05-25,03:32,1,2,3
19,2025-05-24T19:33:00+02:00,2025-05-25,03:33,1,1,2
19,2025-05-24T19:39:00+02:00,2025-05-25,03:39,1,1,2
20,2025-05-24T19:27:00+02:00,2025-05-25,03:27,2,7,9
20,2025-05-24T19:32:00+02:00,2025-05-25,03:32,0,5,5
20,2025-05-24T19:36:00+02:00,2025-05-25,03:36,0,1,1
20,2025-05-24T19:39:00+02:00,2025-05-25,03:39,0,5,5
23,2025-05-24T19:27:00+02:00,2025-05-25,03:27,0,1,1
24,2025-05-24T19:35:00+02:00,2025-05-25,03:35,0,1,1
27,2025-05-24T19:31:00+02:00,2025-05-25,03:31,1,0,1
27,2025-05-24T19:39:00+02:00,2025-05-25,03:39,0,1,1
30,2025-05-24T19:33:00+02:00,2025-05-25,03:33,6,1,7
30,2025-05-24T19:38:00+02:00,2025-05-25,03:38,5,0,5
35,2025-05-24T19:25:00+02:00,2025-05-25,03:25,0,1,1
35,2025-05-24T19:27:00+02:00,2025-05-25,03:27,2,1,3
35,2025-05-24T19:32:00+02:00,2025-05-25,03:32,2,1,3
49,2025-05-24T19:26:00+02:00,2025-05-25,03:26,1,0,1
49,2025-05-24T19:32:00+02:00,2025-05-25,03:32,0,1,1
51,2025-05-24T19:29:00+02:00,2025-05-25,03:29,2,0,2
51,2025-05-24T19:32:00+02:00,2025-05-25,03:32,0,1,1
52,2025-05-24T19:25:00+02:00,2025-05-25,03:25,6,1,7
52,2025-05-24T19:28:00+02:00,2025-05-25,03:28,0,2,2
52,2025-05-24T19:29:00+02:00,2025-05-25,03:29,0,4,4
52,2025-05-24T19:33:00+02:00,2025-05-25,03:33,2,1,3
52,2025-05-24T19:38:00+02:00,2025-05-25,03:38,2,0,2
56,2025-05-24T19:26:00+02:00,2025-05-25,03:26,5,0,5
56,2025-05-24T19:29:00+02:00,2025-05-25,03:29,3,0,3
56,2025-05-24T19:30:00+02:00,2025-05-25,03:30,1,0,1
56,2025-05-24T19:35:00+02:00,2025-05-25,03:35,1,1,2
56,2025-05-24T19:37:00+02:00,2025-05-25,03:37,1,2,3
58,2025-05-24T19:36:00+02:00,2025-05-25,03:36,5,0,5
58,2025-05-24T19:38:00+02:00,2025-05-25,03:38,5,1,6
63,2025-05-24T19:25:00+02:00,2025-05-25,03:25,0,1,1
63,2025-05-24T19:36:00+02:00,2025-05-25,03:36,0,2,2
67,2025-05-24T19:26:00+02:00,2025-05-25,03:26,1,0,1
79,2025-05-24T19:25:00+02:00,2025-05-25,03:25,1,0,1
79,2025-05-24T19:34:00+02:00,2025-05-25,03:34,1,2,3
139,2025-05-24T19:30:00+02:00,2025-05-25,03:30,1,0,1
164,2025-05-24T19:30:00+02:00,2025-05-25,03:30,0,1,1
3,2025-05-24T20:27:00+02:00,2025-05-25,04:27,6,0,6
3,2025-05-24T20:28:00+02:00,2025-05-25,04:28,1,0,1
3,2025-05-24T20:36:00+02:00,2025-05-25,04:36,4,0,4
3,2025-05-24T20:37:00+02:00,2025-05-25,04:37,0,1,1
3,2025-05-24T20:38:00+02:00,2025-05-25,04:38,1,0,1
4,2025-05-24T20:26:00+02:00,2025-05-25,04:26,0,1,1
4,2025-05-24T20:32:00+02:00,2025-05-25,04:32,0,1,1
4,2025-05-24T20:33:00+02:00,2025-05-25,04:33,0,1,1
6,2025-05-24T20:25:00+02:00,2025-05-25,04:25,1,3,4
6,2025-05-24T20:29:00+02:00,2025-05-25,04:29,1,0,1
6,2025-05-24T20:39:00+02:00,2025-05-25,04:39,2,0,2
28,2025-05-24T20:31:00+02:00,2025-05-25,04:31,0,1,1
29,2025-05-24T20:26:00+02:00,2025-05-25,04:26,10,0,10
29,2025-05-24T20:27:00+02:00,2025-05-25,04:27,0,6,6
29,2025-05-24T20:34:00+02:00,2025-05-25,04:34,0,3,3
41,2025-05-24T20:25:00+02:00,2025-05-25,04:25,0,3,3
41,2025-05-24T20:30:00+02:00,2025-05-25,04:30,0,2,2
41,2025-05-24T20:31:00+02:00,2025-05-25,04:31,0,1,1
45,2025-05-24T20:25:00+02:00,2025-05-25,04:25,0,1,1
45,2025-05-24T20:27:00+02:00,2025-05-25,04:27,0,1,1
45,2025-05-24T20:36:00+02:00,2025-05-25,04:36,0,3,3
47,2025-05-24T20:27:00+02:00,2025-05-25,04:27,3,0,3
47,2025-05-24T20:28:00+02:00,2025-05-25,04:28,0,1,1
47,2025-05-24T20:35:00+02:00,2025-05-25,04:35,0,1,1
47,2025-05-24T20:36:00+02:00,2025-05-25,04:36,0,2,2
47,2025-05-24T20:39:00+02:00,2025-05-25,04:39,2,2,4
54,2025-05-24T20:32:00+02:00,2025-05-25,04:32,3,0,3
54,2025-05-24T20:34:00+02:00,2025-05-25,04:34,0,1,1
59,2025-05-24T20:25:00+02:00,2025-05-25,04:25,4,2,6
61,2025-05-24T20:26:00+02:00,2025-05-25,04:26,1,0,1
61,2025-05-24T20:27:00+02:00,2025-05-25,04:27,1,0,1
61,2025-05-24T20:34:00+02:00,2025-05-25,04:34,2,0,2
66,2025-05-24T20:30:00+02:00,2025-05-25,04:30,1,0,1
66,2025-05-24T20:39:00+02:00,2025-05-25,04:39,1,0,1
77,2025-05-24T20:35:00+02:00,2025-05-25,04:35,1,0,1
84,2025-05-24T20:35:00+02:00,2025-05-25,04:35,4,16,20
108,2025-05-24T20:34:00+02:00,2025-05-25,04:34,3,0,3
108,2025-05-24T20:35:00+02:00,2025-05-25,04:35,1,0,1
108,2025-05-24T20:38:00+02:00,2025-05-25,04:38,3,0,3
108,2025-05-24T20:39:00+02:00,2025-05-25,04:39,4,1,5
131,2025-05-24T20:30:00+02:00,2025-05-25,04:30,0,7,7
132,2025-05-24T20:30:00+02:00,2025-05-25,04:30,3,1,4
134,2025-05-24T20:30:00+02:00,2025-05-25,04:30,4,4,8
135,2025-05-24T20:30:00+02:00,2025-05-25,04:30,6,7,13
135,2025-05-24T20:35:00+02:00,2025-05-25,04:35,3,5,8
162,2025-05-24T20:25:00+02:00,2025-05-25,04:25,4,0,4
162,2025-05-24T20:30:00+02:00,2025-05-25,04:30,4,0,4
2,2025-05-24T20:29:00+02:00,2025-05-25,04:29,0,2,2
2,2025-05-24T20:30:00+02:00,2025-05-25,04:30,0,1,1
12,2025-05-24T20:36:00+02:00,2025-05-25,04:36,0,2,2
17,2025-05-24T20:33:00+02:00,2025-05-25,04:33,1,0,1
19,2025-05-24T20:35:00+02:00,2025-05-25,04:35,0,1,1
20,2025-05-24T20:25:00+02:00,2025-05-25,04:25,3,0,3
20,2025-05-24T20:29:00+02:00,2025-05-25,04:29,1,0,1
20,2025-05-24T20:33:00+02:00,2025-05-25,04:33,6,5,11
23,2025-05-24T20:31:00+02:00,2025-05-25,04:31,0,1,1
23,2025-05-24T20:34:00+02:00,2025-05-25,04:34,2,0,2
24,2025-05-24T20:27:00+02:00,2025-05-25,04:27,0,3,3
24,2025-05-24T20:31:00+02:00,2025-05-25,04:31,0,1,1
24,2025-05-24T20:34:00+02:00,2025-05-25,04:34,1,1,2
24,2025-05-24T20:37:00+02:00,2025-05-25,04:37,2,0,2
24,2025-05-24T20:39:00+02:00,2025-05-25,04:39,3,0,3
30,2025-05-24T20:27:00+02:00,2025-05-25,04:27,5,0,5
30,2025-05-24T20:30:00+02:00,2025-05-25,04:30,3,3,6
30,2025-05-24T20:31:00+02:00,2025-05-25,04:31,4,0,4
30,2025-05-24T20:35:00+02:00,2025-05-25,04:35,0,13,13
49,2025-05-24T20:26:00+02:00,2025-05-25,04:26,0,2,2
49,2025-05-24T20:28:00+02:00,2025-05-25,04:28,4,1,5
49,2025-05-24T20:35:00+02:00,2025-05-25,04:35,2,0,2
52,2025-05-24T20:27:00+02:00,2025-05-25,04:27,3,0,3
52,2025-05-24T20:28:00+02:00,2025-05-25,04:28,2,1,3
52,2025-05-24T20:31:00+02:00,2025-05-25,04:31,3,1,4
52,2025-05-24T20:37:00+02:00,2025-05-25,04:37,6,0,6
58,2025-05-24T20:31:00+02:00,2025-05-25,04:31,0,1,1
58,2025-05-24T20:32:00+02:00,2025-05-25,04:32,0,3,3
58,2025-05-24T20:34:00+02:00,2025-05-25,04:34,0,1,1
62,2025-05-24T20:33:00+02:00,2025-05-25,04:33,1,0,1
62,2025-05-24T20:34:00+02:00,2025-05-25,04:34,2,0,2
63,2025-05-24T20:25:00+02:00,2025-05-25,04:25,0,1,1
67,2025-05-24T20:26:00+02:00,2025-05-25,04:26,0,2,2
67,2025-05-24T20:34:00+02:00,2025-05-25,04:34,1,0,1
79,2025-05-24T20:25:00+02:00,2025-05-25,04:25,0,4,4
79,2025-05-24T20:31:00+02:00,2025-05-25,04:31,0,1,1
141,2025-05-24T20:25:00+02:00,2025-05-25,04:25,2,6,8
164,2025-05-24T20:25:00+02:00,2025-05-25,04:25,0,3,3
3,2025-05-24T20:10:00+02:00,2025-05-25,04:10,4,1,5
3,2025-05-24T20:17:00+02:00,2025-05-25,04:17,1,2,3
3,2025-05-24T20:19:00+02:00,2025-05-25,04:19,2,2,4
4,2025-05-24T20:11:00+02:00,2025-05-25,04:11,0,3,3
4,2025-05-24T20:14:00+02:00,2025-05-25,04:14,0,2,2
4,2025-05-24T20:15:00+02:00,2025-05-25,04:15,0,1,1
4,2025-05-24T20:16:00+02:00,2025-05-25,04:16,0,2,2
4,2025-05-24T20:19:00+02:00,2025-05-25,04:19,1,1,2
4,2025-05-24T20:22:00+02:00,2025-05-25,04:22,1,0,1
4,2025-05-24T20:23:00+02:00,2025-05-25,04:23,1,0,1
5,2025-05-24T20:15:00+02:00,2025-05-25,04:15,2,2,4
5,2025-05-24T20:20:00+02:00,2025-05-25,04:20,1,0,1
6,2025-05-24T20:10:00+02:00,2025-05-25,04:10,0,1,1
6,2025-05-24T20:11:00+02:00,2025-05-25,04:11,1,0,1
6,2025-05-24T20:15:00+02:00,2025-05-25,04:15,1,3,4
6,2025-05-24T20:19:00+02:00,2025-05-25,04:19,2,2,4
29,2025-05-24T20:14:00+02:00,2025-05-25,04:14,0,1,1
29,2025-05-24T20:15:00+02:00,2025-05-25,04:15,1,0,1
31,2025-05-24T20:15:00+02:00,2025-05-25,04:15,1,0,1
36,2025-05-24T20:15:00+02:00,2025-05-25,04:15,5,1,6
36,2025-05-24T20:18:00+02:00,2025-05-25,04:18,2,0,2
36,2025-05-24T20:23:00+02:00,2025-05-25,04:23,1,1,2
40,2025-05-24T20:23:00+02:00,2025-05-25,04:23,2,0,2
41,2025-05-24T20:18:00+02:00,2025-05-25,04:18,0,1,1
45,2025-05-24T20:20:00+02:00,2025-05-25,04:20,0,5,5
45,2025-05-24T20:22:00+02:00,2025-05-25,04:22,0,3,3
47,2025-05-24T20:12:00+02:00,2025-05-25,04:12,0,4,4
47,2025-05-24T20:16:00+02:00,2025-05-25,04:16,0,2,2
47,2025-05-24T20:20:00+02:00,2025-05-25,04:20,0,1,1
47,2025-05-24T20:22:00+02:00,2025-05-25,04:22,3,1,4
59,2025-05-24T20:20:00+02:00,2025-05-25,04:20,4,1,5
61,2025-05-24T20:11:00+02:00,2025-05-25,04:11,1,0,1
61,2025-05-24T20:17:00+02:00,2025-05-25,04:17,4,0,4
66,2025-05-24T20:12:00+02:00,2025-05-25,04:12,0,1,1
66,2025-05-24T20:16:00+02:00,2025-05-25,04:16,1,0,1
70,2025-05-24T20:19:00+02:00,2025-05-25,04:19,0,1,1
84,2025-05-24T20:20:00+02:00,2025-05-25,04:20,2,7,9
107,2025-05-24T20:10:00+02:00,2025-05-25,04:10,0,2,2
108,2025-05-24T20:11:00+02:00,2025-05-25,04:11,1,0,1
108,2025-05-24T20:23:00+02:00,2025-05-25,04:23,2,0,2
131,2025-05-24T20:20:00+02:00,2025-05-25,04:20,6,5,11
134,2025-05-24T20:15:00+02:00,2025-05-25,04:15,0,7,7
134,2025-05-24T20:20:00+02:00,2025-05-25,04:20,3,0,3
135,2025-05-24T20:15:00+02:00,2025-05-25,04:15,1,1,2
179,2025-05-24T20:10:00+02:00,2025-05-25,04:10,1,0,1
179,2025-05-24T20:15:00+02:00,2025-05-25,04:15,1,0,1
2,2025-05-24T20:13:00+02:00,2025-05-25,04:13,1,0,1
2,2025-05-24T20:20:00+02:00,2025-05-25,04:20,0,2,2
12,2025-05-24T20:18:00+02:00,2025-05-25,04:18,1,0,1
18,2025-05-24T20:20:00+02:00,2025-05-25,04:20,0,1,1
19,2025-05-24T20:12:00+02:00,2025-05-25,04:12,2,1,3
20,2025-05-24T20:14:00+02:00,2025-05-25,04:14,5,0,5
20,2025-05-24T20:16:00+02:00,2025-05-25,04:16,1,0,1
20,2025-05-24T20:24:00+02:00,2025-05-25,04:24,2,0,2
25,2025-05-24T20:10:00+02:00,2025-05-25,04:10,1,2,3
25,2025-05-24T20:20:00+02:00,2025-05-25,04:20,0,1,1
30,2025-05-24T20:12:00+02:00,2025-05-25,04:12,1,2,3
30,2025-05-24T20:13:00+02:00,2025-05-25,04:13,7,0,7
30,2025-05-24T20:17:00+02:00,2025-05-25,04:17,0,2,2
30,2025-05-24T20:18:00+02:00,2025-05-25,04:18,3,11,14
30,2025-05-24T20:22:00+02:00,2025-05-25,04:22,0,10,10
35,2025-05-24T20:14:00+02:00,2025-05-25,04:14,1,0,1
35,2025-05-24T20:18:00+02:00,2025-05-25,04:18,0,5,5
49,2025-05-24T20:18:00+02:00,2025-05-25,04:18,5,0,5
52,2025-05-24T20:12:00+02:00,2025-05-25,04:12,3,0,3
52,2025-05-24T20:23:00+02:00,2025-05-25,04:23,1,0,1
52,2025-05-24T20:24:00+02:00,2025-05-25,04:24,3,0,3
53,2025-05-24T20:12:00+02:00,2025-05-25,04:12,0,1,1
53,2025-05-24T20:21:00+02:00,2025-05-25,04:21,0,1,1
58,2025-05-24T20:12:00+02:00,2025-05-25,04:12,0,2,2
58,2025-05-24T20:23:00+02:00,2025-05-25,04:23,0,1,1
62,2025-05-24T20:24:00+02:00,2025-05-25,04:24,2,0,2
63,2025-05-24T20:11:00+02:00,2025-05-25,04:11,0,1,1
63,2025-05-24T20:14:00+02:00,2025-05-25,04:14,0,1,1
63,2025-05-24T20:24:00+02:00,2025-05-25,04:24,0,1,1
67,2025-05-24T20:21:00+02:00,2025-05-25,04:21,0,1,1
72,2025-05-24T20:15:00+02:00,2025-05-25,04:15,0,2,2
72,2025-05-24T20:17:00+02:00,2025-05-25,04:17,2,0,2
79,2025-05-24T20:10:00+02:00,2025-05-25,04:10,0,1,1
141,2025-05-24T20:10:00+02:00,2025-05-25,04:10,1,8,9
181,2025-05-24T20:10:00+02:00,2025-05-25,04:10,0,3,3
181,2025-05-24T20:14:00+02:00,2025-05-25,04:14,2,1,3
181,2025-05-24T20:18:00+02:00,2025-05-25,04:18,1,5,6
181,2025-05-24T20:20:00+02:00,2025-05-25,04:20,3,0,3
181,2025-05-24T20:24:00+02:00,2025-05-25,04:24,2,1,3
182,2025-05-24T20:10:00+02:00,2025-05-25,04:10,7,8,15
182,2025-05-24T20:20:00+02:00,2025-05-25,04:20,14,9,23
181,2025-05-24T20:25:00+02:00,2025-05-25,04:25,1,0,1
181,2025-05-24T20:30:00+02:00,2025-05-25,04:30,3,0,3
181,2025-05-24T20:31:00+02:00,2025-05-25,04:31,2,0,2
181,2025-05-24T20:32:00+02:00,2025-05-25,04:32,0,1,1
181,2025-05-24T20:39:00+02:00,2025-05-25,04:39,1,3,4
182,2025-05-24T20:35:00+02:00,2025-05-25,04:35,2,3,5
3,2025-05-24T19:40:00+02:00,2025-05-25,03:40,4,0,4
3,2025-05-24T19:44:00+02:00,2025-05-25,03:44,1,0,1
3,2025-05-24T19:47:00+02:00,2025-05-25,03:47,0,2,2
3,2025-05-24T19:49:00+02:00,2025-05-25,03:49,1,0,1
3,2025-05-24T19:51:00+02:00,2025-05-25,03:51,0,3,3
3,2025-05-24T19:53:00+02:00,2025-05-25,03:53,0,4,4
4,2025-05-24T19:45:00+02:00,2025-05-25,03:45,2,2,4
4,2025-05-24T19:54:00+02:00,2025-05-25,03:54,1,0,1
5,2025-05-24T19:40:00+02:00,2025-05-25,03:40,5,2,7
5,2025-05-24T19:50:00+02:00,2025-05-25,03:50,5,5,10
6,2025-05-24T19:40:00+02:00,2025-05-25,03:40,0,2,2
6,2025-05-24T19:41:00+02:00,2025-05-25,03:41,0,1,1
6,2025-05-24T19:43:00+02:00,2025-05-25,03:43,3,2,5
6,2025-05-24T19:46:00+02:00,2025-05-25,03:46,1,0,1
6,2025-05-24T19:47:00+02:00,2025-05-25,03:47,1,2,3
6,2025-05-24T19:49:00+02:00,2025-05-25,03:49,0,2,2
6,2025-05-24T19:51:00+02:00,2025-05-25,03:51,0,2,2
28,2025-05-24T19:40:00+02:00,2025-05-25,03:40,1,0,1
28,2025-05-24T19:46:00+02:00,2025-05-25,03:46,0,1,1
28,2025-05-24T19:52:00+02:00,2025-05-25,03:52,1,0,1
29,2025-05-24T19:48:00+02:00,2025-05-25,03:48,3,0,3
29,2025-05-24T19:52:00+02:00,2025-05-25,03:52,1,2,3
36,2025-05-24T19:42:00+02:00,2025-05-25,03:42,2,4,6
36,2025-05-24T19:44:00+02:00,2025-05-25,03:44,1,3,4
36,2025-05-24T19:45:00+02:00,2025-05-25,03:45,9,2,11
36,2025-05-24T19:46:00+02:00,2025-05-25,03:46,2,0,2
36,2025-05-24T19:48:00+02:00,2025-05-25,03:48,0,1,1
37,2025-05-24T19:43:00+02:00,2025-05-25,03:43,0,1,1
37,2025-05-24T19:45:00+02:00,2025-05-25,03:45,2,0,2
37,2025-05-24T19:48:00+02:00,2025-05-25,03:48,3,0,3
37,2025-05-24T19:49:00+02:00,2025-05-25,03:49,0,1,1
40,2025-05-24T19:42:00+02:00,2025-05-25,03:42,0,1,1
41,2025-05-24T19:48:00+02:00,2025-05-25,03:48,0,2,2
41,2025-05-24T19:53:00+02:00,2025-05-25,03:53,1,0,1
41,2025-05-24T19:54:00+02:00,2025-05-25,03:54,0,1,1
45,2025-05-24T19:44:00+02:00,2025-05-25,03:44,0,1,1
45,2025-05-24T19:48:00+02:00,2025-05-25,03:48,1,1,2
45,2025-05-24T19:51:00+02:00,2025-05-25,03:51,0,1,1
45,2025-05-24T19:53:00+02:00,2025-05-25,03:53,1,0,1
47,2025-05-24T19:46:00+02:00,2025-05-25,03:46,0,2,2
50,2025-05-24T19:46:00+02:00,2025-05-25,03:46,1,0,1
54,2025-05-24T19:44:00+02:00,2025-05-25,03:44,0,3,3
54,2025-05-24T19:47:00+02:00,2025-05-25,03:47,0,2,2
54,2025-05-24T19:54:00+02:00,2025-05-25,03:54,0,1,1
59,2025-05-24T19:40:00+02:00,2025-05-25,03:40,3,1,4
59,2025-05-24T19:45:00+02:00,2025-05-25,03:45,2,0,2
66,2025-05-24T19:46:00+02:00,2025-05-25,03:46,0,1,1
66,2025-05-24T19:51:00+02:00,2025-05-25,03:51,0,3,3
66,2025-05-24T19:52:00+02:00,2025-05-25,03:52,1,0,1
66,2025-05-24T19:53:00+02:00,2025-05-25,03:53,0,2,2
84,2025-05-24T19:40:00+02:00,2025-05-25,03:40,3,4,7
84,2025-05-24T19:50:00+02:00,2025-05-25,03:50,2,14,16
131,2025-05-24T19:50:00+02:00,2025-05-25,03:50,12,8,20
132,2025-05-24T19:45:00+02:00,2025-05-25,03:45,4,1,5
133,2025-05-24T19:50:00+02:00,2025-05-25,03:50,6,0,6
135,2025-05-24T19:50:00+02:00,2025-05-25,03:50,6,2,8
162,2025-05-24T19:50:00+02:00,2025-05-25,03:50,3,0,3
165,2025-05-24T19:40:00+02:00,2025-05-25,03:40,1,0,1
179,2025-05-24T19:45:00+02:00,2025-05-25,03:45,3,0,3
1,2025-05-24T19:42:00+02:00,2025-05-25,03:42,0,2,2
1,2025-05-24T19:44:00+02:00,2025-05-25,03:44,0,1,1
2,2025-05-24T19:49:00+02:00,2025-05-25,03:49,0,1,1
2,2025-05-24T19:51:00+02:00,2025-05-25,03:51,0,2,2
19,2025-05-24T19:43:00+02:00,2025-05-25,03:43,0,2,2
19,2025-05-24T19:44:00+02:00,2025-05-25,03:44,8,0,8
19,2025-05-24T19:45:00+02:00,2025-05-25,03:45,2,5,7
19,2025-05-24T19:54:00+02:00,2025-05-25,03:54,0,6,6
20,2025-05-24T19:42:00+02:00,2025-05-25,03:42,0,2,2
20,2025-05-24T19:43:00+02:00,2025-05-25,03:43,0,3,3
20,2025-05-24T19:46:00+02:00,2025-05-25,03:46,3,0,3
20,2025-05-24T19:51:00+02:00,2025-05-25,03:51,1,0,1
20,2025-05-24T19:53:00+02:00,2025-05-25,03:53,0,4,4
24,2025-05-24T19:48:00+02:00,2025-05-25,03:48,2,0,2
24,2025-05-24T19:52:00+02:00,2025-05-25,03:52,2,1,3
25,2025-05-24T19:50:00+02:00,2025-05-25,03:50,1,0,1
27,2025-05-24T19:49:00+02:00,2025-05-25,03:49,1,0,1
30,2025-05-24T19:43:00+02:00,2025-05-25,03:43,4,0,4
30,2025-05-24T19:44:00+02:00,2025-05-25,03:44,0,3,3
30,2025-05-24T19:45:00+02:00,2025-05-25,03:45,1,7,8
30,2025-05-24T19:46:00+02:00,2025-05-25,03:46,4,7,11
30,2025-05-24T19:52:00+02:00,2025-05-25,03:52,3,0,3
30,2025-05-24T19:54:00+02:00,2025-05-25,03:54,4,4,8
35,2025-05-24T19:42:00+02:00,2025-05-25,03:42,1,1,2
35,2025-05-24T19:45:00+02:00,2025-05-25,03:45,0,3,3
35,2025-05-24T19:48:00+02:00,2025-05-25,03:48,0,1,1
35,2025-05-24T19:49:00+02:00,2025-05-25,03:49,0,2,2
35,2025-05-24T19:54:00+02:00,2025-05-25,03:54,0,2,2
49,2025-05-24T19:41:00+02:00,2025-05-25,03:41,2,0,2
49,2025-05-24T19:42:00+02:00,2025-05-25,03:42,3,2,5
49,2025-05-24T19:43:00+02:00,2025-05-25,03:43,0,2,2
49,2025-05-24T19:44:00+02:00,2025-05-25,03:44,0,2,2
49,2025-05-24T19:46:00+02:00,2025-05-25,03:46,0,1,1
49,2025-05-24T19:49:00+02:00,2025-05-25,03:49,1,0,1
51,2025-05-24T19:49:00+02:00,2025-05-25,03:49,1,0,1
52,2025-05-24T19:40:00+02:00,2025-05-25,03:40,5,0,5
52,2025-05-24T19:42:00+02:00,2025-05-25,03:42,1,0,1
52,2025-05-24T19:48:00+02:00,2025-05-25,03:48,2,0,2
52,2025-05-24T19:49:00+02:00,2025-05-25,03:49,0,2,2
52,2025-05-24T19:54:00+02:00,2025-05-25,03:54,0,1,1
53,2025-05-24T19:54:00+02:00,2025-05-25,03:54,0,1,1
56,2025-05-24T19:41:00+02:00,2025-05-25,03:41,1,0,1
56,2025-05-24T19:51:00+02:00,2025-05-25,03:51,3,0,3
58,2025-05-24T19:47:00+02:00,2025-05-25,03:47,0,2,2
58,2025-05-24T19:48:00+02:00,2025-05-25,03:48,0,2,2
58,2025-05-24T19:49:00+02:00,2025-05-25,03:49,0,4,4
62,2025-05-24T19:41:00+02:00,2025-05-25,03:41,0,1,1
63,2025-05-24T19:43:00+02:00,2025-05-25,03:43,0,2,2
63,2025-05-24T19:45:00+02:00,2025-05-25,03:45,1,0,1
63,2025-05-24T19:50:00+02:00,2025-05-25,03:50,0,2,2
72,2025-05-24T19:43:00+02:00,2025-05-25,03:43,0,2,2
79,2025-05-24T19:40:00+02:00,2025-05-25,03:40,2,0,2
79,2025-05-24T19:49:00+02:00,2025-05-25,03:49,0,1,1
123,2025-05-24T19:40:00+02:00,2025-05-25,03:40,1,0,1
137,2025-05-24T19:50:00+02:00,2025-05-25,03:50,0,1,1
139,2025-05-24T19:40:00+02:00,2025-05-25,03:40,2,0,2
141,2025-05-24T19:50:00+02:00,2025-05-25,03:50,1,3,4
181,2025-05-24T19:47:00+02:00,2025-05-25,03:47,0,2,2
181,2025-05-24T19:48:00+02:00,2025-05-25,03:48,1,1,2
182,2025-05-24T19:50:00+02:00,2025-05-25,03:50,12,10,22
181,2025-05-24T19:56:00+02:00,2025-05-25,03:56,0,3,3
181,2025-05-24T19:59:00+02:00,2025-05-25,03:59,2,0,2
181,2025-05-24T20:04:00+02:00,2025-05-25,04:04,3,4,7
181,2025-05-24T20:05:00+02:00,2025-05-25,04:05,1,3,4
181,2025-05-24T20:07:00+02:00,2025-05-25,04:07,1,3,4
182,2025-05-24T19:55:00+02:00,2025-05-25,03:55,4,8,12
182,2025-05-24T20:00:00+02:00,2025-05-25,04:00,4,7,11
182,2025-05-24T20:05:00+02:00,2025-05-25,04:05,3,3,6
3,2025-05-24T19:56:00+02:00,2025-05-25,03:56,3,3,6
3,2025-05-24T19:59:00+02:00,2025-05-25,03:59,0,5,5
3,2025-05-24T20:00:00+02:00,2025-05-25,04:00,1,0,1
3,2025-05-24T20:02:00+02:00,2025-05-25,04:02,2,0,2
3,2025-05-24T20:05:00+02:00,2025-05-25,04:05,1,0,1
4,2025-05-24T19:57:00+02:00,2025-05-25,03:57,0,1,1
4,2025-05-24T20:03:00+02:00,2025-05-25,04:03,0,3,3
4,2025-05-24T20:05:00+02:00,2025-05-25,04:05,0,2,2
4,2025-05-24T20:07:00+02:00,2025-05-25,04:07,0,2,2
6,2025-05-24T19:56:00+02:00,2025-05-25,03:56,1,0,1
6,2025-05-24T19:57:00+02:00,2025-05-25,03:57,1,0,1
6,2025-05-24T20:00:00+02:00,2025-05-25,04:00,1,1,2
6,2025-05-24T20:01:00+02:00,2025-05-25,04:01,3,0,3
6,2025-05-24T20:07:00+02:00,2025-05-25,04:07,0,3,3
28,2025-05-24T19:59:00+02:00,2025-05-25,03:59,0,1,1
28,2025-05-24T20:01:00+02:00,2025-05-25,04:01,0,3,3
29,2025-05-24T20:00:00+02:00,2025-05-25,04:00,1,0,1
29,2025-05-24T20:04:00+02:00,2025-05-25,04:04,0,2,2
36,2025-05-24T19:55:00+02:00,2025-05-25,03:55,7,0,7
36,2025-05-24T20:00:00+02:00,2025-05-25,04:00,2,2,4
36,2025-05-24T20:02:00+02:00,2025-05-25,04:02,0,4,4
36,2025-05-24T20:05:00+02:00,2025-05-25,04:05,5,4,9
36,2025-05-24T20:06:00+02:00,2025-05-25,04:06,1,2,3
36,2025-05-24T20:08:00+02:00,2025-05-25,04:08,3,5,8
36,2025-05-24T20:09:00+02:00,2025-05-25,04:09,0,1,1
37,2025-05-24T19:57:00+02:00,2025-05-25,03:57,1,0,1
41,2025-05-24T19:56:00+02:00,2025-05-25,03:56,0,1,1
41,2025-05-24T20:06:00+02:00,2025-05-25,04:06,1,1,2
45,2025-05-24T19:56:00+02:00,2025-05-25,03:56,0,3,3
45,2025-05-24T20:09:00+02:00,2025-05-25,04:09,0,1,1
47,2025-05-24T20:02:00+02:00,2025-05-25,04:02,3,0,3
47,2025-05-24T20:03:00+02:00,2025-05-25,04:03,3,0,3
47,2025-05-24T20:06:00+02:00,2025-05-25,04:06,0,3,3
61,2025-05-24T19:57:00+02:00,2025-05-25,03:57,2,0,2
61,2025-05-24T19:59:00+02:00,2025-05-25,03:59,0,1,1
61,2025-05-24T20:09:00+02:00,2025-05-25,04:09,2,0,2
66,2025-05-24T19:56:00+02:00,2025-05-25,03:56,0,1,1
66,2025-05-24T20:03:00+02:00,2025-05-25,04:03,0,1,1
77,2025-05-24T19:55:00+02:00,2025-05-25,03:55,1,0,1
131,2025-05-24T20:00:00+02:00,2025-05-25,04:00,4,6,10
133,2025-05-24T19:55:00+02:00,2025-05-25,03:55,4,3,7
135,2025-05-24T19:55:00+02:00,2025-05-25,03:55,8,0,8
135,2025-05-24T20:00:00+02:00,2025-05-25,04:00,4,6,10
162,2025-05-24T20:00:00+02:00,2025-05-25,04:00,8,2,10
165,2025-05-24T20:00:00+02:00,2025-05-25,04:00,2,0,2
179,2025-05-24T20:05:00+02:00,2025-05-25,04:05,2,2,4
1,2025-05-24T20:03:00+02:00,2025-05-25,04:03,2,0,2
1,2025-05-24T20:06:00+02:00,2025-05-25,04:06,0,3,3
2,2025-05-24T19:57:00+02:00,2025-05-25,03:57,0,4,4
2,2025-05-24T19:58:00+02:00,2025-05-25,03:58,0,3,3
2,2025-05-24T20:03:00+02:00,2025-05-25,04:03,1,2,3
9,2025-05-24T19:59:00+02:00,2025-05-25,03:59,0,2,2
10,2025-05-24T19:55:00+02:00,2025-05-25,03:55,1,0,1
10,2025-05-24T20:05:00+02:00,2025-05-25,04:05,2,0,2
11,2025-05-24T20:08:00+02:00,2025-05-25,04:08,0,1,1
17,2025-05-24T20:04:00+02:00,2025-05-25,04:04,0,1,1
17,2025-05-24T20:06:00+02:00,2025-05-25,04:06,1,0,1
19,2025-05-24T19:56:00+02:00,2025-05-25,03:56,0,8,8
19,2025-05-24T20:00:00+02:00,2025-05-25,04:00,0,1,1
19,2025-05-24T20:02:00+02:00,2025-05-25,04:02,2,9,11
19,2025-05-24T20:05:00+02:00,2025-05-25,04:05,1,4,5
20,2025-05-24T19:57:00+02:00,2025-05-25,03:57,0,1,1
20,2025-05-24T20:04:00+02:00,2025-05-25,04:04,0,4,4
24,2025-05-24T19:55:00+02:00,2025-05-25,03:55,3,2,5
25,2025-05-24T20:05:00+02:00,2025-05-25,04:05,3,2,5
30,2025-05-24T19:55:00+02:00,2025-05-25,03:55,6,1,7
30,2025-05-24T19:57:00+02:00,2025-05-25,03:57,1,7,8
30,2025-05-24T19:58:00+02:00,2025-05-25,03:58,2,0,2
30,2025-05-24T19:59:00+02:00,2025-05-25,03:59,3,4,7
30,2025-05-24T20:00:00+02:00,2025-05-25,04:00,1,1,2
30,2025-05-24T20:07:00+02:00,2025-05-25,04:07,0,2,2
30,2025-05-24T20:09:00+02:00,2025-05-25,04:09,1,2,3
35,2025-05-24T19:57:00+02:00,2025-05-25,03:57,0,1,1
35,2025-05-24T20:02:00+02:00,2025-05-25,04:02,1,2,3
35,2025-05-24T20:09:00+02:00,2025-05-25,04:09,0,2,2
49,2025-05-24T19:57:00+02:00,2025-05-25,03:57,1,0,1
49,2025-05-24T20:04:00+02:00,2025-05-25,04:04,1,0,1
51,2025-05-24T19:56:00+02:00,2025-05-25,03:56,0,1,1
51,2025-05-24T20:07:00+02:00,2025-05-25,04:07,1,0,1
52,2025-05-24T20:01:00+02:00,2025-05-25,04:01,4,0,4
52,2025-05-24T20:09:00+02:00,2025-05-25,04:09,14,3,17
56,2025-05-24T19:57:00+02:00,2025-05-25,03:57,0,1,1
56,2025-05-24T19:58:00+02:00,2025-05-25,03:58,0,3,3
58,2025-05-24T20:03:00+02:00,2025-05-25,04:03,1,0,1
62,2025-05-24T20:05:00+02:00,2025-05-25,04:05,0,1,1
63,2025-05-24T20:05:00+02:00,2025-05-25,04:05,1,0,1
63,2025-05-24T20:09:00+02:00,2025-05-25,04:09,1,0,1
139,2025-05-24T20:05:00+02:00,2025-05-25,04:05,1,0,1
141,2025-05-24T20:05:00+02:00,2025-05-25,04:05,1,0,1
3,2025-05-24T20:44:00+02:00,2025-05-25,04:44,6,2,8
3,2025-05-24T20:45:00+02:00,2025-05-25,04:45,0,4,4
3,2025-05-24T20:51:00+02:00,2025-05-25,04:51,2,0,2
3,2025-05-24T20:52:00+02:00,2025-05-25,04:52,0,2,2
3,2025-05-24T20:53:00+02:00,2025-05-25,04:53,2,0,2
4,2025-05-24T20:42:00+02:00,2025-05-25,04:42,0,3,3
4,2025-05-24T20:45:00+02:00,2025-05-25,04:45,2,3,5
4,2025-05-24T20:47:00+02:00,2025-05-25,04:47,1,0,1
4,2025-05-24T20:53:00+02:00,2025-05-25,04:53,0,6,6
6,2025-05-24T20:40:00+02:00,2025-05-25,04:40,0,1,1
6,2025-05-24T20:48:00+02:00,2025-05-25,04:48,0,1,1
6,2025-05-24T20:52:00+02:00,2025-05-25,04:52,1,0,1
6,2025-05-24T20:54:00+02:00,2025-05-25,04:54,1,0,1
29,2025-05-24T20:40:00+02:00,2025-05-25,04:40,0,1,1
36,2025-05-24T20:48:00+02:00,2025-05-25,04:48,1,0,1
45,2025-05-24T20:41:00+02:00,2025-05-25,04:41,0,4,4
45,2025-05-24T20:45:00+02:00,2025-05-25,04:45,1,1,2
45,2025-05-24T20:46:00+02:00,2025-05-25,04:46,0,3,3
47,2025-05-24T20:42:00+02:00,2025-05-25,04:42,1,1,2
47,2025-05-24T20:46:00+02:00,2025-05-25,04:46,0,2,2
47,2025-05-24T20:48:00+02:00,2025-05-25,04:48,0,1,1
47,2025-05-24T20:49:00+02:00,2025-05-25,04:49,0,2,2
59,2025-05-24T20:40:00+02:00,2025-05-25,04:40,1,0,1
59,2025-05-24T20:45:00+02:00,2025-05-25,04:45,1,0,1
59,2025-05-24T20:50:00+02:00,2025-05-25,04:50,3,2,5
66,2025-05-24T20:41:00+02:00,2025-05-25,04:41,0,1,1
66,2025-05-24T20:46:00+02:00,2025-05-25,04:46,1,0,1
66,2025-05-24T20:47:00+02:00,2025-05-25,04:47,0,1,1
84,2025-05-24T20:45:00+02:00,2025-05-25,04:45,8,4,12
87,2025-05-24T20:42:00+02:00,2025-05-25,04:42,1,0,1
108,2025-05-24T20:44:00+02:00,2025-05-25,04:44,0,1,1
132,2025-05-24T20:45:00+02:00,2025-05-25,04:45,2,0,2
132,2025-05-24T20:50:00+02:00,2025-05-25,04:50,1,0,1
1,2025-05-24T20:51:00+02:00,2025-05-25,04:51,1,0,1
10,2025-05-24T20:49:00+02:00,2025-05-25,04:49,1,0,1
10,2025-05-24T20:51:00+02:00,2025-05-25,04:51,0,1,1
18,2025-05-24T20:48:00+02:00,2025-05-25,04:48,0,1,1
19,2025-05-24T20:40:00+02:00,2025-05-25,04:40,0,4,4
19,2025-05-24T20:50:00+02:00,2025-05-25,04:50,0,1,1
20,2025-05-24T20:46:00+02:00,2025-05-25,04:46,2,0,2
20,2025-05-24T20:48:00+02:00,2025-05-25,04:48,0,1,1
20,2025-05-24T20:52:00+02:00,2025-05-25,04:52,0,3,3
20,2025-05-24T20:54:00+02:00,2025-05-25,04:54,1,2,3
23,2025-05-24T20:44:00+02:00,2025-05-25,04:44,0,1,1
24,2025-05-24T20:42:00+02:00,2025-05-25,04:42,0,5,5
24,2025-05-24T20:44:00+02:00,2025-05-25,04:44,0,1,1
24,2025-05-24T20:48:00+02:00,2025-05-25,04:48,1,0,1
24,2025-05-24T20:52:00+02:00,2025-05-25,04:52,0,2,2
27,2025-05-24T20:53:00+02:00,2025-05-25,04:53,3,1,4
30,2025-05-24T20:42:00+02:00,2025-05-25,04:42,0,5,5
30,2025-05-24T20:50:00+02:00,2025-05-25,04:50,1,2,3
30,2025-05-24T20:52:00+02:00,2025-05-25,04:52,3,1,4
30,2025-05-24T20:53:00+02:00,2025-05-25,04:53,0,2,2
35,2025-05-24T20:47:00+02:00,2025-05-25,04:47,0,1,1
49,2025-05-24T20:45:00+02:00,2025-05-25,04:45,0,1,1
49,2025-05-24T20:48:00+02:00,2025-05-25,04:48,4,1,5
49,2025-05-24T20:49:00+02:00,2025-05-25,04:49,1,3,4
49,2025-05-24T20:50:00+02:00,2025-05-25,04:50,1,0,1
49,2025-05-24T20:52:00+02:00,2025-05-25,04:52,1,2,3
52,2025-05-24T20:44:00+02:00,2025-05-25,04:44,5,0,5
52,2025-05-24T20:46:00+02:00,2025-05-25,04:46,6,1,7
53,2025-05-24T20:44:00+02:00,2025-05-25,04:44,1,0,1
56,2025-05-24T20:44:00+02:00,2025-05-25,04:44,0,1,1
58,2025-05-24T20:47:00+02:00,2025-05-25,04:47,2,0,2
62,2025-05-24T20:43:00+02:00,2025-05-25,04:43,1,0,1
62,2025-05-24T20:47:00+02:00,2025-05-25,04:47,0,1,1
62,2025-05-24T20:49:00+02:00,2025-05-25,04:49,1,1,2
63,2025-05-24T20:43:00+02:00,2025-05-25,04:43,0,1,1
68,2025-05-24T20:43:00+02:00,2025-05-25,04:43,0,1,1
79,2025-05-24T20:41:00+02:00,2025-05-25,04:41,0,1,1
79,2025-05-24T20:47:00+02:00,2025-05-25,04:47,1,2,3
85,2025-05-24T20:42:00+02:00,2025-05-25,04:42,1,0,1
109,2025-05-24T20:40:00+02:00,2025-05-25,04:40,0,1,1
109,2025-05-24T20:50:00+02:00,2025-05-25,04:50,0,1,1
117,2025-05-24T20:45:00+02:00,2025-05-25,04:45,0,1,1
130,2025-05-24T20:50:00+02:00,2025-05-25,04:50,0,1,1
137,2025-05-24T20:40:00+02:00,2025-05-25,04:40,2,0,2
141,2025-05-24T20:50:00+02:00,2025-05-25,04:50,6,4,10
142,2025-05-24T20:45:00+02:00,2025-05-25,04:45,1,0,1
181,2025-05-24T20:43:00+02:00,2025-05-25,04:43,3,0,3
181,2025-05-24T20:45:00+02:00,2025-05-25,04:45,0,1,1
181,2025-05-24T20:58:00+02:00,2025-05-25,04:58,1,0,1
181,2025-05-24T20:59:00+02:00,2025-05-25,04:59,5,3,8
3,2025-05-24T20:57:00+02:00,2025-05-25,04:57,1,0,1
3,2025-05-24T21:02:00+02:00,2025-05-25,05:02,0,3,3
3,2025-05-24T21:04:00+02:00,2025-05-25,05:04,3,2,5
3,2025-05-24T21:05:00+02:00,2025-05-25,05:05,2,1,3
4,2025-05-24T20:58:00+02:00,2025-05-25,04:58,0,3,3
4,2025-05-24T20:59:00+02:00,2025-05-25,04:59,0,4,4
4,2025-05-24T21:00:00+02:00,2025-05-25,05:00,1,2,3
5,2025-05-24T20:55:00+02:00,2025-05-25,04:55,0,2,2
5,2025-05-24T21:00:00+02:00,2025-05-25,05:00,0,2,2
5,2025-05-24T21:05:00+02:00,2025-05-25,05:05,0,1,1
6,2025-05-24T21:02:00+02:00,2025-05-25,05:02,0,2,2
6,2025-05-24T21:07:00+02:00,2025-05-25,05:07,3,0,3
6,2025-05-24T21:09:00+02:00,2025-05-25,05:09,0,1,1
28,2025-05-24T21:05:00+02:00,2025-05-25,05:05,0,2,2
36,2025-05-24T21:01:00+02:00,2025-05-25,05:01,0,2,2
36,2025-05-24T21:03:00+02:00,2025-05-25,05:03,0,2,2
36,2025-05-24T21:09:00+02:00,2025-05-25,05:09,1,0,1
40,2025-05-24T21:00:00+02:00,2025-05-25,05:00,2,0,2
41,2025-05-24T21:01:00+02:00,2025-05-25,05:01,0,1,1
45,2025-05-24T21:03:00+02:00,2025-05-25,05:03,2,1,3
47,2025-05-24T20:56:00+02:00,2025-05-25,04:56,4,0,4
47,2025-05-24T20:57:00+02:00,2025-05-25,04:57,1,0,1
47,2025-05-24T21:02:00+02:00,2025-05-25,05:02,1,1,2
47,2025-05-24T21:07:00+02:00,2025-05-25,05:07,1,0,1
54,2025-05-24T21:03:00+02:00,2025-05-25,05:03,1,0,1
59,2025-05-24T21:00:00+02:00,2025-05-25,05:00,1,0,1
61,2025-05-24T20:55:00+02:00,2025-05-25,04:55,2,0,2
61,2025-05-24T20:59:00+02:00,2025-05-25,04:59,0,1,1
61,2025-05-24T21:03:00+02:00,2025-05-25,05:03,1,0,1
66,2025-05-24T20:56:00+02:00,2025-05-25,04:56,2,0,2
66,2025-05-24T21:05:00+02:00,2025-05-25,05:05,3,0,3
66,2025-05-24T21:07:00+02:00,2025-05-25,05:07,1,0,1
70,2025-05-24T20:58:00+02:00,2025-05-25,04:58,0,1,1
84,2025-05-24T21:05:00+02:00,2025-05-25,05:05,1,5,6
108,2025-05-24T21:04:00+02:00,2025-05-25,05:04,0,1,1
131,2025-05-24T20:55:00+02:00,2025-05-25,04:55,0,9,9
131,2025-05-24T21:00:00+02:00,2025-05-25,05:00,1,8,9
135,2025-05-24T21:00:00+02:00,2025-05-25,05:00,5,3,8
2,2025-05-24T21:08:00+02:00,2025-05-25,05:08,3,0,3
9,2025-05-24T21:00:00+02:00,2025-05-25,05:00,0,1,1
11,2025-05-24T20:55:00+02:00,2025-05-25,04:55,1,0,1
19,2025-05-24T21:07:00+02:00,2025-05-25,05:07,1,1,2
20,2025-05-24T21:03:00+02:00,2025-05-25,05:03,0,1,1
20,2025-05-24T21:09:00+02:00,2025-05-25,05:09,3,0,3
24,2025-05-24T20:56:00+02:00,2025-05-25,04:56,0,2,2
24,2025-05-24T20:57:00+02:00,2025-05-25,04:57,0,3,3
24,2025-05-24T20:58:00+02:00,2025-05-25,04:58,2,1,3
24,2025-05-24T21:04:00+02:00,2025-05-25,05:04,6,0,6
25,2025-05-24T21:00:00+02:00,2025-05-25,05:00,1,1,2
27,2025-05-24T21:04:00+02:00,2025-05-25,05:04,5,1,6
30,2025-05-24T20:58:00+02:00,2025-05-25,04:58,2,4,6
30,2025-05-24T21:04:00+02:00,2025-05-25,05:04,0,2,2
30,2025-05-24T21:05:00+02:00,2025-05-25,05:05,1,7,8
30,2025-05-24T21:07:00+02:00,2025-05-25,05:07,5,1,6
30,2025-05-24T21:08:00+02:00,2025-05-25,05:08,1,1,2
49,2025-05-24T20:57:00+02:00,2025-05-25,04:57,1,4,5
49,2025-05-24T20:58:00+02:00,2025-05-25,04:58,3,1,4
49,2025-05-24T21:01:00+02:00,2025-05-25,05:01,1,0,1
49,2025-05-24T21:06:00+02:00,2025-05-25,05:06,2,0,2
52,2025-05-24T20:56:00+02:00,2025-05-25,04:56,1,0,1
52,2025-05-24T21:06:00+02:00,2025-05-25,05:06,1,2,3
52,2025-05-24T21:07:00+02:00,2025-05-25,05:07,2,0,2
56,2025-05-24T21:08:00+02:00,2025-05-25,05:08,1,0,1
58,2025-05-24T20:57:00+02:00,2025-05-25,04:57,0,1,1
58,2025-05-24T21:05:00+02:00,2025-05-25,05:05,3,0,3
58,2025-05-24T21:07:00+02:00,2025-05-25,05:07,1,0,1
62,2025-05-24T21:00:00+02:00,2025-05-25,05:00,1,0,1
63,2025-05-24T21:00:00+02:00,2025-05-25,05:00,0,1,1
63,2025-05-24T21:09:00+02:00,2025-05-25,05:09,0,2,2
67,2025-05-24T21:00:00+02:00,2025-05-25,05:00,0,2,2
67,2025-05-24T21:02:00+02:00,2025-05-25,05:02,0,1,1
79,2025-05-24T21:01:00+02:00,2025-05-25,05:01,2,0,2
79,2025-05-24T21:07:00+02:00,2025-05-25,05:07,1,0,1
79,2025-05-24T21:09:00+02:00,2025-05-25,05:09,1,0,1
109,2025-05-24T20:55:00+02:00,2025-05-25,04:55,2,0,2
109,2025-05-24T21:00:00+02:00,2025-05-25,05:00,0,1,1
109,2025-05-24T21:05:00+02:00,2025-05-25,05:05,0,2,2
141,2025-05-24T20:55:00+02:00,2025-05-25,04:55,2,2,4
141,2025-05-24T21:00:00+02:00,2025-05-25,05:00,4,1,5
164,2025-05-24T20:55:00+02:00,2025-05-25,04:55,0,1,1
3,2025-05-24T21:25:00+02:00,2025-05-25,05:25,0,2,2
3,2025-05-24T21:32:00+02:00,2025-05-25,05:32,1,1,2
4,2025-05-24T21:25:00+02:00,2025-05-25,05:25,1,1,2
4,2025-05-24T21:28:00+02:00,2025-05-25,05:28,1,1,2
4,2025-05-24T21:29:00+02:00,2025-05-25,05:29,3,2,5
4,2025-05-24T21:30:00+02:00,2025-05-25,05:30,0,1,1
4,2025-05-24T21:33:00+02:00,2025-05-25,05:33,0,3,3
4,2025-05-24T21:34:00+02:00,2025-05-25,05:34,1,0,1
5,2025-05-24T21:30:00+02:00,2025-05-25,05:30,2,1,3
6,2025-05-24T21:26:00+02:00,2025-05-25,05:26,2,2,4
6,2025-05-24T21:28:00+02:00,2025-05-25,05:28,1,0,1
6,2025-05-24T21:31:00+02:00,2025-05-25,05:31,1,2,3
6,2025-05-24T21:33:00+02:00,2025-05-25,05:33,0,2,2
6,2025-05-24T21:34:00+02:00,2025-05-25,05:34,1,1,2
6,2025-05-24T21:35:00+02:00,2025-05-25,05:35,1,0,1
6,2025-05-24T21:38:00+02:00,2025-05-25,05:38,1,4,5
6,2025-05-24T21:39:00+02:00,2025-05-25,05:39,0,7,7
8,2025-05-24T21:37:00+02:00,2025-05-25,05:37,1,0,1
28,2025-05-24T21:26:00+02:00,2025-05-25,05:26,0,1,1
31,2025-05-24T21:39:00+02:00,2025-05-25,05:39,1,0,1
36,2025-05-24T21:27:00+02:00,2025-05-25,05:27,0,1,1
41,2025-05-24T21:25:00+02:00,2025-05-25,05:25,0,1,1
41,2025-05-24T21:27:00+02:00,2025-05-25,05:27,1,2,3
45,2025-05-24T21:38:00+02:00,2025-05-25,05:38,1,1,2
45,2025-05-24T21:39:00+02:00,2025-05-25,05:39,2,1,3
47,2025-05-24T21:31:00+02:00,2025-05-25,05:31,1,2,3
47,2025-05-24T21:39:00+02:00,2025-05-25,05:39,0,2,2
61,2025-05-24T21:27:00+02:00,2025-05-25,05:27,1,0,1
66,2025-05-24T21:28:00+02:00,2025-05-25,05:28,0,1,1
66,2025-05-24T21:33:00+02:00,2025-05-25,05:33,2,0,2
84,2025-05-24T21:25:00+02:00,2025-05-25,05:25,2,3,5
108,2025-05-24T21:29:00+02:00,2025-05-25,05:29,2,0,2
131,2025-05-24T21:30:00+02:00,2025-05-25,05:30,0,16,16
132,2025-05-24T21:35:00+02:00,2025-05-25,05:35,1,0,1
134,2025-05-24T21:25:00+02:00,2025-05-25,05:25,1,2,3
162,2025-05-24T21:35:00+02:00,2025-05-25,05:35,0,2,2
179,2025-05-24T21:25:00+02:00,2025-05-25,05:25,2,0,2
179,2025-05-24T21:30:00+02:00,2025-05-25,05:30,1,1,2
1,2025-05-24T21:27:00+02:00,2025-05-25,05:27,1,0,1
1,2025-05-24T21:31:00+02:00,2025-05-25,05:31,0,1,1
1,2025-05-24T21:32:00+02:00,2025-05-25,05:32,0,2,2
1,2025-05-24T21:36:00+02:00,2025-05-25,05:36,1,0,1
2,2025-05-24T21:25:00+02:00,2025-05-25,05:25,1,0,1
2,2025-05-24T21:26:00+02:00,2025-05-25,05:26,0,1,1
9,2025-05-24T21:35:00+02:00,2025-05-25,05:35,1,2,3
17,2025-05-24T21:25:00+02:00,2025-05-25,05:25,1,0,1
17,2025-05-24T21:34:00+02:00,2025-05-25,05:34,1,0,1
17,2025-05-24T21:38:00+02:00,2025-05-25,05:38,1,0,1
20,2025-05-24T21:27:00+02:00,2025-05-25,05:27,0,2,2
23,2025-05-24T21:31:00+02:00,2025-05-25,05:31,4,0,4
23,2025-05-24T21:37:00+02:00,2025-05-25,05:37,1,3,4
24,2025-05-24T21:30:00+02:00,2025-05-25,05:30,3,2,5
24,2025-05-24T21:31:00+02:00,2025-05-25,05:31,0,2,2
24,2025-05-24T21:33:00+02:00,2025-05-25,05:33,0,1,1
24,2025-05-24T21:34:00+02:00,2025-05-25,05:34,0,2,2
27,2025-05-24T21:36:00+02:00,2025-05-25,05:36,3,0,3
27,2025-05-24T21:38:00+02:00,2025-05-25,05:38,2,0,2
30,2025-05-24T21:30:00+02:00,2025-05-25,05:30,0,1,1
30,2025-05-24T21:37:00+02:00,2025-05-25,05:37,1,2,3
35,2025-05-24T21:38:00+02:00,2025-05-25,05:38,0,1,1
35,2025-05-24T21:39:00+02:00,2025-05-25,05:39,0,1,1
49,2025-05-24T21:29:00+02:00,2025-05-25,05:29,0,2,2
49,2025-05-24T21:31:00+02:00,2025-05-25,05:31,1,2,3
52,2025-05-24T21:25:00+02:00,2025-05-25,05:25,0,3,3
52,2025-05-24T21:29:00+02:00,2025-05-25,05:29,0,1,1
53,2025-05-24T21:27:00+02:00,2025-05-25,05:27,0,1,1
53,2025-05-24T21:32:00+02:00,2025-05-25,05:32,0,1,1
53,2025-05-24T21:38:00+02:00,2025-05-25,05:38,1,0,1
56,2025-05-24T21:31:00+02:00,2025-05-25,05:31,1,1,2
56,2025-05-24T21:34:00+02:00,2025-05-25,05:34,2,0,2
56,2025-05-24T21:38:00+02:00,2025-05-25,05:38,3,0,3
58,2025-05-24T21:31:00+02:00,2025-05-25,05:31,1,0,1
58,2025-05-24T21:39:00+02:00,2025-05-25,05:39,2,0,2
67,2025-05-24T21:36:00+02:00,2025-05-25,05:36,0,1,1
79,2025-05-24T21:25:00+02:00,2025-05-25,05:25,1,0,1
79,2025-05-24T21:27:00+02:00,2025-05-25,05:27,1,0,1
79,2025-05-24T21:29:00+02:00,2025-05-25,05:29,0,2,2
79,2025-05-24T21:31:00+02:00,2025-05-25,05:31,4,0,4
79,2025-05-24T21:38:00+02:00,2025-05-25,05:38,0,1,1
117,2025-05-24T21:30:00+02:00,2025-05-25,05:30,1,0,1
117,2025-05-24T21:35:00+02:00,2025-05-25,05:35,1,0,1
139,2025-05-24T21:25:00+02:00,2025-05-25,05:25,1,0,1
141,2025-05-24T21:30:00+02:00,2025-05-25,05:30,5,1,6
142,2025-05-24T21:25:00+02:00,2025-05-25,05:25,1,0,1
164,2025-05-24T21:25:00+02:00,2025-05-25,05:25,1,1,2
181,2025-05-24T21:10:00+02:00,2025-05-25,05:10,1,0,1
181,2025-05-24T21:22:00+02:00,2025-05-25,05:22,4,2,6
182,2025-05-24T21:10:00+02:00,2025-05-25,05:10,3,1,4
182,2025-05-24T21:15:00+02:00,2025-05-25,05:15,4,8,12
3,2025-05-24T21:14:00+02:00,2025-05-25,05:14,3,0,3
3,2025-05-24T21:20:00+02:00,2025-05-25,05:20,1,2,3
4,2025-05-24T21:10:00+02:00,2025-05-25,05:10,1,0,1
4,2025-05-24T21:14:00+02:00,2025-05-25,05:14,1,3,4
4,2025-05-24T21:18:00+02:00,2025-05-25,05:18,3,0,3
37,2025-05-24T21:17:00+02:00,2025-05-25,05:17,0,1,1
41,2025-05-24T21:12:00+02:00,2025-05-25,05:12,0,4,4
41,2025-05-24T21:21:00+02:00,2025-05-25,05:21,1,1,2
41,2025-05-24T21:24:00+02:00,2025-05-25,05:24,2,0,2
45,2025-05-24T21:10:00+02:00,2025-05-25,05:10,1,0,1
45,2025-05-24T21:11:00+02:00,2025-05-25,05:11,2,1,3
45,2025-05-24T21:12:00+02:00,2025-05-25,05:12,0,2,2
45,2025-05-24T21:13:00+02:00,2025-05-25,05:13,0,2,2
47,2025-05-24T21:11:00+02:00,2025-05-25,05:11,3,1,4
47,2025-05-24T21:12:00+02:00,2025-05-25,05:12,0,1,1
47,2025-05-24T21:13:00+02:00,2025-05-25,05:13,1,0,1
47,2025-05-24T21:14:00+02:00,2025-05-25,05:14,2,0,2
47,2025-05-24T21:17:00+02:00,2025-05-25,05:17,1,1,2
47,2025-05-24T21:23:00+02:00,2025-05-25,05:23,0,7,7
54,2025-05-24T21:11:00+02:00,2025-05-25,05:11,0,1,1
54,2025-05-24T21:13:00+02:00,2025-05-25,05:13,1,0,1
61,2025-05-24T21:20:00+02:00,2025-05-25,05:20,2,1,3
66,2025-05-24T21:16:00+02:00,2025-05-25,05:16,0,1,1
66,2025-05-24T21:20:00+02:00,2025-05-25,05:20,1,0,1
70,2025-05-24T21:24:00+02:00,2025-05-25,05:24,2,0,2
84,2025-05-24T21:10:00+02:00,2025-05-25,05:10,1,3,4
84,2025-05-24T21:20:00+02:00,2025-05-25,05:20,1,3,4
108,2025-05-24T21:23:00+02:00,2025-05-25,05:23,0,2,2
108,2025-05-24T21:24:00+02:00,2025-05-25,05:24,2,0,2
131,2025-05-24T21:15:00+02:00,2025-05-25,05:15,2,1,3
132,2025-05-24T21:10:00+02:00,2025-05-25,05:10,3,0,3
134,2025-05-24T21:15:00+02:00,2025-05-25,05:15,3,3,6
135,2025-05-24T21:15:00+02:00,2025-05-25,05:15,6,0,6
135,2025-05-24T21:20:00+02:00,2025-05-25,05:20,4,3,7
162,2025-05-24T21:10:00+02:00,2025-05-25,05:10,1,0,1
162,2025-05-24T21:20:00+02:00,2025-05-25,05:20,2,2,4
167,2025-05-24T21:10:00+02:00,2025-05-25,05:10,0,1,1
1,2025-05-24T21:13:00+02:00,2025-05-25,05:13,0,1,1
1,2025-05-24T21:17:00+02:00,2025-05-25,05:17,3,0,3
1,2025-05-24T21:20:00+02:00,2025-05-25,05:20,0,1,1
2,2025-05-24T21:20:00+02:00,2025-05-25,05:20,1,1,2
12,2025-05-24T21:10:00+02:00,2025-05-25,05:10,1,0,1
17,2025-05-24T21:24:00+02:00,2025-05-25,05:24,0,1,1
19,2025-05-24T21:22:00+02:00,2025-05-25,05:22,0,4,4
20,2025-05-24T21:11:00+02:00,2025-05-25,05:11,0,1,1
24,2025-05-24T21:15:00+02:00,2025-05-25,05:15,2,4,6
24,2025-05-24T21:17:00+02:00,2025-05-25,05:17,3,0,3
24,2025-05-24T21:20:00+02:00,2025-05-25,05:20,1,0,1
25,2025-05-24T21:20:00+02:00,2025-05-25,05:20,1,1,2
30,2025-05-24T21:10:00+02:00,2025-05-25,05:10,0,5,5
30,2025-05-24T21:11:00+02:00,2025-05-25,05:11,3,1,4
30,2025-05-24T21:13:00+02:00,2025-05-25,05:13,1,0,1
30,2025-05-24T21:17:00+02:00,2025-05-25,05:17,0,2,2
30,2025-05-24T21:22:00+02:00,2025-05-25,05:22,0,1,1
30,2025-05-24T21:24:00+02:00,2025-05-25,05:24,2,0,2
35,2025-05-24T21:18:00+02:00,2025-05-25,05:18,0,1,1
35,2025-05-24T21:24:00+02:00,2025-05-25,05:24,0,3,3
49,2025-05-24T21:10:00+02:00,2025-05-25,05:10,2,0,2
49,2025-05-24T21:15:00+02:00,2025-05-25,05:15,2,0,2
49,2025-05-24T21:16:00+02:00,2025-05-25,05:16,0,1,1
49,2025-05-24T21:17:00+02:00,2025-05-25,05:17,1,2,3
51,2025-05-24T21:21:00+02:00,2025-05-25,05:21,1,0,1
52,2025-05-24T21:14:00+02:00,2025-05-25,05:14,4,0,4
52,2025-05-24T21:15:00+02:00,2025-05-25,05:15,0,1,1
52,2025-05-24T21:20:00+02:00,2025-05-25,05:20,0,2,2
52,2025-05-24T21:21:00+02:00,2025-05-25,05:21,1,0,1
56,2025-05-24T21:15:00+02:00,2025-05-25,05:15,1,0,1
56,2025-05-24T21:24:00+02:00,2025-05-25,05:24,1,0,1
58,2025-05-24T21:11:00+02:00,2025-05-25,05:11,1,1,2
58,2025-05-24T21:18:00+02:00,2025-05-25,05:18,3,0,3
58,2025-05-24T21:23:00+02:00,2025-05-25,05:23,1,2,3
62,2025-05-24T21:20:00+02:00,2025-05-25,05:20,1,0,1
63,2025-05-24T21:11:00+02:00,2025-05-25,05:11,1,0,1
63,2025-05-24T21:24:00+02:00,2025-05-25,05:24,0,1,1
67,2025-05-24T21:18:00+02:00,2025-05-25,05:18,0,1,1
67,2025-05-24T21:24:00+02:00,2025-05-25,05:24,0,1,1
141,2025-05-24T21:20:00+02:00,2025-05-25,05:20,1,0,1
142,2025-05-24T21:20:00+02:00,2025-05-25,05:20,1,3,4
164,2025-05-24T21:10:00+02:00,2025-05-25,05:10,0,1,1
181,2025-05-24T21:27:00+02:00,2025-05-25,05:27,0,1,1
181,2025-05-24T21:34:00+02:00,2025-05-25,05:34,1,0,1
181,2025-05-24T21:36:00+02:00,2025-05-25,05:36,0,2,2
182,2025-05-24T21:25:00+02:00,2025-05-25,05:25,4,3,7
3,2025-05-24T21:51:00+02:00,2025-05-25,05:51,0,2,2
4,2025-05-24T21:40:00+02:00,2025-05-25,05:40,0,1,1
4,2025-05-24T21:46:00+02:00,2025-05-25,05:46,0,4,4
4,2025-05-24T21:47:00+02:00,2025-05-25,05:47,1,0,1
4,2025-05-24T21:52:00+02:00,2025-05-25,05:52,1,0,1
4,2025-05-24T21:53:00+02:00,2025-05-25,05:53,0,1,1
6,2025-05-24T21:41:00+02:00,2025-05-25,05:41,0,1,1
6,2025-05-24T21:42:00+02:00,2025-05-25,05:42,0,2,2
28,2025-05-24T21:43:00+02:00,2025-05-25,05:43,1,0,1
28,2025-05-24T21:50:00+02:00,2025-05-25,05:50,0,1,1
28,2025-05-24T21:51:00+02:00,2025-05-25,05:51,0,1,1
36,2025-05-24T21:40:00+02:00,2025-05-25,05:40,0,3,3
41,2025-05-24T21:44:00+02:00,2025-05-25,05:44,1,0,1
41,2025-05-24T21:47:00+02:00,2025-05-25,05:47,1,1,2
41,2025-05-24T21:53:00+02:00,2025-05-25,05:53,0,1,1
43,2025-05-24T21:40:00+02:00,2025-05-25,05:40,0,1,1
44,2025-05-24T21:40:00+02:00,2025-05-25,05:40,0,1,1
45,2025-05-24T21:45:00+02:00,2025-05-25,05:45,1,1,2
45,2025-05-24T21:48:00+02:00,2025-05-25,05:48,2,1,3
45,2025-05-24T21:49:00+02:00,2025-05-25,05:49,1,0,1
45,2025-05-24T21:54:00+02:00,2025-05-25,05:54,1,1,2
47,2025-05-24T21:47:00+02:00,2025-05-25,05:47,1,0,1
47,2025-05-24T21:51:00+02:00,2025-05-25,05:51,0,1,1
54,2025-05-24T21:51:00+02:00,2025-05-25,05:51,1,0,1
59,2025-05-24T21:50:00+02:00,2025-05-25,05:50,0,3,3
66,2025-05-24T21:40:00+02:00,2025-05-25,05:40,1,0,1
66,2025-05-24T21:45:00+02:00,2025-05-25,05:45,0,1,1
66,2025-05-24T21:47:00+02:00,2025-05-25,05:47,1,0,1
66,2025-05-24T21:49:00+02:00,2025-05-25,05:49,3,0,3
66,2025-05-24T21:52:00+02:00,2025-05-25,05:52,0,1,1
70,2025-05-24T21:48:00+02:00,2025-05-25,05:48,0,1,1
84,2025-05-24T21:50:00+02:00,2025-05-25,05:50,4,2,6
107,2025-05-24T21:45:00+02:00,2025-05-25,05:45,1,2,3
108,2025-05-24T21:40:00+02:00,2025-05-25,05:40,1,0,1
108,2025-05-24T21:52:00+02:00,2025-05-25,05:52,0,1,1
131,2025-05-24T21:40:00+02:00,2025-05-25,05:40,5,3,8
134,2025-05-24T21:45:00+02:00,2025-05-25,05:45,9,5,14
134,2025-05-24T21:50:00+02:00,2025-05-25,05:50,11,2,13
162,2025-05-24T21:40:00+02:00,2025-05-25,05:40,4,9,13
162,2025-05-24T21:45:00+02:00,2025-05-25,05:45,2,0,2
1,2025-05-24T21:49:00+02:00,2025-05-25,05:49,0,3,3
1,2025-05-24T21:54:00+02:00,2025-05-25,05:54,0,1,1
9,2025-05-24T21:47:00+02:00,2025-05-25,05:47,0,1,1
10,2025-05-24T21:48:00+02:00,2025-05-25,05:48,0,1,1
18,2025-05-24T21:53:00+02:00,2025-05-25,05:53,1,0,1
20,2025-05-24T21:43:00+02:00,2025-05-25,05:43,1,0,1
23,2025-05-24T21:50:00+02:00,2025-05-25,05:50,2,0,2
24,2025-05-24T21:40:00+02:00,2025-05-25,05:40,0,2,2
24,2025-05-24T21:52:00+02:00,2025-05-25,05:52,0,1,1
27,2025-05-24T21:51:00+02:00,2025-05-25,05:51,2,0,2
30,2025-05-24T21:40:00+02:00,2025-05-25,05:40,0,2,2
30,2025-05-24T21:45:00+02:00,2025-05-25,05:45,3,1,4
30,2025-05-24T21:46:00+02:00,2025-05-25,05:46,1,1,2
30,2025-05-24T21:47:00+02:00,2025-05-25,05:47,1,0,1
30,2025-05-24T21:53:00+02:00,2025-05-25,05:53,5,2,7
30,2025-05-24T21:54:00+02:00,2025-05-25,05:54,0,5,5
35,2025-05-24T21:41:00+02:00,2025-05-25,05:41,0,1,1
35,2025-05-24T21:52:00+02:00,2025-05-25,05:52,1,0,1
51,2025-05-24T21:53:00+02:00,2025-05-25,05:53,1,0,1
52,2025-05-24T21:48:00+02:00,2025-05-25,05:48,0,1,1
53,2025-05-24T21:43:00+02:00,2025-05-25,05:43,1,2,3
58,2025-05-24T21:44:00+02:00,2025-05-25,05:44,1,0,1
58,2025-05-24T21:48:00+02:00,2025-05-25,05:48,2,2,4
58,2025-05-24T21:50:00+02:00,2025-05-25,05:50,0,6,6
58,2025-05-24T21:52:00+02:00,2025-05-25,05:52,0,1,1
58,2025-05-24T21:54:00+02:00,2025-05-25,05:54,0,1,1
62,2025-05-24T21:48:00+02:00,2025-05-25,05:48,1,1,2
67,2025-05-24T21:54:00+02:00,2025-05-25,05:54,0,1,1
72,2025-05-24T21:45:00+02:00,2025-05-25,05:45,1,0,1
79,2025-05-24T21:41:00+02:00,2025-05-25,05:41,2,0,2
79,2025-05-24T21:44:00+02:00,2025-05-25,05:44,0,1,1
86,2025-05-24T21:52:00+02:00,2025-05-25,05:52,1,0,1
130,2025-05-24T21:45:00+02:00,2025-05-25,05:45,1,0,1
181,2025-05-24T21:41:00+02:00,2025-05-25,05:41,0,4,4
181,2025-05-24T21:42:00+02:00,2025-05-25,05:42,0,1,1
181,2025-05-24T21:43:00+02:00,2025-05-25,05:43,2,0,2
181,2025-05-24T21:47:00+02:00,2025-05-25,05:47,3,0,3
181,2025-05-24T21:51:00+02:00,2025-05-25,05:51,0,1,1
181,2025-05-24T21:54:00+02:00,2025-05-25,05:54,2,0,2
182,2025-05-24T21:40:00+02:00,2025-05-25,05:40,2,5,7
182,2025-05-24T21:45:00+02:00,2025-05-25,05:45,0,4,4
3,2025-05-24T21:56:00+02:00,2025-05-25,05:56,0,2,2
3,2025-05-24T21:58:00+02:00,2025-05-25,05:58,0,3,3
3,2025-05-24T22:05:00+02:00,2025-05-25,06:05,1,1,2
3,2025-05-24T22:06:00+02:00,2025-05-25,06:06,2,1,3
3,2025-05-24T22:07:00+02:00,2025-05-25,06:07,2,1,3
3,2025-05-24T22:08:00+02:00,2025-05-25,06:08,3,0,3
3,2025-05-24T22:09:00+02:00,2025-05-25,06:09,2,0,2
4,2025-05-24T21:58:00+02:00,2025-05-25,05:58,1,0,1
4,2025-05-24T21:59:00+02:00,2025-05-25,05:59,2,2,4
6,2025-05-24T21:56:00+02:00,2025-05-25,05:56,3,3,6
6,2025-05-24T21:58:00+02:00,2025-05-25,05:58,1,0,1
6,2025-05-24T21:59:00+02:00,2025-05-25,05:59,1,0,1
6,2025-05-24T22:03:00+02:00,2025-05-25,06:03,1,0,1
6,2025-05-24T22:07:00+02:00,2025-05-25,06:07,0,1,1
28,2025-05-24T21:59:00+02:00,2025-05-25,05:59,0,1,1
28,2025-05-24T22:07:00+02:00,2025-05-25,06:07,1,1,2
28,2025-05-24T22:09:00+02:00,2025-05-25,06:09,1,0,1
29,2025-05-24T22:02:00+02:00,2025-05-25,06:02,0,1,1
37,2025-05-24T21:55:00+02:00,2025-05-25,05:55,2,0,2
37,2025-05-24T22:02:00+02:00,2025-05-25,06:02,0,1,1
41,2025-05-24T21:57:00+02:00,2025-05-25,05:57,3,0,3
41,2025-05-24T21:58:00+02:00,2025-05-25,05:58,1,0,1
41,2025-05-24T21:59:00+02:00,2025-05-25,05:59,0,1,1
41,2025-05-24T22:03:00+02:00,2025-05-25,06:03,0,1,1
41,2025-05-24T22:08:00+02:00,2025-05-25,06:08,0,2,2
41,2025-05-24T22:09:00+02:00,2025-05-25,06:09,0,2,2
45,2025-05-24T21:56:00+02:00,2025-05-25,05:56,1,2,3
45,2025-05-24T21:59:00+02:00,2025-05-25,05:59,3,0,3
45,2025-05-24T22:00:00+02:00,2025-05-25,06:00,2,1,3
45,2025-05-24T22:01:00+02:00,2025-05-25,06:01,1,2,3
45,2025-05-24T22:04:00+02:00,2025-05-25,06:04,0,1,1
47,2025-05-24T21:56:00+02:00,2025-05-25,05:56,0,1,1
47,2025-05-24T22:05:00+02:00,2025-05-25,06:05,3,0,3
54,2025-05-24T21:58:00+02:00,2025-05-25,05:58,1,0,1
54,2025-05-24T22:07:00+02:00,2025-05-25,06:07,0,1,1
66,2025-05-24T21:56:00+02:00,2025-05-25,05:56,0,1,1
66,2025-05-24T22:08:00+02:00,2025-05-25,06:08,0,3,3
70,2025-05-24T21:59:00+02:00,2025-05-25,05:59,0,1,1
84,2025-05-24T21:55:00+02:00,2025-05-25,05:55,2,4,6
84,2025-05-24T22:00:00+02:00,2025-05-25,06:00,2,0,2
108,2025-05-24T22:00:00+02:00,2025-05-25,06:00,1,1,2
108,2025-05-24T22:05:00+02:00,2025-05-25,06:05,1,0,1
131,2025-05-24T21:55:00+02:00,2025-05-25,05:55,0,6,6
131,2025-05-24T22:05:00+02:00,2025-05-25,06:05,7,2,9
133,2025-05-24T21:55:00+02:00,2025-05-25,05:55,1,9,10
133,2025-05-24T22:05:00+02:00,2025-05-25,06:05,3,6,9
2,2025-05-24T21:55:00+02:00,2025-05-25,05:55,1,0,1
2,2025-05-24T22:02:00+02:00,2025-05-25,06:02,0,1,1
2,2025-05-24T22:09:00+02:00,2025-05-25,06:09,0,1,1
9,2025-05-24T21:59:00+02:00,2025-05-25,05:59,1,0,1
17,2025-05-24T21:58:00+02:00,2025-05-25,05:58,1,0,1
20,2025-05-24T22:00:00+02:00,2025-05-25,06:00,0,2,2
23,2025-05-24T22:00:00+02:00,2025-05-25,06:00,1,0,1
24,2025-05-24T21:56:00+02:00,2025-05-25,05:56,0,1,1
24,2025-05-24T21:57:00+02:00,2025-05-25,05:57,0,1,1
24,2025-05-24T22:00:00+02:00,2025-05-25,06:00,0,2,2
24,2025-05-24T22:04:00+02:00,2025-05-25,06:04,0,1,1
24,2025-05-24T22:06:00+02:00,2025-05-25,06:06,1,1,2
24,2025-05-24T22:08:00+02:00,2025-05-25,06:08,0,3,3
27,2025-05-24T21:59:00+02:00,2025-05-25,05:59,1,0,1
30,2025-05-24T22:00:00+02:00,2025-05-25,06:00,7,1,8
30,2025-05-24T22:01:00+02:00,2025-05-25,06:01,1,1,2
30,2025-05-24T22:08:00+02:00,2025-05-25,06:08,2,0,2
35,2025-05-24T21:56:00+02:00,2025-05-25,05:56,2,0,2
35,2025-05-24T22:02:00+02:00,2025-05-25,06:02,1,1,2
35,2025-05-24T22:03:00+02:00,2025-05-25,06:03,1,1,2
35,2025-05-24T22:04:00+02:00,2025-05-25,06:04,0,1,1
48,2025-05-24T22:03:00+02:00,2025-05-25,06:03,0,1,1
49,2025-05-24T21:57:00+02:00,2025-05-25,05:57,2,0,2
49,2025-05-24T21:59:00+02:00,2025-05-25,05:59,4,1,5
51,2025-05-24T21:56:00+02:00,2025-05-25,05:56,1,0,1
51,2025-05-24T21:58:00+02:00,2025-05-25,05:58,2,0,2
53,2025-05-24T21:57:00+02:00,2025-05-25,05:57,0,1,1
58,2025-05-24T22:07:00+02:00,2025-05-25,06:07,2,0,2
62,2025-05-24T21:55:00+02:00,2025-05-25,05:55,1,0,1
62,2025-05-24T21:57:00+02:00,2025-05-25,05:57,0,1,1
62,2025-05-24T22:03:00+02:00,2025-05-25,06:03,1,0,1
62,2025-05-24T22:08:00+02:00,2025-05-25,06:08,0,1,1
72,2025-05-24T21:59:00+02:00,2025-05-25,05:59,0,1,1
72,2025-05-24T22:04:00+02:00,2025-05-25,06:04,0,1,1
79,2025-05-24T21:56:00+02:00,2025-05-25,05:56,0,1,1
79,2025-05-24T21:57:00+02:00,2025-05-25,05:57,1,1,2
79,2025-05-24T22:05:00+02:00,2025-05-25,06:05,2,0,2
109,2025-05-24T21:55:00+02:00,2025-05-25,05:55,0,1,1
136,2025-05-24T21:55:00+02:00,2025-05-25,05:55,1,0,1
141,2025-05-24T22:00:00+02:00,2025-05-25,06:00,3,2,5
181,2025-05-24T21:58:00+02:00,2025-05-25,05:58,1,2,3
181,2025-05-24T22:00:00+02:00,2025-05-25,06:00,1,0,1
182,2025-05-24T21:55:00+02:00,2025-05-25,05:55,2,3,5
182,2025-05-24T22:00:00+02:00,2025-05-25,06:00,0,5,5
182,2025-05-24T22:05:00+02:00,2025-05-25,06:05,3,8,11
3,2025-05-24T22:10:00+02:00,2025-05-25,06:10,0,1,1
4,2025-05-24T22:15:00+02:00,2025-05-25,06:15,0,2,2
4,2025-05-24T22:17:00+02:00,2025-05-25,06:17,0,1,1
4,2025-05-24T22:18:00+02:00,2025-05-25,06:18,0,1,1
4,2025-05-24T22:20:00+02:00,2025-05-25,06:20,1,0,1
5,2025-05-24T22:10:00+02:00,2025-05-25,06:10,3,0,3
5,2025-05-24T22:15:00+02:00,2025-05-25,06:15,3,3,6
6,2025-05-24T22:20:00+02:00,2025-05-25,06:20,2,1,3
28,2025-05-24T22:14:00+02:00,2025-05-25,06:14,0,1,1
28,2025-05-24T22:21:00+02:00,2025-05-25,06:21,1,0,1
41,2025-05-24T22:10:00+02:00,2025-05-25,06:10,5,0,5
41,2025-05-24T22:23:00+02:00,2025-05-25,06:23,0,1,1
50,2025-05-24T22:17:00+02:00,2025-05-25,06:17,1,0,1
50,2025-05-24T22:19:00+02:00,2025-05-25,06:19,1,0,1
61,2025-05-24T22:10:00+02:00,2025-05-25,06:10,0,1,1
61,2025-05-24T22:18:00+02:00,2025-05-25,06:18,1,0,1
66,2025-05-24T22:12:00+02:00,2025-05-25,06:12,1,1,2
66,2025-05-24T22:13:00+02:00,2025-05-25,06:13,0,1,1
69,2025-05-24T22:21:00+02:00,2025-05-25,06:21,0,1,1
87,2025-05-24T22:23:00+02:00,2025-05-25,06:23,1,1,2
107,2025-05-24T22:10:00+02:00,2025-05-25,06:10,1,0,1
108,2025-05-24T22:11:00+02:00,2025-05-25,06:11,1,1,2
108,2025-05-24T22:13:00+02:00,2025-05-25,06:13,0,1,1
131,2025-05-24T22:10:00+02:00,2025-05-25,06:10,0,7,7
131,2025-05-24T22:15:00+02:00,2025-05-25,06:15,2,2,4
131,2025-05-24T22:20:00+02:00,2025-05-25,06:20,1,6,7
132,2025-05-24T22:10:00+02:00,2025-05-25,06:10,2,0,2
133,2025-05-24T22:15:00+02:00,2025-05-25,06:15,3,7,10
134,2025-05-24T22:10:00+02:00,2025-05-25,06:10,2,1,3
134,2025-05-24T22:15:00+02:00,2025-05-25,06:15,13,3,16
162,2025-05-24T22:10:00+02:00,2025-05-25,06:10,1,2,3
1,2025-05-24T22:23:00+02:00,2025-05-25,06:23,1,0,1
9,2025-05-24T22:13:00+02:00,2025-05-25,06:13,0,2,2
9,2025-05-24T22:19:00+02:00,2025-05-25,06:19,1,1,2
9,2025-05-24T22:21:00+02:00,2025-05-25,06:21,1,0,1
10,2025-05-24T22:18:00+02:00,2025-05-25,06:18,2,0,2
12,2025-05-24T22:21:00+02:00,2025-05-25,06:21,0,1,1
20,2025-05-24T22:21:00+02:00,2025-05-25,06:21,1,0,1
24,2025-05-24T22:12:00+02:00,2025-05-25,06:12,1,0,1
24,2025-05-24T22:19:00+02:00,2025-05-25,06:19,0,1,1
24,2025-05-24T22:20:00+02:00,2025-05-25,06:20,1,0,1
25,2025-05-24T22:15:00+02:00,2025-05-25,06:15,0,4,4
30,2025-05-24T22:17:00+02:00,2025-05-25,06:17,0,4,4
30,2025-05-24T22:22:00+02:00,2025-05-25,06:22,3,0,3
35,2025-05-24T22:11:00+02:00,2025-05-25,06:11,0,3,3
35,2025-05-24T22:19:00+02:00,2025-05-25,06:19,1,0,1
35,2025-05-24T22:24:00+02:00,2025-05-25,06:24,1,0,1
48,2025-05-24T22:10:00+02:00,2025-05-25,06:10,2,0,2
48,2025-05-24T22:12:00+02:00,2025-05-25,06:12,0,1,1
48,2025-05-24T22:13:00+02:00,2025-05-25,06:13,0,1,1
48,2025-05-24T22:17:00+02:00,2025-05-25,06:17,1,0,1
48,2025-05-24T22:21:00+02:00,2025-05-25,06:21,0,1,1
49,2025-05-24T22:10:00+02:00,2025-05-25,06:10,0,1,1
49,2025-05-24T22:13:00+02:00,2025-05-25,06:13,1,0,1
49,2025-05-24T22:21:00+02:00,2025-05-25,06:21,2,1,3
52,2025-05-24T22:11:00+02:00,2025-05-25,06:11,0,2,2
52,2025-05-24T22:13:00+02:00,2025-05-25,06:13,1,0,1
52,2025-05-24T22:22:00+02:00,2025-05-25,06:22,0,1,1
53,2025-05-24T22:11:00+02:00,2025-05-25,06:11,1,0,1
53,2025-05-24T22:23:00+02:00,2025-05-25,06:23,0,1,1
58,2025-05-24T22:11:00+02:00,2025-05-25,06:11,0,1,1
58,2025-05-24T22:12:00+02:00,2025-05-25,06:12,1,0,1
58,2025-05-24T22:14:00+02:00,2025-05-25,06:14,1,0,1
62,2025-05-24T22:11:00+02:00,2025-05-25,06:11,1,0,1
62,2025-05-24T22:24:00+02:00,2025-05-25,06:24,1,0,1
67,2025-05-24T22:21:00+02:00,2025-05-25,06:21,0,1,1
68,2025-05-24T22:16:00+02:00,2025-05-25,06:16,1,0,1
79,2025-05-24T22:15:00+02:00,2025-05-25,06:15,3,0,3
79,2025-05-24T22:18:00+02:00,2025-05-25,06:18,1,0,1
79,2025-05-24T22:20:00+02:00,2025-05-25,06:20,2,0,2
117,2025-05-24T22:20:00+02:00,2025-05-25,06:20,2,0,2
164,2025-05-24T22:20:00+02:00,2025-05-25,06:20,0,2,2
181,2025-05-24T22:13:00+02:00,2025-05-25,06:13,0,1,1
181,2025-05-24T22:15:00+02:00,2025-05-25,06:15,1,0,1
181,2025-05-24T22:20:00+02:00,2025-05-25,06:20,0,1,1
181,2025-05-24T22:24:00+02:00,2025-05-25,06:24,0,2,2
182,2025-05-24T22:20:00+02:00,2025-05-25,06:20,3,2,5
3,2025-05-24T22:31:00+02:00,2025-05-25,06:31,3,0,3
3,2025-05-24T22:35:00+02:00,2025-05-25,06:35,0,2,2
4,2025-05-24T22:25:00+02:00,2025-05-25,06:25,0,2,2
4,2025-05-24T22:32:00+02:00,2025-05-25,06:32,0,1,1
4,2025-05-24T22:34:00+02:00,2025-05-25,06:34,1,3,4
4,2025-05-24T22:38:00+02:00,2025-05-25,06:38,2,0,2
5,2025-05-24T22:30:00+02:00,2025-05-25,06:30,2,8,10
6,2025-05-24T22:25:00+02:00,2025-05-25,06:25,2,0,2
6,2025-05-24T22:29:00+02:00,2025-05-25,06:29,1,0,1
6,2025-05-24T22:30:00+02:00,2025-05-25,06:30,3,3,6
6,2025-05-24T22:35:00+02:00,2025-05-25,06:35,1,0,1
6,2025-05-24T22:39:00+02:00,2025-05-25,06:39,1,2,3
28,2025-05-24T22:36:00+02:00,2025-05-25,06:36,0,10,10
29,2025-05-24T22:33:00+02:00,2025-05-25,06:33,0,1,1
29,2025-05-24T22:34:00+02:00,2025-05-25,06:34,0,2,2
40,2025-05-24T22:32:00+02:00,2025-05-25,06:32,1,0,1
41,2025-05-24T22:36:00+02:00,2025-05-25,06:36,3,0,3
41,2025-05-24T22:37:00+02:00,2025-05-25,06:37,0,1,1
45,2025-05-24T22:25:00+02:00,2025-05-25,06:25,0,6,6
45,2025-05-24T22:26:00+02:00,2025-05-25,06:26,1,0,1
45,2025-05-24T22:29:00+02:00,2025-05-25,06:29,1,0,1
45,2025-05-24T22:37:00+02:00,2025-05-25,06:37,2,1,3
45,2025-05-24T22:39:00+02:00,2025-05-25,06:39,2,1,3
47,2025-05-24T22:25:00+02:00,2025-05-25,06:25,0,1,1
47,2025-05-24T22:32:00+02:00,2025-05-25,06:32,1,2,3
47,2025-05-24T22:33:00+02:00,2025-05-25,06:33,2,1,3
47,2025-05-24T22:34:00+02:00,2025-05-25,06:34,3,0,3
47,2025-05-24T22:37:00+02:00,2025-05-25,06:37,2,4,6
54,2025-05-24T22:33:00+02:00,2025-05-25,06:33,0,1,1
59,2025-05-24T22:25:00+02:00,2025-05-25,06:25,2,2,4
61,2025-05-24T22:37:00+02:00,2025-05-25,06:37,1,0,1
61,2025-05-24T22:39:00+02:00,2025-05-25,06:39,0,1,1
66,2025-05-24T22:25:00+02:00,2025-05-25,06:25,0,1,1
66,2025-05-24T22:26:00+02:00,2025-05-25,06:26,0,1,1
66,2025-05-24T22:34:00+02:00,2025-05-25,06:34,2,0,2
69,2025-05-24T22:25:00+02:00,2025-05-25,06:25,1,0,1
70,2025-05-24T22:27:00+02:00,2025-05-25,06:27,0,1,1
75,2025-05-24T22:28:00+02:00,2025-05-25,06:28,1,0,1
75,2025-05-24T22:35:00+02:00,2025-05-25,06:35,0,1,1
77,2025-05-24T22:25:00+02:00,2025-05-25,06:25,0,2,2
77,2025-05-24T22:35:00+02:00,2025-05-25,06:35,0,4,4
87,2025-05-24T22:39:00+02:00,2025-05-25,06:39,1,0,1
107,2025-05-24T22:35:00+02:00,2025-05-25,06:35,1,1,2
108,2025-05-24T22:26:00+02:00,2025-05-25,06:26,0,1,1
108,2025-05-24T22:27:00+02:00,2025-05-25,06:27,0,1,1
133,2025-05-24T22:25:00+02:00,2025-05-25,06:25,2,7,9
134,2025-05-24T22:25:00+02:00,2025-05-25,06:25,5,0,5
134,2025-05-24T22:30:00+02:00,2025-05-25,06:30,5,3,8
135,2025-05-24T22:35:00+02:00,2025-05-25,06:35,4,5,9
167,2025-05-24T22:25:00+02:00,2025-05-25,06:25,0,1,1
179,2025-05-24T22:25:00+02:00,2025-05-25,06:25,0,1,1
179,2025-05-24T22:30:00+02:00,2025-05-25,06:30,0,1,1
1,2025-05-24T22:26:00+02:00,2025-05-25,06:26,1,0,1
1,2025-05-24T22:29:00+02:00,2025-05-25,06:29,1,0,1
1,2025-05-24T22:31:00+02:00,2025-05-25,06:31,0,1,1
2,2025-05-24T22:30:00+02:00,2025-05-25,06:30,0,1,1
2,2025-05-24T22:33:00+02:00,2025-05-25,06:33,0,1,1
2,2025-05-24T22:34:00+02:00,2025-05-25,06:34,1,0,1
2,2025-05-24T22:38:00+02:00,2025-05-25,06:38,0,1,1
11,2025-05-24T22:33:00+02:00,2025-05-25,06:33,0,1,1
11,2025-05-24T22:35:00+02:00,2025-05-25,06:35,1,0,1
11,2025-05-24T22:38:00+02:00,2025-05-25,06:38,1,0,1
12,2025-05-24T22:38:00+02:00,2025-05-25,06:38,1,0,1
20,2025-05-24T22:36:00+02:00,2025-05-25,06:36,0,1,1
23,2025-05-24T22:25:00+02:00,2025-05-25,06:25,0,1,1
23,2025-05-24T22:38:00+02:00,2025-05-25,06:38,0,3,3
24,2025-05-24T22:25:00+02:00,2025-05-25,06:25,0,8,8
24,2025-05-24T22:30:00+02:00,2025-05-25,06:30,0,2,2
24,2025-05-24T22:32:00+02:00,2025-05-25,06:32,3,0,3
24,2025-05-24T22:34:00+02:00,2025-05-25,06:34,1,0,1
24,2025-05-24T22:36:00+02:00,2025-05-25,06:36,4,1,5
24,2025-05-24T22:39:00+02:00,2025-05-25,06:39,2,3,5
27,2025-05-24T22:25:00+02:00,2025-05-25,06:25,1,0,1
30,2025-05-24T22:32:00+02:00,2025-05-25,06:32,3,1,4
30,2025-05-24T22:34:00+02:00,2025-05-25,06:34,0,1,1
30,2025-05-24T22:35:00+02:00,2025-05-25,06:35,0,2,2
30,2025-05-24T22:36:00+02:00,2025-05-25,06:36,0,1,1
35,2025-05-24T22:30:00+02:00,2025-05-25,06:30,3,0,3
35,2025-05-24T22:31:00+02:00,2025-05-25,06:31,4,0,4
35,2025-05-24T22:35:00+02:00,2025-05-25,06:35,0,1,1
48,2025-05-24T22:39:00+02:00,2025-05-25,06:39,1,1,2
49,2025-05-24T22:31:00+02:00,2025-05-25,06:31,1,0,1
49,2025-05-24T22:32:00+02:00,2025-05-25,06:32,0,1,1
49,2025-05-24T22:34:00+02:00,2025-05-25,06:34,0,2,2
49,2025-05-24T22:36:00+02:00,2025-05-25,06:36,0,2,2
52,2025-05-24T22:36:00+02:00,2025-05-25,06:36,1,0,1
52,2025-05-24T22:37:00+02:00,2025-05-25,06:37,1,3,4
52,2025-05-24T22:39:00+02:00,2025-05-25,06:39,0,2,2
53,2025-05-24T22:26:00+02:00,2025-05-25,06:26,0,1,1
56,2025-05-24T22:36:00+02:00,2025-05-25,06:36,0,2,2
58,2025-05-24T22:25:00+02:00,2025-05-25,06:25,1,1,2
58,2025-05-24T22:29:00+02:00,2025-05-25,06:29,0,1,1
58,2025-05-24T22:32:00+02:00,2025-05-25,06:32,1,0,1
58,2025-05-24T22:33:00+02:00,2025-05-25,06:33,2,0,2
58,2025-05-24T22:37:00+02:00,2025-05-25,06:37,3,1,4
62,2025-05-24T22:29:00+02:00,2025-05-25,06:29,2,0,2
63,2025-05-24T22:25:00+02:00,2025-05-25,06:25,0,1,1
63,2025-05-24T22:39:00+02:00,2025-05-25,06:39,0,1,1
67,2025-05-24T22:35:00+02:00,2025-05-25,06:35,2,0,2
68,2025-05-24T22:36:00+02:00,2025-05-25,06:36,0,1,1
72,2025-05-24T22:25:00+02:00,2025-05-25,06:25,0,1,1
72,2025-05-24T22:39:00+02:00,2025-05-25,06:39,1,0,1
79,2025-05-24T22:28:00+02:00,2025-05-25,06:28,1,0,1
79,2025-05-24T22:29:00+02:00,2025-05-25,06:29,0,2,2
79,2025-05-24T22:37:00+02:00,2025-05-25,06:37,0,1,1
117,2025-05-24T22:30:00+02:00,2025-05-25,06:30,1,1,2
141,2025-05-24T22:25:00+02:00,2025-05-25,06:25,1,0,1
141,2025-05-24T22:35:00+02:00,2025-05-25,06:35,1,0,1
164,2025-05-24T22:25:00+02:00,2025-05-25,06:25,0,1,1
181,2025-05-24T22:27:00+02:00,2025-05-25,06:27,1,1,2
181,2025-05-24T22:31:00+02:00,2025-05-25,06:31,0,2,2
181,2025-05-24T22:37:00+02:00,2025-05-25,06:37,0,1,1
182,2025-05-24T22:25:00+02:00,2025-05-25,06:25,4,2,6
180,2025-05-24T22:28:00+02:00,2025-05-25,06:28,0,1,1
3,2025-05-24T22:41:00+02:00,2025-05-25,06:41,1,0,1
3,2025-05-24T22:42:00+02:00,2025-05-25,06:42,1,0,1
3,2025-05-24T22:51:00+02:00,2025-05-25,06:51,1,0,1
3,2025-05-24T22:53:00+02:00,2025-05-25,06:53,2,0,2
3,2025-05-24T22:54:00+02:00,2025-05-25,06:54,1,0,1
4,2025-05-24T22:43:00+02:00,2025-05-25,06:43,1,0,1
4,2025-05-24T22:44:00+02:00,2025-05-25,06:44,1,0,1
4,2025-05-24T22:45:00+02:00,2025-05-25,06:45,2,1,3
4,2025-05-24T22:49:00+02:00,2025-05-25,06:49,1,0,1
4,2025-05-24T22:50:00+02:00,2025-05-25,06:50,0,2,2
4,2025-05-24T22:52:00+02:00,2025-05-25,06:52,9,2,11
5,2025-05-24T22:45:00+02:00,2025-05-25,06:45,1,2,3
6,2025-05-24T22:41:00+02:00,2025-05-25,06:41,1,1,2
28,2025-05-24T22:53:00+02:00,2025-05-25,06:53,0,1,1
28,2025-05-24T22:54:00+02:00,2025-05-25,06:54,0,1,1
29,2025-05-24T22:46:00+02:00,2025-05-25,06:46,0,4,4
29,2025-05-24T22:48:00+02:00,2025-05-25,06:48,2,2,4
29,2025-05-24T22:50:00+02:00,2025-05-25,06:50,0,1,1
29,2025-05-24T22:52:00+02:00,2025-05-25,06:52,0,2,2
31,2025-05-24T22:42:00+02:00,2025-05-25,06:42,0,1,1
31,2025-05-24T22:53:00+02:00,2025-05-25,06:53,1,0,1
37,2025-05-24T22:44:00+02:00,2025-05-25,06:44,0,2,2
37,2025-05-24T22:46:00+02:00,2025-05-25,06:46,0,1,1
40,2025-05-24T22:47:00+02:00,2025-05-25,06:47,0,1,1
41,2025-05-24T22:46:00+02:00,2025-05-25,06:46,2,1,3
41,2025-05-24T22:51:00+02:00,2025-05-25,06:51,1,2,3
45,2025-05-24T22:40:00+02:00,2025-05-25,06:40,2,0,2
45,2025-05-24T22:47:00+02:00,2025-05-25,06:47,1,3,4
45,2025-05-24T22:49:00+02:00,2025-05-25,06:49,0,3,3
45,2025-05-24T22:54:00+02:00,2025-05-25,06:54,0,1,1
47,2025-05-24T22:43:00+02:00,2025-05-25,06:43,0,1,1
47,2025-05-24T22:47:00+02:00,2025-05-25,06:47,0,2,2
47,2025-05-24T22:48:00+02:00,2025-05-25,06:48,0,2,2
47,2025-05-24T22:54:00+02:00,2025-05-25,06:54,0,4,4
50,2025-05-24T22:41:00+02:00,2025-05-25,06:41,1,0,1
54,2025-05-24T22:52:00+02:00,2025-05-25,06:52,0,1,1
59,2025-05-24T22:45:00+02:00,2025-05-25,06:45,1,1,2
61,2025-05-24T22:49:00+02:00,2025-05-25,06:49,0,1,1
66,2025-05-24T22:41:00+02:00,2025-05-25,06:41,2,0,2
66,2025-05-24T22:44:00+02:00,2025-05-25,06:44,1,1,2
75,2025-05-24T22:40:00+02:00,2025-05-25,06:40,2,0,2
77,2025-05-24T22:40:00+02:00,2025-05-25,06:40,0,3,3
84,2025-05-24T22:40:00+02:00,2025-05-25,06:40,8,3,11
84,2025-05-24T22:45:00+02:00,2025-05-25,06:45,5,7,12
84,2025-05-24T22:50:00+02:00,2025-05-25,06:50,5,6,11
87,2025-05-24T22:42:00+02:00,2025-05-25,06:42,1,0,1
107,2025-05-24T22:40:00+02:00,2025-05-25,06:40,0,1,1
107,2025-05-24T22:50:00+02:00,2025-05-25,06:50,0,1,1
108,2025-05-24T22:47:00+02:00,2025-05-25,06:47,4,1,5
131,2025-05-24T22:45:00+02:00,2025-05-25,06:45,4,2,6
131,2025-05-24T22:50:00+02:00,2025-05-25,06:50,0,6,6
134,2025-05-24T22:40:00+02:00,2025-05-25,06:40,3,4,7
162,2025-05-24T22:50:00+02:00,2025-05-25,06:50,4,2,6
167,2025-05-24T22:45:00+02:00,2025-05-25,06:45,0,1,1
1,2025-05-24T22:41:00+02:00,2025-05-25,06:41,1,0,1
1,2025-05-24T22:52:00+02:00,2025-05-25,06:52,2,0,2
2,2025-05-24T22:50:00+02:00,2025-05-25,06:50,0,1,1
2,2025-05-24T22:51:00+02:00,2025-05-25,06:51,0,2,2
9,2025-05-24T22:40:00+02:00,2025-05-25,06:40,0,2,2
12,2025-05-24T22:44:00+02:00,2025-05-25,06:44,1,0,1
12,2025-05-24T22:53:00+02:00,2025-05-25,06:53,1,0,1
17,2025-05-24T22:41:00+02:00,2025-05-25,06:41,0,1,1
17,2025-05-24T22:43:00+02:00,2025-05-25,06:43,0,1,1
17,2025-05-24T22:49:00+02:00,2025-05-25,06:49,1,0,1
17,2025-05-24T22:54:00+02:00,2025-05-25,06:54,1,0,1
19,2025-05-24T22:53:00+02:00,2025-05-25,06:53,0,1,1
20,2025-05-24T22:46:00+02:00,2025-05-25,06:46,0,1,1
20,2025-05-24T22:51:00+02:00,2025-05-25,06:51,2,0,2
23,2025-05-24T22:40:00+02:00,2025-05-25,06:40,0,2,2
23,2025-05-24T22:41:00+02:00,2025-05-25,06:41,2,0,2
23,2025-05-24T22:43:00+02:00,2025-05-25,06:43,0,2,2
23,2025-05-24T22:44:00+02:00,2025-05-25,06:44,2,0,2
23,2025-05-24T22:49:00+02:00,2025-05-25,06:49,0,1,1
23,2025-05-24T22:52:00+02:00,2025-05-25,06:52,0,1,1
24,2025-05-24T22:46:00+02:00,2025-05-25,06:46,1,0,1
24,2025-05-24T22:51:00+02:00,2025-05-25,06:51,3,4,7
24,2025-05-24T22:53:00+02:00,2025-05-25,06:53,0,8,8
25,2025-05-24T22:50:00+02:00,2025-05-25,06:50,6,17,23
27,2025-05-24T22:40:00+02:00,2025-05-25,06:40,1,1,2
27,2025-05-24T22:49:00+02:00,2025-05-25,06:49,0,2,2
30,2025-05-24T22:48:00+02:00,2025-05-25,06:48,1,1,2
30,2025-05-24T22:52:00+02:00,2025-05-25,06:52,0,1,1
35,2025-05-24T22:40:00+02:00,2025-05-25,06:40,0,1,1
35,2025-05-24T22:45:00+02:00,2025-05-25,06:45,1,1,2
35,2025-05-24T22:52:00+02:00,2025-05-25,06:52,3,0,3
48,2025-05-24T22:51:00+02:00,2025-05-25,06:51,2,0,2
49,2025-05-24T22:41:00+02:00,2025-05-25,06:41,4,1,5
49,2025-05-24T22:43:00+02:00,2025-05-25,06:43,1,0,1
49,2025-05-24T22:46:00+02:00,2025-05-25,06:46,1,0,1
49,2025-05-24T22:47:00+02:00,2025-05-25,06:47,1,0,1
49,2025-05-24T22:52:00+02:00,2025-05-25,06:52,2,2,4
52,2025-05-24T22:49:00+02:00,2025-05-25,06:49,1,0,1
56,2025-05-24T22:51:00+02:00,2025-05-25,06:51,1,0,1
58,2025-05-24T22:50:00+02:00,2025-05-25,06:50,1,0,1
62,2025-05-24T22:42:00+02:00,2025-05-25,06:42,1,1,2
62,2025-05-24T22:43:00+02:00,2025-05-25,06:43,1,1,2
62,2025-05-24T22:49:00+02:00,2025-05-25,06:49,0,1,1
67,2025-05-24T22:44:00+02:00,2025-05-25,06:44,1,0,1
67,2025-05-24T22:54:00+02:00,2025-05-25,06:54,0,1,1
79,2025-05-24T22:42:00+02:00,2025-05-25,06:42,0,1,1
79,2025-05-24T22:43:00+02:00,2025-05-25,06:43,3,1,4
79,2025-05-24T22:52:00+02:00,2025-05-25,06:52,1,0,1
86,2025-05-24T22:52:00+02:00,2025-05-25,06:52,0,1,1
109,2025-05-24T22:45:00+02:00,2025-05-25,06:45,3,0,3
123,2025-05-24T22:50:00+02:00,2025-05-25,06:50,1,0,1
141,2025-05-24T22:40:00+02:00,2025-05-25,06:40,3,2,5
141,2025-05-24T22:50:00+02:00,2025-05-25,06:50,6,3,9
164,2025-05-24T22:50:00+02:00,2025-05-25,06:50,2,0,2
181,2025-05-24T22:43:00+02:00,2025-05-25,06:43,1,1,2
181,2025-05-24T22:46:00+02:00,2025-05-25,06:46,1,0,1
181,2025-05-24T22:47:00+02:00,2025-05-25,06:47,0,1,1
181,2025-05-24T22:51:00+02:00,2025-05-25,06:51,0,2,2
181,2025-05-24T22:52:00+02:00,2025-05-25,06:52,0,2,2
182,2025-05-24T22:50:00+02:00,2025-05-25,06:50,3,3,6
181,2025-05-24T23:02:00+02:00,2025-05-25,07:02,1,1,2
181,2025-05-24T23:08:00+02:00,2025-05-25,07:08,1,2,3
3,2025-05-24T23:37:00+02:00,2025-05-25,07:37,1,0,1
3,2025-05-24T23:38:00+02:00,2025-05-25,07:38,0,2,2
4,2025-05-24T23:26:00+02:00,2025-05-25,07:26,0,2,2
4,2025-05-24T23:28:00+02:00,2025-05-25,07:28,0,2,2
4,2025-05-24T23:32:00+02:00,2025-05-25,07:32,0,2,2
4,2025-05-24T23:34:00+02:00,2025-05-25,07:34,2,0,2
4,2025-05-24T23:36:00+02:00,2025-05-25,07:36,1,2,3
4,2025-05-24T23:39:00+02:00,2025-05-25,07:39,0,1,1
5,2025-05-24T23:25:00+02:00,2025-05-25,07:25,2,5,7
5,2025-05-24T23:30:00+02:00,2025-05-25,07:30,10,4,14
6,2025-05-24T23:28:00+02:00,2025-05-25,07:28,7,1,8
6,2025-05-24T23:29:00+02:00,2025-05-25,07:29,3,0,3
6,2025-05-24T23:33:00+02:00,2025-05-25,07:33,2,0,2
8,2025-05-24T23:25:00+02:00,2025-05-25,07:25,0,3,3
8,2025-05-24T23:27:00+02:00,2025-05-25,07:27,0,4,4
8,2025-05-24T23:28:00+02:00,2025-05-25,07:28,3,1,4
8,2025-05-24T23:30:00+02:00,2025-05-25,07:30,0,4,4
8,2025-05-24T23:32:00+02:00,2025-05-25,07:32,1,2,3
8,2025-05-24T23:34:00+02:00,2025-05-25,07:34,1,1,2
8,2025-05-24T23:37:00+02:00,2025-05-25,07:37,1,0,1
28,2025-05-24T23:29:00+02:00,2025-05-25,07:29,1,1,2
28,2025-05-24T23:35:00+02:00,2025-05-25,07:35,2,3,5
28,2025-05-24T23:36:00+02:00,2025-05-25,07:36,1,0,1
29,2025-05-24T23:26:00+02:00,2025-05-25,07:26,0,1,1
29,2025-05-24T23:28:00+02:00,2025-05-25,07:28,0,3,3
29,2025-05-24T23:30:00+02:00,2025-05-25,07:30,0,2,2
29,2025-05-24T23:32:00+02:00,2025-05-25,07:32,0,2,2
29,2025-05-24T23:34:00+02:00,2025-05-25,07:34,1,0,1
29,2025-05-24T23:38:00+02:00,2025-05-25,07:38,0,3,3
36,2025-05-24T23:25:00+02:00,2025-05-25,07:25,2,1,3
36,2025-05-24T23:27:00+02:00,2025-05-25,07:27,0,1,1
36,2025-05-24T23:30:00+02:00,2025-05-25,07:30,1,0,1
40,2025-05-24T23:26:00+02:00,2025-05-25,07:26,0,1,1
40,2025-05-24T23:37:00+02:00,2025-05-25,07:37,0,1,1
41,2025-05-24T23:32:00+02:00,2025-05-25,07:32,0,1,1
43,2025-05-24T23:25:00+02:00,2025-05-25,07:25,1,1,2
43,2025-05-24T23:35:00+02:00,2025-05-25,07:35,2,0,2
45,2025-05-24T23:26:00+02:00,2025-05-25,07:26,0,2,2
45,2025-05-24T23:29:00+02:00,2025-05-25,07:29,0,1,1
45,2025-05-24T23:31:00+02:00,2025-05-25,07:31,2,1,3
47,2025-05-24T23:27:00+02:00,2025-05-25,07:27,3,2,5
47,2025-05-24T23:31:00+02:00,2025-05-25,07:31,8,0,8
47,2025-05-24T23:36:00+02:00,2025-05-25,07:36,1,3,4
47,2025-05-24T23:39:00+02:00,2025-05-25,07:39,2,5,7
59,2025-05-24T23:25:00+02:00,2025-05-25,07:25,1,1,2
59,2025-05-24T23:30:00+02:00,2025-05-25,07:30,1,4,5
61,2025-05-24T23:26:00+02:00,2025-05-25,07:26,0,2,2
61,2025-05-24T23:32:00+02:00,2025-05-25,07:32,0,2,2
61,2025-05-24T23:37:00+02:00,2025-05-25,07:37,0,1,1
61,2025-05-24T23:39:00+02:00,2025-05-25,07:39,0,2,2
66,2025-05-24T23:33:00+02:00,2025-05-25,07:33,2,2,4
66,2025-05-24T23:36:00+02:00,2025-05-25,07:36,0,1,1
66,2025-05-24T23:39:00+02:00,2025-05-25,07:39,1,2,3
69,2025-05-24T23:25:00+02:00,2025-05-25,07:25,1,1,2
69,2025-05-24T23:26:00+02:00,2025-05-25,07:26,1,0,1
69,2025-05-24T23:27:00+02:00,2025-05-25,07:27,1,2,3
69,2025-05-24T23:36:00+02:00,2025-05-25,07:36,0,1,1
75,2025-05-24T23:35:00+02:00,2025-05-25,07:35,0,1,1
77,2025-05-24T23:30:00+02:00,2025-05-25,07:30,0,5,5
77,2025-05-24T23:35:00+02:00,2025-05-25,07:35,1,1,2
78,2025-05-24T23:30:00+02:00,2025-05-25,07:30,0,1,1
78,2025-05-24T23:38:00+02:00,2025-05-25,07:38,0,1,1
84,2025-05-24T23:25:00+02:00,2025-05-25,07:25,19,8,27
84,2025-05-24T23:35:00+02:00,2025-05-25,07:35,16,4,20
107,2025-05-24T23:25:00+02:00,2025-05-25,07:25,2,0,2
108,2025-05-24T23:31:00+02:00,2025-05-25,07:31,1,0,1
108,2025-05-24T23:34:00+02:00,2025-05-25,07:34,0,1,1
108,2025-05-24T23:39:00+02:00,2025-05-25,07:39,0,1,1
124,2025-05-24T23:30:00+02:00,2025-05-25,07:30,1,1,2
131,2025-05-24T23:25:00+02:00,2025-05-25,07:25,2,3,5
132,2025-05-24T23:30:00+02:00,2025-05-25,07:30,1,4,5
134,2025-05-24T23:30:00+02:00,2025-05-25,07:30,17,10,27
140,2025-05-24T23:25:00+02:00,2025-05-25,07:25,1,1,2
167,2025-05-24T23:25:00+02:00,2025-05-25,07:25,0,3,3
179,2025-05-24T23:30:00+02:00,2025-05-25,07:30,0,1,1
1,2025-05-24T23:27:00+02:00,2025-05-25,07:27,1,2,3
1,2025-05-24T23:28:00+02:00,2025-05-25,07:28,0,1,1
1,2025-05-24T23:30:00+02:00,2025-05-25,07:30,2,0,2
2,2025-05-24T23:34:00+02:00,2025-05-25,07:34,0,2,2
10,2025-05-24T23:36:00+02:00,2025-05-25,07:36,0,1,1
11,2025-05-24T23:25:00+02:00,2025-05-25,07:25,3,0,3
11,2025-05-24T23:31:00+02:00,2025-05-25,07:31,0,1,1
12,2025-05-24T23:25:00+02:00,2025-05-25,07:25,1,0,1
12,2025-05-24T23:28:00+02:00,2025-05-25,07:28,1,0,1
12,2025-05-24T23:29:00+02:00,2025-05-25,07:29,0,1,1
12,2025-05-24T23:30:00+02:00,2025-05-25,07:30,2,0,2
12,2025-05-24T23:33:00+02:00,2025-05-25,07:33,3,0,3
17,2025-05-24T23:26:00+02:00,2025-05-25,07:26,1,0,1
17,2025-05-24T23:27:00+02:00,2025-05-25,07:27,0,1,1
17,2025-05-24T23:28:00+02:00,2025-05-25,07:28,1,0,1
17,2025-05-24T23:37:00+02:00,2025-05-25,07:37,1,0,1
17,2025-05-24T23:39:00+02:00,2025-05-25,07:39,1,3,4
18,2025-05-24T23:33:00+02:00,2025-05-25,07:33,1,0,1
20,2025-05-24T23:28:00+02:00,2025-05-25,07:28,1,0,1
20,2025-05-24T23:34:00+02:00,2025-05-25,07:34,1,0,1
20,2025-05-24T23:37:00+02:00,2025-05-25,07:37,2,0,2
24,2025-05-24T23:25:00+02:00,2025-05-25,07:25,0,2,2
24,2025-05-24T23:27:00+02:00,2025-05-25,07:27,0,7,7
24,2025-05-24T23:28:00+02:00,2025-05-25,07:28,0,12,12
24,2025-05-24T23:34:00+02:00,2025-05-25,07:34,6,1,7
24,2025-05-24T23:35:00+02:00,2025-05-25,07:35,6,11,17
24,2025-05-24T23:37:00+02:00,2025-05-25,07:37,3,0,3
24,2025-05-24T23:38:00+02:00,2025-05-25,07:38,4,1,5
25,2025-05-24T23:30:00+02:00,2025-05-25,07:30,11,12,23
25,2025-05-24T23:35:00+02:00,2025-05-25,07:35,7,9,16
27,2025-05-24T23:27:00+02:00,2025-05-25,07:27,0,2,2
27,2025-05-24T23:28:00+02:00,2025-05-25,07:28,1,0,1
27,2025-05-24T23:32:00+02:00,2025-05-25,07:32,0,2,2
27,2025-05-24T23:33:00+02:00,2025-05-25,07:33,0,6,6
27,2025-05-24T23:39:00+02:00,2025-05-25,07:39,1,1,2
30,2025-05-24T23:28:00+02:00,2025-05-25,07:28,2,2,4
30,2025-05-24T23:31:00+02:00,2025-05-25,07:31,0,1,1
30,2025-05-24T23:35:00+02:00,2025-05-25,07:35,1,0,1
35,2025-05-24T23:26:00+02:00,2025-05-25,07:26,8,3,11
35,2025-05-24T23:27:00+02:00,2025-05-25,07:27,5,8,13
35,2025-05-24T23:28:00+02:00,2025-05-25,07:28,5,7,12
35,2025-05-24T23:29:00+02:00,2025-05-25,07:29,5,1,6
35,2025-05-24T23:33:00+02:00,2025-05-25,07:33,7,4,11
35,2025-05-24T23:34:00+02:00,2025-05-25,07:34,8,1,9
35,2025-05-24T23:37:00+02:00,2025-05-25,07:37,3,3,6
46,2025-05-24T23:25:00+02:00,2025-05-25,07:25,4,0,4
48,2025-05-24T23:29:00+02:00,2025-05-25,07:29,0,3,3
49,2025-05-24T23:30:00+02:00,2025-05-25,07:30,0,2,2
49,2025-05-24T23:35:00+02:00,2025-05-25,07:35,2,5,7
49,2025-05-24T23:37:00+02:00,2025-05-25,07:37,0,1,1
51,2025-05-24T23:25:00+02:00,2025-05-25,07:25,1,0,1
51,2025-05-24T23:26:00+02:00,2025-05-25,07:26,0,1,1
51,2025-05-24T23:39:00+02:00,2025-05-25,07:39,2,0,2
52,2025-05-24T23:34:00+02:00,2025-05-25,07:34,1,0,1
53,2025-05-24T23:25:00+02:00,2025-05-25,07:25,1,2,3
53,2025-05-24T23:33:00+02:00,2025-05-25,07:33,1,0,1
53,2025-05-24T23:36:00+02:00,2025-05-25,07:36,1,0,1
56,2025-05-24T23:30:00+02:00,2025-05-25,07:30,0,1,1
56,2025-05-24T23:37:00+02:00,2025-05-25,07:37,1,1,2
56,2025-05-24T23:38:00+02:00,2025-05-25,07:38,0,1,1
56,2025-05-24T23:39:00+02:00,2025-05-25,07:39,2,1,3
58,2025-05-24T23:29:00+02:00,2025-05-25,07:29,1,2,3
58,2025-05-24T23:38:00+02:00,2025-05-25,07:38,3,0,3
62,2025-05-24T23:30:00+02:00,2025-05-25,07:30,2,0,2
62,2025-05-24T23:32:00+02:00,2025-05-25,07:32,2,0,2
62,2025-05-24T23:34:00+02:00,2025-05-25,07:34,0,1,1
63,2025-05-24T23:28:00+02:00,2025-05-25,07:28,0,2,2
63,2025-05-24T23:29:00+02:00,2025-05-25,07:29,1,0,1
63,2025-05-24T23:38:00+02:00,2025-05-25,07:38,0,1,1
63,2025-05-24T23:39:00+02:00,2025-05-25,07:39,0,1,1
67,2025-05-24T23:34:00+02:00,2025-05-25,07:34,1,1,2
67,2025-05-24T23:36:00+02:00,2025-05-25,07:36,1,0,1
68,2025-05-24T23:28:00+02:00,2025-05-25,07:28,2,1,3
68,2025-05-24T23:39:00+02:00,2025-05-25,07:39,0,1,1
72,2025-05-24T23:27:00+02:00,2025-05-25,07:27,1,0,1
72,2025-05-24T23:30:00+02:00,2025-05-25,07:30,2,1,3
72,2025-05-24T23:38:00+02:00,2025-05-25,07:38,1,0,1
72,2025-05-24T23:39:00+02:00,2025-05-25,07:39,2,0,2
76,2025-05-24T23:35:00+02:00,2025-05-25,07:35,1,0,1
76,2025-05-24T23:39:00+02:00,2025-05-25,07:39,1,0,1
79,2025-05-24T23:28:00+02:00,2025-05-25,07:28,0,2,2
79,2025-05-24T23:31:00+02:00,2025-05-25,07:31,4,1,5
79,2025-05-24T23:34:00+02:00,2025-05-25,07:34,5,1,6
79,2025-05-24T23:38:00+02:00,2025-05-25,07:38,1,2,3
86,2025-05-24T23:37:00+02:00,2025-05-25,07:37,2,0,2
109,2025-05-24T23:30:00+02:00,2025-05-25,07:30,4,2,6
123,2025-05-24T23:30:00+02:00,2025-05-25,07:30,2,0,2
123,2025-05-24T23:35:00+02:00,2025-05-25,07:35,0,3,3
137,2025-05-24T23:35:00+02:00,2025-05-25,07:35,0,2,2
139,2025-05-24T23:25:00+02:00,2025-05-25,07:25,1,0,1
141,2025-05-24T23:35:00+02:00,2025-05-25,07:35,5,0,5
161,2025-05-24T23:25:00+02:00,2025-05-25,07:25,5,4,9
164,2025-05-24T23:25:00+02:00,2025-05-25,07:25,2,1,3
164,2025-05-24T23:35:00+02:00,2025-05-25,07:35,3,3,6
3,2025-05-24T22:55:00+02:00,2025-05-25,06:55,0,1,1
3,2025-05-24T23:05:00+02:00,2025-05-25,07:05,1,1,2
4,2025-05-24T22:58:00+02:00,2025-05-25,06:58,0,1,1
4,2025-05-24T23:01:00+02:00,2025-05-25,07:01,2,0,2
4,2025-05-24T23:07:00+02:00,2025-05-25,07:07,1,7,8
5,2025-05-24T22:55:00+02:00,2025-05-25,06:55,1,5,6
5,2025-05-24T23:00:00+02:00,2025-05-25,07:00,3,4,7
5,2025-05-24T23:05:00+02:00,2025-05-25,07:05,4,6,10
6,2025-05-24T22:55:00+02:00,2025-05-25,06:55,1,1,2
6,2025-05-24T23:05:00+02:00,2025-05-25,07:05,3,0,3
6,2025-05-24T23:08:00+02:00,2025-05-25,07:08,1,0,1
8,2025-05-24T23:04:00+02:00,2025-05-25,07:04,0,1,1
8,2025-05-24T23:06:00+02:00,2025-05-25,07:06,1,0,1
8,2025-05-24T23:08:00+02:00,2025-05-25,07:08,1,0,1
28,2025-05-24T22:55:00+02:00,2025-05-25,06:55,1,0,1
28,2025-05-24T22:58:00+02:00,2025-05-25,06:58,0,1,1
28,2025-05-24T23:06:00+02:00,2025-05-25,07:06,0,1,1
28,2025-05-24T23:08:00+02:00,2025-05-25,07:08,0,1,1
29,2025-05-24T22:59:00+02:00,2025-05-25,06:59,0,2,2
29,2025-05-24T23:03:00+02:00,2025-05-25,07:03,2,2,4
29,2025-05-24T23:05:00+02:00,2025-05-25,07:05,0,1,1
36,2025-05-24T22:59:00+02:00,2025-05-25,06:59,4,0,4
37,2025-05-24T23:00:00+02:00,2025-05-25,07:00,2,0,2
37,2025-05-24T23:01:00+02:00,2025-05-25,07:01,0,1,1
41,2025-05-24T23:02:00+02:00,2025-05-25,07:02,0,2,2
45,2025-05-24T22:55:00+02:00,2025-05-25,06:55,2,0,2
45,2025-05-24T22:57:00+02:00,2025-05-25,06:57,0,1,1
45,2025-05-24T22:58:00+02:00,2025-05-25,06:58,1,0,1
45,2025-05-24T23:04:00+02:00,2025-05-25,07:04,0,2,2
47,2025-05-24T22:55:00+02:00,2025-05-25,06:55,0,1,1
47,2025-05-24T22:58:00+02:00,2025-05-25,06:58,2,2,4
47,2025-05-24T23:00:00+02:00,2025-05-25,07:00,2,3,5
47,2025-05-24T23:07:00+02:00,2025-05-25,07:07,0,1,1
47,2025-05-24T23:08:00+02:00,2025-05-25,07:08,0,2,2
50,2025-05-24T22:57:00+02:00,2025-05-25,06:57,0,1,1
54,2025-05-24T23:08:00+02:00,2025-05-25,07:08,0,2,2
59,2025-05-24T22:55:00+02:00,2025-05-25,06:55,1,1,2
61,2025-05-24T23:01:00+02:00,2025-05-25,07:01,1,0,1
61,2025-05-24T23:05:00+02:00,2025-05-25,07:05,1,0,1
66,2025-05-24T22:59:00+02:00,2025-05-25,06:59,2,1,3
70,2025-05-24T23:00:00+02:00,2025-05-25,07:00,1,0,1
71,2025-05-24T23:02:00+02:00,2025-05-25,07:02,1,0,1
77,2025-05-24T22:55:00+02:00,2025-05-25,06:55,1,1,2
77,2025-05-24T23:05:00+02:00,2025-05-25,07:05,2,1,3
87,2025-05-24T23:04:00+02:00,2025-05-25,07:04,0,1,1
107,2025-05-24T23:05:00+02:00,2025-05-25,07:05,0,1,1
108,2025-05-24T23:05:00+02:00,2025-05-25,07:05,0,2,2
131,2025-05-24T23:00:00+02:00,2025-05-25,07:00,0,2,2
131,2025-05-24T23:05:00+02:00,2025-05-25,07:05,0,1,1
133,2025-05-24T23:00:00+02:00,2025-05-25,07:00,8,19,27
135,2025-05-24T22:55:00+02:00,2025-05-25,06:55,4,3,7
140,2025-05-24T23:05:00+02:00,2025-05-25,07:05,3,0,3
167,2025-05-24T23:05:00+02:00,2025-05-25,07:05,0,1,1
179,2025-05-24T23:00:00+02:00,2025-05-25,07:00,0,2,2
179,2025-05-24T23:05:00+02:00,2025-05-25,07:05,1,0,1
1,2025-05-24T23:03:00+02:00,2025-05-25,07:03,1,0,1
2,2025-05-24T23:02:00+02:00,2025-05-25,07:02,0,2,2
9,2025-05-24T23:08:00+02:00,2025-05-25,07:08,0,1,1
10,2025-05-24T23:09:00+02:00,2025-05-25,07:09,0,1,1
11,2025-05-24T22:56:00+02:00,2025-05-25,06:56,1,0,1
11,2025-05-24T23:05:00+02:00,2025-05-25,07:05,3,0,3
11,2025-05-24T23:06:00+02:00,2025-05-25,07:06,1,0,1
12,2025-05-24T22:55:00+02:00,2025-05-25,06:55,0,1,1
12,2025-05-24T22:58:00+02:00,2025-05-25,06:58,0,2,2
12,2025-05-24T23:03:00+02:00,2025-05-25,07:03,0,1,1
12,2025-05-24T23:07:00+02:00,2025-05-25,07:07,1,0,1
17,2025-05-24T23:07:00+02:00,2025-05-25,07:07,1,0,1
19,2025-05-24T22:56:00+02:00,2025-05-25,06:56,0,1,1
19,2025-05-24T23:02:00+02:00,2025-05-25,07:02,0,1,1
19,2025-05-24T23:06:00+02:00,2025-05-25,07:06,0,3,3
20,2025-05-24T23:02:00+02:00,2025-05-25,07:02,0,1,1
20,2025-05-24T23:09:00+02:00,2025-05-25,07:09,0,1,1
23,2025-05-24T22:56:00+02:00,2025-05-25,06:56,0,1,1
23,2025-05-24T23:02:00+02:00,2025-05-25,07:02,0,8,8
23,2025-05-24T23:08:00+02:00,2025-05-25,07:08,7,0,7
24,2025-05-24T22:56:00+02:00,2025-05-25,06:56,0,6,6
24,2025-05-24T22:57:00+02:00,2025-05-25,06:57,1,1,2
24,2025-05-24T23:01:00+02:00,2025-05-25,07:01,1,0,1
24,2025-05-24T23:05:00+02:00,2025-05-25,07:05,1,0,1
24,2025-05-24T23:08:00+02:00,2025-05-25,07:08,3,2,5
27,2025-05-24T22:58:00+02:00,2025-05-25,06:58,2,0,2
27,2025-05-24T23:09:00+02:00,2025-05-25,07:09,0,1,1
30,2025-05-24T23:02:00+02:00,2025-05-25,07:02,0,1,1
35,2025-05-24T22:55:00+02:00,2025-05-25,06:55,2,1,3
35,2025-05-24T22:58:00+02:00,2025-05-25,06:58,1,3,4
35,2025-05-24T23:01:00+02:00,2025-05-25,07:01,0,1,1
35,2025-05-24T23:02:00+02:00,2025-05-25,07:02,3,6,9
48,2025-05-24T22:56:00+02:00,2025-05-25,06:56,1,0,1
48,2025-05-24T23:01:00+02:00,2025-05-25,07:01,0,1,1
48,2025-05-24T23:06:00+02:00,2025-05-25,07:06,3,0,3
48,2025-05-24T23:08:00+02:00,2025-05-25,07:08,4,0,4
49,2025-05-24T22:56:00+02:00,2025-05-25,06:56,1,1,2
49,2025-05-24T23:05:00+02:00,2025-05-25,07:05,1,0,1
49,2025-05-24T23:06:00+02:00,2025-05-25,07:06,2,1,3
49,2025-05-24T23:09:00+02:00,2025-05-25,07:09,1,0,1
51,2025-05-24T23:01:00+02:00,2025-05-25,07:01,1,0,1
52,2025-05-24T22:56:00+02:00,2025-05-25,06:56,1,0,1
52,2025-05-24T23:01:00+02:00,2025-05-25,07:01,1,0,1
52,2025-05-24T23:03:00+02:00,2025-05-25,07:03,0,1,1
53,2025-05-24T23:00:00+02:00,2025-05-25,07:00,0,1,1
53,2025-05-24T23:02:00+02:00,2025-05-25,07:02,0,1,1
53,2025-05-24T23:09:00+02:00,2025-05-25,07:09,0,2,2
58,2025-05-24T22:57:00+02:00,2025-05-25,06:57,0,2,2
58,2025-05-24T22:59:00+02:00,2025-05-25,06:59,1,0,1
58,2025-05-24T23:05:00+02:00,2025-05-25,07:05,0,2,2
58,2025-05-24T23:07:00+02:00,2025-05-25,07:07,0,1,1
58,2025-05-24T23:09:00+02:00,2025-05-25,07:09,0,2,2
62,2025-05-24T22:55:00+02:00,2025-05-25,06:55,1,0,1
62,2025-05-24T22:57:00+02:00,2025-05-25,06:57,1,0,1
62,2025-05-24T23:02:00+02:00,2025-05-25,07:02,1,0,1
63,2025-05-24T22:56:00+02:00,2025-05-25,06:56,0,2,2
67,2025-05-24T22:58:00+02:00,2025-05-25,06:58,1,0,1
67,2025-05-24T22:59:00+02:00,2025-05-25,06:59,1,2,3
67,2025-05-24T23:02:00+02:00,2025-05-25,07:02,0,1,1
76,2025-05-24T22:55:00+02:00,2025-05-25,06:55,0,1,1
79,2025-05-24T22:55:00+02:00,2025-05-25,06:55,0,1,1
79,2025-05-24T22:56:00+02:00,2025-05-25,06:56,0,3,3
79,2025-05-24T22:58:00+02:00,2025-05-25,06:58,2,4,6
79,2025-05-24T23:01:00+02:00,2025-05-25,07:01,0,4,4
79,2025-05-24T23:02:00+02:00,2025-05-25,07:02,4,1,5
79,2025-05-24T23:07:00+02:00,2025-05-25,07:07,1,0,1
79,2025-05-24T23:08:00+02:00,2025-05-25,07:08,1,0,1
85,2025-05-24T23:06:00+02:00,2025-05-25,07:06,1,0,1
109,2025-05-24T23:05:00+02:00,2025-05-25,07:05,3,2,5
117,2025-05-24T23:05:00+02:00,2025-05-25,07:05,0,1,1
139,2025-05-24T23:00:00+02:00,2025-05-25,07:00,0,2,2
142,2025-05-24T23:05:00+02:00,2025-05-25,07:05,5,0,5
161,2025-05-24T22:55:00+02:00,2025-05-25,06:55,1,2,3
181,2025-05-24T23:11:00+02:00,2025-05-25,07:11,2,2,4
181,2025-05-24T23:16:00+02:00,2025-05-25,07:16,1,7,8
181,2025-05-24T23:18:00+02:00,2025-05-25,07:18,1,1,2
181,2025-05-24T23:19:00+02:00,2025-05-25,07:19,0,2,2
181,2025-05-24T23:20:00+02:00,2025-05-25,07:20,0,4,4
181,2025-05-24T23:22:00+02:00,2025-05-25,07:22,0,2,2
180,2025-05-24T23:23:00+02:00,2025-05-25,07:23,0,1,1
3,2025-05-24T23:10:00+02:00,2025-05-25,07:10,0,1,1
3,2025-05-24T23:11:00+02:00,2025-05-25,07:11,1,0,1
4,2025-05-24T23:11:00+02:00,2025-05-25,07:11,0,1,1
4,2025-05-24T23:14:00+02:00,2025-05-25,07:14,1,0,1
4,2025-05-24T23:19:00+02:00,2025-05-25,07:19,1,0,1
4,2025-05-24T23:21:00+02:00,2025-05-25,07:21,1,1,2
4,2025-05-24T23:23:00+02:00,2025-05-25,07:23,2,2,4
5,2025-05-24T23:15:00+02:00,2025-05-25,07:15,2,3,5
6,2025-05-24T23:16:00+02:00,2025-05-25,07:16,0,3,3
6,2025-05-24T23:21:00+02:00,2025-05-25,07:21,2,2,4
8,2025-05-24T23:16:00+02:00,2025-05-25,07:16,0,1,1
8,2025-05-24T23:20:00+02:00,2025-05-25,07:20,0,1,1
28,2025-05-24T23:17:00+02:00,2025-05-25,07:17,0,1,1
29,2025-05-24T23:12:00+02:00,2025-05-25,07:12,1,2,3
29,2025-05-24T23:13:00+02:00,2025-05-25,07:13,4,0,4
29,2025-05-24T23:14:00+02:00,2025-05-25,07:14,0,2,2
29,2025-05-24T23:17:00+02:00,2025-05-25,07:17,1,0,1
31,2025-05-24T23:24:00+02:00,2025-05-25,07:24,0,1,1
36,2025-05-24T23:16:00+02:00,2025-05-25,07:16,0,2,2
36,2025-05-24T23:21:00+02:00,2025-05-25,07:21,1,0,1
36,2025-05-24T23:22:00+02:00,2025-05-25,07:22,1,0,1
41,2025-05-24T23:24:00+02:00,2025-05-25,07:24,1,0,1
43,2025-05-24T23:15:00+02:00,2025-05-25,07:15,0,3,3
44,2025-05-24T23:10:00+02:00,2025-05-25,07:10,1,3,4
44,2025-05-24T23:20:00+02:00,2025-05-25,07:20,0,2,2
45,2025-05-24T23:12:00+02:00,2025-05-25,07:12,0,2,2
45,2025-05-24T23:18:00+02:00,2025-05-25,07:18,0,2,2
45,2025-05-24T23:23:00+02:00,2025-05-25,07:23,3,2,5
47,2025-05-24T23:17:00+02:00,2025-05-25,07:17,0,2,2
47,2025-05-24T23:22:00+02:00,2025-05-25,07:22,1,3,4
47,2025-05-24T23:23:00+02:00,2025-05-25,07:23,1,0,1
47,2025-05-24T23:24:00+02:00,2025-05-25,07:24,0,2,2
61,2025-05-24T23:11:00+02:00,2025-05-25,07:11,2,0,2
61,2025-05-24T23:13:00+02:00,2025-05-25,07:13,1,0,1
61,2025-05-24T23:20:00+02:00,2025-05-25,07:20,0,2,2
61,2025-05-24T23:23:00+02:00,2025-05-25,07:23,1,0,1
66,2025-05-24T23:17:00+02:00,2025-05-25,07:17,1,0,1
70,2025-05-24T23:21:00+02:00,2025-05-25,07:21,1,0,1
75,2025-05-24T23:12:00+02:00,2025-05-25,07:12,0,1,1
107,2025-05-24T23:10:00+02:00,2025-05-25,07:10,3,1,4
107,2025-05-24T23:20:00+02:00,2025-05-25,07:20,0,2,2
108,2025-05-24T23:20:00+02:00,2025-05-25,07:20,0,1,1
108,2025-05-24T23:22:00+02:00,2025-05-25,07:22,0,1,1
132,2025-05-24T23:15:00+02:00,2025-05-25,07:15,2,2,4
134,2025-05-24T23:15:00+02:00,2025-05-25,07:15,11,13,24
134,2025-05-24T23:20:00+02:00,2025-05-25,07:20,12,11,23
140,2025-05-24T23:20:00+02:00,2025-05-25,07:20,2,1,3
162,2025-05-24T23:20:00+02:00,2025-05-25,07:20,5,4,9
179,2025-05-24T23:20:00+02:00,2025-05-25,07:20,1,2,3
1,2025-05-24T23:10:00+02:00,2025-05-25,07:10,0,3,3
1,2025-05-24T23:20:00+02:00,2025-05-25,07:20,0,1,1
2,2025-05-24T23:11:00+02:00,2025-05-25,07:11,1,1,2
2,2025-05-24T23:17:00+02:00,2025-05-25,07:17,0,1,1
2,2025-05-24T23:23:00+02:00,2025-05-25,07:23,0,1,1
9,2025-05-24T23:12:00+02:00,2025-05-25,07:12,1,0,1
9,2025-05-24T23:14:00+02:00,2025-05-25,07:14,1,0,1
9,2025-05-24T23:19:00+02:00,2025-05-25,07:19,1,1,2
11,2025-05-24T23:10:00+02:00,2025-05-25,07:10,1,0,1
12,2025-05-24T23:19:00+02:00,2025-05-25,07:19,1,0,1
17,2025-05-24T23:14:00+02:00,2025-05-25,07:14,2,1,3
17,2025-05-24T23:17:00+02:00,2025-05-25,07:17,1,0,1
17,2025-05-24T23:20:00+02:00,2025-05-25,07:20,1,1,2
18,2025-05-24T23:13:00+02:00,2025-05-25,07:13,0,1,1
19,2025-05-24T23:16:00+02:00,2025-05-25,07:16,0,2,2
19,2025-05-24T23:18:00+02:00,2025-05-25,07:18,1,0,1
20,2025-05-24T23:12:00+02:00,2025-05-25,07:12,0,4,4
20,2025-05-24T23:13:00+02:00,2025-05-25,07:13,1,0,1
20,2025-05-24T23:20:00+02:00,2025-05-25,07:20,2,0,2
23,2025-05-24T23:11:00+02:00,2025-05-25,07:11,1,1,2
23,2025-05-24T23:12:00+02:00,2025-05-25,07:12,0,2,2
23,2025-05-24T23:16:00+02:00,2025-05-25,07:16,1,1,2
23,2025-05-24T23:19:00+02:00,2025-05-25,07:19,1,0,1
23,2025-05-24T23:23:00+02:00,2025-05-25,07:23,0,1,1
24,2025-05-24T23:17:00+02:00,2025-05-25,07:17,0,4,4
24,2025-05-24T23:18:00+02:00,2025-05-25,07:18,1,0,1
24,2025-05-24T23:21:00+02:00,2025-05-25,07:21,1,2,3
25,2025-05-24T23:20:00+02:00,2025-05-25,07:20,6,11,17
27,2025-05-24T23:11:00+02:00,2025-05-25,07:11,0,2,2
30,2025-05-24T23:19:00+02:00,2025-05-25,07:19,1,0,1
35,2025-05-24T23:13:00+02:00,2025-05-25,07:13,2,0,2
35,2025-05-24T23:18:00+02:00,2025-05-25,07:18,7,3,10
35,2025-05-24T23:20:00+02:00,2025-05-25,07:20,6,3,9
35,2025-05-24T23:24:00+02:00,2025-05-25,07:24,4,3,7
46,2025-05-24T23:15:00+02:00,2025-05-25,07:15,1,0,1
48,2025-05-24T23:14:00+02:00,2025-05-25,07:14,1,2,3
49,2025-05-24T23:10:00+02:00,2025-05-25,07:10,1,2,3
49,2025-05-24T23:14:00+02:00,2025-05-25,07:14,6,2,8
51,2025-05-24T23:10:00+02:00,2025-05-25,07:10,2,1,3
51,2025-05-24T23:12:00+02:00,2025-05-25,07:12,1,0,1
53,2025-05-24T23:13:00+02:00,2025-05-25,07:13,0,1,1
53,2025-05-24T23:14:00+02:00,2025-05-25,07:14,0,2,2
53,2025-05-24T23:17:00+02:00,2025-05-25,07:17,1,0,1
56,2025-05-24T23:18:00+02:00,2025-05-25,07:18,1,0,1
58,2025-05-24T23:15:00+02:00,2025-05-25,07:15,1,0,1
62,2025-05-24T23:22:00+02:00,2025-05-25,07:22,1,0,1
63,2025-05-24T23:11:00+02:00,2025-05-25,07:11,0,1,1
63,2025-05-24T23:15:00+02:00,2025-05-25,07:15,2,1,3
63,2025-05-24T23:18:00+02:00,2025-05-25,07:18,1,0,1
63,2025-05-24T23:21:00+02:00,2025-05-25,07:21,0,1,1
67,2025-05-24T23:23:00+02:00,2025-05-25,07:23,0,1,1
67,2025-05-24T23:24:00+02:00,2025-05-25,07:24,1,0,1
68,2025-05-24T23:18:00+02:00,2025-05-25,07:18,0,1,1
68,2025-05-24T23:20:00+02:00,2025-05-25,07:20,1,0,1
72,2025-05-24T23:12:00+02:00,2025-05-25,07:12,0,1,1
76,2025-05-24T23:19:00+02:00,2025-05-25,07:19,0,1,1
79,2025-05-24T23:11:00+02:00,2025-05-25,07:11,2,1,3
79,2025-05-24T23:13:00+02:00,2025-05-25,07:13,0,1,1
85,2025-05-24T23:20:00+02:00,2025-05-25,07:20,1,0,1
130,2025-05-24T23:20:00+02:00,2025-05-25,07:20,0,1,1
137,2025-05-24T23:10:00+02:00,2025-05-25,07:10,0,1,1
139,2025-05-24T23:15:00+02:00,2025-05-25,07:15,22,2,24
141,2025-05-24T23:10:00+02:00,2025-05-25,07:10,2,2,4
142,2025-05-24T23:15:00+02:00,2025-05-25,07:15,6,6,12
161,2025-05-24T23:10:00+02:00,2025-05-25,07:10,1,2,3
181,2025-05-24T23:30:00+02:00,2025-05-25,07:30,0,3,3
181,2025-05-24T23:31:00+02:00,2025-05-25,07:31,2,6,8
181,2025-05-24T23:32:00+02:00,2025-05-25,07:32,0,1,1
181,2025-05-24T23:33:00+02:00,2025-05-25,07:33,1,4,5
181,2025-05-24T23:35:00+02:00,2025-05-25,07:35,1,2,3
181,2025-05-24T23:39:00+02:00,2025-05-25,07:39,0,3,3
182,2025-05-24T23:25:00+02:00,2025-05-25,07:25,4,3,7
182,2025-05-24T23:35:00+02:00,2025-05-25,07:35,9,3,12
180,2025-05-24T23:25:00+02:00,2025-05-25,07:25,0,1,1
180,2025-05-24T23:34:00+02:00,2025-05-25,07:34,1,1,2
180,2025-05-24T23:36:00+02:00,2025-05-25,07:36,1,0,1
3,2025-05-24T23:43:00+02:00,2025-05-25,07:43,0,1,1
3,2025-05-24T23:44:00+02:00,2025-05-25,07:44,0,1,1
3,2025-05-24T23:45:00+02:00,2025-05-25,07:45,1,2,3
3,2025-05-24T23:47:00+02:00,2025-05-25,07:47,1,0,1
3,2025-05-24T23:48:00+02:00,2025-05-25,07:48,1,0,1
4,2025-05-24T23:41:00+02:00,2025-05-25,07:41,1,1,2
4,2025-05-24T23:43:00+02:00,2025-05-25,07:43,1,0,1
4,2025-05-24T23:44:00+02:00,2025-05-25,07:44,2,5,7
4,2025-05-24T23:46:00+02:00,2025-05-25,07:46,0,1,1
4,2025-05-24T23:51:00+02:00,2025-05-25,07:51,1,0,1
4,2025-05-24T23:54:00+02:00,2025-05-25,07:54,0,3,3
5,2025-05-24T23:40:00+02:00,2025-05-25,07:40,9,6,15
5,2025-05-24T23:45:00+02:00,2025-05-25,07:45,10,7,17
6,2025-05-24T23:40:00+02:00,2025-05-25,07:40,1,2,3
6,2025-05-24T23:42:00+02:00,2025-05-25,07:42,4,0,4
6,2025-05-24T23:44:00+02:00,2025-05-25,07:44,9,2,11
6,2025-05-24T23:52:00+02:00,2025-05-25,07:52,4,1,5
8,2025-05-24T23:44:00+02:00,2025-05-25,07:44,1,1,2
8,2025-05-24T23:45:00+02:00,2025-05-25,07:45,0,1,1
8,2025-05-24T23:47:00+02:00,2025-05-25,07:47,1,1,2
8,2025-05-24T23:50:00+02:00,2025-05-25,07:50,1,0,1
8,2025-05-24T23:54:00+02:00,2025-05-25,07:54,2,1,3
28,2025-05-24T23:51:00+02:00,2025-05-25,07:51,2,2,4
29,2025-05-24T23:45:00+02:00,2025-05-25,07:45,0,1,1
29,2025-05-24T23:47:00+02:00,2025-05-25,07:47,1,0,1
29,2025-05-24T23:49:00+02:00,2025-05-25,07:49,1,0,1
31,2025-05-24T23:43:00+02:00,2025-05-25,07:43,0,1,1
36,2025-05-24T23:50:00+02:00,2025-05-25,07:50,0,1,1
36,2025-05-24T23:54:00+02:00,2025-05-25,07:54,1,0,1
37,2025-05-24T23:49:00+02:00,2025-05-25,07:49,0,1,1
39,2025-05-24T23:48:00+02:00,2025-05-25,07:48,1,0,1
41,2025-05-24T23:54:00+02:00,2025-05-25,07:54,0,2,2
43,2025-05-24T23:50:00+02:00,2025-05-25,07:50,0,1,1
45,2025-05-24T23:44:00+02:00,2025-05-25,07:44,3,1,4
45,2025-05-24T23:45:00+02:00,2025-05-25,07:45,1,0,1
45,2025-05-24T23:51:00+02:00,2025-05-25,07:51,7,1,8
45,2025-05-24T23:52:00+02:00,2025-05-25,07:52,0,1,1
45,2025-05-24T23:53:00+02:00,2025-05-25,07:53,1,0,1
45,2025-05-24T23:54:00+02:00,2025-05-25,07:54,0,5,5
47,2025-05-24T23:40:00+02:00,2025-05-25,07:40,2,1,3
47,2025-05-24T23:44:00+02:00,2025-05-25,07:44,3,0,3
47,2025-05-24T23:45:00+02:00,2025-05-25,07:45,0,3,3
47,2025-05-24T23:47:00+02:00,2025-05-25,07:47,2,0,2
47,2025-05-24T23:54:00+02:00,2025-05-25,07:54,0,6,6
50,2025-05-24T23:40:00+02:00,2025-05-25,07:40,0,1,1
50,2025-05-24T23:51:00+02:00,2025-05-25,07:51,2,0,2
54,2025-05-24T23:40:00+02:00,2025-05-25,07:40,0,2,2
54,2025-05-24T23:51:00+02:00,2025-05-25,07:51,1,0,1
54,2025-05-24T23:53:00+02:00,2025-05-25,07:53,0,1,1
59,2025-05-24T23:40:00+02:00,2025-05-25,07:40,0,4,4
61,2025-05-24T23:43:00+02:00,2025-05-25,07:43,1,1,2
61,2025-05-24T23:45:00+02:00,2025-05-25,07:45,3,1,4
61,2025-05-24T23:46:00+02:00,2025-05-25,07:46,0,1,1
61,2025-05-24T23:47:00+02:00,2025-05-25,07:47,1,0,1
61,2025-05-24T23:51:00+02:00,2025-05-25,07:51,1,1,2
66,2025-05-24T23:41:00+02:00,2025-05-25,07:41,3,0,3
66,2025-05-24T23:43:00+02:00,2025-05-25,07:43,1,1,2
66,2025-05-24T23:48:00+02:00,2025-05-25,07:48,6,4,10
66,2025-05-24T23:51:00+02:00,2025-05-25,07:51,2,0,2
66,2025-05-24T23:52:00+02:00,2025-05-25,07:52,1,0,1
69,2025-05-24T23:43:00+02:00,2025-05-25,07:43,0,1,1
69,2025-05-24T23:48:00+02:00,2025-05-25,07:48,1,0,1
69,2025-05-24T23:54:00+02:00,2025-05-25,07:54,1,0,1
71,2025-05-24T23:52:00+02:00,2025-05-25,07:52,1,0,1
75,2025-05-24T23:41:00+02:00,2025-05-25,07:41,0,2,2
75,2025-05-24T23:48:00+02:00,2025-05-25,07:48,1,0,1
77,2025-05-24T23:40:00+02:00,2025-05-25,07:40,0,1,1
78,2025-05-24T23:51:00+02:00,2025-05-25,07:51,0,2,2
84,2025-05-24T23:50:00+02:00,2025-05-25,07:50,8,9,17
108,2025-05-24T23:49:00+02:00,2025-05-25,07:49,2,1,3
108,2025-05-24T23:53:00+02:00,2025-05-25,07:53,2,0,2
131,2025-05-24T23:40:00+02:00,2025-05-25,07:40,2,1,3
132,2025-05-24T23:40:00+02:00,2025-05-25,07:40,6,3,9
133,2025-05-24T23:45:00+02:00,2025-05-25,07:45,11,23,34
133,2025-05-24T23:50:00+02:00,2025-05-25,07:50,18,35,53
135,2025-05-24T23:40:00+02:00,2025-05-25,07:40,0,11,11
135,2025-05-24T23:50:00+02:00,2025-05-25,07:50,15,12,27
140,2025-05-24T23:40:00+02:00,2025-05-25,07:40,2,1,3
166,2025-05-24T23:50:00+02:00,2025-05-25,07:50,1,0,1
179,2025-05-24T23:45:00+02:00,2025-05-25,07:45,1,0,1
2,2025-05-24T23:42:00+02:00,2025-05-25,07:42,1,0,1
2,2025-05-24T23:53:00+02:00,2025-05-25,07:53,0,1,1
9,2025-05-24T23:40:00+02:00,2025-05-25,07:40,2,0,2
9,2025-05-24T23:51:00+02:00,2025-05-25,07:51,3,0,3
10,2025-05-24T23:44:00+02:00,2025-05-25,07:44,2,0,2
10,2025-05-24T23:48:00+02:00,2025-05-25,07:48,1,0,1
11,2025-05-24T23:44:00+02:00,2025-05-25,07:44,0,1,1
11,2025-05-24T23:46:00+02:00,2025-05-25,07:46,0,1,1
11,2025-05-24T23:47:00+02:00,2025-05-25,07:47,1,0,1
11,2025-05-24T23:54:00+02:00,2025-05-25,07:54,1,0,1
12,2025-05-24T23:41:00+02:00,2025-05-25,07:41,1,0,1
12,2025-05-24T23:49:00+02:00,2025-05-25,07:49,6,0,6
12,2025-05-24T23:50:00+02:00,2025-05-25,07:50,0,1,1
12,2025-05-24T23:54:00+02:00,2025-05-25,07:54,0,1,1
17,2025-05-24T23:42:00+02:00,2025-05-25,07:42,2,0,2
17,2025-05-24T23:43:00+02:00,2025-05-25,07:43,2,0,2
17,2025-05-24T23:52:00+02:00,2025-05-25,07:52,0,1,1
17,2025-05-24T23:54:00+02:00,2025-05-25,07:54,3,0,3
18,2025-05-24T23:41:00+02:00,2025-05-25,07:41,0,1,1
18,2025-05-24T23:47:00+02:00,2025-05-25,07:47,1,0,1
18,2025-05-24T23:49:00+02:00,2025-05-25,07:49,1,0,1
18,2025-05-24T23:54:00+02:00,2025-05-25,07:54,4,0,4
19,2025-05-24T23:43:00+02:00,2025-05-25,07:43,1,0,1
20,2025-05-24T23:44:00+02:00,2025-05-25,07:44,0,2,2
20,2025-05-24T23:49:00+02:00,2025-05-25,07:49,2,0,2
20,2025-05-24T23:50:00+02:00,2025-05-25,07:50,1,0,1
20,2025-05-24T23:51:00+02:00,2025-05-25,07:51,1,0,1
23,2025-05-24T23:47:00+02:00,2025-05-25,07:47,0,6,6
23,2025-05-24T23:50:00+02:00,2025-05-25,07:50,0,1,1
24,2025-05-24T23:40:00+02:00,2025-05-25,07:40,3,4,7
24,2025-05-24T23:44:00+02:00,2025-05-25,07:44,1,10,11
24,2025-05-24T23:45:00+02:00,2025-05-25,07:45,2,0,2
24,2025-05-24T23:46:00+02:00,2025-05-25,07:46,1,0,1
24,2025-05-24T23:49:00+02:00,2025-05-25,07:49,6,4,10
25,2025-05-24T23:45:00+02:00,2025-05-25,07:45,7,16,23
27,2025-05-24T23:41:00+02:00,2025-05-25,07:41,2,0,2
27,2025-05-24T23:44:00+02:00,2025-05-25,07:44,0,1,1
27,2025-05-24T23:49:00+02:00,2025-05-25,07:49,0,1,1
27,2025-05-24T23:52:00+02:00,2025-05-25,07:52,3,0,3
30,2025-05-24T23:50:00+02:00,2025-05-25,07:50,2,7,9
35,2025-05-24T23:42:00+02:00,2025-05-25,07:42,6,4,10
35,2025-05-24T23:49:00+02:00,2025-05-25,07:49,3,4,7
35,2025-05-24T23:53:00+02:00,2025-05-25,07:53,5,2,7
48,2025-05-24T23:43:00+02:00,2025-05-25,07:43,0,1,1
48,2025-05-24T23:47:00+02:00,2025-05-25,07:47,0,1,1
48,2025-05-24T23:50:00+02:00,2025-05-25,07:50,1,4,5
48,2025-05-24T23:52:00+02:00,2025-05-25,07:52,3,0,3
48,2025-05-24T23:54:00+02:00,2025-05-25,07:54,2,0,2
49,2025-05-24T23:41:00+02:00,2025-05-25,07:41,1,0,1
49,2025-05-24T23:45:00+02:00,2025-05-25,07:45,0,1,1
49,2025-05-24T23:51:00+02:00,2025-05-25,07:51,3,0,3
52,2025-05-24T23:41:00+02:00,2025-05-25,07:41,3,1,4
52,2025-05-24T23:46:00+02:00,2025-05-25,07:46,1,0,1
52,2025-05-24T23:49:00+02:00,2025-05-25,07:49,0,1,1
52,2025-05-24T23:53:00+02:00,2025-05-25,07:53,1,1,2
52,2025-05-24T23:54:00+02:00,2025-05-25,07:54,0,1,1
53,2025-05-24T23:41:00+02:00,2025-05-25,07:41,0,1,1
53,2025-05-24T23:43:00+02:00,2025-05-25,07:43,1,0,1
53,2025-05-24T23:52:00+02:00,2025-05-25,07:52,3,1,4
56,2025-05-24T23:42:00+02:00,2025-05-25,07:42,1,2,3
56,2025-05-24T23:44:00+02:00,2025-05-25,07:44,1,1,2
56,2025-05-24T23:47:00+02:00,2025-05-25,07:47,2,0,2
56,2025-05-24T23:49:00+02:00,2025-05-25,07:49,1,0,1
56,2025-05-24T23:54:00+02:00,2025-05-25,07:54,5,1,6
58,2025-05-24T23:41:00+02:00,2025-05-25,07:41,0,3,3
58,2025-05-24T23:43:00+02:00,2025-05-25,07:43,4,0,4
58,2025-05-24T23:44:00+02:00,2025-05-25,07:44,2,0,2
58,2025-05-24T23:48:00+02:00,2025-05-25,07:48,1,1,2
58,2025-05-24T23:49:00+02:00,2025-05-25,07:49,1,2,3
58,2025-05-24T23:51:00+02:00,2025-05-25,07:51,0,1,1
62,2025-05-24T23:45:00+02:00,2025-05-25,07:45,1,0,1
63,2025-05-24T23:49:00+02:00,2025-05-25,07:49,1,0,1
63,2025-05-24T23:50:00+02:00,2025-05-25,07:50,1,0,1
63,2025-05-24T23:52:00+02:00,2025-05-25,07:52,0,1,1
67,2025-05-24T23:49:00+02:00,2025-05-25,07:49,0,2,2
67,2025-05-24T23:50:00+02:00,2025-05-25,07:50,0,1,1
67,2025-05-24T23:52:00+02:00,2025-05-25,07:52,0,1,1
68,2025-05-24T23:43:00+02:00,2025-05-25,07:43,0,1,1
68,2025-05-24T23:46:00+02:00,2025-05-25,07:46,1,0,1
68,2025-05-24T23:47:00+02:00,2025-05-25,07:47,1,0,1
68,2025-05-24T23:49:00+02:00,2025-05-25,07:49,1,1,2
68,2025-05-24T23:50:00+02:00,2025-05-25,07:50,1,0,1
72,2025-05-24T23:40:00+02:00,2025-05-25,07:40,1,0,1
72,2025-05-24T23:42:00+02:00,2025-05-25,07:42,1,1,2
72,2025-05-24T23:45:00+02:00,2025-05-25,07:45,0,2,2
72,2025-05-24T23:49:00+02:00,2025-05-25,07:49,0,1,1
72,2025-05-24T23:50:00+02:00,2025-05-25,07:50,0,1,1
76,2025-05-24T23:47:00+02:00,2025-05-25,07:47,2,0,2
76,2025-05-24T23:48:00+02:00,2025-05-25,07:48,0,1,1
76,2025-05-24T23:52:00+02:00,2025-05-25,07:52,1,1,2
79,2025-05-24T23:40:00+02:00,2025-05-25,07:40,0,2,2
79,2025-05-24T23:44:00+02:00,2025-05-25,07:44,0,1,1
79,2025-05-24T23:48:00+02:00,2025-05-25,07:48,1,1,2
85,2025-05-24T23:45:00+02:00,2025-05-25,07:45,0,1,1
86,2025-05-24T23:52:00+02:00,2025-05-25,07:52,0,2,2
109,2025-05-24T23:45:00+02:00,2025-05-25,07:45,2,1,3
123,2025-05-24T23:45:00+02:00,2025-05-25,07:45,1,0,1
130,2025-05-24T23:40:00+02:00,2025-05-25,07:40,2,2,4
136,2025-05-24T23:40:00+02:00,2025-05-25,07:40,8,7,15
137,2025-05-24T23:50:00+02:00,2025-05-25,07:50,0,2,2
141,2025-05-24T23:40:00+02:00,2025-05-25,07:40,2,2,4
142,2025-05-24T23:40:00+02:00,2025-05-25,07:40,20,3,23
142,2025-05-24T23:45:00+02:00,2025-05-25,07:45,21,13,34
161,2025-05-24T23:40:00+02:00,2025-05-25,07:40,8,3,11
164,2025-05-24T23:40:00+02:00,2025-05-25,07:40,0,2,2
164,2025-05-24T23:45:00+02:00,2025-05-25,07:45,1,1,2
181,2025-05-24T23:46:00+02:00,2025-05-25,07:46,1,1,2
181,2025-05-24T23:49:00+02:00,2025-05-25,07:49,1,5,6
182,2025-05-24T23:40:00+02:00,2025-05-25,07:40,1,1,2
182,2025-05-24T23:45:00+02:00,2025-05-25,07:45,4,5,9
182,2025-05-24T23:50:00+02:00,2025-05-25,07:50,7,10,17
180,2025-05-24T23:49:00+02:00,2025-05-25,07:49,1,0,1
180,2025-05-24T23:52:00+02:00,2025-05-25,07:52,0,1,1
181,2025-05-24T23:57:00+02:00,2025-05-25,07:57,1,4,5
181,2025-05-24T23:58:00+02:00,2025-05-25,07:58,0,4,4
181,2025-05-24T23:59:00+02:00,2025-05-25,07:59,1,3,4
181,2025-05-25T00:02:00+02:00,2025-05-25,08:02,1,4,5
181,2025-05-25T00:04:00+02:00,2025-05-25,08:04,1,3,4
181,2025-05-25T00:07:00+02:00,2025-05-25,08:07,1,1,2
181,2025-05-25T00:08:00+02:00,2025-05-25,08:08,0,9,9
182,2025-05-25T00:00:00+02:00,2025-05-25,08:00,3,8,11
180,2025-05-25T00:06:00+02:00,2025-05-25,08:06,1,0,1
180,2025-05-25T00:07:00+02:00,2025-05-25,08:07,1,0,1
3,2025-05-24T23:56:00+02:00,2025-05-25,07:56,3,3,6
3,2025-05-24T23:58:00+02:00,2025-05-25,07:58,1,1,2
3,2025-05-24T23:59:00+02:00,2025-05-25,07:59,1,0,1
3,2025-05-25T00:00:00+02:00,2025-05-25,08:00,0,1,1
3,2025-05-25T00:04:00+02:00,2025-05-25,08:04,1,1,2
3,2025-05-25T00:07:00+02:00,2025-05-25,08:07,1,4,5
3,2025-05-25T00:08:00+02:00,2025-05-25,08:08,1,2,3
3,2025-05-25T00:09:00+02:00,2025-05-25,08:09,1,0,1
4,2025-05-24T23:55:00+02:00,2025-05-25,07:55,1,0,1
4,2025-05-24T23:56:00+02:00,2025-05-25,07:56,3,0,3
4,2025-05-25T00:02:00+02:00,2025-05-25,08:02,1,1,2
4,2025-05-25T00:03:00+02:00,2025-05-25,08:03,2,0,2
4,2025-05-25T00:05:00+02:00,2025-05-25,08:05,2,4,6
5,2025-05-24T23:55:00+02:00,2025-05-25,07:55,10,5,15
5,2025-05-25T00:00:00+02:00,2025-05-25,08:00,6,8,14
6,2025-05-25T00:01:00+02:00,2025-05-25,08:01,2,0,2
6,2025-05-25T00:05:00+02:00,2025-05-25,08:05,4,8,12
8,2025-05-25T00:07:00+02:00,2025-05-25,08:07,0,1,1
28,2025-05-24T23:56:00+02:00,2025-05-25,07:56,1,0,1
28,2025-05-24T23:59:00+02:00,2025-05-25,07:59,0,2,2
28,2025-05-25T00:01:00+02:00,2025-05-25,08:01,2,1,3
28,2025-05-25T00:09:00+02:00,2025-05-25,08:09,1,0,1
29,2025-05-24T23:56:00+02:00,2025-05-25,07:56,1,0,1
29,2025-05-24T23:57:00+02:00,2025-05-25,07:57,1,2,3
29,2025-05-24T23:58:00+02:00,2025-05-25,07:58,1,2,3
29,2025-05-24T23:59:00+02:00,2025-05-25,07:59,0,3,3
29,2025-05-25T00:00:00+02:00,2025-05-25,08:00,3,6,9
29,2025-05-25T00:04:00+02:00,2025-05-25,08:04,4,0,4
29,2025-05-25T00:07:00+02:00,2025-05-25,08:07,3,3,6
29,2025-05-25T00:09:00+02:00,2025-05-25,08:09,2,0,2
31,2025-05-25T00:07:00+02:00,2025-05-25,08:07,0,2,2
36,2025-05-24T23:59:00+02:00,2025-05-25,07:59,1,0,1
36,2025-05-25T00:07:00+02:00,2025-05-25,08:07,2,0,2
37,2025-05-25T00:08:00+02:00,2025-05-25,08:08,1,0,1
40,2025-05-24T23:59:00+02:00,2025-05-25,07:59,0,1,1
40,2025-05-25T00:06:00+02:00,2025-05-25,08:06,0,3,3
41,2025-05-25T00:00:00+02:00,2025-05-25,08:00,2,3,5
41,2025-05-25T00:01:00+02:00,2025-05-25,08:01,1,0,1
41,2025-05-25T00:03:00+02:00,2025-05-25,08:03,0,1,1
41,2025-05-25T00:04:00+02:00,2025-05-25,08:04,2,6,8
41,2025-05-25T00:07:00+02:00,2025-05-25,08:07,3,2,5
44,2025-05-25T00:00:00+02:00,2025-05-25,08:00,0,2,2
44,2025-05-25T00:05:00+02:00,2025-05-25,08:05,0,1,1
45,2025-05-24T23:55:00+02:00,2025-05-25,07:55,0,1,1
45,2025-05-24T23:59:00+02:00,2025-05-25,07:59,2,1,3
45,2025-05-25T00:00:00+02:00,2025-05-25,08:00,1,3,4
45,2025-05-25T00:01:00+02:00,2025-05-25,08:01,0,1,1
45,2025-05-25T00:02:00+02:00,2025-05-25,08:02,0,2,2
45,2025-05-25T00:06:00+02:00,2025-05-25,08:06,0,2,2
47,2025-05-25T00:03:00+02:00,2025-05-25,08:03,0,2,2
47,2025-05-25T00:08:00+02:00,2025-05-25,08:08,0,6,6
47,2025-05-25T00:09:00+02:00,2025-05-25,08:09,1,2,3
50,2025-05-24T23:58:00+02:00,2025-05-25,07:58,1,0,1
50,2025-05-25T00:08:00+02:00,2025-05-25,08:08,1,0,1
54,2025-05-24T23:55:00+02:00,2025-05-25,07:55,0,1,1
54,2025-05-25T00:03:00+02:00,2025-05-25,08:03,0,2,2
54,2025-05-25T00:06:00+02:00,2025-05-25,08:06,0,1,1
59,2025-05-25T00:00:00+02:00,2025-05-25,08:00,2,9,11
59,2025-05-25T00:05:00+02:00,2025-05-25,08:05,3,3,6
61,2025-05-25T00:04:00+02:00,2025-05-25,08:04,0,2,2
61,2025-05-25T00:05:00+02:00,2025-05-25,08:05,0,3,3
66,2025-05-24T23:55:00+02:00,2025-05-25,07:55,2,6,8
66,2025-05-24T23:56:00+02:00,2025-05-25,07:56,1,3,4
66,2025-05-24T23:58:00+02:00,2025-05-25,07:58,0,5,5
66,2025-05-25T00:01:00+02:00,2025-05-25,08:01,0,1,1
66,2025-05-25T00:02:00+02:00,2025-05-25,08:02,1,2,3
66,2025-05-25T00:03:00+02:00,2025-05-25,08:03,1,1,2
66,2025-05-25T00:05:00+02:00,2025-05-25,08:05,0,1,1
69,2025-05-24T23:57:00+02:00,2025-05-25,07:57,4,1,5
69,2025-05-25T00:01:00+02:00,2025-05-25,08:01,3,0,3
69,2025-05-25T00:04:00+02:00,2025-05-25,08:04,1,2,3
70,2025-05-25T00:03:00+02:00,2025-05-25,08:03,1,1,2
70,2025-05-25T00:04:00+02:00,2025-05-25,08:04,1,0,1
71,2025-05-25T00:02:00+02:00,2025-05-25,08:02,0,1,1
71,2025-05-25T00:05:00+02:00,2025-05-25,08:05,1,0,1
75,2025-05-25T00:01:00+02:00,2025-05-25,08:01,0,2,2
75,2025-05-25T00:08:00+02:00,2025-05-25,08:08,0,2,2
77,2025-05-25T00:05:00+02:00,2025-05-25,08:05,5,4,9
78,2025-05-24T23:59:00+02:00,2025-05-25,07:59,1,2,3
78,2025-05-25T00:01:00+02:00,2025-05-25,08:01,1,0,1
84,2025-05-24T23:55:00+02:00,2025-05-25,07:55,21,18,39
87,2025-05-25T00:05:00+02:00,2025-05-25,08:05,1,0,1
87,2025-05-25T00:09:00+02:00,2025-05-25,08:09,0,1,1
107,2025-05-25T00:00:00+02:00,2025-05-25,08:00,5,10,15
107,2025-05-25T00:05:00+02:00,2025-05-25,08:05,1,4,5
108,2025-05-24T23:58:00+02:00,2025-05-25,07:58,1,0,1
108,2025-05-25T00:01:00+02:00,2025-05-25,08:01,1,0,1
108,2025-05-25T00:07:00+02:00,2025-05-25,08:07,2,1,3
118,2025-05-24T23:55:00+02:00,2025-05-25,07:55,0,1,1
131,2025-05-24T23:55:00+02:00,2025-05-25,07:55,1,2,3
133,2025-05-24T23:55:00+02:00,2025-05-25,07:55,18,26,44
133,2025-05-25T00:00:00+02:00,2025-05-25,08:00,11,19,30
134,2025-05-25T00:00:00+02:00,2025-05-25,08:00,18,9,27
135,2025-05-25T00:00:00+02:00,2025-05-25,08:00,17,15,32
140,2025-05-25T00:00:00+02:00,2025-05-25,08:00,5,0,5
140,2025-05-25T00:05:00+02:00,2025-05-25,08:05,9,0,9
162,2025-05-24T23:55:00+02:00,2025-05-25,07:55,14,10,24
165,2025-05-25T00:00:00+02:00,2025-05-25,08:00,3,2,5
165,2025-05-25T00:05:00+02:00,2025-05-25,08:05,2,1,3
1,2025-05-24T23:56:00+02:00,2025-05-25,07:56,1,0,1
1,2025-05-24T23:59:00+02:00,2025-05-25,07:59,1,0,1
1,2025-05-25T00:01:00+02:00,2025-05-25,08:01,0,1,1
1,2025-05-25T00:06:00+02:00,2025-05-25,08:06,1,1,2
2,2025-05-24T23:55:00+02:00,2025-05-25,07:55,2,0,2
2,2025-05-25T00:03:00+02:00,2025-05-25,08:03,0,2,2
2,2025-05-25T00:04:00+02:00,2025-05-25,08:04,1,0,1
2,2025-05-25T00:05:00+02:00,2025-05-25,08:05,0,1,1
2,2025-05-25T00:07:00+02:00,2025-05-25,08:07,0,3,3
2,2025-05-25T00:08:00+02:00,2025-05-25,08:08,2,4,6
9,2025-05-24T23:59:00+02:00,2025-05-25,07:59,0,1,1
9,2025-05-25T00:04:00+02:00,2025-05-25,08:04,2,0,2
9,2025-05-25T00:09:00+02:00,2025-05-25,08:09,1,1,2
11,2025-05-25T00:00:00+02:00,2025-05-25,08:00,3,0,3
11,2025-05-25T00:05:00+02:00,2025-05-25,08:05,1,1,2
11,2025-05-25T00:06:00+02:00,2025-05-25,08:06,0,1,1
11,2025-05-25T00:08:00+02:00,2025-05-25,08:08,1,1,2
12,2025-05-24T23:56:00+02:00,2025-05-25,07:56,3,1,4
12,2025-05-25T00:00:00+02:00,2025-05-25,08:00,2,1,3
12,2025-05-25T00:03:00+02:00,2025-05-25,08:03,0,1,1
12,2025-05-25T00:04:00+02:00,2025-05-25,08:04,2,0,2
17,2025-05-25T00:04:00+02:00,2025-05-25,08:04,1,0,1
17,2025-05-25T00:07:00+02:00,2025-05-25,08:07,3,1,4
17,2025-05-25T00:09:00+02:00,2025-05-25,08:09,0,2,2
19,2025-05-25T00:04:00+02:00,2025-05-25,08:04,1,0,1
19,2025-05-25T00:07:00+02:00,2025-05-25,08:07,2,0,2
20,2025-05-24T23:55:00+02:00,2025-05-25,07:55,1,1,2
20,2025-05-25T00:01:00+02:00,2025-05-25,08:01,2,3,5
20,2025-05-25T00:02:00+02:00,2025-05-25,08:02,1,0,1
23,2025-05-24T23:57:00+02:00,2025-05-25,07:57,2,1,3
23,2025-05-24T23:58:00+02:00,2025-05-25,07:58,1,0,1
23,2025-05-25T00:02:00+02:00,2025-05-25,08:02,0,1,1
23,2025-05-25T00:06:00+02:00,2025-05-25,08:06,1,0,1
23,2025-05-25T00:07:00+02:00,2025-05-25,08:07,0,2,2
23,2025-05-25T00:08:00+02:00,2025-05-25,08:08,0,1,1
24,2025-05-24T23:56:00+02:00,2025-05-25,07:56,0,2,2
24,2025-05-25T00:00:00+02:00,2025-05-25,08:00,6,2,8
24,2025-05-25T00:03:00+02:00,2025-05-25,08:03,3,0,3
24,2025-05-25T00:05:00+02:00,2025-05-25,08:05,4,0,4
24,2025-05-25T00:09:00+02:00,2025-05-25,08:09,2,9,11
25,2025-05-25T00:05:00+02:00,2025-05-25,08:05,13,15,28
27,2025-05-24T23:55:00+02:00,2025-05-25,07:55,0,1,1
27,2025-05-24T23:56:00+02:00,2025-05-25,07:56,0,1,1
27,2025-05-24T23:58:00+02:00,2025-05-25,07:58,1,0,1
30,2025-05-25T00:00:00+02:00,2025-05-25,08:00,0,5,5
35,2025-05-24T23:56:00+02:00,2025-05-25,07:56,4,7,11
35,2025-05-25T00:00:00+02:00,2025-05-25,08:00,1,8,9
35,2025-05-25T00:03:00+02:00,2025-05-25,08:03,12,6,18
35,2025-05-25T00:07:00+02:00,2025-05-25,08:07,5,4,9
48,2025-05-24T23:55:00+02:00,2025-05-25,07:55,2,0,2
48,2025-05-24T23:57:00+02:00,2025-05-25,07:57,4,0,4
48,2025-05-24T23:59:00+02:00,2025-05-25,07:59,1,0,1
48,2025-05-25T00:00:00+02:00,2025-05-25,08:00,0,1,1
48,2025-05-25T00:08:00+02:00,2025-05-25,08:08,1,9,10
49,2025-05-24T23:56:00+02:00,2025-05-25,07:56,4,1,5
49,2025-05-24T23:59:00+02:00,2025-05-25,07:59,0,1,1
49,2025-05-25T00:04:00+02:00,2025-05-25,08:04,3,4,7
49,2025-05-25T00:07:00+02:00,2025-05-25,08:07,4,0,4
51,2025-05-24T23:56:00+02:00,2025-05-25,07:56,0,4,4
52,2025-05-24T23:59:00+02:00,2025-05-25,07:59,0,1,1
52,2025-05-25T00:03:00+02:00,2025-05-25,08:03,3,0,3
52,2025-05-25T00:07:00+02:00,2025-05-25,08:07,1,0,1
53,2025-05-24T23:55:00+02:00,2025-05-25,07:55,1,0,1
56,2025-05-24T23:57:00+02:00,2025-05-25,07:57,1,1,2
56,2025-05-24T23:58:00+02:00,2025-05-25,07:58,3,0,3
58,2025-05-25T00:00:00+02:00,2025-05-25,08:00,2,0,2
58,2025-05-25T00:02:00+02:00,2025-05-25,08:02,2,2,4
58,2025-05-25T00:03:00+02:00,2025-05-25,08:03,5,0,5
58,2025-05-25T00:04:00+02:00,2025-05-25,08:04,1,5,6
62,2025-05-24T23:55:00+02:00,2025-05-25,07:55,1,1,2
62,2025-05-25T00:07:00+02:00,2025-05-25,08:07,0,1,1
63,2025-05-24T23:55:00+02:00,2025-05-25,07:55,1,0,1
63,2025-05-24T23:56:00+02:00,2025-05-25,07:56,0,1,1
63,2025-05-24T23:59:00+02:00,2025-05-25,07:59,0,1,1
63,2025-05-25T00:02:00+02:00,2025-05-25,08:02,2,0,2
63,2025-05-25T00:04:00+02:00,2025-05-25,08:04,1,2,3
63,2025-05-25T00:06:00+02:00,2025-05-25,08:06,0,2,2
63,2025-05-25T00:09:00+02:00,2025-05-25,08:09,0,1,1
67,2025-05-25T00:02:00+02:00,2025-05-25,08:02,1,1,2
67,2025-05-25T00:03:00+02:00,2025-05-25,08:03,0,3,3
67,2025-05-25T00:06:00+02:00,2025-05-25,08:06,0,3,3
67,2025-05-25T00:09:00+02:00,2025-05-25,08:09,0,3,3
68,2025-05-24T23:59:00+02:00,2025-05-25,07:59,0,1,1
68,2025-05-25T00:04:00+02:00,2025-05-25,08:04,1,1,2
68,2025-05-25T00:07:00+02:00,2025-05-25,08:07,0,1,1
72,2025-05-24T23:56:00+02:00,2025-05-25,07:56,0,1,1
72,2025-05-25T00:06:00+02:00,2025-05-25,08:06,0,2,2
76,2025-05-24T23:56:00+02:00,2025-05-25,07:56,1,0,1
76,2025-05-24T23:59:00+02:00,2025-05-25,07:59,0,1,1
76,2025-05-25T00:02:00+02:00,2025-05-25,08:02,1,1,2
76,2025-05-25T00:06:00+02:00,2025-05-25,08:06,0,1,1
79,2025-05-24T23:55:00+02:00,2025-05-25,07:55,1,0,1
79,2025-05-25T00:00:00+02:00,2025-05-25,08:00,2,2,4
79,2025-05-25T00:03:00+02:00,2025-05-25,08:03,1,2,3
79,2025-05-25T00:04:00+02:00,2025-05-25,08:04,2,0,2
79,2025-05-25T00:08:00+02:00,2025-05-25,08:08,2,4,6
85,2025-05-24T23:58:00+02:00,2025-05-25,07:58,4,0,4
86,2025-05-24T23:55:00+02:00,2025-05-25,07:55,1,0,1
86,2025-05-25T00:04:00+02:00,2025-05-25,08:04,1,0,1
141,2025-05-24T23:55:00+02:00,2025-05-25,07:55,2,5,7
142,2025-05-25T00:00:00+02:00,2025-05-25,08:00,19,21,40
164,2025-05-25T00:05:00+02:00,2025-05-25,08:05,2,0,2
181,2025-05-25T00:10:00+02:00,2025-05-25,08:10,3,1,4
181,2025-05-25T00:19:00+02:00,2025-05-25,08:19,3,1,4
181,2025-05-25T00:21:00+02:00,2025-05-25,08:21,2,2,4
181,2025-05-25T00:22:00+02:00,2025-05-25,08:22,3,2,5
181,2025-05-25T00:24:00+02:00,2025-05-25,08:24,1,4,5
182,2025-05-25T00:15:00+02:00,2025-05-25,08:15,6,6,12
3,2025-05-25T00:10:00+02:00,2025-05-25,08:10,0,2,2
3,2025-05-25T00:12:00+02:00,2025-05-25,08:12,1,3,4
3,2025-05-25T00:16:00+02:00,2025-05-25,08:16,0,2,2
3,2025-05-25T00:18:00+02:00,2025-05-25,08:18,2,0,2
3,2025-05-25T00:20:00+02:00,2025-05-25,08:20,2,0,2
3,2025-05-25T00:21:00+02:00,2025-05-25,08:21,1,0,1
3,2025-05-25T00:24:00+02:00,2025-05-25,08:24,0,1,1
4,2025-05-25T00:12:00+02:00,2025-05-25,08:12,0,2,2
4,2025-05-25T00:16:00+02:00,2025-05-25,08:16,2,1,3
4,2025-05-25T00:17:00+02:00,2025-05-25,08:17,2,0,2
4,2025-05-25T00:20:00+02:00,2025-05-25,08:20,2,1,3
4,2025-05-25T00:24:00+02:00,2025-05-25,08:24,3,2,5
5,2025-05-25T00:10:00+02:00,2025-05-25,08:10,3,14,17
6,2025-05-25T00:10:00+02:00,2025-05-25,08:10,2,1,3
6,2025-05-25T00:16:00+02:00,2025-05-25,08:16,3,3,6
6,2025-05-25T00:20:00+02:00,2025-05-25,08:20,0,2,2
8,2025-05-25T00:12:00+02:00,2025-05-25,08:12,0,2,2
8,2025-05-25T00:15:00+02:00,2025-05-25,08:15,3,4,7
8,2025-05-25T00:20:00+02:00,2025-05-25,08:20,1,3,4
8,2025-05-25T00:24:00+02:00,2025-05-25,08:24,0,2,2
28,2025-05-25T00:14:00+02:00,2025-05-25,08:14,1,0,1
28,2025-05-25T00:21:00+02:00,2025-05-25,08:21,1,1,2
28,2025-05-25T00:22:00+02:00,2025-05-25,08:22,1,1,2
28,2025-05-25T00:23:00+02:00,2025-05-25,08:23,2,0,2
29,2025-05-25T00:10:00+02:00,2025-05-25,08:10,1,3,4
29,2025-05-25T00:16:00+02:00,2025-05-25,08:16,3,2,5
29,2025-05-25T00:17:00+02:00,2025-05-25,08:17,1,1,2
29,2025-05-25T00:19:00+02:00,2025-05-25,08:19,3,1,4
29,2025-05-25T00:21:00+02:00,2025-05-25,08:21,0,1,1
31,2025-05-25T00:13:00+02:00,2025-05-25,08:13,1,1,2
31,2025-05-25T00:16:00+02:00,2025-05-25,08:16,1,0,1
31,2025-05-25T00:23:00+02:00,2025-05-25,08:23,2,0,2
36,2025-05-25T00:12:00+02:00,2025-05-25,08:12,1,0,1
36,2025-05-25T00:22:00+02:00,2025-05-25,08:22,1,0,1
37,2025-05-25T00:10:00+02:00,2025-05-25,08:10,2,0,2
37,2025-05-25T00:22:00+02:00,2025-05-25,08:22,1,0,1
39,2025-05-25T00:19:00+02:00,2025-05-25,08:19,1,0,1
39,2025-05-25T00:24:00+02:00,2025-05-25,08:24,1,0,1
41,2025-05-25T00:15:00+02:00,2025-05-25,08:15,8,0,8
45,2025-05-25T00:11:00+02:00,2025-05-25,08:11,2,6,8
45,2025-05-25T00:12:00+02:00,2025-05-25,08:12,2,4,6
45,2025-05-25T00:18:00+02:00,2025-05-25,08:18,1,0,1
45,2025-05-25T00:24:00+02:00,2025-05-25,08:24,2,0,2
47,2025-05-25T00:14:00+02:00,2025-05-25,08:14,1,2,3
47,2025-05-25T00:17:00+02:00,2025-05-25,08:17,1,1,2
47,2025-05-25T00:18:00+02:00,2025-05-25,08:18,1,6,7
47,2025-05-25T00:19:00+02:00,2025-05-25,08:19,3,0,3
47,2025-05-25T00:20:00+02:00,2025-05-25,08:20,0,2,2
47,2025-05-25T00:22:00+02:00,2025-05-25,08:22,1,2,3
47,2025-05-25T00:23:00+02:00,2025-05-25,08:23,1,4,5
50,2025-05-25T00:17:00+02:00,2025-05-25,08:17,0,1,1
50,2025-05-25T00:22:00+02:00,2025-05-25,08:22,0,2,2
54,2025-05-25T00:21:00+02:00,2025-05-25,08:21,2,0,2
54,2025-05-25T00:23:00+02:00,2025-05-25,08:23,1,1,2
59,2025-05-25T00:20:00+02:00,2025-05-25,08:20,2,4,6
61,2025-05-25T00:11:00+02:00,2025-05-25,08:11,1,0,1
61,2025-05-25T00:19:00+02:00,2025-05-25,08:19,0,1,1
61,2025-05-25T00:22:00+02:00,2025-05-25,08:22,0,1,1
61,2025-05-25T00:24:00+02:00,2025-05-25,08:24,1,0,1
66,2025-05-25T00:10:00+02:00,2025-05-25,08:10,0,1,1
66,2025-05-25T00:11:00+02:00,2025-05-25,08:11,1,2,3
66,2025-05-25T00:12:00+02:00,2025-05-25,08:12,1,0,1
66,2025-05-25T00:17:00+02:00,2025-05-25,08:17,0,1,1
66,2025-05-25T00:19:00+02:00,2025-05-25,08:19,1,1,2
66,2025-05-25T00:22:00+02:00,2025-05-25,08:22,1,3,4
69,2025-05-25T00:11:00+02:00,2025-05-25,08:11,1,2,3
69,2025-05-25T00:22:00+02:00,2025-05-25,08:22,0,1,1
69,2025-05-25T00:24:00+02:00,2025-05-25,08:24,3,0,3
70,2025-05-25T00:12:00+02:00,2025-05-25,08:12,1,1,2
70,2025-05-25T00:22:00+02:00,2025-05-25,08:22,2,0,2
75,2025-05-25T00:15:00+02:00,2025-05-25,08:15,1,1,2
77,2025-05-25T00:15:00+02:00,2025-05-25,08:15,3,10,13
78,2025-05-25T00:11:00+02:00,2025-05-25,08:11,1,0,1
78,2025-05-25T00:16:00+02:00,2025-05-25,08:16,0,1,1
84,2025-05-25T00:10:00+02:00,2025-05-25,08:10,12,14,26
87,2025-05-25T00:19:00+02:00,2025-05-25,08:19,2,1,3
108,2025-05-25T00:11:00+02:00,2025-05-25,08:11,1,0,1
108,2025-05-25T00:14:00+02:00,2025-05-25,08:14,1,1,2
108,2025-05-25T00:18:00+02:00,2025-05-25,08:18,5,2,7
108,2025-05-25T00:23:00+02:00,2025-05-25,08:23,5,2,7
131,2025-05-25T00:10:00+02:00,2025-05-25,08:10,1,0,1
131,2025-05-25T00:20:00+02:00,2025-05-25,08:20,4,4,8
134,2025-05-25T00:15:00+02:00,2025-05-25,08:15,7,13,20
135,2025-05-25T00:20:00+02:00,2025-05-25,08:20,7,12,19
165,2025-05-25T00:15:00+02:00,2025-05-25,08:15,1,3,4
166,2025-05-25T00:15:00+02:00,2025-05-25,08:15,0,1,1
166,2025-05-25T00:20:00+02:00,2025-05-25,08:20,1,0,1
167,2025-05-25T00:10:00+02:00,2025-05-25,08:10,0,2,2
179,2025-05-25T00:10:00+02:00,2025-05-25,08:10,2,0,2
179,2025-05-25T00:15:00+02:00,2025-05-25,08:15,1,1,2
179,2025-05-25T00:20:00+02:00,2025-05-25,08:20,2,0,2
1,2025-05-25T00:13:00+02:00,2025-05-25,08:13,1,0,1
1,2025-05-25T00:19:00+02:00,2025-05-25,08:19,2,1,3
1,2025-05-25T00:20:00+02:00,2025-05-25,08:20,0,4,4
2,2025-05-25T00:22:00+02:00,2025-05-25,08:22,0,2,2
9,2025-05-25T00:10:00+02:00,2025-05-25,08:10,0,1,1
9,2025-05-25T00:11:00+02:00,2025-05-25,08:11,2,0,2
9,2025-05-25T00:13:00+02:00,2025-05-25,08:13,0,3,3
9,2025-05-25T00:17:00+02:00,2025-05-25,08:17,0,1,1
9,2025-05-25T00:19:00+02:00,2025-05-25,08:19,0,1,1
10,2025-05-25T00:22:00+02:00,2025-05-25,08:22,1,0,1
11,2025-05-25T00:11:00+02:00,2025-05-25,08:11,2,1,3
11,2025-05-25T00:20:00+02:00,2025-05-25,08:20,2,4,6
12,2025-05-25T00:12:00+02:00,2025-05-25,08:12,4,4,8
12,2025-05-25T00:13:00+02:00,2025-05-25,08:13,1,0,1
12,2025-05-25T00:19:00+02:00,2025-05-25,08:19,2,3,5
12,2025-05-25T00:20:00+02:00,2025-05-25,08:20,0,4,4
12,2025-05-25T00:21:00+02:00,2025-05-25,08:21,2,2,4
17,2025-05-25T00:10:00+02:00,2025-05-25,08:10,1,0,1
17,2025-05-25T00:13:00+02:00,2025-05-25,08:13,1,0,1
17,2025-05-25T00:18:00+02:00,2025-05-25,08:18,0,2,2
17,2025-05-25T00:21:00+02:00,2025-05-25,08:21,1,0,1
18,2025-05-25T00:11:00+02:00,2025-05-25,08:11,2,0,2
18,2025-05-25T00:14:00+02:00,2025-05-25,08:14,0,1,1
18,2025-05-25T00:17:00+02:00,2025-05-25,08:17,3,0,3
19,2025-05-25T00:13:00+02:00,2025-05-25,08:13,0,1,1
19,2025-05-25T00:17:00+02:00,2025-05-25,08:17,0,2,2
20,2025-05-25T00:10:00+02:00,2025-05-25,08:10,1,0,1
20,2025-05-25T00:18:00+02:00,2025-05-25,08:18,0,1,1
20,2025-05-25T00:21:00+02:00,2025-05-25,08:21,1,0,1
23,2025-05-25T00:12:00+02:00,2025-05-25,08:12,0,6,6
23,2025-05-25T00:20:00+02:00,2025-05-25,08:20,4,0,4
24,2025-05-25T00:13:00+02:00,2025-05-25,08:13,0,4,4
24,2025-05-25T00:15:00+02:00,2025-05-25,08:15,6,1,7
24,2025-05-25T00:22:00+02:00,2025-05-25,08:22,2,5,7
24,2025-05-25T00:23:00+02:00,2025-05-25,08:23,6,0,6
24,2025-05-25T00:24:00+02:00,2025-05-25,08:24,4,1,5
27,2025-05-25T00:12:00+02:00,2025-05-25,08:12,0,3,3
27,2025-05-25T00:19:00+02:00,2025-05-25,08:19,4,1,5
27,2025-05-25T00:20:00+02:00,2025-05-25,08:20,1,2,3
27,2025-05-25T00:23:00+02:00,2025-05-25,08:23,2,1,3
30,2025-05-25T00:12:00+02:00,2025-05-25,08:12,2,2,4
30,2025-05-25T00:18:00+02:00,2025-05-25,08:18,1,0,1
30,2025-05-25T00:19:00+02:00,2025-05-25,08:19,1,1,2
30,2025-05-25T00:20:00+02:00,2025-05-25,08:20,0,2,2
30,2025-05-25T00:23:00+02:00,2025-05-25,08:23,1,0,1
35,2025-05-25T00:14:00+02:00,2025-05-25,08:14,5,8,13
35,2025-05-25T00:19:00+02:00,2025-05-25,08:19,4,4,8
46,2025-05-25T00:15:00+02:00,2025-05-25,08:15,2,1,3
48,2025-05-25T00:10:00+02:00,2025-05-25,08:10,1,0,1
48,2025-05-25T00:11:00+02:00,2025-05-25,08:11,0,5,5
48,2025-05-25T00:17:00+02:00,2025-05-25,08:17,4,1,5
48,2025-05-25T00:24:00+02:00,2025-05-25,08:24,3,4,7
49,2025-05-25T00:23:00+02:00,2025-05-25,08:23,3,5,8
49,2025-05-25T00:24:00+02:00,2025-05-25,08:24,0,1,1
51,2025-05-25T00:11:00+02:00,2025-05-25,08:11,0,3,3
51,2025-05-25T00:14:00+02:00,2025-05-25,08:14,0,2,2
52,2025-05-25T00:12:00+02:00,2025-05-25,08:12,0,1,1
52,2025-05-25T00:13:00+02:00,2025-05-25,08:13,0,3,3
52,2025-05-25T00:15:00+02:00,2025-05-25,08:15,1,1,2
52,2025-05-25T00:16:00+02:00,2025-05-25,08:16,0,1,1
52,2025-05-25T00:17:00+02:00,2025-05-25,08:17,1,0,1
52,2025-05-25T00:20:00+02:00,2025-05-25,08:20,1,0,1
52,2025-05-25T00:21:00+02:00,2025-05-25,08:21,0,1,1
52,2025-05-25T00:22:00+02:00,2025-05-25,08:22,3,1,4
53,2025-05-25T00:12:00+02:00,2025-05-25,08:12,1,0,1
53,2025-05-25T00:17:00+02:00,2025-05-25,08:17,2,0,2
53,2025-05-25T00:19:00+02:00,2025-05-25,08:19,0,1,1
53,2025-05-25T00:20:00+02:00,2025-05-25,08:20,0,1,1
53,2025-05-25T00:21:00+02:00,2025-05-25,08:21,0,1,1
56,2025-05-25T00:11:00+02:00,2025-05-25,08:11,1,1,2
56,2025-05-25T00:15:00+02:00,2025-05-25,08:15,1,0,1
56,2025-05-25T00:18:00+02:00,2025-05-25,08:18,1,0,1
56,2025-05-25T00:20:00+02:00,2025-05-25,08:20,0,1,1
56,2025-05-25T00:22:00+02:00,2025-05-25,08:22,0,1,1
58,2025-05-25T00:10:00+02:00,2025-05-25,08:10,2,2,4
58,2025-05-25T00:16:00+02:00,2025-05-25,08:16,5,1,6
62,2025-05-25T00:10:00+02:00,2025-05-25,08:10,1,0,1
62,2025-05-25T00:15:00+02:00,2025-05-25,08:15,2,1,3
62,2025-05-25T00:17:00+02:00,2025-05-25,08:17,3,1,4
62,2025-05-25T00:19:00+02:00,2025-05-25,08:19,0,1,1
63,2025-05-25T00:14:00+02:00,2025-05-25,08:14,2,0,2
63,2025-05-25T00:18:00+02:00,2025-05-25,08:18,0,1,1
63,2025-05-25T00:20:00+02:00,2025-05-25,08:20,1,2,3
63,2025-05-25T00:24:00+02:00,2025-05-25,08:24,1,2,3
67,2025-05-25T00:13:00+02:00,2025-05-25,08:13,0,1,1
67,2025-05-25T00:14:00+02:00,2025-05-25,08:14,0,1,1
67,2025-05-25T00:20:00+02:00,2025-05-25,08:20,1,3,4
68,2025-05-25T00:15:00+02:00,2025-05-25,08:15,3,1,4
68,2025-05-25T00:19:00+02:00,2025-05-25,08:19,3,1,4
68,2025-05-25T00:22:00+02:00,2025-05-25,08:22,2,0,2
72,2025-05-25T00:11:00+02:00,2025-05-25,08:11,1,3,4
72,2025-05-25T00:17:00+02:00,2025-05-25,08:17,0,1,1
72,2025-05-25T00:23:00+02:00,2025-05-25,08:23,0,1,1
79,2025-05-25T00:12:00+02:00,2025-05-25,08:12,1,1,2
79,2025-05-25T00:16:00+02:00,2025-05-25,08:16,0,1,1
79,2025-05-25T00:17:00+02:00,2025-05-25,08:17,0,4,4
79,2025-05-25T00:18:00+02:00,2025-05-25,08:18,0,3,3
79,2025-05-25T00:19:00+02:00,2025-05-25,08:19,5,1,6
79,2025-05-25T00:22:00+02:00,2025-05-25,08:22,0,1,1
85,2025-05-25T00:14:00+02:00,2025-05-25,08:14,1,2,3
85,2025-05-25T00:20:00+02:00,2025-05-25,08:20,1,0,1
85,2025-05-25T00:22:00+02:00,2025-05-25,08:22,1,0,1
86,2025-05-25T00:14:00+02:00,2025-05-25,08:14,1,1,2
86,2025-05-25T00:15:00+02:00,2025-05-25,08:15,1,0,1
86,2025-05-25T00:18:00+02:00,2025-05-25,08:18,1,0,1
86,2025-05-25T00:19:00+02:00,2025-05-25,08:19,2,0,2
109,2025-05-25T00:15:00+02:00,2025-05-25,08:15,2,1,3
109,2025-05-25T00:20:00+02:00,2025-05-25,08:20,1,3,4
117,2025-05-25T00:20:00+02:00,2025-05-25,08:20,1,2,3
136,2025-05-25T00:10:00+02:00,2025-05-25,08:10,8,2,10
141,2025-05-25T00:10:00+02:00,2025-05-25,08:10,1,2,3
141,2025-05-25T00:20:00+02:00,2025-05-25,08:20,3,3,6
142,2025-05-25T00:15:00+02:00,2025-05-25,08:15,26,41,67
161,2025-05-25T00:10:00+02:00,2025-05-25,08:10,10,5,15
164,2025-05-25T00:15:00+02:00,2025-05-25,08:15,0,3,3
164,2025-05-25T00:20:00+02:00,2025-05-25,08:20,5,0,5
181,2025-05-25T00:30:00+02:00,2025-05-25,08:30,2,6,8
181,2025-05-25T00:33:00+02:00,2025-05-25,08:33,2,7,9
181,2025-05-25T00:39:00+02:00,2025-05-25,08:39,2,2,4
182,2025-05-25T00:25:00+02:00,2025-05-25,08:25,3,2,5
180,2025-05-25T00:37:00+02:00,2025-05-25,08:37,1,0,1
180,2025-05-25T00:39:00+02:00,2025-05-25,08:39,1,0,1
3,2025-05-25T00:31:00+02:00,2025-05-25,08:31,0,3,3
3,2025-05-25T00:32:00+02:00,2025-05-25,08:32,1,0,1
3,2025-05-25T00:39:00+02:00,2025-05-25,08:39,0,2,2
4,2025-05-25T00:27:00+02:00,2025-05-25,08:27,3,1,4
4,2025-05-25T00:28:00+02:00,2025-05-25,08:28,1,1,2
4,2025-05-25T00:29:00+02:00,2025-05-25,08:29,2,0,2
4,2025-05-25T00:39:00+02:00,2025-05-25,08:39,3,2,5
6,2025-05-25T00:28:00+02:00,2025-05-25,08:28,7,14,21
6,2025-05-25T00:35:00+02:00,2025-05-25,08:35,6,17,23
6,2025-05-25T00:36:00+02:00,2025-05-25,08:36,2,3,5
6,2025-05-25T00:39:00+02:00,2025-05-25,08:39,1,0,1
8,2025-05-25T00:28:00+02:00,2025-05-25,08:28,1,2,3
8,2025-05-25T00:32:00+02:00,2025-05-25,08:32,19,0,19
8,2025-05-25T00:36:00+02:00,2025-05-25,08:36,7,1,8
8,2025-05-25T00:37:00+02:00,2025-05-25,08:37,3,3,6
8,2025-05-25T00:39:00+02:00,2025-05-25,08:39,2,2,4
28,2025-05-25T00:28:00+02:00,2025-05-25,08:28,0,1,1
28,2025-05-25T00:29:00+02:00,2025-05-25,08:29,1,0,1
28,2025-05-25T00:35:00+02:00,2025-05-25,08:35,1,0,1
28,2025-05-25T00:37:00+02:00,2025-05-25,08:37,3,2,5
28,2025-05-25T00:38:00+02:00,2025-05-25,08:38,1,3,4
29,2025-05-25T00:28:00+02:00,2025-05-25,08:28,2,1,3
29,2025-05-25T00:31:00+02:00,2025-05-25,08:31,1,5,6
29,2025-05-25T00:32:00+02:00,2025-05-25,08:32,2,6,8
29,2025-05-25T00:33:00+02:00,2025-05-25,08:33,1,2,3
29,2025-05-25T00:39:00+02:00,2025-05-25,08:39,3,2,5
31,2025-05-25T00:30:00+02:00,2025-05-25,08:30,2,0,2
31,2025-05-25T00:36:00+02:00,2025-05-25,08:36,2,0,2
36,2025-05-25T00:28:00+02:00,2025-05-25,08:28,0,1,1
36,2025-05-25T00:36:00+02:00,2025-05-25,08:36,0,3,3
37,2025-05-25T00:25:00+02:00,2025-05-25,08:25,1,0,1
39,2025-05-25T00:28:00+02:00,2025-05-25,08:28,1,0,1
39,2025-05-25T00:30:00+02:00,2025-05-25,08:30,1,1,2
39,2025-05-25T00:38:00+02:00,2025-05-25,08:38,2,0,2
40,2025-05-25T00:26:00+02:00,2025-05-25,08:26,0,1,1
40,2025-05-25T00:32:00+02:00,2025-05-25,08:32,0,4,4
40,2025-05-25T00:37:00+02:00,2025-05-25,08:37,1,0,1
40,2025-05-25T00:39:00+02:00,2025-05-25,08:39,2,0,2
41,2025-05-25T00:28:00+02:00,2025-05-25,08:28,2,0,2
41,2025-05-25T00:30:00+02:00,2025-05-25,08:30,0,2,2
41,2025-05-25T00:34:00+02:00,2025-05-25,08:34,0,1,1
41,2025-05-25T00:38:00+02:00,2025-05-25,08:38,7,0,7
41,2025-05-25T00:39:00+02:00,2025-05-25,08:39,1,1,2
43,2025-05-25T00:25:00+02:00,2025-05-25,08:25,1,2,3
43,2025-05-25T00:35:00+02:00,2025-05-25,08:35,1,2,3
44,2025-05-25T00:35:00+02:00,2025-05-25,08:35,0,2,2
45,2025-05-25T00:25:00+02:00,2025-05-25,08:25,2,0,2
45,2025-05-25T00:27:00+02:00,2025-05-25,08:27,0,2,2
45,2025-05-25T00:32:00+02:00,2025-05-25,08:32,0,2,2
45,2025-05-25T00:38:00+02:00,2025-05-25,08:38,1,0,1
47,2025-05-25T00:25:00+02:00,2025-05-25,08:25,1,0,1
47,2025-05-25T00:34:00+02:00,2025-05-25,08:34,5,2,7
47,2025-05-25T00:36:00+02:00,2025-05-25,08:36,3,6,9
47,2025-05-25T00:37:00+02:00,2025-05-25,08:37,0,6,6
47,2025-05-25T00:38:00+02:00,2025-05-25,08:38,5,5,10
50,2025-05-25T00:33:00+02:00,2025-05-25,08:33,0,1,1
50,2025-05-25T00:37:00+02:00,2025-05-25,08:37,0,2,2
50,2025-05-25T00:39:00+02:00,2025-05-25,08:39,0,1,1
54,2025-05-25T00:26:00+02:00,2025-05-25,08:26,5,0,5
54,2025-05-25T00:30:00+02:00,2025-05-25,08:30,1,0,1
54,2025-05-25T00:38:00+02:00,2025-05-25,08:38,2,0,2
59,2025-05-25T00:25:00+02:00,2025-05-25,08:25,6,5,11
61,2025-05-25T00:25:00+02:00,2025-05-25,08:25,0,3,3
61,2025-05-25T00:26:00+02:00,2025-05-25,08:26,2,0,2
61,2025-05-25T00:30:00+02:00,2025-05-25,08:30,1,2,3
61,2025-05-25T00:31:00+02:00,2025-05-25,08:31,2,0,2
61,2025-05-25T00:36:00+02:00,2025-05-25,08:36,0,1,1
61,2025-05-25T00:38:00+02:00,2025-05-25,08:38,1,2,3
66,2025-05-25T00:32:00+02:00,2025-05-25,08:32,1,2,3
66,2025-05-25T00:35:00+02:00,2025-05-25,08:35,2,1,3
66,2025-05-25T00:36:00+02:00,2025-05-25,08:36,2,1,3
66,2025-05-25T00:39:00+02:00,2025-05-25,08:39,2,2,4
69,2025-05-25T00:33:00+02:00,2025-05-25,08:33,0,1,1
69,2025-05-25T00:36:00+02:00,2025-05-25,08:36,1,2,3
69,2025-05-25T00:39:00+02:00,2025-05-25,08:39,2,0,2
70,2025-05-25T00:31:00+02:00,2025-05-25,08:31,1,1,2
70,2025-05-25T00:33:00+02:00,2025-05-25,08:33,1,0,1
70,2025-05-25T00:38:00+02:00,2025-05-25,08:38,0,1,1
75,2025-05-25T00:27:00+02:00,2025-05-25,08:27,0,1,1
75,2025-05-25T00:29:00+02:00,2025-05-25,08:29,0,2,2
75,2025-05-25T00:36:00+02:00,2025-05-25,08:36,1,0,1
78,2025-05-25T00:26:00+02:00,2025-05-25,08:26,2,1,3
78,2025-05-25T00:31:00+02:00,2025-05-25,08:31,1,1,2
78,2025-05-25T00:33:00+02:00,2025-05-25,08:33,1,0,1
78,2025-05-25T00:35:00+02:00,2025-05-25,08:35,0,2,2
78,2025-05-25T00:36:00+02:00,2025-05-25,08:36,1,1,2
84,2025-05-25T00:25:00+02:00,2025-05-25,08:25,20,9,29
87,2025-05-25T00:28:00+02:00,2025-05-25,08:28,4,2,6
87,2025-05-25T00:29:00+02:00,2025-05-25,08:29,1,3,4
87,2025-05-25T00:38:00+02:00,2025-05-25,08:38,0,3,3
107,2025-05-25T00:35:00+02:00,2025-05-25,08:35,0,2,2
108,2025-05-25T00:25:00+02:00,2025-05-25,08:25,2,0,2
108,2025-05-25T00:33:00+02:00,2025-05-25,08:33,0,1,1
108,2025-05-25T00:36:00+02:00,2025-05-25,08:36,0,1,1
108,2025-05-25T00:38:00+02:00,2025-05-25,08:38,0,1,1
118,2025-05-25T00:25:00+02:00,2025-05-25,08:25,1,0,1
131,2025-05-25T00:30:00+02:00,2025-05-25,08:30,2,4,6
133,2025-05-25T00:25:00+02:00,2025-05-25,08:25,15,11,26
135,2025-05-25T00:30:00+02:00,2025-05-25,08:30,6,8,14
140,2025-05-25T00:25:00+02:00,2025-05-25,08:25,5,3,8
162,2025-05-25T00:25:00+02:00,2025-05-25,08:25,10,9,19
162,2025-05-25T00:30:00+02:00,2025-05-25,08:30,11,11,22
179,2025-05-25T00:25:00+02:00,2025-05-25,08:25,3,1,4
179,2025-05-25T00:30:00+02:00,2025-05-25,08:30,0,1,1
179,2025-05-25T00:35:00+02:00,2025-05-25,08:35,1,3,4
1,2025-05-25T00:29:00+02:00,2025-05-25,08:29,1,1,2
1,2025-05-25T00:39:00+02:00,2025-05-25,08:39,1,0,1
2,2025-05-25T00:27:00+02:00,2025-05-25,08:27,0,1,1
2,2025-05-25T00:28:00+02:00,2025-05-25,08:28,0,6,6
2,2025-05-25T00:38:00+02:00,2025-05-25,08:38,1,4,5
9,2025-05-25T00:26:00+02:00,2025-05-25,08:26,1,2,3
9,2025-05-25T00:31:00+02:00,2025-05-25,08:31,0,1,1
9,2025-05-25T00:34:00+02:00,2025-05-25,08:34,0,2,2
11,2025-05-25T00:25:00+02:00,2025-05-25,08:25,1,4,5
11,2025-05-25T00:30:00+02:00,2025-05-25,08:30,1,1,2
11,2025-05-25T00:31:00+02:00,2025-05-25,08:31,2,0,2
11,2025-05-25T00:34:00+02:00,2025-05-25,08:34,3,3,6
11,2025-05-25T00:35:00+02:00,2025-05-25,08:35,4,2,6
11,2025-05-25T00:38:00+02:00,2025-05-25,08:38,2,1,3
12,2025-05-25T00:34:00+02:00,2025-05-25,08:34,0,1,1
17,2025-05-25T00:25:00+02:00,2025-05-25,08:25,3,0,3
17,2025-05-25T00:28:00+02:00,2025-05-25,08:28,2,0,2
18,2025-05-25T00:37:00+02:00,2025-05-25,08:37,0,1,1
19,2025-05-25T00:30:00+02:00,2025-05-25,08:30,0,5,5
19,2025-05-25T00:31:00+02:00,2025-05-25,08:31,0,3,3
19,2025-05-25T00:36:00+02:00,2025-05-25,08:36,1,0,1
20,2025-05-25T00:31:00+02:00,2025-05-25,08:31,0,1,1
20,2025-05-25T00:35:00+02:00,2025-05-25,08:35,0,3,3
23,2025-05-25T00:31:00+02:00,2025-05-25,08:31,1,0,1
23,2025-05-25T00:32:00+02:00,2025-05-25,08:32,0,3,3
24,2025-05-25T00:26:00+02:00,2025-05-25,08:26,8,1,9
24,2025-05-25T00:29:00+02:00,2025-05-25,08:29,1,6,7
24,2025-05-25T00:33:00+02:00,2025-05-25,08:33,3,3,6
24,2025-05-25T00:34:00+02:00,2025-05-25,08:34,3,0,3
24,2025-05-25T00:36:00+02:00,2025-05-25,08:36,2,14,16
24,2025-05-25T00:37:00+02:00,2025-05-25,08:37,9,5,14
24,2025-05-25T00:39:00+02:00,2025-05-25,08:39,12,0,12
25,2025-05-25T00:30:00+02:00,2025-05-25,08:30,21,53,74
27,2025-05-25T00:28:00+02:00,2025-05-25,08:28,0,2,2
27,2025-05-25T00:34:00+02:00,2025-05-25,08:34,1,2,3
27,2025-05-25T00:35:00+02:00,2025-05-25,08:35,3,0,3
27,2025-05-25T00:37:00+02:00,2025-05-25,08:37,0,3,3
30,2025-05-25T00:25:00+02:00,2025-05-25,08:25,2,3,5
30,2025-05-25T00:26:00+02:00,2025-05-25,08:26,0,4,4
30,2025-05-25T00:34:00+02:00,2025-05-25,08:34,0,5,5
30,2025-05-25T00:36:00+02:00,2025-05-25,08:36,0,1,1
30,2025-05-25T00:37:00+02:00,2025-05-25,08:37,0,1,1
30,2025-05-25T00:39:00+02:00,2025-05-25,08:39,0,1,1
35,2025-05-25T00:26:00+02:00,2025-05-25,08:26,9,8,17
35,2025-05-25T00:30:00+02:00,2025-05-25,08:30,9,13,22
35,2025-05-25T00:32:00+02:00,2025-05-25,08:32,3,8,11
35,2025-05-25T00:36:00+02:00,2025-05-25,08:36,10,12,22
35,2025-05-25T00:37:00+02:00,2025-05-25,08:37,11,15,26
35,2025-05-25T00:38:00+02:00,2025-05-25,08:38,12,6,18
35,2025-05-25T00:39:00+02:00,2025-05-25,08:39,7,7,14
46,2025-05-25T00:30:00+02:00,2025-05-25,08:30,1,0,1
48,2025-05-25T00:26:00+02:00,2025-05-25,08:26,2,1,3
48,2025-05-25T00:28:00+02:00,2025-05-25,08:28,3,0,3
48,2025-05-25T00:35:00+02:00,2025-05-25,08:35,1,2,3
48,2025-05-25T00:39:00+02:00,2025-05-25,08:39,0,2,2
49,2025-05-25T00:25:00+02:00,2025-05-25,08:25,1,0,1
49,2025-05-25T00:30:00+02:00,2025-05-25,08:30,3,0,3
49,2025-05-25T00:35:00+02:00,2025-05-25,08:35,0,3,3
49,2025-05-25T00:38:00+02:00,2025-05-25,08:38,0,1,1
51,2025-05-25T00:25:00+02:00,2025-05-25,08:25,0,3,3
51,2025-05-25T00:26:00+02:00,2025-05-25,08:26,3,0,3
51,2025-05-25T00:33:00+02:00,2025-05-25,08:33,0,1,1
51,2025-05-25T00:34:00+02:00,2025-05-25,08:34,0,1,1
51,2025-05-25T00:35:00+02:00,2025-05-25,08:35,1,0,1
51,2025-05-25T00:39:00+02:00,2025-05-25,08:39,0,4,4
52,2025-05-25T00:28:00+02:00,2025-05-25,08:28,0,1,1
52,2025-05-25T00:33:00+02:00,2025-05-25,08:33,1,0,1
52,2025-05-25T00:34:00+02:00,2025-05-25,08:34,1,1,2
52,2025-05-25T00:38:00+02:00,2025-05-25,08:38,0,4,4
53,2025-05-25T00:32:00+02:00,2025-05-25,08:32,0,1,1
53,2025-05-25T00:35:00+02:00,2025-05-25,08:35,4,0,4
53,2025-05-25T00:38:00+02:00,2025-05-25,08:38,1,0,1
53,2025-05-25T00:39:00+02:00,2025-05-25,08:39,1,1,2
56,2025-05-25T00:30:00+02:00,2025-05-25,08:30,0,1,1
56,2025-05-25T00:31:00+02:00,2025-05-25,08:31,1,6,7
56,2025-05-25T00:36:00+02:00,2025-05-25,08:36,1,2,3
58,2025-05-25T00:27:00+02:00,2025-05-25,08:27,6,2,8
58,2025-05-25T00:28:00+02:00,2025-05-25,08:28,0,2,2
58,2025-05-25T00:30:00+02:00,2025-05-25,08:30,1,0,1
58,2025-05-25T00:31:00+02:00,2025-05-25,08:31,3,1,4
58,2025-05-25T00:33:00+02:00,2025-05-25,08:33,1,0,1
58,2025-05-25T00:36:00+02:00,2025-05-25,08:36,1,7,8
58,2025-05-25T00:39:00+02:00,2025-05-25,08:39,3,4,7
62,2025-05-25T00:30:00+02:00,2025-05-25,08:30,0,1,1
62,2025-05-25T00:35:00+02:00,2025-05-25,08:35,0,1,1
63,2025-05-25T00:25:00+02:00,2025-05-25,08:25,0,5,5
63,2025-05-25T00:26:00+02:00,2025-05-25,08:26,1,5,6
63,2025-05-25T00:30:00+02:00,2025-05-25,08:30,0,2,2
63,2025-05-25T00:34:00+02:00,2025-05-25,08:34,1,2,3
63,2025-05-25T00:36:00+02:00,2025-05-25,08:36,0,1,1
63,2025-05-25T00:39:00+02:00,2025-05-25,08:39,0,1,1
67,2025-05-25T00:25:00+02:00,2025-05-25,08:25,3,3,6
67,2025-05-25T00:26:00+02:00,2025-05-25,08:26,2,1,3
67,2025-05-25T00:27:00+02:00,2025-05-25,08:27,0,1,1
67,2025-05-25T00:28:00+02:00,2025-05-25,08:28,2,0,2
67,2025-05-25T00:32:00+02:00,2025-05-25,08:32,2,7,9
67,2025-05-25T00:35:00+02:00,2025-05-25,08:35,1,1,2
67,2025-05-25T00:36:00+02:00,2025-05-25,08:36,2,0,2
67,2025-05-25T00:37:00+02:00,2025-05-25,08:37,1,1,2
67,2025-05-25T00:38:00+02:00,2025-05-25,08:38,1,1,2
67,2025-05-25T00:39:00+02:00,2025-05-25,08:39,4,2,6
68,2025-05-25T00:25:00+02:00,2025-05-25,08:25,1,0,1
68,2025-05-25T00:29:00+02:00,2025-05-25,08:29,0,1,1
68,2025-05-25T00:31:00+02:00,2025-05-25,08:31,1,1,2
68,2025-05-25T00:34:00+02:00,2025-05-25,08:34,0,1,1
68,2025-05-25T00:37:00+02:00,2025-05-25,08:37,4,0,4
72,2025-05-25T00:27:00+02:00,2025-05-25,08:27,2,1,3
72,2025-05-25T00:29:00+02:00,2025-05-25,08:29,1,0,1
72,2025-05-25T00:34:00+02:00,2025-05-25,08:34,0,2,2
72,2025-05-25T00:36:00+02:00,2025-05-25,08:36,0,2,2
72,2025-05-25T00:37:00+02:00,2025-05-25,08:37,0,1,1
76,2025-05-25T00:28:00+02:00,2025-05-25,08:28,1,0,1
76,2025-05-25T00:29:00+02:00,2025-05-25,08:29,0,1,1
76,2025-05-25T00:31:00+02:00,2025-05-25,08:31,1,2,3
79,2025-05-25T00:26:00+02:00,2025-05-25,08:26,5,1,6
79,2025-05-25T00:29:00+02:00,2025-05-25,08:29,2,1,3
79,2025-05-25T00:32:00+02:00,2025-05-25,08:32,2,1,3
79,2025-05-25T00:33:00+02:00,2025-05-25,08:33,1,0,1
85,2025-05-25T00:38:00+02:00,2025-05-25,08:38,2,0,2
86,2025-05-25T00:26:00+02:00,2025-05-25,08:26,0,1,1
86,2025-05-25T00:33:00+02:00,2025-05-25,08:33,2,1,3
109,2025-05-25T00:25:00+02:00,2025-05-25,08:25,5,1,6
109,2025-05-25T00:30:00+02:00,2025-05-25,08:30,4,2,6
117,2025-05-25T00:35:00+02:00,2025-05-25,08:35,2,5,7
139,2025-05-25T00:35:00+02:00,2025-05-25,08:35,0,2,2
141,2025-05-25T00:25:00+02:00,2025-05-25,08:25,4,2,6
141,2025-05-25T00:35:00+02:00,2025-05-25,08:35,5,4,9
161,2025-05-25T00:30:00+02:00,2025-05-25,08:30,11,14,25
164,2025-05-25T00:35:00+02:00,2025-05-25,08:35,1,0,1
3,2025-05-25T00:41:00+02:00,2025-05-25,08:41,2,4,6
3,2025-05-25T00:42:00+02:00,2025-05-25,08:42,2,1,3
3,2025-05-25T00:46:00+02:00,2025-05-25,08:46,3,2,5
4,2025-05-25T00:47:00+02:00,2025-05-25,08:47,2,1,3
4,2025-05-25T00:48:00+02:00,2025-05-25,08:48,4,8,12
4,2025-05-25T00:50:00+02:00,2025-05-25,08:50,1,1,2
4,2025-05-25T00:53:00+02:00,2025-05-25,08:53,1,6,7
5,2025-05-25T00:40:00+02:00,2025-05-25,08:40,14,6,20
5,2025-05-25T00:50:00+02:00,2025-05-25,08:50,10,8,18
6,2025-05-25T00:40:00+02:00,2025-05-25,08:40,2,3,5
6,2025-05-25T00:45:00+02:00,2025-05-25,08:45,5,3,8
6,2025-05-25T00:47:00+02:00,2025-05-25,08:47,1,8,9
6,2025-05-25T00:49:00+02:00,2025-05-25,08:49,6,3,9
6,2025-05-25T00:52:00+02:00,2025-05-25,08:52,7,1,8
8,2025-05-25T00:48:00+02:00,2025-05-25,08:48,0,2,2
28,2025-05-25T00:43:00+02:00,2025-05-25,08:43,0,3,3
28,2025-05-25T00:51:00+02:00,2025-05-25,08:51,1,1,2
29,2025-05-25T00:41:00+02:00,2025-05-25,08:41,2,1,3
29,2025-05-25T00:44:00+02:00,2025-05-25,08:44,4,4,8
29,2025-05-25T00:45:00+02:00,2025-05-25,08:45,2,1,3
29,2025-05-25T00:47:00+02:00,2025-05-25,08:47,4,2,6
29,2025-05-25T00:48:00+02:00,2025-05-25,08:48,0,3,3
29,2025-05-25T00:49:00+02:00,2025-05-25,08:49,1,5,6
31,2025-05-25T00:46:00+02:00,2025-05-25,08:46,0,4,4
31,2025-05-25T00:47:00+02:00,2025-05-25,08:47,3,0,3
31,2025-05-25T00:49:00+02:00,2025-05-25,08:49,2,0,2
36,2025-05-25T00:42:00+02:00,2025-05-25,08:42,2,0,2
36,2025-05-25T00:51:00+02:00,2025-05-25,08:51,2,0,2
36,2025-05-25T00:52:00+02:00,2025-05-25,08:52,0,1,1
37,2025-05-25T00:41:00+02:00,2025-05-25,08:41,3,0,3
39,2025-05-25T00:45:00+02:00,2025-05-25,08:45,1,0,1
39,2025-05-25T00:53:00+02:00,2025-05-25,08:53,1,0,1
40,2025-05-25T00:40:00+02:00,2025-05-25,08:40,0,3,3
40,2025-05-25T00:41:00+02:00,2025-05-25,08:41,1,0,1
40,2025-05-25T00:43:00+02:00,2025-05-25,08:43,0,1,1
40,2025-05-25T00:49:00+02:00,2025-05-25,08:49,5,0,5
40,2025-05-25T00:52:00+02:00,2025-05-25,08:52,0,2,2
41,2025-05-25T00:40:00+02:00,2025-05-25,08:40,6,1,7
41,2025-05-25T00:41:00+02:00,2025-05-25,08:41,3,7,10
41,2025-05-25T00:44:00+02:00,2025-05-25,08:44,2,2,4
41,2025-05-25T00:47:00+02:00,2025-05-25,08:47,3,1,4
41,2025-05-25T00:48:00+02:00,2025-05-25,08:48,3,1,4
44,2025-05-25T00:45:00+02:00,2025-05-25,08:45,4,1,5
45,2025-05-25T00:40:00+02:00,2025-05-25,08:40,1,1,2
45,2025-05-25T00:42:00+02:00,2025-05-25,08:42,0,2,2
45,2025-05-25T00:46:00+02:00,2025-05-25,08:46,1,0,1
45,2025-05-25T00:47:00+02:00,2025-05-25,08:47,1,1,2
45,2025-05-25T00:50:00+02:00,2025-05-25,08:50,5,2,7
45,2025-05-25T00:51:00+02:00,2025-05-25,08:51,2,5,7
45,2025-05-25T00:52:00+02:00,2025-05-25,08:52,6,7,13
47,2025-05-25T00:40:00+02:00,2025-05-25,08:40,0,8,8
47,2025-05-25T00:45:00+02:00,2025-05-25,08:45,3,5,8
47,2025-05-25T00:46:00+02:00,2025-05-25,08:46,1,0,1
47,2025-05-25T00:47:00+02:00,2025-05-25,08:47,0,7,7
47,2025-05-25T00:51:00+02:00,2025-05-25,08:51,3,5,8
47,2025-05-25T00:52:00+02:00,2025-05-25,08:52,4,3,7
47,2025-05-25T00:54:00+02:00,2025-05-25,08:54,3,8,11
50,2025-05-25T00:43:00+02:00,2025-05-25,08:43,2,3,5
50,2025-05-25T00:48:00+02:00,2025-05-25,08:48,1,3,4
50,2025-05-25T00:52:00+02:00,2025-05-25,08:52,3,1,4
54,2025-05-25T00:43:00+02:00,2025-05-25,08:43,1,0,1
54,2025-05-25T00:46:00+02:00,2025-05-25,08:46,1,0,1
54,2025-05-25T00:47:00+02:00,2025-05-25,08:47,1,1,2
54,2025-05-25T00:54:00+02:00,2025-05-25,08:54,1,0,1
59,2025-05-25T00:40:00+02:00,2025-05-25,08:40,7,10,17
61,2025-05-25T00:40:00+02:00,2025-05-25,08:40,1,1,2
61,2025-05-25T00:42:00+02:00,2025-05-25,08:42,1,8,9
61,2025-05-25T00:43:00+02:00,2025-05-25,08:43,1,1,2
61,2025-05-25T00:44:00+02:00,2025-05-25,08:44,2,9,11
61,2025-05-25T00:48:00+02:00,2025-05-25,08:48,2,1,3
61,2025-05-25T00:50:00+02:00,2025-05-25,08:50,1,2,3
61,2025-05-25T00:54:00+02:00,2025-05-25,08:54,2,4,6
66,2025-05-25T00:41:00+02:00,2025-05-25,08:41,1,0,1
66,2025-05-25T00:42:00+02:00,2025-05-25,08:42,0,1,1
66,2025-05-25T00:43:00+02:00,2025-05-25,08:43,0,3,3
66,2025-05-25T00:48:00+02:00,2025-05-25,08:48,1,0,1
69,2025-05-25T00:43:00+02:00,2025-05-25,08:43,0,1,1
69,2025-05-25T00:44:00+02:00,2025-05-25,08:44,0,2,2
69,2025-05-25T00:49:00+02:00,2025-05-25,08:49,6,2,8
70,2025-05-25T00:40:00+02:00,2025-05-25,08:40,0,1,1
70,2025-05-25T00:48:00+02:00,2025-05-25,08:48,1,0,1
70,2025-05-25T00:50:00+02:00,2025-05-25,08:50,0,1,1
75,2025-05-25T00:53:00+02:00,2025-05-25,08:53,2,2,4
77,2025-05-25T00:45:00+02:00,2025-05-25,08:45,5,19,24
78,2025-05-25T00:40:00+02:00,2025-05-25,08:40,1,0,1
84,2025-05-25T00:40:00+02:00,2025-05-25,08:40,20,26,46
84,2025-05-25T00:50:00+02:00,2025-05-25,08:50,43,19,62
87,2025-05-25T00:41:00+02:00,2025-05-25,08:41,1,0,1
87,2025-05-25T00:45:00+02:00,2025-05-25,08:45,0,2,2
87,2025-05-25T00:48:00+02:00,2025-05-25,08:48,0,2,2
87,2025-05-25T00:54:00+02:00,2025-05-25,08:54,1,0,1
107,2025-05-25T00:40:00+02:00,2025-05-25,08:40,5,4,9
108,2025-05-25T00:40:00+02:00,2025-05-25,08:40,1,0,1
108,2025-05-25T00:45:00+02:00,2025-05-25,08:45,2,3,5
108,2025-05-25T00:48:00+02:00,2025-05-25,08:48,1,0,1
108,2025-05-25T00:49:00+02:00,2025-05-25,08:49,2,2,4
108,2025-05-25T00:53:00+02:00,2025-05-25,08:53,1,4,5
108,2025-05-25T00:54:00+02:00,2025-05-25,08:54,4,0,4
118,2025-05-25T00:50:00+02:00,2025-05-25,08:50,1,2,3
124,2025-05-25T00:50:00+02:00,2025-05-25,08:50,1,1,2
131,2025-05-25T00:45:00+02:00,2025-05-25,08:45,7,1,8
133,2025-05-25T00:40:00+02:00,2025-05-25,08:40,24,25,49
133,2025-05-25T00:45:00+02:00,2025-05-25,08:45,16,21,37
134,2025-05-25T00:50:00+02:00,2025-05-25,08:50,18,19,37
140,2025-05-25T00:40:00+02:00,2025-05-25,08:40,3,0,3
140,2025-05-25T00:50:00+02:00,2025-05-25,08:50,7,3,10
162,2025-05-25T00:40:00+02:00,2025-05-25,08:40,5,9,14
166,2025-05-25T00:45:00+02:00,2025-05-25,08:45,1,2,3
167,2025-05-25T00:40:00+02:00,2025-05-25,08:40,2,4,6
1,2025-05-25T00:41:00+02:00,2025-05-25,08:41,5,1,6
1,2025-05-25T00:42:00+02:00,2025-05-25,08:42,0,2,2
1,2025-05-25T00:44:00+02:00,2025-05-25,08:44,0,2,2
1,2025-05-25T00:47:00+02:00,2025-05-25,08:47,0,1,1
1,2025-05-25T00:49:00+02:00,2025-05-25,08:49,5,0,5
1,2025-05-25T00:50:00+02:00,2025-05-25,08:50,5,1,6
1,2025-05-25T00:52:00+02:00,2025-05-25,08:52,2,0,2
1,2025-05-25T00:53:00+02:00,2025-05-25,08:53,3,3,6
2,2025-05-25T00:42:00+02:00,2025-05-25,08:42,4,0,4
2,2025-05-25T00:47:00+02:00,2025-05-25,08:47,1,2,3
2,2025-05-25T00:49:00+02:00,2025-05-25,08:49,0,1,1
2,2025-05-25T00:54:00+02:00,2025-05-25,08:54,4,0,4
9,2025-05-25T00:44:00+02:00,2025-05-25,08:44,1,0,1
9,2025-05-25T00:45:00+02:00,2025-05-25,08:45,0,2,2
9,2025-05-25T00:51:00+02:00,2025-05-25,08:51,1,1,2
10,2025-05-25T00:43:00+02:00,2025-05-25,08:43,2,1,3
10,2025-05-25T00:48:00+02:00,2025-05-25,08:48,0,1,1
10,2025-05-25T00:51:00+02:00,2025-05-25,08:51,2,0,2
11,2025-05-25T00:45:00+02:00,2025-05-25,08:45,3,0,3
11,2025-05-25T00:50:00+02:00,2025-05-25,08:50,3,2,5
11,2025-05-25T00:54:00+02:00,2025-05-25,08:54,0,1,1
12,2025-05-25T00:41:00+02:00,2025-05-25,08:41,2,0,2
12,2025-05-25T00:46:00+02:00,2025-05-25,08:46,0,3,3
12,2025-05-25T00:48:00+02:00,2025-05-25,08:48,0,3,3
12,2025-05-25T00:49:00+02:00,2025-05-25,08:49,3,0,3
17,2025-05-25T00:40:00+02:00,2025-05-25,08:40,1,0,1
17,2025-05-25T00:50:00+02:00,2025-05-25,08:50,0,1,1
17,2025-05-25T00:51:00+02:00,2025-05-25,08:51,3,0,3
17,2025-05-25T00:53:00+02:00,2025-05-25,08:53,0,2,2
19,2025-05-25T00:40:00+02:00,2025-05-25,08:40,0,1,1
19,2025-05-25T00:46:00+02:00,2025-05-25,08:46,1,1,2
19,2025-05-25T00:47:00+02:00,2025-05-25,08:47,2,0,2
19,2025-05-25T00:49:00+02:00,2025-05-25,08:49,1,0,1
20,2025-05-25T00:43:00+02:00,2025-05-25,08:43,0,1,1
20,2025-05-25T00:53:00+02:00,2025-05-25,08:53,0,1,1
23,2025-05-25T00:44:00+02:00,2025-05-25,08:44,3,1,4
23,2025-05-25T00:49:00+02:00,2025-05-25,08:49,1,3,4
23,2025-05-25T00:50:00+02:00,2025-05-25,08:50,0,1,1
23,2025-05-25T00:51:00+02:00,2025-05-25,08:51,0,1,1
23,2025-05-25T00:53:00+02:00,2025-05-25,08:53,2,1,3
23,2025-05-25T00:54:00+02:00,2025-05-25,08:54,1,2,3
24,2025-05-25T00:43:00+02:00,2025-05-25,08:43,6,2,8
24,2025-05-25T00:44:00+02:00,2025-05-25,08:44,2,0,2
24,2025-05-25T00:45:00+02:00,2025-05-25,08:45,2,2,4
24,2025-05-25T00:47:00+02:00,2025-05-25,08:47,4,8,12
24,2025-05-25T00:49:00+02:00,2025-05-25,08:49,0,5,5
24,2025-05-25T00:50:00+02:00,2025-05-25,08:50,31,3,34
24,2025-05-25T00:52:00+02:00,2025-05-25,08:52,5,5,10
24,2025-05-25T00:54:00+02:00,2025-05-25,08:54,3,4,7
27,2025-05-25T00:41:00+02:00,2025-05-25,08:41,1,2,3
27,2025-05-25T00:42:00+02:00,2025-05-25,08:42,3,1,4
27,2025-05-25T00:44:00+02:00,2025-05-25,08:44,1,3,4
27,2025-05-25T00:45:00+02:00,2025-05-25,08:45,0,3,3
27,2025-05-25T00:48:00+02:00,2025-05-25,08:48,0,4,4
27,2025-05-25T00:52:00+02:00,2025-05-25,08:52,3,1,4
30,2025-05-25T00:45:00+02:00,2025-05-25,08:45,0,5,5
30,2025-05-25T00:47:00+02:00,2025-05-25,08:47,1,4,5
30,2025-05-25T00:50:00+02:00,2025-05-25,08:50,2,2,4
35,2025-05-25T00:42:00+02:00,2025-05-25,08:42,5,6,11
35,2025-05-25T00:45:00+02:00,2025-05-25,08:45,7,2,9
46,2025-05-25T00:40:00+02:00,2025-05-25,08:40,1,0,1
46,2025-05-25T00:50:00+02:00,2025-05-25,08:50,2,1,3
48,2025-05-25T00:45:00+02:00,2025-05-25,08:45,0,1,1
48,2025-05-25T00:49:00+02:00,2025-05-25,08:49,1,0,1
48,2025-05-25T00:54:00+02:00,2025-05-25,08:54,0,5,5
49,2025-05-25T00:42:00+02:00,2025-05-25,08:42,1,1,2
49,2025-05-25T00:50:00+02:00,2025-05-25,08:50,2,1,3
49,2025-05-25T00:54:00+02:00,2025-05-25,08:54,6,2,8
51,2025-05-25T00:43:00+02:00,2025-05-25,08:43,0,1,1
51,2025-05-25T00:50:00+02:00,2025-05-25,08:50,3,1,4
52,2025-05-25T00:45:00+02:00,2025-05-25,08:45,1,1,2
52,2025-05-25T00:47:00+02:00,2025-05-25,08:47,0,1,1
52,2025-05-25T00:51:00+02:00,2025-05-25,08:51,0,3,3
52,2025-05-25T00:54:00+02:00,2025-05-25,08:54,1,0,1
53,2025-05-25T00:41:00+02:00,2025-05-25,08:41,1,1,2
53,2025-05-25T00:42:00+02:00,2025-05-25,08:42,0,3,3
53,2025-05-25T00:43:00+02:00,2025-05-25,08:43,0,5,5
53,2025-05-25T00:45:00+02:00,2025-05-25,08:45,4,1,5
53,2025-05-25T00:48:00+02:00,2025-05-25,08:48,3,0,3
53,2025-05-25T00:51:00+02:00,2025-05-25,08:51,2,3,5
53,2025-05-25T00:54:00+02:00,2025-05-25,08:54,6,0,6
56,2025-05-25T00:40:00+02:00,2025-05-25,08:40,4,0,4
56,2025-05-25T00:46:00+02:00,2025-05-25,08:46,1,3,4
56,2025-05-25T00:51:00+02:00,2025-05-25,08:51,0,4,4
56,2025-05-25T00:54:00+02:00,2025-05-25,08:54,2,2,4
58,2025-05-25T00:43:00+02:00,2025-05-25,08:43,6,3,9
58,2025-05-25T00:49:00+02:00,2025-05-25,08:49,3,2,5
58,2025-05-25T00:50:00+02:00,2025-05-25,08:50,7,3,10
58,2025-05-25T00:54:00+02:00,2025-05-25,08:54,6,4,10
62,2025-05-25T00:42:00+02:00,2025-05-25,08:42,1,2,3
62,2025-05-25T00:53:00+02:00,2025-05-25,08:53,2,0,2
63,2025-05-25T00:42:00+02:00,2025-05-25,08:42,0,4,4
63,2025-05-25T00:47:00+02:00,2025-05-25,08:47,2,0,2
63,2025-05-25T00:51:00+02:00,2025-05-25,08:51,1,1,2
67,2025-05-25T00:42:00+02:00,2025-05-25,08:42,0,2,2
67,2025-05-25T00:44:00+02:00,2025-05-25,08:44,1,1,2
67,2025-05-25T00:51:00+02:00,2025-05-25,08:51,2,3,5
67,2025-05-25T00:52:00+02:00,2025-05-25,08:52,4,2,6
67,2025-05-25T00:53:00+02:00,2025-05-25,08:53,1,3,4
68,2025-05-25T00:41:00+02:00,2025-05-25,08:41,2,1,3
68,2025-05-25T00:44:00+02:00,2025-05-25,08:44,2,1,3
68,2025-05-25T00:45:00+02:00,2025-05-25,08:45,0,2,2
68,2025-05-25T00:47:00+02:00,2025-05-25,08:47,4,0,4
68,2025-05-25T00:51:00+02:00,2025-05-25,08:51,0,1,1
72,2025-05-25T00:40:00+02:00,2025-05-25,08:40,4,0,4
72,2025-05-25T00:41:00+02:00,2025-05-25,08:41,1,0,1
72,2025-05-25T00:43:00+02:00,2025-05-25,08:43,2,3,5
72,2025-05-25T00:48:00+02:00,2025-05-25,08:48,0,1,1
72,2025-05-25T00:49:00+02:00,2025-05-25,08:49,1,1,2
72,2025-05-25T00:53:00+02:00,2025-05-25,08:53,1,2,3
76,2025-05-25T00:45:00+02:00,2025-05-25,08:45,2,1,3
76,2025-05-25T00:46:00+02:00,2025-05-25,08:46,0,3,3
79,2025-05-25T00:46:00+02:00,2025-05-25,08:46,1,6,7
79,2025-05-25T00:47:00+02:00,2025-05-25,08:47,0,1,1
79,2025-05-25T00:48:00+02:00,2025-05-25,08:48,1,3,4
79,2025-05-25T00:51:00+02:00,2025-05-25,08:51,0,2,2
79,2025-05-25T00:52:00+02:00,2025-05-25,08:52,5,3,8
85,2025-05-25T00:44:00+02:00,2025-05-25,08:44,1,2,3
85,2025-05-25T00:49:00+02:00,2025-05-25,08:49,0,1,1
86,2025-05-25T00:40:00+02:00,2025-05-25,08:40,1,0,1
86,2025-05-25T00:41:00+02:00,2025-05-25,08:41,2,0,2
86,2025-05-25T00:52:00+02:00,2025-05-25,08:52,0,1,1
109,2025-05-25T00:45:00+02:00,2025-05-25,08:45,8,1,9
123,2025-05-25T00:40:00+02:00,2025-05-25,08:40,4,2,6
123,2025-05-25T00:45:00+02:00,2025-05-25,08:45,1,1,2
130,2025-05-25T00:50:00+02:00,2025-05-25,08:50,1,0,1
139,2025-05-25T00:45:00+02:00,2025-05-25,08:45,3,0,3
142,2025-05-25T00:40:00+02:00,2025-05-25,08:40,24,23,47
181,2025-05-25T00:40:00+02:00,2025-05-25,08:40,5,3,8
181,2025-05-25T00:49:00+02:00,2025-05-25,08:49,7,4,11
181,2025-05-25T00:50:00+02:00,2025-05-25,08:50,1,5,6
181,2025-05-25T00:52:00+02:00,2025-05-25,08:52,0,10,10
182,2025-05-25T00:40:00+02:00,2025-05-25,08:40,3,5,8
180,2025-05-25T00:40:00+02:00,2025-05-25,08:40,0,3,3
180,2025-05-25T00:45:00+02:00,2025-05-25,08:45,5,0,5
180,2025-05-25T00:48:00+02:00,2025-05-25,08:48,2,0,2
180,2025-05-25T00:53:00+02:00,2025-05-25,08:53,4,0,4
3,2025-05-25T00:59:00+02:00,2025-05-25,08:59,1,0,1
3,2025-05-25T01:02:00+02:00,2025-05-25,09:02,3,0,3
3,2025-05-25T01:03:00+02:00,2025-05-25,09:03,2,0,2
3,2025-05-25T01:06:00+02:00,2025-05-25,09:06,3,0,3
3,2025-05-25T01:07:00+02:00,2025-05-25,09:07,0,1,1
3,2025-05-25T01:09:00+02:00,2025-05-25,09:09,4,1,5
4,2025-05-25T00:55:00+02:00,2025-05-25,08:55,3,5,8
4,2025-05-25T00:56:00+02:00,2025-05-25,08:56,2,7,9
4,2025-05-25T01:02:00+02:00,2025-05-25,09:02,4,2,6
4,2025-05-25T01:05:00+02:00,2025-05-25,09:05,1,1,2
5,2025-05-25T00:55:00+02:00,2025-05-25,08:55,15,11,26
5,2025-05-25T01:00:00+02:00,2025-05-25,09:00,11,20,31
5,2025-05-25T01:05:00+02:00,2025-05-25,09:05,7,19,26
6,2025-05-25T00:55:00+02:00,2025-05-25,08:55,13,1,14
6,2025-05-25T01:02:00+02:00,2025-05-25,09:02,1,6,7
6,2025-05-25T01:04:00+02:00,2025-05-25,09:04,6,1,7
6,2025-05-25T01:06:00+02:00,2025-05-25,09:06,4,5,9
6,2025-05-25T01:09:00+02:00,2025-05-25,09:09,8,3,11
8,2025-05-25T00:55:00+02:00,2025-05-25,08:55,3,2,5
8,2025-05-25T00:59:00+02:00,2025-05-25,08:59,0,4,4
8,2025-05-25T01:00:00+02:00,2025-05-25,09:00,5,1,6
8,2025-05-25T01:01:00+02:00,2025-05-25,09:01,0,1,1
8,2025-05-25T01:06:00+02:00,2025-05-25,09:06,0,4,4
28,2025-05-25T00:55:00+02:00,2025-05-25,08:55,3,0,3
28,2025-05-25T00:58:00+02:00,2025-05-25,08:58,1,1,2
28,2025-05-25T01:09:00+02:00,2025-05-25,09:09,0,3,3
29,2025-05-25T00:56:00+02:00,2025-05-25,08:56,1,1,2
29,2025-05-25T00:58:00+02:00,2025-05-25,08:58,1,3,4
29,2025-05-25T00:59:00+02:00,2025-05-25,08:59,1,3,4
29,2025-05-25T01:00:00+02:00,2025-05-25,09:00,1,4,5
31,2025-05-25T01:01:00+02:00,2025-05-25,09:01,2,0,2
31,2025-05-25T01:09:00+02:00,2025-05-25,09:09,1,1,2
36,2025-05-25T00:55:00+02:00,2025-05-25,08:55,2,2,4
36,2025-05-25T00:57:00+02:00,2025-05-25,08:57,3,0,3
36,2025-05-25T01:00:00+02:00,2025-05-25,09:00,1,0,1
36,2025-05-25T01:03:00+02:00,2025-05-25,09:03,1,0,1
36,2025-05-25T01:04:00+02:00,2025-05-25,09:04,0,2,2
37,2025-05-25T00:55:00+02:00,2025-05-25,08:55,1,0,1
37,2025-05-25T01:06:00+02:00,2025-05-25,09:06,0,1,1
37,2025-05-25T01:07:00+02:00,2025-05-25,09:07,1,2,3
39,2025-05-25T01:02:00+02:00,2025-05-25,09:02,2,0,2
40,2025-05-25T00:59:00+02:00,2025-05-25,08:59,6,0,6
41,2025-05-25T01:02:00+02:00,2025-05-25,09:02,1,3,4
41,2025-05-25T01:03:00+02:00,2025-05-25,09:03,2,1,3
41,2025-05-25T01:05:00+02:00,2025-05-25,09:05,0,2,2
43,2025-05-25T01:00:00+02:00,2025-05-25,09:00,0,2,2
43,2025-05-25T01:05:00+02:00,2025-05-25,09:05,2,0,2
44,2025-05-25T00:55:00+02:00,2025-05-25,08:55,2,0,2
44,2025-05-25T01:00:00+02:00,2025-05-25,09:00,1,1,2
45,2025-05-25T00:56:00+02:00,2025-05-25,08:56,0,3,3
45,2025-05-25T00:58:00+02:00,2025-05-25,08:58,3,1,4
45,2025-05-25T01:04:00+02:00,2025-05-25,09:04,6,2,8
45,2025-05-25T01:05:00+02:00,2025-05-25,09:05,2,5,7
45,2025-05-25T01:07:00+02:00,2025-05-25,09:07,1,4,5
47,2025-05-25T00:55:00+02:00,2025-05-25,08:55,3,9,12
47,2025-05-25T00:58:00+02:00,2025-05-25,08:58,3,3,6
47,2025-05-25T00:59:00+02:00,2025-05-25,08:59,4,9,13
47,2025-05-25T01:01:00+02:00,2025-05-25,09:01,2,3,5
47,2025-05-25T01:04:00+02:00,2025-05-25,09:04,0,3,3
50,2025-05-25T00:56:00+02:00,2025-05-25,08:56,0,2,2
50,2025-05-25T00:59:00+02:00,2025-05-25,08:59,1,0,1
54,2025-05-25T00:56:00+02:00,2025-05-25,08:56,2,0,2
54,2025-05-25T01:04:00+02:00,2025-05-25,09:04,0,1,1
54,2025-05-25T01:05:00+02:00,2025-05-25,09:05,1,0,1
54,2025-05-25T01:06:00+02:00,2025-05-25,09:06,0,2,2
59,2025-05-25T00:55:00+02:00,2025-05-25,08:55,1,10,11
59,2025-05-25T01:00:00+02:00,2025-05-25,09:00,5,10,15
61,2025-05-25T00:55:00+02:00,2025-05-25,08:55,0,2,2
61,2025-05-25T00:58:00+02:00,2025-05-25,08:58,0,2,2
61,2025-05-25T00:59:00+02:00,2025-05-25,08:59,2,3,5
61,2025-05-25T01:03:00+02:00,2025-05-25,09:03,1,4,5
61,2025-05-25T01:04:00+02:00,2025-05-25,09:04,0,3,3
61,2025-05-25T01:08:00+02:00,2025-05-25,09:08,2,2,4
66,2025-05-25T00:57:00+02:00,2025-05-25,08:57,3,1,4
66,2025-05-25T01:00:00+02:00,2025-05-25,09:00,0,2,2
66,2025-05-25T01:01:00+02:00,2025-05-25,09:01,0,1,1
66,2025-05-25T01:04:00+02:00,2025-05-25,09:04,0,4,4
69,2025-05-25T00:56:00+02:00,2025-05-25,08:56,4,6,10
69,2025-05-25T01:00:00+02:00,2025-05-25,09:00,8,1,9
69,2025-05-25T01:01:00+02:00,2025-05-25,09:01,6,2,8
69,2025-05-25T01:03:00+02:00,2025-05-25,09:03,2,0,2
69,2025-05-25T01:05:00+02:00,2025-05-25,09:05,3,2,5
70,2025-05-25T00:55:00+02:00,2025-05-25,08:55,1,2,3
70,2025-05-25T00:56:00+02:00,2025-05-25,08:56,1,0,1
70,2025-05-25T00:57:00+02:00,2025-05-25,08:57,1,0,1
70,2025-05-25T00:58:00+02:00,2025-05-25,08:58,2,1,3
70,2025-05-25T00:59:00+02:00,2025-05-25,08:59,1,0,1
70,2025-05-25T01:07:00+02:00,2025-05-25,09:07,1,0,1
70,2025-05-25T01:09:00+02:00,2025-05-25,09:09,1,0,1
75,2025-05-25T00:56:00+02:00,2025-05-25,08:56,1,1,2
75,2025-05-25T00:57:00+02:00,2025-05-25,08:57,1,4,5
75,2025-05-25T01:00:00+02:00,2025-05-25,09:00,0,3,3
77,2025-05-25T00:55:00+02:00,2025-05-25,08:55,9,17,26
77,2025-05-25T01:00:00+02:00,2025-05-25,09:00,14,12,26
77,2025-05-25T01:05:00+02:00,2025-05-25,09:05,4,9,13
78,2025-05-25T00:57:00+02:00,2025-05-25,08:57,0,3,3
78,2025-05-25T01:06:00+02:00,2025-05-25,09:06,0,1,1
84,2025-05-25T00:55:00+02:00,2025-05-25,08:55,30,14,44
84,2025-05-25T01:05:00+02:00,2025-05-25,09:05,35,16,51
87,2025-05-25T00:58:00+02:00,2025-05-25,08:58,1,2,3
87,2025-05-25T01:01:00+02:00,2025-05-25,09:01,0,2,2
87,2025-05-25T01:02:00+02:00,2025-05-25,09:02,1,1,2
87,2025-05-25T01:09:00+02:00,2025-05-25,09:09,0,1,1
107,2025-05-25T00:55:00+02:00,2025-05-25,08:55,3,13,16
107,2025-05-25T01:05:00+02:00,2025-05-25,09:05,6,7,13
108,2025-05-25T00:55:00+02:00,2025-05-25,08:55,2,1,3
108,2025-05-25T00:57:00+02:00,2025-05-25,08:57,4,0,4
108,2025-05-25T00:59:00+02:00,2025-05-25,08:59,2,1,3
108,2025-05-25T01:00:00+02:00,2025-05-25,09:00,2,2,4
108,2025-05-25T01:03:00+02:00,2025-05-25,09:03,1,0,1
108,2025-05-25T01:05:00+02:00,2025-05-25,09:05,9,1,10
108,2025-05-25T01:07:00+02:00,2025-05-25,09:07,3,0,3
118,2025-05-25T01:05:00+02:00,2025-05-25,09:05,4,3,7
124,2025-05-25T01:00:00+02:00,2025-05-25,09:00,0,1,1
131,2025-05-25T01:05:00+02:00,2025-05-25,09:05,4,7,11
132,2025-05-25T01:00:00+02:00,2025-05-25,09:00,13,1,14
133,2025-05-25T01:00:00+02:00,2025-05-25,09:00,32,27,59
134,2025-05-25T00:55:00+02:00,2025-05-25,08:55,19,12,31
134,2025-05-25T01:05:00+02:00,2025-05-25,09:05,12,16,28
167,2025-05-25T00:55:00+02:00,2025-05-25,08:55,0,3,3
167,2025-05-25T01:05:00+02:00,2025-05-25,09:05,6,3,9
1,2025-05-25T00:56:00+02:00,2025-05-25,08:56,2,2,4
1,2025-05-25T01:00:00+02:00,2025-05-25,09:00,2,1,3
1,2025-05-25T01:02:00+02:00,2025-05-25,09:02,2,4,6
1,2025-05-25T01:05:00+02:00,2025-05-25,09:05,1,2,3
1,2025-05-25T01:06:00+02:00,2025-05-25,09:06,2,0,2
1,2025-05-25T01:07:00+02:00,2025-05-25,09:07,1,0,1
1,2025-05-25T01:08:00+02:00,2025-05-25,09:08,1,4,5
2,2025-05-25T00:56:00+02:00,2025-05-25,08:56,0,1,1
2,2025-05-25T00:59:00+02:00,2025-05-25,08:59,0,3,3
2,2025-05-25T01:01:00+02:00,2025-05-25,09:01,0,4,4
9,2025-05-25T00:57:00+02:00,2025-05-25,08:57,0,1,1
9,2025-05-25T00:59:00+02:00,2025-05-25,08:59,0,1,1
9,2025-05-25T01:01:00+02:00,2025-05-25,09:01,1,0,1
10,2025-05-25T00:57:00+02:00,2025-05-25,08:57,0,1,1
10,2025-05-25T00:58:00+02:00,2025-05-25,08:58,1,0,1
10,2025-05-25T00:59:00+02:00,2025-05-25,08:59,0,1,1
10,2025-05-25T01:02:00+02:00,2025-05-25,09:02,0,3,3
11,2025-05-25T00:59:00+02:00,2025-05-25,08:59,0,2,2
11,2025-05-25T01:04:00+02:00,2025-05-25,09:04,0,1,1
11,2025-05-25T01:08:00+02:00,2025-05-25,09:08,3,0,3
12,2025-05-25T01:07:00+02:00,2025-05-25,09:07,1,1,2
12,2025-05-25T01:08:00+02:00,2025-05-25,09:08,2,1,3
12,2025-05-25T01:09:00+02:00,2025-05-25,09:09,2,4,6
17,2025-05-25T00:55:00+02:00,2025-05-25,08:55,0,1,1
17,2025-05-25T01:01:00+02:00,2025-05-25,09:01,1,1,2
17,2025-05-25T01:03:00+02:00,2025-05-25,09:03,2,0,2
17,2025-05-25T01:09:00+02:00,2025-05-25,09:09,0,1,1
18,2025-05-25T00:56:00+02:00,2025-05-25,08:56,0,2,2
18,2025-05-25T00:59:00+02:00,2025-05-25,08:59,1,0,1
18,2025-05-25T01:00:00+02:00,2025-05-25,09:00,1,0,1
18,2025-05-25T01:02:00+02:00,2025-05-25,09:02,1,0,1
18,2025-05-25T01:08:00+02:00,2025-05-25,09:08,1,0,1
18,2025-05-25T01:09:00+02:00,2025-05-25,09:09,0,1,1
19,2025-05-25T01:00:00+02:00,2025-05-25,09:00,5,0,5
19,2025-05-25T01:05:00+02:00,2025-05-25,09:05,0,1,1
23,2025-05-25T01:00:00+02:00,2025-05-25,09:00,4,3,7
23,2025-05-25T01:02:00+02:00,2025-05-25,09:02,0,9,9
23,2025-05-25T01:03:00+02:00,2025-05-25,09:03,3,0,3
23,2025-05-25T01:05:00+02:00,2025-05-25,09:05,0,1,1
23,2025-05-25T01:07:00+02:00,2025-05-25,09:07,4,4,8
23,2025-05-25T01:08:00+02:00,2025-05-25,09:08,1,2,3
24,2025-05-25T00:55:00+02:00,2025-05-25,08:55,2,6,8
24,2025-05-25T00:56:00+02:00,2025-05-25,08:56,2,0,2
24,2025-05-25T00:58:00+02:00,2025-05-25,08:58,9,2,11
24,2025-05-25T01:03:00+02:00,2025-05-25,09:03,6,5,11
24,2025-05-25T01:05:00+02:00,2025-05-25,09:05,3,9,12
24,2025-05-25T01:06:00+02:00,2025-05-25,09:06,6,3,9
24,2025-05-25T01:08:00+02:00,2025-05-25,09:08,1,1,2
25,2025-05-25T01:00:00+02:00,2025-05-25,09:00,18,25,43
27,2025-05-25T01:00:00+02:00,2025-05-25,09:00,1,6,7
27,2025-05-25T01:01:00+02:00,2025-05-25,09:01,2,0,2
27,2025-05-25T01:02:00+02:00,2025-05-25,09:02,1,4,5
27,2025-05-25T01:04:00+02:00,2025-05-25,09:04,0,3,3
27,2025-05-25T01:06:00+02:00,2025-05-25,09:06,5,8,13
27,2025-05-25T01:07:00+02:00,2025-05-25,09:07,1,3,4
27,2025-05-25T01:08:00+02:00,2025-05-25,09:08,3,6,9
30,2025-05-25T01:02:00+02:00,2025-05-25,09:02,3,2,5
30,2025-05-25T01:03:00+02:00,2025-05-25,09:03,1,1,2
30,2025-05-25T01:06:00+02:00,2025-05-25,09:06,0,2,2
30,2025-05-25T01:08:00+02:00,2025-05-25,09:08,0,3,3
30,2025-05-25T01:09:00+02:00,2025-05-25,09:09,2,0,2
35,2025-05-25T00:55:00+02:00,2025-05-25,08:55,9,12,21
35,2025-05-25T00:59:00+02:00,2025-05-25,08:59,4,2,6
35,2025-05-25T01:00:00+02:00,2025-05-25,09:00,7,5,12
35,2025-05-25T01:02:00+02:00,2025-05-25,09:02,8,6,14
35,2025-05-25T01:04:00+02:00,2025-05-25,09:04,8,6,14
35,2025-05-25T01:07:00+02:00,2025-05-25,09:07,14,8,22
35,2025-05-25T01:09:00+02:00,2025-05-25,09:09,19,6,25
48,2025-05-25T00:58:00+02:00,2025-05-25,08:58,2,3,5
49,2025-05-25T00:56:00+02:00,2025-05-25,08:56,3,3,6
49,2025-05-25T00:57:00+02:00,2025-05-25,08:57,2,6,8
49,2025-05-25T00:58:00+02:00,2025-05-25,08:58,4,4,8
49,2025-05-25T01:03:00+02:00,2025-05-25,09:03,6,4,10
49,2025-05-25T01:05:00+02:00,2025-05-25,09:05,7,5,12
49,2025-05-25T01:06:00+02:00,2025-05-25,09:06,2,3,5
51,2025-05-25T00:55:00+02:00,2025-05-25,08:55,1,0,1
51,2025-05-25T01:00:00+02:00,2025-05-25,09:00,1,0,1
51,2025-05-25T01:01:00+02:00,2025-05-25,09:01,0,1,1
51,2025-05-25T01:04:00+02:00,2025-05-25,09:04,1,3,4
51,2025-05-25T01:06:00+02:00,2025-05-25,09:06,1,1,2
51,2025-05-25T01:07:00+02:00,2025-05-25,09:07,5,1,6
51,2025-05-25T01:08:00+02:00,2025-05-25,09:08,0,4,4
51,2025-05-25T01:09:00+02:00,2025-05-25,09:09,0,1,1
52,2025-05-25T00:56:00+02:00,2025-05-25,08:56,2,0,2
52,2025-05-25T00:57:00+02:00,2025-05-25,08:57,3,1,4
52,2025-05-25T01:02:00+02:00,2025-05-25,09:02,1,2,3
52,2025-05-25T01:03:00+02:00,2025-05-25,09:03,2,1,3
52,2025-05-25T01:04:00+02:00,2025-05-25,09:04,0,4,4
53,2025-05-25T00:57:00+02:00,2025-05-25,08:57,1,1,2
53,2025-05-25T01:03:00+02:00,2025-05-25,09:03,3,2,5
53,2025-05-25T01:05:00+02:00,2025-05-25,09:05,1,0,1
56,2025-05-25T01:06:00+02:00,2025-05-25,09:06,2,3,5
56,2025-05-25T01:08:00+02:00,2025-05-25,09:08,0,1,1
58,2025-05-25T00:56:00+02:00,2025-05-25,08:56,5,7,12
58,2025-05-25T00:57:00+02:00,2025-05-25,08:57,1,2,3
58,2025-05-25T01:04:00+02:00,2025-05-25,09:04,4,1,5
58,2025-05-25T01:05:00+02:00,2025-05-25,09:05,3,0,3
58,2025-05-25T01:08:00+02:00,2025-05-25,09:08,4,3,7
62,2025-05-25T00:57:00+02:00,2025-05-25,08:57,0,2,2
62,2025-05-25T01:00:00+02:00,2025-05-25,09:00,0,1,1
62,2025-05-25T01:05:00+02:00,2025-05-25,09:05,1,1,2
62,2025-05-25T01:07:00+02:00,2025-05-25,09:07,1,0,1
62,2025-05-25T01:08:00+02:00,2025-05-25,09:08,1,1,2
63,2025-05-25T00:56:00+02:00,2025-05-25,08:56,1,0,1
63,2025-05-25T01:00:00+02:00,2025-05-25,09:00,1,1,2
63,2025-05-25T01:04:00+02:00,2025-05-25,09:04,0,1,1
63,2025-05-25T01:05:00+02:00,2025-05-25,09:05,0,3,3
63,2025-05-25T01:08:00+02:00,2025-05-25,09:08,1,4,5
67,2025-05-25T00:56:00+02:00,2025-05-25,08:56,2,1,3
67,2025-05-25T00:59:00+02:00,2025-05-25,08:59,0,3,3
67,2025-05-25T01:00:00+02:00,2025-05-25,09:00,5,2,7
67,2025-05-25T01:09:00+02:00,2025-05-25,09:09,1,4,5
68,2025-05-25T00:59:00+02:00,2025-05-25,08:59,2,4,6
68,2025-05-25T01:01:00+02:00,2025-05-25,09:01,6,2,8
68,2025-05-25T01:07:00+02:00,2025-05-25,09:07,1,1,2
72,2025-05-25T00:55:00+02:00,2025-05-25,08:55,1,1,2
72,2025-05-25T00:59:00+02:00,2025-05-25,08:59,2,0,2
72,2025-05-25T01:00:00+02:00,2025-05-25,09:00,0,1,1
72,2025-05-25T01:03:00+02:00,2025-05-25,09:03,1,2,3
72,2025-05-25T01:04:00+02:00,2025-05-25,09:04,1,2,3
72,2025-05-25T01:05:00+02:00,2025-05-25,09:05,0,3,3
72,2025-05-25T01:07:00+02:00,2025-05-25,09:07,0,3,3
72,2025-05-25T01:08:00+02:00,2025-05-25,09:08,2,2,4
76,2025-05-25T00:55:00+02:00,2025-05-25,08:55,2,0,2
76,2025-05-25T00:57:00+02:00,2025-05-25,08:57,0,2,2
76,2025-05-25T01:00:00+02:00,2025-05-25,09:00,0,1,1
76,2025-05-25T01:02:00+02:00,2025-05-25,09:02,1,0,1
76,2025-05-25T01:07:00+02:00,2025-05-25,09:07,1,0,1
76,2025-05-25T01:08:00+02:00,2025-05-25,09:08,0,1,1
79,2025-05-25T00:55:00+02:00,2025-05-25,08:55,3,0,3
79,2025-05-25T01:08:00+02:00,2025-05-25,09:08,4,1,5
85,2025-05-25T00:58:00+02:00,2025-05-25,08:58,1,4,5
85,2025-05-25T01:06:00+02:00,2025-05-25,09:06,0,1,1
85,2025-05-25T01:09:00+02:00,2025-05-25,09:09,1,0,1
86,2025-05-25T00:56:00+02:00,2025-05-25,08:56,2,1,3
86,2025-05-25T00:57:00+02:00,2025-05-25,08:57,3,0,3
86,2025-05-25T01:05:00+02:00,2025-05-25,09:05,1,1,2
86,2025-05-25T01:07:00+02:00,2025-05-25,09:07,1,0,1
86,2025-05-25T01:08:00+02:00,2025-05-25,09:08,2,1,3
109,2025-05-25T00:55:00+02:00,2025-05-25,08:55,5,3,8
130,2025-05-25T01:05:00+02:00,2025-05-25,09:05,4,6,10
136,2025-05-25T00:55:00+02:00,2025-05-25,08:55,8,10,18
137,2025-05-25T01:00:00+02:00,2025-05-25,09:00,2,3,5
142,2025-05-25T00:55:00+02:00,2025-05-25,08:55,37,22,59
164,2025-05-25T01:05:00+02:00,2025-05-25,09:05,6,1,7
181,2025-05-25T00:59:00+02:00,2025-05-25,08:59,4,5,9
181,2025-05-25T01:00:00+02:00,2025-05-25,09:00,7,1,8
181,2025-05-25T01:03:00+02:00,2025-05-25,09:03,2,7,9
181,2025-05-25T01:05:00+02:00,2025-05-25,09:05,6,8,14
181,2025-05-25T01:07:00+02:00,2025-05-25,09:07,2,8,10
180,2025-05-25T00:55:00+02:00,2025-05-25,08:55,1,0,1
3,2025-05-25T01:11:00+02:00,2025-05-25,09:11,1,0,1
3,2025-05-25T01:12:00+02:00,2025-05-25,09:12,1,0,1
3,2025-05-25T01:15:00+02:00,2025-05-25,09:15,0,2,2
3,2025-05-25T01:16:00+02:00,2025-05-25,09:16,4,3,7
3,2025-05-25T01:17:00+02:00,2025-05-25,09:17,4,3,7
3,2025-05-25T01:23:00+02:00,2025-05-25,09:23,2,7,9
4,2025-05-25T01:13:00+02:00,2025-05-25,09:13,4,0,4
4,2025-05-25T01:14:00+02:00,2025-05-25,09:14,8,3,11
4,2025-05-25T01:15:00+02:00,2025-05-25,09:15,0,7,7
4,2025-05-25T01:18:00+02:00,2025-05-25,09:18,8,7,15
4,2025-05-25T01:21:00+02:00,2025-05-25,09:21,6,3,9
4,2025-05-25T01:23:00+02:00,2025-05-25,09:23,7,6,13
6,2025-05-25T01:13:00+02:00,2025-05-25,09:13,11,6,17
6,2025-05-25T01:15:00+02:00,2025-05-25,09:15,4,4,8
6,2025-05-25T01:19:00+02:00,2025-05-25,09:19,3,1,4
6,2025-05-25T01:22:00+02:00,2025-05-25,09:22,13,2,15
6,2025-05-25T01:23:00+02:00,2025-05-25,09:23,5,3,8
6,2025-05-25T01:24:00+02:00,2025-05-25,09:24,5,4,9
8,2025-05-25T01:11:00+02:00,2025-05-25,09:11,0,2,2
8,2025-05-25T01:12:00+02:00,2025-05-25,09:12,2,6,8
8,2025-05-25T01:15:00+02:00,2025-05-25,09:15,1,1,2
8,2025-05-25T01:17:00+02:00,2025-05-25,09:17,1,3,4
8,2025-05-25T01:19:00+02:00,2025-05-25,09:19,3,0,3
8,2025-05-25T01:21:00+02:00,2025-05-25,09:21,4,2,6
8,2025-05-25T01:23:00+02:00,2025-05-25,09:23,1,4,5
8,2025-05-25T01:24:00+02:00,2025-05-25,09:24,1,3,4
28,2025-05-25T01:12:00+02:00,2025-05-25,09:12,3,1,4
28,2025-05-25T01:22:00+02:00,2025-05-25,09:22,2,2,4
28,2025-05-25T01:23:00+02:00,2025-05-25,09:23,2,1,3
29,2025-05-25T01:15:00+02:00,2025-05-25,09:15,2,7,9
29,2025-05-25T01:16:00+02:00,2025-05-25,09:16,3,2,5
29,2025-05-25T01:19:00+02:00,2025-05-25,09:19,3,4,7
29,2025-05-25T01:20:00+02:00,2025-05-25,09:20,2,4,6
29,2025-05-25T01:22:00+02:00,2025-05-25,09:22,4,5,9
31,2025-05-25T01:10:00+02:00,2025-05-25,09:10,0,1,1
31,2025-05-25T01:13:00+02:00,2025-05-25,09:13,2,0,2
31,2025-05-25T01:14:00+02:00,2025-05-25,09:14,1,0,1
31,2025-05-25T01:21:00+02:00,2025-05-25,09:21,1,0,1
36,2025-05-25T01:10:00+02:00,2025-05-25,09:10,2,3,5
36,2025-05-25T01:12:00+02:00,2025-05-25,09:12,5,0,5
36,2025-05-25T01:13:00+02:00,2025-05-25,09:13,2,0,2
36,2025-05-25T01:20:00+02:00,2025-05-25,09:20,1,0,1
36,2025-05-25T01:21:00+02:00,2025-05-25,09:21,4,0,4
37,2025-05-25T01:17:00+02:00,2025-05-25,09:17,1,0,1
37,2025-05-25T01:20:00+02:00,2025-05-25,09:20,1,2,3
37,2025-05-25T01:21:00+02:00,2025-05-25,09:21,0,2,2
39,2025-05-25T01:16:00+02:00,2025-05-25,09:16,0,1,1
39,2025-05-25T01:18:00+02:00,2025-05-25,09:18,3,0,3
39,2025-05-25T01:23:00+02:00,2025-05-25,09:23,2,0,2
39,2025-05-25T01:24:00+02:00,2025-05-25,09:24,1,0,1
40,2025-05-25T01:11:00+02:00,2025-05-25,09:11,2,0,2
40,2025-05-25T01:12:00+02:00,2025-05-25,09:12,0,2,2
40,2025-05-25T01:16:00+02:00,2025-05-25,09:16,2,1,3
40,2025-05-25T01:18:00+02:00,2025-05-25,09:18,2,3,5
40,2025-05-25T01:19:00+02:00,2025-05-25,09:19,4,0,4
40,2025-05-25T01:20:00+02:00,2025-05-25,09:20,1,1,2
41,2025-05-25T01:10:00+02:00,2025-05-25,09:10,3,4,7
41,2025-05-25T01:22:00+02:00,2025-05-25,09:22,1,2,3
41,2025-05-25T01:24:00+02:00,2025-05-25,09:24,1,1,2
43,2025-05-25T01:10:00+02:00,2025-05-25,09:10,2,1,3
44,2025-05-25T01:15:00+02:00,2025-05-25,09:15,0,3,3
45,2025-05-25T01:17:00+02:00,2025-05-25,09:17,15,0,15
45,2025-05-25T01:18:00+02:00,2025-05-25,09:18,3,3,6
45,2025-05-25T01:20:00+02:00,2025-05-25,09:20,2,2,4
45,2025-05-25T01:22:00+02:00,2025-05-25,09:22,5,2,7
47,2025-05-25T01:12:00+02:00,2025-05-25,09:12,0,3,3
47,2025-05-25T01:16:00+02:00,2025-05-25,09:16,4,3,7
47,2025-05-25T01:19:00+02:00,2025-05-25,09:19,7,10,17
50,2025-05-25T01:10:00+02:00,2025-05-25,09:10,0,3,3
50,2025-05-25T01:13:00+02:00,2025-05-25,09:13,1,1,2
50,2025-05-25T01:16:00+02:00,2025-05-25,09:16,1,1,2
54,2025-05-25T01:13:00+02:00,2025-05-25,09:13,0,1,1
54,2025-05-25T01:18:00+02:00,2025-05-25,09:18,0,1,1
54,2025-05-25T01:19:00+02:00,2025-05-25,09:19,1,1,2
54,2025-05-25T01:23:00+02:00,2025-05-25,09:23,2,0,2
54,2025-05-25T01:24:00+02:00,2025-05-25,09:24,1,1,2
59,2025-05-25T01:10:00+02:00,2025-05-25,09:10,5,9,14
61,2025-05-25T01:12:00+02:00,2025-05-25,09:12,2,5,7
61,2025-05-25T01:13:00+02:00,2025-05-25,09:13,0,2,2
61,2025-05-25T01:14:00+02:00,2025-05-25,09:14,3,3,6
61,2025-05-25T01:17:00+02:00,2025-05-25,09:17,0,3,3
61,2025-05-25T01:20:00+02:00,2025-05-25,09:20,8,2,10
61,2025-05-25T01:22:00+02:00,2025-05-25,09:22,2,1,3
66,2025-05-25T01:12:00+02:00,2025-05-25,09:12,7,6,13
66,2025-05-25T01:16:00+02:00,2025-05-25,09:16,3,2,5
66,2025-05-25T01:20:00+02:00,2025-05-25,09:20,7,4,11
69,2025-05-25T01:10:00+02:00,2025-05-25,09:10,0,3,3
69,2025-05-25T01:13:00+02:00,2025-05-25,09:13,1,0,1
69,2025-05-25T01:14:00+02:00,2025-05-25,09:14,0,2,2
69,2025-05-25T01:18:00+02:00,2025-05-25,09:18,3,0,3
69,2025-05-25T01:20:00+02:00,2025-05-25,09:20,1,0,1
70,2025-05-25T01:14:00+02:00,2025-05-25,09:14,0,1,1
70,2025-05-25T01:18:00+02:00,2025-05-25,09:18,0,1,1
70,2025-05-25T01:19:00+02:00,2025-05-25,09:19,2,0,2
75,2025-05-25T01:14:00+02:00,2025-05-25,09:14,1,0,1
75,2025-05-25T01:20:00+02:00,2025-05-25,09:20,3,0,3
75,2025-05-25T01:23:00+02:00,2025-05-25,09:23,1,0,1
77,2025-05-25T01:10:00+02:00,2025-05-25,09:10,11,7,18
78,2025-05-25T01:11:00+02:00,2025-05-25,09:11,1,0,1
78,2025-05-25T01:13:00+02:00,2025-05-25,09:13,0,1,1
78,2025-05-25T01:15:00+02:00,2025-05-25,09:15,0,1,1
78,2025-05-25T01:16:00+02:00,2025-05-25,09:16,1,7,8
78,2025-05-25T01:21:00+02:00,2025-05-25,09:21,0,1,1
87,2025-05-25T01:10:00+02:00,2025-05-25,09:10,1,0,1
87,2025-05-25T01:18:00+02:00,2025-05-25,09:18,2,0,2
87,2025-05-25T01:19:00+02:00,2025-05-25,09:19,0,1,1
87,2025-05-25T01:20:00+02:00,2025-05-25,09:20,1,1,2
87,2025-05-25T01:22:00+02:00,2025-05-25,09:22,3,0,3
108,2025-05-25T01:12:00+02:00,2025-05-25,09:12,1,3,4
108,2025-05-25T01:15:00+02:00,2025-05-25,09:15,2,4,6
108,2025-05-25T01:21:00+02:00,2025-05-25,09:21,6,2,8
108,2025-05-25T01:22:00+02:00,2025-05-25,09:22,2,3,5
108,2025-05-25T01:24:00+02:00,2025-05-25,09:24,2,4,6
133,2025-05-25T01:15:00+02:00,2025-05-25,09:15,26,34,60
134,2025-05-25T01:15:00+02:00,2025-05-25,09:15,23,11,34
135,2025-05-25T01:15:00+02:00,2025-05-25,09:15,22,11,33
162,2025-05-25T01:10:00+02:00,2025-05-25,09:10,20,14,34
179,2025-05-25T01:15:00+02:00,2025-05-25,09:15,4,2,6
179,2025-05-25T01:20:00+02:00,2025-05-25,09:20,1,1,2
1,2025-05-25T01:12:00+02:00,2025-05-25,09:12,1,2,3
1,2025-05-25T01:18:00+02:00,2025-05-25,09:18,1,2,3
1,2025-05-25T01:19:00+02:00,2025-05-25,09:19,5,0,5
1,2025-05-25T01:20:00+02:00,2025-05-25,09:20,2,1,3
2,2025-05-25T01:11:00+02:00,2025-05-25,09:11,3,3,6
2,2025-05-25T01:12:00+02:00,2025-05-25,09:12,0,5,5
2,2025-05-25T01:13:00+02:00,2025-05-25,09:13,3,3,6
2,2025-05-25T01:17:00+02:00,2025-05-25,09:17,4,4,8
2,2025-05-25T01:20:00+02:00,2025-05-25,09:20,1,0,1
2,2025-05-25T01:21:00+02:00,2025-05-25,09:21,1,0,1
2,2025-05-25T01:22:00+02:00,2025-05-25,09:22,0,9,9
9,2025-05-25T01:11:00+02:00,2025-05-25,09:11,0,1,1
9,2025-05-25T01:14:00+02:00,2025-05-25,09:14,0,1,1
9,2025-05-25T01:23:00+02:00,2025-05-25,09:23,1,0,1
9,2025-05-25T01:24:00+02:00,2025-05-25,09:24,2,0,2
10,2025-05-25T01:13:00+02:00,2025-05-25,09:13,1,0,1
10,2025-05-25T01:22:00+02:00,2025-05-25,09:22,1,2,3
10,2025-05-25T01:23:00+02:00,2025-05-25,09:23,1,0,1
11,2025-05-25T01:10:00+02:00,2025-05-25,09:10,3,1,4
11,2025-05-25T01:13:00+02:00,2025-05-25,09:13,2,0,2
11,2025-05-25T01:16:00+02:00,2025-05-25,09:16,0,1,1
12,2025-05-25T01:12:00+02:00,2025-05-25,09:12,0,1,1
12,2025-05-25T01:17:00+02:00,2025-05-25,09:17,3,2,5
12,2025-05-25T01:18:00+02:00,2025-05-25,09:18,4,1,5
12,2025-05-25T01:24:00+02:00,2025-05-25,09:24,4,5,9
17,2025-05-25T01:13:00+02:00,2025-05-25,09:13,5,6,11
17,2025-05-25T01:15:00+02:00,2025-05-25,09:15,1,6,7
17,2025-05-25T01:17:00+02:00,2025-05-25,09:17,1,2,3
17,2025-05-25T01:19:00+02:00,2025-05-25,09:19,0,1,1
17,2025-05-25T01:20:00+02:00,2025-05-25,09:20,1,0,1
18,2025-05-25T01:10:00+02:00,2025-05-25,09:10,2,0,2
18,2025-05-25T01:11:00+02:00,2025-05-25,09:11,1,1,2
18,2025-05-25T01:16:00+02:00,2025-05-25,09:16,0,2,2
18,2025-05-25T01:20:00+02:00,2025-05-25,09:20,0,2,2
19,2025-05-25T01:12:00+02:00,2025-05-25,09:12,2,5,7
19,2025-05-25T01:16:00+02:00,2025-05-25,09:16,4,0,4
19,2025-05-25T01:17:00+02:00,2025-05-25,09:17,1,1,2
20,2025-05-25T01:13:00+02:00,2025-05-25,09:13,0,1,1
23,2025-05-25T01:10:00+02:00,2025-05-25,09:10,2,7,9
23,2025-05-25T01:16:00+02:00,2025-05-25,09:16,5,3,8
23,2025-05-25T01:17:00+02:00,2025-05-25,09:17,1,0,1
23,2025-05-25T01:20:00+02:00,2025-05-25,09:20,2,4,6
23,2025-05-25T01:23:00+02:00,2025-05-25,09:23,0,1,1
24,2025-05-25T01:11:00+02:00,2025-05-25,09:11,0,7,7
24,2025-05-25T01:12:00+02:00,2025-05-25,09:12,1,1,2
24,2025-05-25T01:16:00+02:00,2025-05-25,09:16,5,1,6
24,2025-05-25T01:19:00+02:00,2025-05-25,09:19,5,1,6
24,2025-05-25T01:20:00+02:00,2025-05-25,09:20,8,0,8
24,2025-05-25T01:23:00+02:00,2025-05-25,09:23,0,2,2
24,2025-05-25T01:24:00+02:00,2025-05-25,09:24,3,4,7
25,2025-05-25T01:10:00+02:00,2025-05-25,09:10,26,32,58
25,2025-05-25T01:15:00+02:00,2025-05-25,09:15,26,31,57
27,2025-05-25T01:15:00+02:00,2025-05-25,09:15,3,1,4
27,2025-05-25T01:16:00+02:00,2025-05-25,09:16,2,6,8
27,2025-05-25T01:17:00+02:00,2025-05-25,09:17,3,2,5
27,2025-05-25T01:23:00+02:00,2025-05-25,09:23,6,5,11
30,2025-05-25T01:12:00+02:00,2025-05-25,09:12,2,3,5
30,2025-05-25T01:20:00+02:00,2025-05-25,09:20,2,1,3
30,2025-05-25T01:22:00+02:00,2025-05-25,09:22,0,1,1
35,2025-05-25T01:16:00+02:00,2025-05-25,09:16,18,19,37
35,2025-05-25T01:18:00+02:00,2025-05-25,09:18,5,3,8
35,2025-05-25T01:21:00+02:00,2025-05-25,09:21,6,12,18
35,2025-05-25T01:22:00+02:00,2025-05-25,09:22,6,3,9
48,2025-05-25T01:10:00+02:00,2025-05-25,09:10,2,0,2
48,2025-05-25T01:13:00+02:00,2025-05-25,09:13,0,9,9
48,2025-05-25T01:14:00+02:00,2025-05-25,09:14,2,3,5
48,2025-05-25T01:15:00+02:00,2025-05-25,09:15,5,11,16
48,2025-05-25T01:16:00+02:00,2025-05-25,09:16,0,1,1
48,2025-05-25T01:17:00+02:00,2025-05-25,09:17,4,2,6
48,2025-05-25T01:19:00+02:00,2025-05-25,09:19,5,2,7
48,2025-05-25T01:24:00+02:00,2025-05-25,09:24,2,2,4
49,2025-05-25T01:11:00+02:00,2025-05-25,09:11,5,2,7
49,2025-05-25T01:15:00+02:00,2025-05-25,09:15,2,1,3
49,2025-05-25T01:16:00+02:00,2025-05-25,09:16,1,2,3
49,2025-05-25T01:17:00+02:00,2025-05-25,09:17,4,4,8
49,2025-05-25T01:19:00+02:00,2025-05-25,09:19,2,4,6
49,2025-05-25T01:22:00+02:00,2025-05-25,09:22,6,1,7
49,2025-05-25T01:24:00+02:00,2025-05-25,09:24,8,1,9
51,2025-05-25T01:19:00+02:00,2025-05-25,09:19,1,2,3
51,2025-05-25T01:20:00+02:00,2025-05-25,09:20,1,0,1
52,2025-05-25T01:11:00+02:00,2025-05-25,09:11,1,0,1
52,2025-05-25T01:12:00+02:00,2025-05-25,09:12,0,1,1
52,2025-05-25T01:16:00+02:00,2025-05-25,09:16,0,1,1
52,2025-05-25T01:19:00+02:00,2025-05-25,09:19,1,0,1
52,2025-05-25T01:24:00+02:00,2025-05-25,09:24,2,1,3
53,2025-05-25T01:15:00+02:00,2025-05-25,09:15,4,0,4
53,2025-05-25T01:19:00+02:00,2025-05-25,09:19,1,0,1
53,2025-05-25T01:22:00+02:00,2025-05-25,09:22,5,6,11
53,2025-05-25T01:23:00+02:00,2025-05-25,09:23,5,0,5
56,2025-05-25T01:11:00+02:00,2025-05-25,09:11,1,3,4
56,2025-05-25T01:12:00+02:00,2025-05-25,09:12,1,2,3
56,2025-05-25T01:13:00+02:00,2025-05-25,09:13,4,1,5
56,2025-05-25T01:14:00+02:00,2025-05-25,09:14,0,1,1
56,2025-05-25T01:16:00+02:00,2025-05-25,09:16,4,8,12
56,2025-05-25T01:18:00+02:00,2025-05-25,09:18,2,5,7
56,2025-05-25T01:22:00+02:00,2025-05-25,09:22,1,1,2
58,2025-05-25T01:10:00+02:00,2025-05-25,09:10,3,11,14
58,2025-05-25T01:14:00+02:00,2025-05-25,09:14,7,0,7
58,2025-05-25T01:16:00+02:00,2025-05-25,09:16,7,4,11
58,2025-05-25T01:19:00+02:00,2025-05-25,09:19,9,1,10
58,2025-05-25T01:20:00+02:00,2025-05-25,09:20,3,2,5
58,2025-05-25T01:22:00+02:00,2025-05-25,09:22,6,2,8
58,2025-05-25T01:23:00+02:00,2025-05-25,09:23,5,4,9
58,2025-05-25T01:24:00+02:00,2025-05-25,09:24,11,3,14
62,2025-05-25T01:10:00+02:00,2025-05-25,09:10,1,1,2
62,2025-05-25T01:12:00+02:00,2025-05-25,09:12,0,2,2
62,2025-05-25T01:13:00+02:00,2025-05-25,09:13,1,0,1
62,2025-05-25T01:18:00+02:00,2025-05-25,09:18,0,1,1
62,2025-05-25T01:24:00+02:00,2025-05-25,09:24,2,0,2
63,2025-05-25T01:11:00+02:00,2025-05-25,09:11,0,4,4
63,2025-05-25T01:17:00+02:00,2025-05-25,09:17,0,2,2
67,2025-05-25T01:21:00+02:00,2025-05-25,09:21,1,3,4
67,2025-05-25T01:22:00+02:00,2025-05-25,09:22,2,2,4
67,2025-05-25T01:23:00+02:00,2025-05-25,09:23,0,6,6
67,2025-05-25T01:24:00+02:00,2025-05-25,09:24,4,3,7
68,2025-05-25T01:11:00+02:00,2025-05-25,09:11,3,0,3
68,2025-05-25T01:17:00+02:00,2025-05-25,09:17,4,7,11
68,2025-05-25T01:21:00+02:00,2025-05-25,09:21,0,3,3
68,2025-05-25T01:22:00+02:00,2025-05-25,09:22,5,5,10
68,2025-05-25T01:24:00+02:00,2025-05-25,09:24,3,2,5
72,2025-05-25T01:17:00+02:00,2025-05-25,09:17,2,3,5
72,2025-05-25T01:18:00+02:00,2025-05-25,09:18,1,2,3
72,2025-05-25T01:20:00+02:00,2025-05-25,09:20,3,0,3
76,2025-05-25T01:10:00+02:00,2025-05-25,09:10,1,0,1
76,2025-05-25T01:12:00+02:00,2025-05-25,09:12,2,0,2
76,2025-05-25T01:17:00+02:00,2025-05-25,09:17,0,1,1
76,2025-05-25T01:23:00+02:00,2025-05-25,09:23,1,1,2
76,2025-05-25T01:24:00+02:00,2025-05-25,09:24,2,0,2
79,2025-05-25T01:12:00+02:00,2025-05-25,09:12,4,1,5
79,2025-05-25T01:16:00+02:00,2025-05-25,09:16,14,3,17
79,2025-05-25T01:17:00+02:00,2025-05-25,09:17,14,2,16
79,2025-05-25T01:20:00+02:00,2025-05-25,09:20,7,4,11
79,2025-05-25T01:21:00+02:00,2025-05-25,09:21,4,2,6
79,2025-05-25T01:24:00+02:00,2025-05-25,09:24,2,1,3
85,2025-05-25T01:13:00+02:00,2025-05-25,09:13,1,0,1
85,2025-05-25T01:20:00+02:00,2025-05-25,09:20,0,1,1
85,2025-05-25T01:21:00+02:00,2025-05-25,09:21,3,0,3
85,2025-05-25T01:23:00+02:00,2025-05-25,09:23,2,1,3
85,2025-05-25T01:24:00+02:00,2025-05-25,09:24,2,1,3
86,2025-05-25T01:11:00+02:00,2025-05-25,09:11,1,1,2
109,2025-05-25T01:15:00+02:00,2025-05-25,09:15,12,1,13
109,2025-05-25T01:20:00+02:00,2025-05-25,09:20,9,4,13
117,2025-05-25T01:10:00+02:00,2025-05-25,09:10,1,8,9
117,2025-05-25T01:20:00+02:00,2025-05-25,09:20,8,5,13
130,2025-05-25T01:15:00+02:00,2025-05-25,09:15,1,4,5
136,2025-05-25T01:15:00+02:00,2025-05-25,09:15,1,8,9
139,2025-05-25T01:10:00+02:00,2025-05-25,09:10,1,1,2
141,2025-05-25T01:10:00+02:00,2025-05-25,09:10,9,10,19
141,2025-05-25T01:15:00+02:00,2025-05-25,09:15,13,8,21
141,2025-05-25T01:20:00+02:00,2025-05-25,09:20,4,4,8
142,2025-05-25T01:10:00+02:00,2025-05-25,09:10,22,19,41
181,2025-05-25T01:13:00+02:00,2025-05-25,09:13,4,11,15
181,2025-05-25T01:14:00+02:00,2025-05-25,09:14,2,13,15
181,2025-05-25T01:15:00+02:00,2025-05-25,09:15,0,4,4
181,2025-05-25T01:17:00+02:00,2025-05-25,09:17,1,3,4
181,2025-05-25T01:18:00+02:00,2025-05-25,09:18,6,3,9
181,2025-05-25T01:19:00+02:00,2025-05-25,09:19,3,8,11
181,2025-05-25T01:21:00+02:00,2025-05-25,09:21,1,9,10
181,2025-05-25T01:23:00+02:00,2025-05-25,09:23,6,10,16
182,2025-05-25T01:20:00+02:00,2025-05-25,09:20,5,8,13
180,2025-05-25T01:13:00+02:00,2025-05-25,09:13,1,1,2
180,2025-05-25T01:15:00+02:00,2025-05-25,09:15,1,0,1
180,2025-05-25T01:16:00+02:00,2025-05-25,09:16,3,0,3
181,2025-05-25T01:32:00+02:00,2025-05-25,09:32,6,1,7
181,2025-05-25T01:33:00+02:00,2025-05-25,09:33,5,8,13
181,2025-05-25T01:36:00+02:00,2025-05-25,09:36,7,7,14
181,2025-05-25T01:39:00+02:00,2025-05-25,09:39,2,8,10
182,2025-05-25T01:25:00+02:00,2025-05-25,09:25,9,13,22
180,2025-05-25T01:32:00+02:00,2025-05-25,09:32,1,0,1
180,2025-05-25T01:36:00+02:00,2025-05-25,09:36,1,0,1
3,2025-05-25T01:25:00+02:00,2025-05-25,09:25,0,1,1
3,2025-05-25T01:30:00+02:00,2025-05-25,09:30,5,3,8
3,2025-05-25T01:35:00+02:00,2025-05-25,09:35,2,1,3
3,2025-05-25T01:38:00+02:00,2025-05-25,09:38,3,2,5
4,2025-05-25T01:25:00+02:00,2025-05-25,09:25,2,5,7
4,2025-05-25T01:26:00+02:00,2025-05-25,09:26,6,1,7
4,2025-05-25T01:27:00+02:00,2025-05-25,09:27,3,5,8
4,2025-05-25T01:29:00+02:00,2025-05-25,09:29,6,0,6
4,2025-05-25T01:30:00+02:00,2025-05-25,09:30,5,6,11
4,2025-05-25T01:31:00+02:00,2025-05-25,09:31,4,4,8
4,2025-05-25T01:32:00+02:00,2025-05-25,09:32,2,3,5
4,2025-05-25T01:35:00+02:00,2025-05-25,09:35,7,13,20
4,2025-05-25T01:37:00+02:00,2025-05-25,09:37,8,2,10
4,2025-05-25T01:39:00+02:00,2025-05-25,09:39,2,7,9
5,2025-05-25T01:25:00+02:00,2025-05-25,09:25,24,19,43
5,2025-05-25T01:30:00+02:00,2025-05-25,09:30,20,19,39
5,2025-05-25T01:35:00+02:00,2025-05-25,09:35,27,23,50
6,2025-05-25T01:27:00+02:00,2025-05-25,09:27,7,3,10
6,2025-05-25T01:29:00+02:00,2025-05-25,09:29,5,9,14
6,2025-05-25T01:31:00+02:00,2025-05-25,09:31,9,1,10
6,2025-05-25T01:34:00+02:00,2025-05-25,09:34,9,13,22
6,2025-05-25T01:36:00+02:00,2025-05-25,09:36,19,7,26
8,2025-05-25T01:27:00+02:00,2025-05-25,09:27,0,6,6
8,2025-05-25T01:28:00+02:00,2025-05-25,09:28,2,5,7
8,2025-05-25T01:34:00+02:00,2025-05-25,09:34,1,6,7
8,2025-05-25T01:39:00+02:00,2025-05-25,09:39,1,5,6
28,2025-05-25T01:26:00+02:00,2025-05-25,09:26,3,0,3
28,2025-05-25T01:27:00+02:00,2025-05-25,09:27,1,1,2
28,2025-05-25T01:31:00+02:00,2025-05-25,09:31,2,2,4
28,2025-05-25T01:33:00+02:00,2025-05-25,09:33,1,3,4
28,2025-05-25T01:36:00+02:00,2025-05-25,09:36,3,1,4
29,2025-05-25T01:25:00+02:00,2025-05-25,09:25,0,3,3
29,2025-05-25T01:26:00+02:00,2025-05-25,09:26,0,4,4
29,2025-05-25T01:39:00+02:00,2025-05-25,09:39,4,3,7
31,2025-05-25T01:31:00+02:00,2025-05-25,09:31,3,0,3
31,2025-05-25T01:36:00+02:00,2025-05-25,09:36,5,0,5
36,2025-05-25T01:25:00+02:00,2025-05-25,09:25,1,1,2
36,2025-05-25T01:31:00+02:00,2025-05-25,09:31,1,3,4
36,2025-05-25T01:33:00+02:00,2025-05-25,09:33,4,0,4
36,2025-05-25T01:36:00+02:00,2025-05-25,09:36,0,1,1
36,2025-05-25T01:37:00+02:00,2025-05-25,09:37,0,3,3
37,2025-05-25T01:31:00+02:00,2025-05-25,09:31,2,0,2
37,2025-05-25T01:38:00+02:00,2025-05-25,09:38,1,0,1
39,2025-05-25T01:28:00+02:00,2025-05-25,09:28,0,1,1
39,2025-05-25T01:30:00+02:00,2025-05-25,09:30,1,0,1
39,2025-05-25T01:33:00+02:00,2025-05-25,09:33,2,5,7
39,2025-05-25T01:34:00+02:00,2025-05-25,09:34,1,0,1
39,2025-05-25T01:39:00+02:00,2025-05-25,09:39,0,3,3
40,2025-05-25T01:25:00+02:00,2025-05-25,09:25,5,0,5
40,2025-05-25T01:27:00+02:00,2025-05-25,09:27,1,4,5
40,2025-05-25T01:30:00+02:00,2025-05-25,09:30,0,4,4
41,2025-05-25T01:27:00+02:00,2025-05-25,09:27,2,0,2
41,2025-05-25T01:33:00+02:00,2025-05-25,09:33,4,1,5
41,2025-05-25T01:34:00+02:00,2025-05-25,09:34,4,1,5
41,2025-05-25T01:36:00+02:00,2025-05-25,09:36,2,1,3
43,2025-05-25T01:30:00+02:00,2025-05-25,09:30,4,1,5
44,2025-05-25T01:25:00+02:00,2025-05-25,09:25,1,2,3
44,2025-05-25T01:30:00+02:00,2025-05-25,09:30,2,1,3
45,2025-05-25T01:25:00+02:00,2025-05-25,09:25,4,6,10
45,2025-05-25T01:28:00+02:00,2025-05-25,09:28,8,4,12
45,2025-05-25T01:29:00+02:00,2025-05-25,09:29,2,1,3
45,2025-05-25T01:34:00+02:00,2025-05-25,09:34,1,3,4
45,2025-05-25T01:37:00+02:00,2025-05-25,09:37,2,3,5
45,2025-05-25T01:38:00+02:00,2025-05-25,09:38,1,2,3
47,2025-05-25T01:25:00+02:00,2025-05-25,09:25,7,5,12
47,2025-05-25T01:30:00+02:00,2025-05-25,09:30,3,7,10
47,2025-05-25T01:32:00+02:00,2025-05-25,09:32,5,14,19
47,2025-05-25T01:34:00+02:00,2025-05-25,09:34,7,2,9
47,2025-05-25T01:38:00+02:00,2025-05-25,09:38,10,7,17
50,2025-05-25T01:32:00+02:00,2025-05-25,09:32,0,2,2
50,2025-05-25T01:37:00+02:00,2025-05-25,09:37,2,1,3
54,2025-05-25T01:25:00+02:00,2025-05-25,09:25,1,1,2
54,2025-05-25T01:26:00+02:00,2025-05-25,09:26,3,3,6
54,2025-05-25T01:29:00+02:00,2025-05-25,09:29,1,0,1
54,2025-05-25T01:31:00+02:00,2025-05-25,09:31,3,0,3
54,2025-05-25T01:34:00+02:00,2025-05-25,09:34,2,1,3
54,2025-05-25T01:36:00+02:00,2025-05-25,09:36,3,0,3
59,2025-05-25T01:30:00+02:00,2025-05-25,09:30,9,4,13
61,2025-05-25T01:25:00+02:00,2025-05-25,09:25,1,2,3
61,2025-05-25T01:31:00+02:00,2025-05-25,09:31,1,7,8
61,2025-05-25T01:34:00+02:00,2025-05-25,09:34,2,1,3
61,2025-05-25T01:35:00+02:00,2025-05-25,09:35,2,7,9
61,2025-05-25T01:39:00+02:00,2025-05-25,09:39,3,4,7
66,2025-05-25T01:30:00+02:00,2025-05-25,09:30,7,5,12
66,2025-05-25T01:34:00+02:00,2025-05-25,09:34,4,4,8
66,2025-05-25T01:35:00+02:00,2025-05-25,09:35,4,0,4
66,2025-05-25T01:37:00+02:00,2025-05-25,09:37,4,1,5
69,2025-05-25T01:26:00+02:00,2025-05-25,09:26,0,1,1
69,2025-05-25T01:33:00+02:00,2025-05-25,09:33,7,0,7
70,2025-05-25T01:25:00+02:00,2025-05-25,09:25,0,1,1
70,2025-05-25T01:28:00+02:00,2025-05-25,09:28,0,1,1
70,2025-05-25T01:30:00+02:00,2025-05-25,09:30,1,1,2
70,2025-05-25T01:34:00+02:00,2025-05-25,09:34,4,0,4
70,2025-05-25T01:35:00+02:00,2025-05-25,09:35,1,1,2
70,2025-05-25T01:37:00+02:00,2025-05-25,09:37,0,2,2
75,2025-05-25T01:25:00+02:00,2025-05-25,09:25,0,2,2
75,2025-05-25T01:31:00+02:00,2025-05-25,09:31,0,1,1
75,2025-05-25T01:32:00+02:00,2025-05-25,09:32,1,0,1
75,2025-05-25T01:37:00+02:00,2025-05-25,09:37,1,2,3
77,2025-05-25T01:30:00+02:00,2025-05-25,09:30,14,22,36
78,2025-05-25T01:37:00+02:00,2025-05-25,09:37,0,3,3
78,2025-05-25T01:38:00+02:00,2025-05-25,09:38,2,1,3
84,2025-05-25T01:30:00+02:00,2025-05-25,09:30,51,42,93
84,2025-05-25T01:35:00+02:00,2025-05-25,09:35,59,35,94
87,2025-05-25T01:26:00+02:00,2025-05-25,09:26,2,0,2
87,2025-05-25T01:29:00+02:00,2025-05-25,09:29,1,3,4
87,2025-05-25T01:30:00+02:00,2025-05-25,09:30,1,3,4
87,2025-05-25T01:31:00+02:00,2025-05-25,09:31,1,1,2
87,2025-05-25T01:37:00+02:00,2025-05-25,09:37,1,0,1
87,2025-05-25T01:38:00+02:00,2025-05-25,09:38,0,1,1
108,2025-05-25T01:33:00+02:00,2025-05-25,09:33,0,1,1
108,2025-05-25T01:35:00+02:00,2025-05-25,09:35,1,0,1
108,2025-05-25T01:39:00+02:00,2025-05-25,09:39,0,1,1
118,2025-05-25T01:30:00+02:00,2025-05-25,09:30,1,0,1
124,2025-05-25T01:35:00+02:00,2025-05-25,09:35,2,3,5
131,2025-05-25T01:25:00+02:00,2025-05-25,09:25,8,10,18
132,2025-05-25T01:25:00+02:00,2025-05-25,09:25,12,5,17
132,2025-05-25T01:35:00+02:00,2025-05-25,09:35,14,5,19
133,2025-05-25T01:25:00+02:00,2025-05-25,09:25,17,36,53
133,2025-05-25T01:35:00+02:00,2025-05-25,09:35,26,24,50
134,2025-05-25T01:25:00+02:00,2025-05-25,09:25,21,8,29
135,2025-05-25T01:35:00+02:00,2025-05-25,09:35,21,19,40
165,2025-05-25T01:35:00+02:00,2025-05-25,09:35,2,5,7
166,2025-05-25T01:30:00+02:00,2025-05-25,09:30,4,2,6
166,2025-05-25T01:35:00+02:00,2025-05-25,09:35,1,4,5
167,2025-05-25T01:25:00+02:00,2025-05-25,09:25,4,5,9
167,2025-05-25T01:30:00+02:00,2025-05-25,09:30,0,4,4
1,2025-05-25T01:26:00+02:00,2025-05-25,09:26,2,4,6
1,2025-05-25T01:32:00+02:00,2025-05-25,09:32,3,8,11
1,2025-05-25T01:33:00+02:00,2025-05-25,09:33,0,2,2
1,2025-05-25T01:35:00+02:00,2025-05-25,09:35,1,6,7
1,2025-05-25T01:36:00+02:00,2025-05-25,09:36,2,7,9
1,2025-05-25T01:38:00+02:00,2025-05-25,09:38,3,3,6
1,2025-05-25T01:39:00+02:00,2025-05-25,09:39,5,8,13
2,2025-05-25T01:26:00+02:00,2025-05-25,09:26,6,0,6
2,2025-05-25T01:27:00+02:00,2025-05-25,09:27,1,0,1
2,2025-05-25T01:28:00+02:00,2025-05-25,09:28,2,3,5
2,2025-05-25T01:31:00+02:00,2025-05-25,09:31,0,2,2
2,2025-05-25T01:32:00+02:00,2025-05-25,09:32,5,5,10
2,2025-05-25T01:34:00+02:00,2025-05-25,09:34,3,8,11
2,2025-05-25T01:35:00+02:00,2025-05-25,09:35,0,5,5
2,2025-05-25T01:39:00+02:00,2025-05-25,09:39,2,0,2
9,2025-05-25T01:25:00+02:00,2025-05-25,09:25,3,1,4
9,2025-05-25T01:27:00+02:00,2025-05-25,09:27,0,1,1
9,2025-05-25T01:28:00+02:00,2025-05-25,09:28,2,1,3
9,2025-05-25T01:30:00+02:00,2025-05-25,09:30,2,1,3
9,2025-05-25T01:31:00+02:00,2025-05-25,09:31,1,0,1
9,2025-05-25T01:35:00+02:00,2025-05-25,09:35,3,0,3
9,2025-05-25T01:36:00+02:00,2025-05-25,09:36,0,1,1
10,2025-05-25T01:34:00+02:00,2025-05-25,09:34,1,0,1
11,2025-05-25T01:28:00+02:00,2025-05-25,09:28,1,0,1
11,2025-05-25T01:30:00+02:00,2025-05-25,09:30,3,3,6
11,2025-05-25T01:35:00+02:00,2025-05-25,09:35,4,3,7
12,2025-05-25T01:26:00+02:00,2025-05-25,09:26,2,6,8
12,2025-05-25T01:27:00+02:00,2025-05-25,09:27,6,4,10
12,2025-05-25T01:29:00+02:00,2025-05-25,09:29,5,1,6
12,2025-05-25T01:30:00+02:00,2025-05-25,09:30,6,0,6
12,2025-05-25T01:33:00+02:00,2025-05-25,09:33,2,1,3
12,2025-05-25T01:34:00+02:00,2025-05-25,09:34,2,3,5
12,2025-05-25T01:39:00+02:00,2025-05-25,09:39,2,1,3
17,2025-05-25T01:26:00+02:00,2025-05-25,09:26,7,1,8
17,2025-05-25T01:29:00+02:00,2025-05-25,09:29,6,0,6
17,2025-05-25T01:36:00+02:00,2025-05-25,09:36,0,4,4
17,2025-05-25T01:37:00+02:00,2025-05-25,09:37,0,3,3
17,2025-05-25T01:39:00+02:00,2025-05-25,09:39,0,3,3
18,2025-05-25T01:27:00+02:00,2025-05-25,09:27,0,2,2
18,2025-05-25T01:35:00+02:00,2025-05-25,09:35,0,2,2
18,2025-05-25T01:36:00+02:00,2025-05-25,09:36,0,3,3
19,2025-05-25T01:26:00+02:00,2025-05-25,09:26,0,2,2
19,2025-05-25T01:29:00+02:00,2025-05-25,09:29,3,0,3
19,2025-05-25T01:31:00+02:00,2025-05-25,09:31,3,3,6
19,2025-05-25T01:34:00+02:00,2025-05-25,09:34,0,1,1
19,2025-05-25T01:39:00+02:00,2025-05-25,09:39,5,1,6
20,2025-05-25T01:25:00+02:00,2025-05-25,09:25,2,3,5
20,2025-05-25T01:29:00+02:00,2025-05-25,09:29,2,0,2
20,2025-05-25T01:31:00+02:00,2025-05-25,09:31,2,1,3
20,2025-05-25T01:36:00+02:00,2025-05-25,09:36,0,3,3
23,2025-05-25T01:26:00+02:00,2025-05-25,09:26,3,1,4
23,2025-05-25T01:29:00+02:00,2025-05-25,09:29,0,1,1
23,2025-05-25T01:32:00+02:00,2025-05-25,09:32,4,0,4
23,2025-05-25T01:37:00+02:00,2025-05-25,09:37,6,2,8
23,2025-05-25T01:38:00+02:00,2025-05-25,09:38,4,0,4
24,2025-05-25T01:34:00+02:00,2025-05-25,09:34,4,15,19
24,2025-05-25T01:38:00+02:00,2025-05-25,09:38,8,1,9
24,2025-05-25T01:39:00+02:00,2025-05-25,09:39,3,10,13
25,2025-05-25T01:30:00+02:00,2025-05-25,09:30,18,61,79
27,2025-05-25T01:25:00+02:00,2025-05-25,09:25,0,6,6
27,2025-05-25T01:28:00+02:00,2025-05-25,09:28,1,3,4
27,2025-05-25T01:30:00+02:00,2025-05-25,09:30,2,4,6
27,2025-05-25T01:31:00+02:00,2025-05-25,09:31,1,2,3
30,2025-05-25T01:31:00+02:00,2025-05-25,09:31,0,1,1
30,2025-05-25T01:34:00+02:00,2025-05-25,09:34,2,0,2
30,2025-05-25T01:36:00+02:00,2025-05-25,09:36,3,0,3
30,2025-05-25T01:37:00+02:00,2025-05-25,09:37,0,2,2
35,2025-05-25T01:28:00+02:00,2025-05-25,09:28,19,3,22
35,2025-05-25T01:30:00+02:00,2025-05-25,09:30,14,7,21
35,2025-05-25T01:32:00+02:00,2025-05-25,09:32,18,5,23
35,2025-05-25T01:36:00+02:00,2025-05-25,09:36,18,17,35
35,2025-05-25T01:37:00+02:00,2025-05-25,09:37,10,11,21
46,2025-05-25T01:25:00+02:00,2025-05-25,09:25,1,1,2
46,2025-05-25T01:30:00+02:00,2025-05-25,09:30,2,3,5
46,2025-05-25T01:35:00+02:00,2025-05-25,09:35,2,0,2
48,2025-05-25T01:26:00+02:00,2025-05-25,09:26,4,2,6
48,2025-05-25T01:27:00+02:00,2025-05-25,09:27,1,4,5
48,2025-05-25T01:32:00+02:00,2025-05-25,09:32,9,1,10
48,2025-05-25T01:33:00+02:00,2025-05-25,09:33,4,0,4
48,2025-05-25T01:34:00+02:00,2025-05-25,09:34,5,4,9
48,2025-05-25T01:37:00+02:00,2025-05-25,09:37,3,1,4
48,2025-05-25T01:39:00+02:00,2025-05-25,09:39,9,1,10
49,2025-05-25T01:26:00+02:00,2025-05-25,09:26,2,3,5
49,2025-05-25T01:30:00+02:00,2025-05-25,09:30,6,12,18
49,2025-05-25T01:31:00+02:00,2025-05-25,09:31,1,3,4
49,2025-05-25T01:39:00+02:00,2025-05-25,09:39,1,8,9
51,2025-05-25T01:29:00+02:00,2025-05-25,09:29,0,1,1
51,2025-05-25T01:33:00+02:00,2025-05-25,09:33,2,0,2
51,2025-05-25T01:35:00+02:00,2025-05-25,09:35,1,2,3
51,2025-05-25T01:36:00+02:00,2025-05-25,09:36,1,2,3
51,2025-05-25T01:38:00+02:00,2025-05-25,09:38,0,3,3
52,2025-05-25T01:29:00+02:00,2025-05-25,09:29,5,0,5
52,2025-05-25T01:32:00+02:00,2025-05-25,09:32,1,2,3
52,2025-05-25T01:39:00+02:00,2025-05-25,09:39,2,1,3
53,2025-05-25T01:28:00+02:00,2025-05-25,09:28,3,1,4
53,2025-05-25T01:31:00+02:00,2025-05-25,09:31,2,0,2
53,2025-05-25T01:32:00+02:00,2025-05-25,09:32,4,5,9
53,2025-05-25T01:37:00+02:00,2025-05-25,09:37,5,2,7
53,2025-05-25T01:38:00+02:00,2025-05-25,09:38,2,2,4
56,2025-05-25T01:25:00+02:00,2025-05-25,09:25,1,2,3
56,2025-05-25T01:29:00+02:00,2025-05-25,09:29,4,1,5
56,2025-05-25T01:38:00+02:00,2025-05-25,09:38,6,1,7
56,2025-05-25T01:39:00+02:00,2025-05-25,09:39,5,1,6
58,2025-05-25T01:25:00+02:00,2025-05-25,09:25,0,1,1
58,2025-05-25T01:29:00+02:00,2025-05-25,09:29,2,4,6
58,2025-05-25T01:32:00+02:00,2025-05-25,09:32,3,7,10
58,2025-05-25T01:34:00+02:00,2025-05-25,09:34,7,1,8
58,2025-05-25T01:35:00+02:00,2025-05-25,09:35,14,3,17
58,2025-05-25T01:37:00+02:00,2025-05-25,09:37,3,0,3
62,2025-05-25T01:25:00+02:00,2025-05-25,09:25,0,3,3
62,2025-05-25T01:33:00+02:00,2025-05-25,09:33,2,0,2
62,2025-05-25T01:35:00+02:00,2025-05-25,09:35,0,1,1
63,2025-05-25T01:26:00+02:00,2025-05-25,09:26,1,4,5
63,2025-05-25T01:27:00+02:00,2025-05-25,09:27,3,1,4
63,2025-05-25T01:28:00+02:00,2025-05-25,09:28,2,2,4
63,2025-05-25T01:29:00+02:00,2025-05-25,09:29,4,3,7
63,2025-05-25T01:30:00+02:00,2025-05-25,09:30,0,1,1
63,2025-05-25T01:32:00+02:00,2025-05-25,09:32,0,7,7
63,2025-05-25T01:35:00+02:00,2025-05-25,09:35,0,5,5
63,2025-05-25T01:37:00+02:00,2025-05-25,09:37,3,2,5
67,2025-05-25T01:26:00+02:00,2025-05-25,09:26,2,3,5
67,2025-05-25T01:27:00+02:00,2025-05-25,09:27,1,1,2
67,2025-05-25T01:29:00+02:00,2025-05-25,09:29,3,0,3
67,2025-05-25T01:30:00+02:00,2025-05-25,09:30,3,2,5
67,2025-05-25T01:32:00+02:00,2025-05-25,09:32,1,4,5
67,2025-05-25T01:36:00+02:00,2025-05-25,09:36,2,2,4
67,2025-05-25T01:38:00+02:00,2025-05-25,09:38,1,2,3
68,2025-05-25T01:28:00+02:00,2025-05-25,09:28,4,1,5
68,2025-05-25T01:32:00+02:00,2025-05-25,09:32,6,2,8
68,2025-05-25T01:36:00+02:00,2025-05-25,09:36,3,1,4
68,2025-05-25T01:39:00+02:00,2025-05-25,09:39,5,2,7
72,2025-05-25T01:26:00+02:00,2025-05-25,09:26,0,5,5
72,2025-05-25T01:28:00+02:00,2025-05-25,09:28,1,0,1
72,2025-05-25T01:29:00+02:00,2025-05-25,09:29,1,2,3
72,2025-05-25T01:33:00+02:00,2025-05-25,09:33,1,0,1
72,2025-05-25T01:35:00+02:00,2025-05-25,09:35,0,7,7
72,2025-05-25T01:36:00+02:00,2025-05-25,09:36,3,3,6
72,2025-05-25T01:38:00+02:00,2025-05-25,09:38,1,1,2
72,2025-05-25T01:39:00+02:00,2025-05-25,09:39,3,0,3
76,2025-05-25T01:27:00+02:00,2025-05-25,09:27,2,0,2
76,2025-05-25T01:30:00+02:00,2025-05-25,09:30,3,1,4
76,2025-05-25T01:34:00+02:00,2025-05-25,09:34,1,0,1
76,2025-05-25T01:38:00+02:00,2025-05-25,09:38,0,1,1
79,2025-05-25T01:27:00+02:00,2025-05-25,09:27,2,6,8
79,2025-05-25T01:28:00+02:00,2025-05-25,09:28,4,2,6
79,2025-05-25T01:29:00+02:00,2025-05-25,09:29,1,2,3
79,2025-05-25T01:30:00+02:00,2025-05-25,09:30,1,2,3
79,2025-05-25T01:35:00+02:00,2025-05-25,09:35,3,1,4
79,2025-05-25T01:36:00+02:00,2025-05-25,09:36,2,5,7
79,2025-05-25T01:39:00+02:00,2025-05-25,09:39,4,5,9
85,2025-05-25T01:26:00+02:00,2025-05-25,09:26,0,3,3
85,2025-05-25T01:30:00+02:00,2025-05-25,09:30,1,3,4
85,2025-05-25T01:33:00+02:00,2025-05-25,09:33,5,0,5
85,2025-05-25T01:38:00+02:00,2025-05-25,09:38,1,1,2
86,2025-05-25T01:25:00+02:00,2025-05-25,09:25,0,1,1
86,2025-05-25T01:29:00+02:00,2025-05-25,09:29,1,1,2
123,2025-05-25T01:25:00+02:00,2025-05-25,09:25,4,2,6
123,2025-05-25T01:30:00+02:00,2025-05-25,09:30,4,1,5
130,2025-05-25T01:25:00+02:00,2025-05-25,09:25,8,5,13
130,2025-05-25T01:30:00+02:00,2025-05-25,09:30,2,4,6
137,2025-05-25T01:30:00+02:00,2025-05-25,09:30,0,1,1
139,2025-05-25T01:35:00+02:00,2025-05-25,09:35,2,2,4
141,2025-05-25T01:25:00+02:00,2025-05-25,09:25,8,1,9
141,2025-05-25T01:35:00+02:00,2025-05-25,09:35,4,21,25
142,2025-05-25T01:30:00+02:00,2025-05-25,09:30,50,23,73
142,2025-05-25T01:35:00+02:00,2025-05-25,09:35,30,25,55
161,2025-05-25T01:25:00+02:00,2025-05-25,09:25,11,11,22
161,2025-05-25T01:35:00+02:00,2025-05-25,09:35,14,15,29
164,2025-05-25T01:30:00+02:00,2025-05-25,09:30,6,0,6
3,2025-05-25T02:25:00+02:00,2025-05-25,10:25,1,5,6
3,2025-05-25T02:26:00+02:00,2025-05-25,10:26,12,9,21
3,2025-05-25T02:27:00+02:00,2025-05-25,10:27,5,4,9
3,2025-05-25T02:30:00+02:00,2025-05-25,10:30,4,4,8
3,2025-05-25T02:34:00+02:00,2025-05-25,10:34,3,5,8
4,2025-05-25T02:27:00+02:00,2025-05-25,10:27,12,1,13
4,2025-05-25T02:35:00+02:00,2025-05-25,10:35,16,9,25
4,2025-05-25T02:36:00+02:00,2025-05-25,10:36,18,9,27
6,2025-05-25T02:25:00+02:00,2025-05-25,10:25,10,11,21
6,2025-05-25T02:26:00+02:00,2025-05-25,10:26,6,1,7
6,2025-05-25T02:27:00+02:00,2025-05-25,10:27,13,10,23
6,2025-05-25T02:28:00+02:00,2025-05-25,10:28,17,3,20
6,2025-05-25T02:31:00+02:00,2025-05-25,10:31,3,1,4
6,2025-05-25T02:33:00+02:00,2025-05-25,10:33,14,4,18
6,2025-05-25T02:34:00+02:00,2025-05-25,10:34,11,5,16
6,2025-05-25T02:39:00+02:00,2025-05-25,10:39,14,6,20
8,2025-05-25T02:27:00+02:00,2025-05-25,10:27,1,2,3
8,2025-05-25T02:28:00+02:00,2025-05-25,10:28,3,4,7
8,2025-05-25T02:29:00+02:00,2025-05-25,10:29,0,6,6
8,2025-05-25T02:33:00+02:00,2025-05-25,10:33,1,5,6
8,2025-05-25T02:37:00+02:00,2025-05-25,10:37,0,3,3
8,2025-05-25T02:38:00+02:00,2025-05-25,10:38,0,4,4
28,2025-05-25T02:25:00+02:00,2025-05-25,10:25,2,5,7
28,2025-05-25T02:31:00+02:00,2025-05-25,10:31,4,4,8
29,2025-05-25T02:26:00+02:00,2025-05-25,10:26,4,4,8
29,2025-05-25T02:31:00+02:00,2025-05-25,10:31,5,7,12
29,2025-05-25T02:35:00+02:00,2025-05-25,10:35,9,8,17
29,2025-05-25T02:38:00+02:00,2025-05-25,10:38,10,7,17
31,2025-05-25T02:27:00+02:00,2025-05-25,10:27,0,2,2
31,2025-05-25T02:32:00+02:00,2025-05-25,10:32,0,4,4
31,2025-05-25T02:35:00+02:00,2025-05-25,10:35,0,4,4
36,2025-05-25T02:27:00+02:00,2025-05-25,10:27,3,1,4
36,2025-05-25T02:33:00+02:00,2025-05-25,10:33,3,3,6
36,2025-05-25T02:35:00+02:00,2025-05-25,10:35,4,2,6
36,2025-05-25T02:36:00+02:00,2025-05-25,10:36,5,6,11
36,2025-05-25T02:39:00+02:00,2025-05-25,10:39,1,2,3
37,2025-05-25T02:26:00+02:00,2025-05-25,10:26,0,3,3
37,2025-05-25T02:27:00+02:00,2025-05-25,10:27,0,1,1
37,2025-05-25T02:29:00+02:00,2025-05-25,10:29,2,1,3
37,2025-05-25T02:32:00+02:00,2025-05-25,10:32,2,1,3
37,2025-05-25T02:33:00+02:00,2025-05-25,10:33,1,0,1
37,2025-05-25T02:35:00+02:00,2025-05-25,10:35,3,0,3
37,2025-05-25T02:38:00+02:00,2025-05-25,10:38,1,2,3
39,2025-05-25T02:28:00+02:00,2025-05-25,10:28,0,2,2
40,2025-05-25T02:33:00+02:00,2025-05-25,10:33,3,2,5
40,2025-05-25T02:36:00+02:00,2025-05-25,10:36,0,1,1
40,2025-05-25T02:37:00+02:00,2025-05-25,10:37,3,3,6
41,2025-05-25T02:26:00+02:00,2025-05-25,10:26,2,7,9
41,2025-05-25T02:28:00+02:00,2025-05-25,10:28,1,3,4
41,2025-05-25T02:29:00+02:00,2025-05-25,10:29,0,2,2
41,2025-05-25T02:31:00+02:00,2025-05-25,10:31,6,6,12
41,2025-05-25T02:34:00+02:00,2025-05-25,10:34,0,4,4
41,2025-05-25T02:36:00+02:00,2025-05-25,10:36,1,2,3
41,2025-05-25T02:39:00+02:00,2025-05-25,10:39,2,7,9
43,2025-05-25T02:30:00+02:00,2025-05-25,10:30,3,3,6
44,2025-05-25T02:25:00+02:00,2025-05-25,10:25,3,4,7
45,2025-05-25T02:30:00+02:00,2025-05-25,10:30,9,3,12
45,2025-05-25T02:32:00+02:00,2025-05-25,10:32,9,3,12
45,2025-05-25T02:34:00+02:00,2025-05-25,10:34,12,1,13
45,2025-05-25T02:37:00+02:00,2025-05-25,10:37,11,2,13
47,2025-05-25T02:26:00+02:00,2025-05-25,10:26,6,23,29
47,2025-05-25T02:32:00+02:00,2025-05-25,10:32,6,9,15
47,2025-05-25T02:33:00+02:00,2025-05-25,10:33,9,14,23
47,2025-05-25T02:34:00+02:00,2025-05-25,10:34,9,10,19
47,2025-05-25T02:39:00+02:00,2025-05-25,10:39,10,13,23
50,2025-05-25T02:25:00+02:00,2025-05-25,10:25,2,4,6
50,2025-05-25T02:32:00+02:00,2025-05-25,10:32,0,1,1
54,2025-05-25T02:26:00+02:00,2025-05-25,10:26,3,0,3
54,2025-05-25T02:28:00+02:00,2025-05-25,10:28,0,1,1
54,2025-05-25T02:31:00+02:00,2025-05-25,10:31,0,2,2
54,2025-05-25T02:38:00+02:00,2025-05-25,10:38,0,2,2
61,2025-05-25T02:27:00+02:00,2025-05-25,10:27,3,3,6
61,2025-05-25T02:28:00+02:00,2025-05-25,10:28,1,7,8
61,2025-05-25T02:29:00+02:00,2025-05-25,10:29,3,6,9
61,2025-05-25T02:30:00+02:00,2025-05-25,10:30,4,0,4
61,2025-05-25T02:35:00+02:00,2025-05-25,10:35,3,2,5
61,2025-05-25T02:37:00+02:00,2025-05-25,10:37,2,1,3
61,2025-05-25T02:39:00+02:00,2025-05-25,10:39,0,3,3
66,2025-05-25T02:25:00+02:00,2025-05-25,10:25,3,5,8
66,2025-05-25T02:27:00+02:00,2025-05-25,10:27,7,4,11
66,2025-05-25T02:29:00+02:00,2025-05-25,10:29,6,4,10
66,2025-05-25T02:30:00+02:00,2025-05-25,10:30,7,3,10
66,2025-05-25T02:32:00+02:00,2025-05-25,10:32,3,7,10
66,2025-05-25T02:37:00+02:00,2025-05-25,10:37,6,6,12
66,2025-05-25T02:38:00+02:00,2025-05-25,10:38,11,8,19
69,2025-05-25T02:28:00+02:00,2025-05-25,10:28,8,1,9
69,2025-05-25T02:29:00+02:00,2025-05-25,10:29,10,6,16
69,2025-05-25T02:30:00+02:00,2025-05-25,10:30,8,6,14
69,2025-05-25T02:31:00+02:00,2025-05-25,10:31,7,1,8
69,2025-05-25T02:33:00+02:00,2025-05-25,10:33,5,2,7
70,2025-05-25T02:26:00+02:00,2025-05-25,10:26,2,1,3
70,2025-05-25T02:27:00+02:00,2025-05-25,10:27,0,1,1
70,2025-05-25T02:32:00+02:00,2025-05-25,10:32,3,1,4
70,2025-05-25T02:33:00+02:00,2025-05-25,10:33,3,4,7
70,2025-05-25T02:35:00+02:00,2025-05-25,10:35,3,2,5
70,2025-05-25T02:36:00+02:00,2025-05-25,10:36,1,0,1
70,2025-05-25T02:37:00+02:00,2025-05-25,10:37,0,3,3
70,2025-05-25T02:38:00+02:00,2025-05-25,10:38,0,3,3
75,2025-05-25T02:25:00+02:00,2025-05-25,10:25,2,1,3
75,2025-05-25T02:28:00+02:00,2025-05-25,10:28,1,0,1
75,2025-05-25T02:31:00+02:00,2025-05-25,10:31,2,0,2
75,2025-05-25T02:34:00+02:00,2025-05-25,10:34,0,1,1
75,2025-05-25T02:36:00+02:00,2025-05-25,10:36,5,4,9
75,2025-05-25T02:39:00+02:00,2025-05-25,10:39,1,0,1
78,2025-05-25T02:25:00+02:00,2025-05-25,10:25,3,2,5
78,2025-05-25T02:28:00+02:00,2025-05-25,10:28,0,1,1
78,2025-05-25T02:32:00+02:00,2025-05-25,10:32,1,0,1
78,2025-05-25T02:33:00+02:00,2025-05-25,10:33,1,0,1
78,2025-05-25T02:34:00+02:00,2025-05-25,10:34,2,1,3
78,2025-05-25T02:36:00+02:00,2025-05-25,10:36,0,1,1
78,2025-05-25T02:38:00+02:00,2025-05-25,10:38,3,0,3
84,2025-05-25T02:25:00+02:00,2025-05-25,10:25,68,28,96
87,2025-05-25T02:29:00+02:00,2025-05-25,10:29,0,1,1
87,2025-05-25T02:30:00+02:00,2025-05-25,10:30,2,0,2
87,2025-05-25T02:33:00+02:00,2025-05-25,10:33,0,6,6
87,2025-05-25T02:34:00+02:00,2025-05-25,10:34,0,2,2
87,2025-05-25T02:36:00+02:00,2025-05-25,10:36,2,4,6
107,2025-05-25T02:25:00+02:00,2025-05-25,10:25,8,16,24
107,2025-05-25T02:35:00+02:00,2025-05-25,10:35,10,18,28
108,2025-05-25T02:33:00+02:00,2025-05-25,10:33,1,2,3
108,2025-05-25T02:35:00+02:00,2025-05-25,10:35,5,4,9
108,2025-05-25T02:36:00+02:00,2025-05-25,10:36,1,0,1
118,2025-05-25T02:25:00+02:00,2025-05-25,10:25,3,1,4
132,2025-05-25T02:25:00+02:00,2025-05-25,10:25,13,10,23
134,2025-05-25T02:30:00+02:00,2025-05-25,10:30,24,34,58
140,2025-05-25T02:30:00+02:00,2025-05-25,10:30,14,4,18
162,2025-05-25T02:25:00+02:00,2025-05-25,10:25,38,33,71
165,2025-05-25T02:30:00+02:00,2025-05-25,10:30,2,6,8
179,2025-05-25T02:35:00+02:00,2025-05-25,10:35,9,3,12
1,2025-05-25T02:36:00+02:00,2025-05-25,10:36,8,14,22
1,2025-05-25T02:37:00+02:00,2025-05-25,10:37,17,8,25
2,2025-05-25T02:26:00+02:00,2025-05-25,10:26,0,10,10
2,2025-05-25T02:29:00+02:00,2025-05-25,10:29,8,0,8
2,2025-05-25T02:31:00+02:00,2025-05-25,10:31,6,8,14
9,2025-05-25T02:28:00+02:00,2025-05-25,10:28,0,2,2
9,2025-05-25T02:33:00+02:00,2025-05-25,10:33,0,1,1
9,2025-05-25T02:34:00+02:00,2025-05-25,10:34,0,3,3
9,2025-05-25T02:35:00+02:00,2025-05-25,10:35,0,2,2
10,2025-05-25T02:39:00+02:00,2025-05-25,10:39,0,1,1
11,2025-05-25T02:26:00+02:00,2025-05-25,10:26,1,0,1
11,2025-05-25T02:29:00+02:00,2025-05-25,10:29,1,0,1
11,2025-05-25T02:32:00+02:00,2025-05-25,10:32,0,2,2
11,2025-05-25T02:33:00+02:00,2025-05-25,10:33,0,3,3
11,2025-05-25T02:35:00+02:00,2025-05-25,10:35,5,4,9
11,2025-05-25T02:37:00+02:00,2025-05-25,10:37,1,2,3
12,2025-05-25T02:29:00+02:00,2025-05-25,10:29,1,6,7
12,2025-05-25T02:30:00+02:00,2025-05-25,10:30,2,2,4
12,2025-05-25T02:31:00+02:00,2025-05-25,10:31,0,7,7
12,2025-05-25T02:34:00+02:00,2025-05-25,10:34,7,3,10
12,2025-05-25T02:35:00+02:00,2025-05-25,10:35,0,2,2
17,2025-05-25T02:28:00+02:00,2025-05-25,10:28,6,3,9
17,2025-05-25T02:29:00+02:00,2025-05-25,10:29,1,1,2
17,2025-05-25T02:35:00+02:00,2025-05-25,10:35,0,6,6
17,2025-05-25T02:37:00+02:00,2025-05-25,10:37,7,1,8
17,2025-05-25T02:38:00+02:00,2025-05-25,10:38,5,7,12
18,2025-05-25T02:27:00+02:00,2025-05-25,10:27,0,2,2
18,2025-05-25T02:39:00+02:00,2025-05-25,10:39,0,3,3
19,2025-05-25T02:29:00+02:00,2025-05-25,10:29,2,1,3
19,2025-05-25T02:37:00+02:00,2025-05-25,10:37,4,5,9
19,2025-05-25T02:38:00+02:00,2025-05-25,10:38,1,10,11
20,2025-05-25T02:26:00+02:00,2025-05-25,10:26,0,2,2
20,2025-05-25T02:29:00+02:00,2025-05-25,10:29,1,0,1
20,2025-05-25T02:33:00+02:00,2025-05-25,10:33,1,2,3
20,2025-05-25T02:34:00+02:00,2025-05-25,10:34,2,2,4
20,2025-05-25T02:35:00+02:00,2025-05-25,10:35,0,2,2
23,2025-05-25T02:25:00+02:00,2025-05-25,10:25,4,1,5
23,2025-05-25T02:29:00+02:00,2025-05-25,10:29,6,1,7
23,2025-05-25T02:30:00+02:00,2025-05-25,10:30,1,2,3
23,2025-05-25T02:32:00+02:00,2025-05-25,10:32,4,0,4
23,2025-05-25T02:34:00+02:00,2025-05-25,10:34,1,4,5
23,2025-05-25T02:36:00+02:00,2025-05-25,10:36,4,3,7
23,2025-05-25T02:37:00+02:00,2025-05-25,10:37,2,3,5
23,2025-05-25T02:38:00+02:00,2025-05-25,10:38,6,0,6
24,2025-05-25T02:28:00+02:00,2025-05-25,10:28,6,3,9
24,2025-05-25T02:30:00+02:00,2025-05-25,10:30,8,13,21
24,2025-05-25T02:32:00+02:00,2025-05-25,10:32,2,7,9
24,2025-05-25T02:36:00+02:00,2025-05-25,10:36,11,15,26
24,2025-05-25T02:37:00+02:00,2025-05-25,10:37,5,7,12
24,2025-05-25T02:39:00+02:00,2025-05-25,10:39,10,4,14
27,2025-05-25T02:29:00+02:00,2025-05-25,10:29,2,0,2
27,2025-05-25T02:31:00+02:00,2025-05-25,10:31,6,5,11
27,2025-05-25T02:34:00+02:00,2025-05-25,10:34,3,1,4
27,2025-05-25T02:38:00+02:00,2025-05-25,10:38,6,8,14
30,2025-05-25T02:26:00+02:00,2025-05-25,10:26,1,5,6
30,2025-05-25T02:29:00+02:00,2025-05-25,10:29,0,6,6
30,2025-05-25T02:31:00+02:00,2025-05-25,10:31,1,3,4
30,2025-05-25T02:33:00+02:00,2025-05-25,10:33,3,6,9
35,2025-05-25T02:27:00+02:00,2025-05-25,10:27,11,4,15
35,2025-05-25T02:34:00+02:00,2025-05-25,10:34,20,13,33
35,2025-05-25T02:36:00+02:00,2025-05-25,10:36,6,21,27
35,2025-05-25T02:38:00+02:00,2025-05-25,10:38,10,17,27
46,2025-05-25T02:35:00+02:00,2025-05-25,10:35,3,7,10
48,2025-05-25T02:25:00+02:00,2025-05-25,10:25,5,5,10
48,2025-05-25T02:28:00+02:00,2025-05-25,10:28,2,1,3
48,2025-05-25T02:39:00+02:00,2025-05-25,10:39,18,7,25
49,2025-05-25T02:26:00+02:00,2025-05-25,10:26,3,9,12
49,2025-05-25T02:27:00+02:00,2025-05-25,10:27,3,10,13
49,2025-05-25T02:28:00+02:00,2025-05-25,10:28,6,6,12
49,2025-05-25T02:29:00+02:00,2025-05-25,10:29,3,9,12
49,2025-05-25T02:32:00+02:00,2025-05-25,10:32,10,8,18
49,2025-05-25T02:33:00+02:00,2025-05-25,10:33,0,8,8
49,2025-05-25T02:34:00+02:00,2025-05-25,10:34,2,10,12
49,2025-05-25T02:38:00+02:00,2025-05-25,10:38,4,2,6
51,2025-05-25T02:26:00+02:00,2025-05-25,10:26,0,1,1
51,2025-05-25T02:29:00+02:00,2025-05-25,10:29,2,1,3
51,2025-05-25T02:35:00+02:00,2025-05-25,10:35,2,1,3
52,2025-05-25T02:29:00+02:00,2025-05-25,10:29,2,2,4
53,2025-05-25T02:25:00+02:00,2025-05-25,10:25,4,2,6
53,2025-05-25T02:27:00+02:00,2025-05-25,10:27,9,2,11
53,2025-05-25T02:30:00+02:00,2025-05-25,10:30,6,2,8
53,2025-05-25T02:32:00+02:00,2025-05-25,10:32,12,3,15
53,2025-05-25T02:34:00+02:00,2025-05-25,10:34,4,1,5
56,2025-05-25T02:29:00+02:00,2025-05-25,10:29,6,1,7
56,2025-05-25T02:30:00+02:00,2025-05-25,10:30,4,2,6
56,2025-05-25T02:34:00+02:00,2025-05-25,10:34,5,2,7
56,2025-05-25T02:35:00+02:00,2025-05-25,10:35,4,2,6
56,2025-05-25T02:37:00+02:00,2025-05-25,10:37,6,6,12
58,2025-05-25T02:26:00+02:00,2025-05-25,10:26,13,6,19
58,2025-05-25T02:31:00+02:00,2025-05-25,10:31,10,1,11
58,2025-05-25T02:36:00+02:00,2025-05-25,10:36,10,2,12
58,2025-05-25T02:37:00+02:00,2025-05-25,10:37,2,2,4
62,2025-05-25T02:27:00+02:00,2025-05-25,10:27,1,1,2
62,2025-05-25T02:28:00+02:00,2025-05-25,10:28,6,3,9
63,2025-05-25T02:26:00+02:00,2025-05-25,10:26,5,4,9
63,2025-05-25T02:31:00+02:00,2025-05-25,10:31,0,2,2
63,2025-05-25T02:33:00+02:00,2025-05-25,10:33,2,0,2
63,2025-05-25T02:36:00+02:00,2025-05-25,10:36,0,6,6
63,2025-05-25T02:38:00+02:00,2025-05-25,10:38,9,1,10
63,2025-05-25T02:39:00+02:00,2025-05-25,10:39,1,2,3
67,2025-05-25T02:25:00+02:00,2025-05-25,10:25,5,2,7
67,2025-05-25T02:27:00+02:00,2025-05-25,10:27,5,0,5
67,2025-05-25T02:31:00+02:00,2025-05-25,10:31,6,10,16
67,2025-05-25T02:36:00+02:00,2025-05-25,10:36,8,9,17
67,2025-05-25T02:37:00+02:00,2025-05-25,10:37,7,3,10
68,2025-05-25T02:25:00+02:00,2025-05-25,10:25,8,6,14
68,2025-05-25T02:26:00+02:00,2025-05-25,10:26,5,8,13
68,2025-05-25T02:30:00+02:00,2025-05-25,10:30,5,5,10
68,2025-05-25T02:31:00+02:00,2025-05-25,10:31,2,0,2
68,2025-05-25T02:38:00+02:00,2025-05-25,10:38,7,1,8
72,2025-05-25T02:26:00+02:00,2025-05-25,10:26,1,2,3
72,2025-05-25T02:30:00+02:00,2025-05-25,10:30,1,12,13
72,2025-05-25T02:33:00+02:00,2025-05-25,10:33,2,4,6
72,2025-05-25T02:35:00+02:00,2025-05-25,10:35,0,1,1
72,2025-05-25T02:36:00+02:00,2025-05-25,10:36,1,6,7
76,2025-05-25T02:26:00+02:00,2025-05-25,10:26,0,2,2
76,2025-05-25T02:32:00+02:00,2025-05-25,10:32,1,1,2
76,2025-05-25T02:33:00+02:00,2025-05-25,10:33,2,0,2
76,2025-05-25T02:34:00+02:00,2025-05-25,10:34,2,0,2
79,2025-05-25T02:25:00+02:00,2025-05-25,10:25,6,10,16
79,2025-05-25T02:26:00+02:00,2025-05-25,10:26,5,0,5
79,2025-05-25T02:27:00+02:00,2025-05-25,10:27,17,5,22
79,2025-05-25T02:35:00+02:00,2025-05-25,10:35,11,3,14
85,2025-05-25T02:28:00+02:00,2025-05-25,10:28,1,1,2
85,2025-05-25T02:33:00+02:00,2025-05-25,10:33,0,1,1
85,2025-05-25T02:37:00+02:00,2025-05-25,10:37,0,2,2
85,2025-05-25T02:38:00+02:00,2025-05-25,10:38,4,3,7
86,2025-05-25T02:33:00+02:00,2025-05-25,10:33,2,0,2
86,2025-05-25T02:37:00+02:00,2025-05-25,10:37,0,3,3
86,2025-05-25T02:38:00+02:00,2025-05-25,10:38,3,0,3
109,2025-05-25T02:30:00+02:00,2025-05-25,10:30,8,4,12
117,2025-05-25T02:25:00+02:00,2025-05-25,10:25,13,8,21
117,2025-05-25T02:30:00+02:00,2025-05-25,10:30,7,7,14
117,2025-05-25T02:35:00+02:00,2025-05-25,10:35,7,9,16
130,2025-05-25T02:30:00+02:00,2025-05-25,10:30,2,2,4
130,2025-05-25T02:35:00+02:00,2025-05-25,10:35,1,1,2
137,2025-05-25T02:35:00+02:00,2025-05-25,10:35,0,1,1
139,2025-05-25T02:25:00+02:00,2025-05-25,10:25,2,1,3
141,2025-05-25T02:25:00+02:00,2025-05-25,10:25,6,5,11
141,2025-05-25T02:35:00+02:00,2025-05-25,10:35,5,15,20
142,2025-05-25T02:25:00+02:00,2025-05-25,10:25,29,57,86
161,2025-05-25T02:35:00+02:00,2025-05-25,10:35,9,9,18
181,2025-05-25T02:43:00+02:00,2025-05-25,10:43,4,13,17
181,2025-05-25T02:45:00+02:00,2025-05-25,10:45,0,18,18
181,2025-05-25T02:51:00+02:00,2025-05-25,10:51,8,9,17
181,2025-05-25T02:52:00+02:00,2025-05-25,10:52,6,13,19
181,2025-05-25T02:53:00+02:00,2025-05-25,10:53,17,8,25
182,2025-05-25T02:50:00+02:00,2025-05-25,10:50,23,11,34
180,2025-05-25T02:49:00+02:00,2025-05-25,10:49,0,1,1
180,2025-05-25T02:51:00+02:00,2025-05-25,10:51,2,0,2
180,2025-05-25T02:54:00+02:00,2025-05-25,10:54,4,2,6
3,2025-05-25T02:43:00+02:00,2025-05-25,10:43,8,11,19
3,2025-05-25T02:48:00+02:00,2025-05-25,10:48,7,8,15
4,2025-05-25T02:41:00+02:00,2025-05-25,10:41,4,14,18
4,2025-05-25T02:42:00+02:00,2025-05-25,10:42,18,5,23
4,2025-05-25T02:43:00+02:00,2025-05-25,10:43,6,7,13
4,2025-05-25T02:48:00+02:00,2025-05-25,10:48,6,12,18
4,2025-05-25T02:53:00+02:00,2025-05-25,10:53,16,10,26
4,2025-05-25T02:54:00+02:00,2025-05-25,10:54,15,5,20
5,2025-05-25T02:40:00+02:00,2025-05-25,10:40,43,51,94
5,2025-05-25T02:45:00+02:00,2025-05-25,10:45,55,79,134
6,2025-05-25T02:40:00+02:00,2025-05-25,10:40,8,6,14
6,2025-05-25T02:43:00+02:00,2025-05-25,10:43,13,12,25
6,2025-05-25T02:44:00+02:00,2025-05-25,10:44,7,12,19
6,2025-05-25T02:45:00+02:00,2025-05-25,10:45,12,10,22
6,2025-05-25T02:48:00+02:00,2025-05-25,10:48,5,22,27
6,2025-05-25T02:53:00+02:00,2025-05-25,10:53,9,10,19
8,2025-05-25T02:41:00+02:00,2025-05-25,10:41,4,4,8
8,2025-05-25T02:43:00+02:00,2025-05-25,10:43,4,11,15
8,2025-05-25T02:44:00+02:00,2025-05-25,10:44,0,6,6
8,2025-05-25T02:50:00+02:00,2025-05-25,10:50,0,13,13
8,2025-05-25T02:51:00+02:00,2025-05-25,10:51,1,5,6
28,2025-05-25T02:40:00+02:00,2025-05-25,10:40,2,3,5
28,2025-05-25T02:42:00+02:00,2025-05-25,10:42,8,7,15
28,2025-05-25T02:43:00+02:00,2025-05-25,10:43,4,0,4
28,2025-05-25T02:48:00+02:00,2025-05-25,10:48,11,3,14
28,2025-05-25T02:49:00+02:00,2025-05-25,10:49,8,5,13
28,2025-05-25T02:50:00+02:00,2025-05-25,10:50,9,7,16
28,2025-05-25T02:52:00+02:00,2025-05-25,10:52,15,6,21
28,2025-05-25T02:54:00+02:00,2025-05-25,10:54,5,1,6
29,2025-05-25T02:42:00+02:00,2025-05-25,10:42,2,7,9
29,2025-05-25T02:47:00+02:00,2025-05-25,10:47,4,0,4
29,2025-05-25T02:51:00+02:00,2025-05-25,10:51,3,2,5
31,2025-05-25T02:41:00+02:00,2025-05-25,10:41,2,2,4
31,2025-05-25T02:43:00+02:00,2025-05-25,10:43,8,0,8
31,2025-05-25T02:52:00+02:00,2025-05-25,10:52,1,6,7
31,2025-05-25T02:53:00+02:00,2025-05-25,10:53,1,0,1
31,2025-05-25T02:54:00+02:00,2025-05-25,10:54,1,0,1
36,2025-05-25T02:41:00+02:00,2025-05-25,10:41,3,1,4
36,2025-05-25T02:45:00+02:00,2025-05-25,10:45,0,3,3
36,2025-05-25T02:46:00+02:00,2025-05-25,10:46,2,5,7
36,2025-05-25T02:48:00+02:00,2025-05-25,10:48,3,3,6
36,2025-05-25T02:52:00+02:00,2025-05-25,10:52,3,2,5
36,2025-05-25T02:53:00+02:00,2025-05-25,10:53,5,0,5
36,2025-05-25T02:54:00+02:00,2025-05-25,10:54,2,0,2
37,2025-05-25T02:41:00+02:00,2025-05-25,10:41,0,1,1
37,2025-05-25T02:45:00+02:00,2025-05-25,10:45,1,0,1
37,2025-05-25T02:49:00+02:00,2025-05-25,10:49,1,0,1
37,2025-05-25T02:50:00+02:00,2025-05-25,10:50,0,2,2
39,2025-05-25T02:47:00+02:00,2025-05-25,10:47,1,0,1
40,2025-05-25T02:43:00+02:00,2025-05-25,10:43,1,2,3
40,2025-05-25T02:45:00+02:00,2025-05-25,10:45,1,1,2
40,2025-05-25T02:47:00+02:00,2025-05-25,10:47,0,5,5
40,2025-05-25T02:50:00+02:00,2025-05-25,10:50,2,4,6
40,2025-05-25T02:53:00+02:00,2025-05-25,10:53,3,0,3
41,2025-05-25T02:45:00+02:00,2025-05-25,10:45,5,0,5
41,2025-05-25T02:46:00+02:00,2025-05-25,10:46,6,7,13
44,2025-05-25T02:45:00+02:00,2025-05-25,10:45,2,1,3
45,2025-05-25T02:40:00+02:00,2025-05-25,10:40,17,9,26
45,2025-05-25T02:46:00+02:00,2025-05-25,10:46,8,6,14
45,2025-05-25T02:54:00+02:00,2025-05-25,10:54,13,2,15
47,2025-05-25T02:41:00+02:00,2025-05-25,10:41,15,4,19
47,2025-05-25T02:42:00+02:00,2025-05-25,10:42,8,8,16
47,2025-05-25T02:43:00+02:00,2025-05-25,10:43,4,13,17
47,2025-05-25T02:50:00+02:00,2025-05-25,10:50,16,11,27
47,2025-05-25T02:51:00+02:00,2025-05-25,10:51,23,7,30
50,2025-05-25T02:42:00+02:00,2025-05-25,10:42,2,4,6
50,2025-05-25T02:43:00+02:00,2025-05-25,10:43,0,3,3
50,2025-05-25T02:44:00+02:00,2025-05-25,10:44,3,4,7
50,2025-05-25T02:45:00+02:00,2025-05-25,10:45,1,2,3
50,2025-05-25T02:46:00+02:00,2025-05-25,10:46,1,6,7
50,2025-05-25T02:47:00+02:00,2025-05-25,10:47,2,0,2
50,2025-05-25T02:52:00+02:00,2025-05-25,10:52,2,1,3
54,2025-05-25T02:41:00+02:00,2025-05-25,10:41,1,3,4
54,2025-05-25T02:50:00+02:00,2025-05-25,10:50,2,1,3
54,2025-05-25T02:54:00+02:00,2025-05-25,10:54,2,0,2
61,2025-05-25T02:40:00+02:00,2025-05-25,10:40,6,13,19
61,2025-05-25T02:42:00+02:00,2025-05-25,10:42,2,9,11
61,2025-05-25T02:45:00+02:00,2025-05-25,10:45,1,1,2
61,2025-05-25T02:47:00+02:00,2025-05-25,10:47,6,6,12
61,2025-05-25T02:51:00+02:00,2025-05-25,10:51,7,11,18
66,2025-05-25T02:41:00+02:00,2025-05-25,10:41,11,15,26
66,2025-05-25T02:53:00+02:00,2025-05-25,10:53,14,9,23
66,2025-05-25T02:54:00+02:00,2025-05-25,10:54,17,13,30
69,2025-05-25T02:45:00+02:00,2025-05-25,10:45,3,7,10
69,2025-05-25T02:48:00+02:00,2025-05-25,10:48,8,4,12
69,2025-05-25T02:53:00+02:00,2025-05-25,10:53,4,1,5
70,2025-05-25T02:41:00+02:00,2025-05-25,10:41,4,4,8
70,2025-05-25T02:50:00+02:00,2025-05-25,10:50,1,0,1
70,2025-05-25T02:51:00+02:00,2025-05-25,10:51,1,1,2
70,2025-05-25T02:53:00+02:00,2025-05-25,10:53,2,2,4
70,2025-05-25T02:54:00+02:00,2025-05-25,10:54,7,6,13
71,2025-05-25T02:44:00+02:00,2025-05-25,10:44,2,0,2
75,2025-05-25T02:45:00+02:00,2025-05-25,10:45,1,0,1
75,2025-05-25T02:48:00+02:00,2025-05-25,10:48,1,1,2
75,2025-05-25T02:51:00+02:00,2025-05-25,10:51,2,1,3
75,2025-05-25T02:53:00+02:00,2025-05-25,10:53,1,0,1
77,2025-05-25T02:45:00+02:00,2025-05-25,10:45,18,6,24
78,2025-05-25T02:41:00+02:00,2025-05-25,10:41,1,5,6
78,2025-05-25T02:42:00+02:00,2025-05-25,10:42,0,2,2
78,2025-05-25T02:44:00+02:00,2025-05-25,10:44,0,4,4
78,2025-05-25T02:53:00+02:00,2025-05-25,10:53,0,1,1
84,2025-05-25T02:40:00+02:00,2025-05-25,10:40,123,46,169
87,2025-05-25T02:40:00+02:00,2025-05-25,10:40,4,1,5
87,2025-05-25T02:44:00+02:00,2025-05-25,10:44,1,0,1
87,2025-05-25T02:45:00+02:00,2025-05-25,10:45,3,3,6
87,2025-05-25T02:46:00+02:00,2025-05-25,10:46,0,3,3
87,2025-05-25T02:47:00+02:00,2025-05-25,10:47,1,1,2
87,2025-05-25T02:48:00+02:00,2025-05-25,10:48,1,2,3
87,2025-05-25T02:50:00+02:00,2025-05-25,10:50,2,3,5
87,2025-05-25T02:52:00+02:00,2025-05-25,10:52,3,0,3
107,2025-05-25T02:45:00+02:00,2025-05-25,10:45,2,4,6
108,2025-05-25T02:40:00+02:00,2025-05-25,10:40,1,3,4
108,2025-05-25T02:45:00+02:00,2025-05-25,10:45,1,1,2
108,2025-05-25T02:53:00+02:00,2025-05-25,10:53,5,2,7
118,2025-05-25T02:40:00+02:00,2025-05-25,10:40,1,0,1
131,2025-05-25T02:40:00+02:00,2025-05-25,10:40,3,8,11
131,2025-05-25T02:45:00+02:00,2025-05-25,10:45,3,7,10
131,2025-05-25T02:50:00+02:00,2025-05-25,10:50,15,13,28
132,2025-05-25T02:45:00+02:00,2025-05-25,10:45,18,4,22
132,2025-05-25T02:50:00+02:00,2025-05-25,10:50,6,6,12
133,2025-05-25T02:40:00+02:00,2025-05-25,10:40,21,34,55
133,2025-05-25T02:45:00+02:00,2025-05-25,10:45,31,45,76
135,2025-05-25T02:50:00+02:00,2025-05-25,10:50,22,33,55
140,2025-05-25T02:50:00+02:00,2025-05-25,10:50,9,3,12
162,2025-05-25T02:50:00+02:00,2025-05-25,10:50,51,49,100
167,2025-05-25T02:45:00+02:00,2025-05-25,10:45,0,2,2
179,2025-05-25T02:40:00+02:00,2025-05-25,10:40,9,1,10
179,2025-05-25T02:45:00+02:00,2025-05-25,10:45,5,8,13
1,2025-05-25T02:47:00+02:00,2025-05-25,10:47,4,7,11
1,2025-05-25T02:51:00+02:00,2025-05-25,10:51,13,11,24
2,2025-05-25T02:40:00+02:00,2025-05-25,10:40,6,6,12
2,2025-05-25T02:43:00+02:00,2025-05-25,10:43,2,4,6
2,2025-05-25T02:44:00+02:00,2025-05-25,10:44,3,3,6
2,2025-05-25T02:47:00+02:00,2025-05-25,10:47,3,12,15
2,2025-05-25T02:48:00+02:00,2025-05-25,10:48,2,5,7
2,2025-05-25T02:49:00+02:00,2025-05-25,10:49,6,7,13
2,2025-05-25T02:50:00+02:00,2025-05-25,10:50,3,5,8
2,2025-05-25T02:54:00+02:00,2025-05-25,10:54,1,9,10
9,2025-05-25T02:40:00+02:00,2025-05-25,10:40,2,0,2
9,2025-05-25T02:41:00+02:00,2025-05-25,10:41,1,0,1
9,2025-05-25T02:43:00+02:00,2025-05-25,10:43,0,1,1
9,2025-05-25T02:47:00+02:00,2025-05-25,10:47,0,2,2
9,2025-05-25T02:54:00+02:00,2025-05-25,10:54,0,1,1
10,2025-05-25T02:48:00+02:00,2025-05-25,10:48,1,2,3
11,2025-05-25T02:40:00+02:00,2025-05-25,10:40,1,2,3
11,2025-05-25T02:44:00+02:00,2025-05-25,10:44,2,4,6
11,2025-05-25T02:47:00+02:00,2025-05-25,10:47,4,0,4
12,2025-05-25T02:42:00+02:00,2025-05-25,10:42,4,0,4
12,2025-05-25T02:43:00+02:00,2025-05-25,10:43,2,5,7
12,2025-05-25T02:53:00+02:00,2025-05-25,10:53,1,1,2
17,2025-05-25T02:42:00+02:00,2025-05-25,10:42,1,1,2
17,2025-05-25T02:45:00+02:00,2025-05-25,10:45,2,0,2
17,2025-05-25T02:48:00+02:00,2025-05-25,10:48,5,1,6
17,2025-05-25T02:54:00+02:00,2025-05-25,10:54,0,2,2
18,2025-05-25T02:40:00+02:00,2025-05-25,10:40,2,1,3
18,2025-05-25T02:49:00+02:00,2025-05-25,10:49,1,3,4
19,2025-05-25T02:45:00+02:00,2025-05-25,10:45,12,0,12
19,2025-05-25T02:52:00+02:00,2025-05-25,10:52,3,0,3
19,2025-05-25T02:53:00+02:00,2025-05-25,10:53,2,3,5
19,2025-05-25T02:54:00+02:00,2025-05-25,10:54,3,3,6
20,2025-05-25T02:43:00+02:00,2025-05-25,10:43,0,3,3
20,2025-05-25T02:46:00+02:00,2025-05-25,10:46,6,0,6
20,2025-05-25T02:48:00+02:00,2025-05-25,10:48,4,0,4
20,2025-05-25T02:50:00+02:00,2025-05-25,10:50,8,1,9
23,2025-05-25T02:40:00+02:00,2025-05-25,10:40,0,3,3
23,2025-05-25T02:45:00+02:00,2025-05-25,10:45,2,2,4
23,2025-05-25T02:48:00+02:00,2025-05-25,10:48,4,2,6
23,2025-05-25T02:50:00+02:00,2025-05-25,10:50,5,0,5
24,2025-05-25T02:40:00+02:00,2025-05-25,10:40,5,3,8
24,2025-05-25T02:41:00+02:00,2025-05-25,10:41,8,2,10
24,2025-05-25T02:43:00+02:00,2025-05-25,10:43,7,2,9
24,2025-05-25T02:45:00+02:00,2025-05-25,10:45,2,15,17
24,2025-05-25T02:47:00+02:00,2025-05-25,10:47,18,3,21
24,2025-05-25T02:48:00+02:00,2025-05-25,10:48,8,1,9
24,2025-05-25T02:53:00+02:00,2025-05-25,10:53,5,12,17
24,2025-05-25T02:54:00+02:00,2025-05-25,10:54,4,6,10
25,2025-05-25T02:40:00+02:00,2025-05-25,10:40,24,74,98
27,2025-05-25T02:44:00+02:00,2025-05-25,10:44,2,0,2
27,2025-05-25T02:46:00+02:00,2025-05-25,10:46,0,7,7
27,2025-05-25T02:50:00+02:00,2025-05-25,10:50,4,3,7
27,2025-05-25T02:52:00+02:00,2025-05-25,10:52,3,4,7
30,2025-05-25T02:40:00+02:00,2025-05-25,10:40,0,6,6
30,2025-05-25T02:42:00+02:00,2025-05-25,10:42,5,2,7
30,2025-05-25T02:43:00+02:00,2025-05-25,10:43,1,2,3
30,2025-05-25T02:44:00+02:00,2025-05-25,10:44,1,3,4
30,2025-05-25T02:48:00+02:00,2025-05-25,10:48,1,3,4
30,2025-05-25T02:49:00+02:00,2025-05-25,10:49,4,3,7
30,2025-05-25T02:50:00+02:00,2025-05-25,10:50,0,3,3
30,2025-05-25T02:53:00+02:00,2025-05-25,10:53,2,0,2
35,2025-05-25T02:40:00+02:00,2025-05-25,10:40,14,11,25
46,2025-05-25T02:50:00+02:00,2025-05-25,10:50,1,2,3
48,2025-05-25T02:43:00+02:00,2025-05-25,10:43,11,3,14
48,2025-05-25T02:51:00+02:00,2025-05-25,10:51,10,2,12
48,2025-05-25T02:54:00+02:00,2025-05-25,10:54,6,0,6
49,2025-05-25T02:41:00+02:00,2025-05-25,10:41,3,10,13
49,2025-05-25T02:42:00+02:00,2025-05-25,10:42,8,12,20
49,2025-05-25T02:43:00+02:00,2025-05-25,10:43,4,11,15
49,2025-05-25T02:46:00+02:00,2025-05-25,10:46,7,5,12
49,2025-05-25T02:50:00+02:00,2025-05-25,10:50,7,8,15
49,2025-05-25T02:51:00+02:00,2025-05-25,10:51,9,4,13
49,2025-05-25T02:53:00+02:00,2025-05-25,10:53,3,6,9
49,2025-05-25T02:54:00+02:00,2025-05-25,10:54,1,7,8
51,2025-05-25T02:41:00+02:00,2025-05-25,10:41,1,3,4
51,2025-05-25T02:42:00+02:00,2025-05-25,10:42,1,3,4
51,2025-05-25T02:44:00+02:00,2025-05-25,10:44,2,8,10
51,2025-05-25T02:46:00+02:00,2025-05-25,10:46,1,3,4
51,2025-05-25T02:47:00+02:00,2025-05-25,10:47,0,2,2
51,2025-05-25T02:49:00+02:00,2025-05-25,10:49,0,3,3
51,2025-05-25T02:51:00+02:00,2025-05-25,10:51,0,4,4
52,2025-05-25T02:40:00+02:00,2025-05-25,10:40,3,0,3
52,2025-05-25T02:45:00+02:00,2025-05-25,10:45,2,1,3
52,2025-05-25T02:47:00+02:00,2025-05-25,10:47,1,2,3
52,2025-05-25T02:49:00+02:00,2025-05-25,10:49,0,2,2
53,2025-05-25T02:42:00+02:00,2025-05-25,10:42,7,0,7
53,2025-05-25T02:43:00+02:00,2025-05-25,10:43,5,7,12
53,2025-05-25T02:46:00+02:00,2025-05-25,10:46,10,2,12
53,2025-05-25T02:48:00+02:00,2025-05-25,10:48,11,0,11
53,2025-05-25T02:49:00+02:00,2025-05-25,10:49,2,8,10
53,2025-05-25T02:51:00+02:00,2025-05-25,10:51,14,8,22
53,2025-05-25T02:54:00+02:00,2025-05-25,10:54,17,9,26
56,2025-05-25T02:41:00+02:00,2025-05-25,10:41,10,6,16
56,2025-05-25T02:45:00+02:00,2025-05-25,10:45,3,6,9
56,2025-05-25T02:46:00+02:00,2025-05-25,10:46,3,3,6
56,2025-05-25T02:49:00+02:00,2025-05-25,10:49,3,7,10
56,2025-05-25T02:51:00+02:00,2025-05-25,10:51,5,3,8
56,2025-05-25T02:52:00+02:00,2025-05-25,10:52,7,5,12
56,2025-05-25T02:54:00+02:00,2025-05-25,10:54,6,4,10
58,2025-05-25T02:42:00+02:00,2025-05-25,10:42,10,3,13
58,2025-05-25T02:46:00+02:00,2025-05-25,10:46,18,0,18
58,2025-05-25T02:49:00+02:00,2025-05-25,10:49,18,2,20
58,2025-05-25T02:51:00+02:00,2025-05-25,10:51,13,8,21
62,2025-05-25T02:47:00+02:00,2025-05-25,10:47,3,0,3
62,2025-05-25T02:54:00+02:00,2025-05-25,10:54,1,1,2
63,2025-05-25T02:40:00+02:00,2025-05-25,10:40,4,7,11
63,2025-05-25T02:43:00+02:00,2025-05-25,10:43,1,8,9
63,2025-05-25T02:45:00+02:00,2025-05-25,10:45,3,8,11
63,2025-05-25T02:46:00+02:00,2025-05-25,10:46,2,8,10
63,2025-05-25T02:49:00+02:00,2025-05-25,10:49,7,2,9
63,2025-05-25T02:50:00+02:00,2025-05-25,10:50,3,3,6
63,2025-05-25T02:51:00+02:00,2025-05-25,10:51,2,6,8
63,2025-05-25T02:53:00+02:00,2025-05-25,10:53,1,4,5
63,2025-05-25T02:54:00+02:00,2025-05-25,10:54,1,3,4
67,2025-05-25T02:40:00+02:00,2025-05-25,10:40,1,6,7
67,2025-05-25T02:47:00+02:00,2025-05-25,10:47,6,3,9
67,2025-05-25T02:48:00+02:00,2025-05-25,10:48,4,2,6
67,2025-05-25T02:50:00+02:00,2025-05-25,10:50,5,8,13
67,2025-05-25T02:51:00+02:00,2025-05-25,10:51,11,2,13
67,2025-05-25T02:52:00+02:00,2025-05-25,10:52,4,7,11
68,2025-05-25T02:44:00+02:00,2025-05-25,10:44,5,2,7
68,2025-05-25T02:46:00+02:00,2025-05-25,10:46,13,5,18
68,2025-05-25T02:47:00+02:00,2025-05-25,10:47,2,8,10
68,2025-05-25T02:52:00+02:00,2025-05-25,10:52,2,5,7
72,2025-05-25T02:40:00+02:00,2025-05-25,10:40,1,2,3
72,2025-05-25T02:43:00+02:00,2025-05-25,10:43,0,1,1
72,2025-05-25T02:45:00+02:00,2025-05-25,10:45,2,1,3
72,2025-05-25T02:48:00+02:00,2025-05-25,10:48,4,3,7
72,2025-05-25T02:51:00+02:00,2025-05-25,10:51,4,1,5
72,2025-05-25T02:53:00+02:00,2025-05-25,10:53,2,4,6
76,2025-05-25T02:43:00+02:00,2025-05-25,10:43,3,0,3
79,2025-05-25T02:43:00+02:00,2025-05-25,10:43,2,10,12
79,2025-05-25T02:44:00+02:00,2025-05-25,10:44,6,8,14
79,2025-05-25T02:48:00+02:00,2025-05-25,10:48,9,10,19
79,2025-05-25T02:49:00+02:00,2025-05-25,10:49,1,1,2
79,2025-05-25T02:50:00+02:00,2025-05-25,10:50,5,4,9
79,2025-05-25T02:51:00+02:00,2025-05-25,10:51,12,8,20
79,2025-05-25T02:53:00+02:00,2025-05-25,10:53,6,11,17
85,2025-05-25T02:41:00+02:00,2025-05-25,10:41,1,2,3
85,2025-05-25T02:43:00+02:00,2025-05-25,10:43,5,2,7
85,2025-05-25T02:49:00+02:00,2025-05-25,10:49,2,1,3
85,2025-05-25T02:53:00+02:00,2025-05-25,10:53,1,1,2
86,2025-05-25T02:44:00+02:00,2025-05-25,10:44,1,3,4
86,2025-05-25T02:45:00+02:00,2025-05-25,10:45,1,0,1
86,2025-05-25T02:51:00+02:00,2025-05-25,10:51,1,0,1
109,2025-05-25T02:40:00+02:00,2025-05-25,10:40,4,5,9
117,2025-05-25T02:40:00+02:00,2025-05-25,10:40,17,11,28
123,2025-05-25T02:50:00+02:00,2025-05-25,10:50,7,3,10
136,2025-05-25T02:40:00+02:00,2025-05-25,10:40,15,6,21
136,2025-05-25T02:50:00+02:00,2025-05-25,10:50,8,17,25
139,2025-05-25T02:40:00+02:00,2025-05-25,10:40,5,3,8
141,2025-05-25T02:50:00+02:00,2025-05-25,10:50,16,31,47
161,2025-05-25T02:40:00+02:00,2025-05-25,10:40,26,12,38
161,2025-05-25T02:50:00+02:00,2025-05-25,10:50,19,28,47
164,2025-05-25T02:45:00+02:00,2025-05-25,10:45,16,1,17
164,2025-05-25T02:50:00+02:00,2025-05-25,10:50,8,6,14
181,2025-05-25T03:03:00+02:00,2025-05-25,11:03,4,13,17
181,2025-05-25T03:08:00+02:00,2025-05-25,11:08,4,15,19
181,2025-05-25T03:09:00+02:00,2025-05-25,11:09,9,12,21
182,2025-05-25T02:55:00+02:00,2025-05-25,10:55,12,9,21
182,2025-05-25T03:05:00+02:00,2025-05-25,11:05,13,15,28
180,2025-05-25T02:57:00+02:00,2025-05-25,10:57,2,0,2
180,2025-05-25T03:06:00+02:00,2025-05-25,11:06,2,0,2
180,2025-05-25T03:07:00+02:00,2025-05-25,11:07,1,0,1
180,2025-05-25T03:09:00+02:00,2025-05-25,11:09,2,3,5
3,2025-05-25T02:57:00+02:00,2025-05-25,10:57,7,6,13
3,2025-05-25T02:58:00+02:00,2025-05-25,10:58,7,5,12
3,2025-05-25T02:59:00+02:00,2025-05-25,10:59,2,8,10
3,2025-05-25T03:02:00+02:00,2025-05-25,11:02,1,30,31
3,2025-05-25T03:03:00+02:00,2025-05-25,11:03,18,8,26
3,2025-05-25T03:04:00+02:00,2025-05-25,11:04,6,6,12
3,2025-05-25T03:08:00+02:00,2025-05-25,11:08,4,10,14
3,2025-05-25T03:09:00+02:00,2025-05-25,11:09,9,12,21
4,2025-05-25T02:59:00+02:00,2025-05-25,10:59,14,10,24
6,2025-05-25T02:55:00+02:00,2025-05-25,10:55,7,8,15
6,2025-05-25T03:03:00+02:00,2025-05-25,11:03,10,9,19
6,2025-05-25T03:04:00+02:00,2025-05-25,11:04,24,6,30
6,2025-05-25T03:08:00+02:00,2025-05-25,11:08,8,11,19
8,2025-05-25T02:55:00+02:00,2025-05-25,10:55,5,2,7
8,2025-05-25T02:58:00+02:00,2025-05-25,10:58,1,14,15
8,2025-05-25T02:59:00+02:00,2025-05-25,10:59,0,3,3
8,2025-05-25T03:04:00+02:00,2025-05-25,11:04,3,2,5
8,2025-05-25T03:05:00+02:00,2025-05-25,11:05,5,7,12
8,2025-05-25T03:08:00+02:00,2025-05-25,11:08,5,4,9
28,2025-05-25T02:57:00+02:00,2025-05-25,10:57,6,1,7
28,2025-05-25T02:59:00+02:00,2025-05-25,10:59,5,8,13
28,2025-05-25T03:01:00+02:00,2025-05-25,11:01,15,7,22
28,2025-05-25T03:04:00+02:00,2025-05-25,11:04,2,6,8
28,2025-05-25T03:05:00+02:00,2025-05-25,11:05,3,10,13
28,2025-05-25T03:06:00+02:00,2025-05-25,11:06,6,3,9
28,2025-05-25T03:08:00+02:00,2025-05-25,11:08,2,4,6
28,2025-05-25T03:09:00+02:00,2025-05-25,11:09,9,10,19
29,2025-05-25T02:55:00+02:00,2025-05-25,10:55,14,2,16
29,2025-05-25T02:56:00+02:00,2025-05-25,10:56,3,5,8
29,2025-05-25T03:00:00+02:00,2025-05-25,11:00,10,7,17
29,2025-05-25T03:02:00+02:00,2025-05-25,11:02,3,2,5
29,2025-05-25T03:03:00+02:00,2025-05-25,11:03,3,2,5
29,2025-05-25T03:06:00+02:00,2025-05-25,11:06,2,9,11
29,2025-05-25T03:08:00+02:00,2025-05-25,11:08,4,6,10
31,2025-05-25T02:57:00+02:00,2025-05-25,10:57,4,2,6
31,2025-05-25T02:58:00+02:00,2025-05-25,10:58,0,1,1
31,2025-05-25T03:04:00+02:00,2025-05-25,11:04,0,2,2
31,2025-05-25T03:06:00+02:00,2025-05-25,11:06,2,0,2
31,2025-05-25T03:08:00+02:00,2025-05-25,11:08,4,1,5
36,2025-05-25T02:57:00+02:00,2025-05-25,10:57,0,3,3
36,2025-05-25T02:59:00+02:00,2025-05-25,10:59,1,0,1
36,2025-05-25T03:02:00+02:00,2025-05-25,11:02,3,6,9
36,2025-05-25T03:08:00+02:00,2025-05-25,11:08,2,8,10
37,2025-05-25T02:56:00+02:00,2025-05-25,10:56,3,1,4
37,2025-05-25T03:00:00+02:00,2025-05-25,11:00,0,1,1
37,2025-05-25T03:02:00+02:00,2025-05-25,11:02,1,2,3
37,2025-05-25T03:03:00+02:00,2025-05-25,11:03,0,2,2
37,2025-05-25T03:04:00+02:00,2025-05-25,11:04,2,1,3
39,2025-05-25T02:56:00+02:00,2025-05-25,10:56,0,2,2
39,2025-05-25T03:03:00+02:00,2025-05-25,11:03,1,0,1
39,2025-05-25T03:04:00+02:00,2025-05-25,11:04,4,2,6
39,2025-05-25T03:07:00+02:00,2025-05-25,11:07,1,0,1
39,2025-05-25T03:09:00+02:00,2025-05-25,11:09,0,1,1
40,2025-05-25T02:56:00+02:00,2025-05-25,10:56,1,1,2
40,2025-05-25T02:57:00+02:00,2025-05-25,10:57,3,4,7
40,2025-05-25T02:58:00+02:00,2025-05-25,10:58,1,3,4
40,2025-05-25T02:59:00+02:00,2025-05-25,10:59,10,1,11
40,2025-05-25T03:02:00+02:00,2025-05-25,11:02,2,1,3
40,2025-05-25T03:04:00+02:00,2025-05-25,11:04,2,1,3
40,2025-05-25T03:05:00+02:00,2025-05-25,11:05,6,2,8
40,2025-05-25T03:07:00+02:00,2025-05-25,11:07,2,0,2
40,2025-05-25T03:08:00+02:00,2025-05-25,11:08,0,4,4
41,2025-05-25T02:56:00+02:00,2025-05-25,10:56,0,2,2
41,2025-05-25T03:03:00+02:00,2025-05-25,11:03,4,2,6
44,2025-05-25T03:05:00+02:00,2025-05-25,11:05,1,8,9
45,2025-05-25T02:55:00+02:00,2025-05-25,10:55,9,9,18
45,2025-05-25T02:57:00+02:00,2025-05-25,10:57,13,3,16
45,2025-05-25T03:00:00+02:00,2025-05-25,11:00,8,8,16
45,2025-05-25T03:03:00+02:00,2025-05-25,11:03,17,2,19
45,2025-05-25T03:06:00+02:00,2025-05-25,11:06,9,3,12
45,2025-05-25T03:07:00+02:00,2025-05-25,11:07,1,6,7
45,2025-05-25T03:08:00+02:00,2025-05-25,11:08,14,8,22
47,2025-05-25T02:57:00+02:00,2025-05-25,10:57,7,14,21
47,2025-05-25T02:58:00+02:00,2025-05-25,10:58,13,12,25
47,2025-05-25T03:00:00+02:00,2025-05-25,11:00,4,17,21
47,2025-05-25T03:01:00+02:00,2025-05-25,11:01,8,10,18
47,2025-05-25T03:03:00+02:00,2025-05-25,11:03,13,20,33
47,2025-05-25T03:04:00+02:00,2025-05-25,11:04,9,16,25
47,2025-05-25T03:08:00+02:00,2025-05-25,11:08,14,10,24
50,2025-05-25T02:56:00+02:00,2025-05-25,10:56,1,3,4
50,2025-05-25T03:00:00+02:00,2025-05-25,11:00,3,2,5
50,2025-05-25T03:01:00+02:00,2025-05-25,11:01,4,8,12
50,2025-05-25T03:02:00+02:00,2025-05-25,11:02,5,2,7
50,2025-05-25T03:06:00+02:00,2025-05-25,11:06,4,9,13
54,2025-05-25T02:57:00+02:00,2025-05-25,10:57,2,4,6
54,2025-05-25T02:58:00+02:00,2025-05-25,10:58,0,8,8
54,2025-05-25T03:01:00+02:00,2025-05-25,11:01,2,3,5
54,2025-05-25T03:04:00+02:00,2025-05-25,11:04,5,0,5
54,2025-05-25T03:05:00+02:00,2025-05-25,11:05,1,4,5
54,2025-05-25T03:06:00+02:00,2025-05-25,11:06,2,1,3
54,2025-05-25T03:08:00+02:00,2025-05-25,11:08,5,2,7
59,2025-05-25T03:05:00+02:00,2025-05-25,11:05,10,27,37
61,2025-05-25T02:59:00+02:00,2025-05-25,10:59,3,9,12
61,2025-05-25T03:00:00+02:00,2025-05-25,11:00,3,9,12
61,2025-05-25T03:03:00+02:00,2025-05-25,11:03,4,3,7
61,2025-05-25T03:05:00+02:00,2025-05-25,11:05,4,1,5
61,2025-05-25T03:08:00+02:00,2025-05-25,11:08,6,1,7
66,2025-05-25T02:56:00+02:00,2025-05-25,10:56,6,15,21
66,2025-05-25T03:01:00+02:00,2025-05-25,11:01,12,4,16
66,2025-05-25T03:02:00+02:00,2025-05-25,11:02,13,22,35
66,2025-05-25T03:04:00+02:00,2025-05-25,11:04,16,9,25
66,2025-05-25T03:06:00+02:00,2025-05-25,11:06,4,15,19
69,2025-05-25T02:59:00+02:00,2025-05-25,10:59,12,1,13
69,2025-05-25T03:02:00+02:00,2025-05-25,11:02,8,2,10
69,2025-05-25T03:05:00+02:00,2025-05-25,11:05,2,0,2
69,2025-05-25T03:08:00+02:00,2025-05-25,11:08,7,6,13
70,2025-05-25T02:55:00+02:00,2025-05-25,10:55,1,0,1
70,2025-05-25T02:56:00+02:00,2025-05-25,10:56,1,12,13
70,2025-05-25T02:59:00+02:00,2025-05-25,10:59,1,0,1
70,2025-05-25T03:01:00+02:00,2025-05-25,11:01,2,0,2
70,2025-05-25T03:02:00+02:00,2025-05-25,11:02,3,3,6
70,2025-05-25T03:03:00+02:00,2025-05-25,11:03,1,1,2
70,2025-05-25T03:04:00+02:00,2025-05-25,11:04,0,4,4
70,2025-05-25T03:05:00+02:00,2025-05-25,11:05,0,1,1
70,2025-05-25T03:08:00+02:00,2025-05-25,11:08,1,3,4
75,2025-05-25T03:05:00+02:00,2025-05-25,11:05,1,0,1
75,2025-05-25T03:06:00+02:00,2025-05-25,11:06,0,1,1
75,2025-05-25T03:07:00+02:00,2025-05-25,11:07,3,0,3
77,2025-05-25T02:55:00+02:00,2025-05-25,10:55,15,19,34
78,2025-05-25T02:57:00+02:00,2025-05-25,10:57,1,1,2
78,2025-05-25T02:59:00+02:00,2025-05-25,10:59,2,0,2
78,2025-05-25T03:00:00+02:00,2025-05-25,11:00,1,1,2
78,2025-05-25T03:01:00+02:00,2025-05-25,11:01,1,1,2
78,2025-05-25T03:02:00+02:00,2025-05-25,11:02,1,0,1
78,2025-05-25T03:08:00+02:00,2025-05-25,11:08,0,1,1
84,2025-05-25T03:00:00+02:00,2025-05-25,11:00,80,39,119
84,2025-05-25T03:05:00+02:00,2025-05-25,11:05,74,50,124
87,2025-05-25T02:56:00+02:00,2025-05-25,10:56,0,1,1
87,2025-05-25T02:57:00+02:00,2025-05-25,10:57,3,1,4
87,2025-05-25T02:58:00+02:00,2025-05-25,10:58,3,2,5
87,2025-05-25T03:00:00+02:00,2025-05-25,11:00,2,0,2
87,2025-05-25T03:09:00+02:00,2025-05-25,11:09,3,0,3
108,2025-05-25T02:58:00+02:00,2025-05-25,10:58,1,3,4
108,2025-05-25T02:59:00+02:00,2025-05-25,10:59,2,2,4
108,2025-05-25T03:02:00+02:00,2025-05-25,11:02,3,1,4
118,2025-05-25T03:00:00+02:00,2025-05-25,11:00,2,0,2
131,2025-05-25T02:55:00+02:00,2025-05-25,10:55,10,6,16
131,2025-05-25T03:00:00+02:00,2025-05-25,11:00,18,23,41
132,2025-05-25T02:55:00+02:00,2025-05-25,10:55,17,13,30
132,2025-05-25T03:00:00+02:00,2025-05-25,11:00,27,6,33
134,2025-05-25T03:00:00+02:00,2025-05-25,11:00,43,19,62
135,2025-05-25T02:55:00+02:00,2025-05-25,10:55,25,24,49
135,2025-05-25T03:00:00+02:00,2025-05-25,11:00,39,46,85
140,2025-05-25T02:55:00+02:00,2025-05-25,10:55,18,7,25
165,2025-05-25T03:05:00+02:00,2025-05-25,11:05,2,2,4
166,2025-05-25T02:55:00+02:00,2025-05-25,10:55,4,4,8
166,2025-05-25T03:05:00+02:00,2025-05-25,11:05,3,6,9
167,2025-05-25T03:05:00+02:00,2025-05-25,11:05,2,16,18
179,2025-05-25T03:00:00+02:00,2025-05-25,11:00,3,2,5
1,2025-05-25T02:55:00+02:00,2025-05-25,10:55,14,16,30
1,2025-05-25T02:57:00+02:00,2025-05-25,10:57,12,6,18
1,2025-05-25T03:01:00+02:00,2025-05-25,11:01,8,14,22
1,2025-05-25T03:02:00+02:00,2025-05-25,11:02,8,11,19
1,2025-05-25T03:05:00+02:00,2025-05-25,11:05,6,13,19
1,2025-05-25T03:08:00+02:00,2025-05-25,11:08,8,26,34
2,2025-05-25T02:57:00+02:00,2025-05-25,10:57,6,4,10
2,2025-05-25T02:58:00+02:00,2025-05-25,10:58,3,3,6
2,2025-05-25T02:59:00+02:00,2025-05-25,10:59,6,6,12
2,2025-05-25T03:00:00+02:00,2025-05-25,11:00,5,10,15
2,2025-05-25T03:04:00+02:00,2025-05-25,11:04,5,9,14
2,2025-05-25T03:09:00+02:00,2025-05-25,11:09,7,3,10
9,2025-05-25T02:57:00+02:00,2025-05-25,10:57,0,2,2
9,2025-05-25T02:59:00+02:00,2025-05-25,10:59,1,0,1
9,2025-05-25T03:03:00+02:00,2025-05-25,11:03,1,0,1
9,2025-05-25T03:05:00+02:00,2025-05-25,11:05,1,0,1
11,2025-05-25T02:56:00+02:00,2025-05-25,10:56,0,2,2
11,2025-05-25T02:59:00+02:00,2025-05-25,10:59,3,0,3
11,2025-05-25T03:00:00+02:00,2025-05-25,11:00,0,5,5
11,2025-05-25T03:05:00+02:00,2025-05-25,11:05,5,1,6
11,2025-05-25T03:06:00+02:00,2025-05-25,11:06,0,3,3
11,2025-05-25T03:07:00+02:00,2025-05-25,11:07,0,1,1
12,2025-05-25T02:58:00+02:00,2025-05-25,10:58,1,0,1
12,2025-05-25T02:59:00+02:00,2025-05-25,10:59,5,0,5
12,2025-05-25T03:00:00+02:00,2025-05-25,11:00,2,3,5
12,2025-05-25T03:06:00+02:00,2025-05-25,11:06,0,2,2
12,2025-05-25T03:08:00+02:00,2025-05-25,11:08,0,4,4
17,2025-05-25T03:05:00+02:00,2025-05-25,11:05,0,4,4
18,2025-05-25T02:59:00+02:00,2025-05-25,10:59,1,3,4
18,2025-05-25T03:00:00+02:00,2025-05-25,11:00,4,0,4
18,2025-05-25T03:02:00+02:00,2025-05-25,11:02,1,0,1
18,2025-05-25T03:06:00+02:00,2025-05-25,11:06,0,2,2
18,2025-05-25T03:07:00+02:00,2025-05-25,11:07,1,2,3
19,2025-05-25T02:59:00+02:00,2025-05-25,10:59,2,1,3
19,2025-05-25T03:00:00+02:00,2025-05-25,11:00,3,7,10
19,2025-05-25T03:03:00+02:00,2025-05-25,11:03,0,5,5
19,2025-05-25T03:07:00+02:00,2025-05-25,11:07,5,4,9
20,2025-05-25T02:58:00+02:00,2025-05-25,10:58,4,4,8
20,2025-05-25T03:00:00+02:00,2025-05-25,11:00,8,2,10
20,2025-05-25T03:02:00+02:00,2025-05-25,11:02,3,4,7
23,2025-05-25T02:55:00+02:00,2025-05-25,10:55,3,2,5
23,2025-05-25T02:57:00+02:00,2025-05-25,10:57,4,0,4
23,2025-05-25T02:58:00+02:00,2025-05-25,10:58,0,5,5
23,2025-05-25T03:01:00+02:00,2025-05-25,11:01,0,2,2
23,2025-05-25T03:03:00+02:00,2025-05-25,11:03,1,3,4
23,2025-05-25T03:06:00+02:00,2025-05-25,11:06,3,2,5
23,2025-05-25T03:09:00+02:00,2025-05-25,11:09,1,3,4
24,2025-05-25T03:00:00+02:00,2025-05-25,11:00,11,4,15
24,2025-05-25T03:06:00+02:00,2025-05-25,11:06,11,10,21
24,2025-05-25T03:09:00+02:00,2025-05-25,11:09,13,3,16
27,2025-05-25T02:55:00+02:00,2025-05-25,10:55,5,6,11
30,2025-05-25T02:59:00+02:00,2025-05-25,10:59,2,3,5
30,2025-05-25T03:02:00+02:00,2025-05-25,11:02,2,2,4
30,2025-05-25T03:04:00+02:00,2025-05-25,11:04,4,6,10
30,2025-05-25T03:06:00+02:00,2025-05-25,11:06,1,2,3
30,2025-05-25T03:08:00+02:00,2025-05-25,11:08,2,2,4
30,2025-05-25T03:09:00+02:00,2025-05-25,11:09,1,2,3
35,2025-05-25T02:57:00+02:00,2025-05-25,10:57,23,8,31
35,2025-05-25T02:58:00+02:00,2025-05-25,10:58,11,9,20
35,2025-05-25T02:59:00+02:00,2025-05-25,10:59,12,18,30
35,2025-05-25T03:01:00+02:00,2025-05-25,11:01,14,11,25
35,2025-05-25T03:04:00+02:00,2025-05-25,11:04,18,16,34
35,2025-05-25T03:07:00+02:00,2025-05-25,11:07,33,26,59
35,2025-05-25T03:08:00+02:00,2025-05-25,11:08,10,22,32
46,2025-05-25T03:00:00+02:00,2025-05-25,11:00,3,3,6
48,2025-05-25T02:55:00+02:00,2025-05-25,10:55,3,1,4
48,2025-05-25T03:06:00+02:00,2025-05-25,11:06,10,4,14
49,2025-05-25T02:55:00+02:00,2025-05-25,10:55,14,10,24
49,2025-05-25T03:01:00+02:00,2025-05-25,11:01,10,11,21
49,2025-05-25T03:04:00+02:00,2025-05-25,11:04,4,7,11
51,2025-05-25T02:59:00+02:00,2025-05-25,10:59,1,1,2
52,2025-05-25T02:59:00+02:00,2025-05-25,10:59,1,2,3
52,2025-05-25T03:02:00+02:00,2025-05-25,11:02,7,0,7
52,2025-05-25T03:07:00+02:00,2025-05-25,11:07,2,3,5
53,2025-05-25T02:56:00+02:00,2025-05-25,10:56,7,3,10
53,2025-05-25T03:00:00+02:00,2025-05-25,11:00,8,0,8
56,2025-05-25T02:55:00+02:00,2025-05-25,10:55,6,7,13
56,2025-05-25T02:56:00+02:00,2025-05-25,10:56,10,3,13
56,2025-05-25T03:07:00+02:00,2025-05-25,11:07,6,1,7
58,2025-05-25T03:00:00+02:00,2025-05-25,11:00,4,7,11
58,2025-05-25T03:05:00+02:00,2025-05-25,11:05,5,9,14
58,2025-05-25T03:06:00+02:00,2025-05-25,11:06,11,11,22
58,2025-05-25T03:09:00+02:00,2025-05-25,11:09,10,5,15
62,2025-05-25T02:55:00+02:00,2025-05-25,10:55,1,1,2
62,2025-05-25T03:04:00+02:00,2025-05-25,11:04,1,2,3
62,2025-05-25T03:06:00+02:00,2025-05-25,11:06,2,2,4
62,2025-05-25T03:08:00+02:00,2025-05-25,11:08,1,3,4
62,2025-05-25T03:09:00+02:00,2025-05-25,11:09,4,1,5
63,2025-05-25T02:55:00+02:00,2025-05-25,10:55,2,3,5
63,2025-05-25T02:56:00+02:00,2025-05-25,10:56,1,3,4
63,2025-05-25T03:00:00+02:00,2025-05-25,11:00,0,1,1
63,2025-05-25T03:01:00+02:00,2025-05-25,11:01,7,3,10
63,2025-05-25T03:04:00+02:00,2025-05-25,11:04,1,2,3
63,2025-05-25T03:06:00+02:00,2025-05-25,11:06,3,3,6
63,2025-05-25T03:08:00+02:00,2025-05-25,11:08,10,11,21
67,2025-05-25T02:55:00+02:00,2025-05-25,10:55,4,12,16
67,2025-05-25T02:56:00+02:00,2025-05-25,10:56,5,6,11
67,2025-05-25T02:59:00+02:00,2025-05-25,10:59,4,9,13
67,2025-05-25T03:00:00+02:00,2025-05-25,11:00,15,4,19
67,2025-05-25T03:06:00+02:00,2025-05-25,11:06,6,5,11
68,2025-05-25T03:05:00+02:00,2025-05-25,11:05,5,7,12
68,2025-05-25T03:07:00+02:00,2025-05-25,11:07,12,10,22
68,2025-05-25T03:08:00+02:00,2025-05-25,11:08,11,5,16
72,2025-05-25T03:00:00+02:00,2025-05-25,11:00,5,2,7
72,2025-05-25T03:03:00+02:00,2025-05-25,11:03,0,8,8
72,2025-05-25T03:04:00+02:00,2025-05-25,11:04,2,0,2
72,2025-05-25T03:05:00+02:00,2025-05-25,11:05,2,0,2
72,2025-05-25T03:06:00+02:00,2025-05-25,11:06,4,3,7
72,2025-05-25T03:07:00+02:00,2025-05-25,11:07,3,1,4
72,2025-05-25T03:08:00+02:00,2025-05-25,11:08,1,6,7
76,2025-05-25T02:57:00+02:00,2025-05-25,10:57,1,2,3
76,2025-05-25T03:01:00+02:00,2025-05-25,11:01,4,0,4
76,2025-05-25T03:07:00+02:00,2025-05-25,11:07,1,2,3
79,2025-05-25T02:56:00+02:00,2025-05-25,10:56,22,0,22
79,2025-05-25T02:59:00+02:00,2025-05-25,10:59,11,1,12
85,2025-05-25T02:57:00+02:00,2025-05-25,10:57,1,2,3
85,2025-05-25T03:00:00+02:00,2025-05-25,11:00,6,1,7
85,2025-05-25T03:01:00+02:00,2025-05-25,11:01,6,1,7
85,2025-05-25T03:06:00+02:00,2025-05-25,11:06,1,2,3
85,2025-05-25T03:09:00+02:00,2025-05-25,11:09,3,1,4
86,2025-05-25T02:57:00+02:00,2025-05-25,10:57,1,0,1
86,2025-05-25T03:08:00+02:00,2025-05-25,11:08,1,0,1
117,2025-05-25T03:05:00+02:00,2025-05-25,11:05,5,37,42
123,2025-05-25T02:55:00+02:00,2025-05-25,10:55,4,5,9
130,2025-05-25T02:55:00+02:00,2025-05-25,10:55,1,2,3
130,2025-05-25T03:05:00+02:00,2025-05-25,11:05,1,5,6
136,2025-05-25T03:00:00+02:00,2025-05-25,11:00,10,5,15
136,2025-05-25T03:05:00+02:00,2025-05-25,11:05,10,11,21
137,2025-05-25T03:05:00+02:00,2025-05-25,11:05,1,5,6
142,2025-05-25T02:55:00+02:00,2025-05-25,10:55,34,33,67
161,2025-05-25T02:55:00+02:00,2025-05-25,10:55,9,19,28
161,2025-05-25T03:05:00+02:00,2025-05-25,11:05,17,12,29
164,2025-05-25T03:05:00+02:00,2025-05-25,11:05,4,1,5
181,2025-05-25T03:10:00+02:00,2025-05-25,11:10,10,9,19
181,2025-05-25T03:11:00+02:00,2025-05-25,11:11,4,12,16
181,2025-05-25T03:14:00+02:00,2025-05-25,11:14,6,14,20
181,2025-05-25T03:16:00+02:00,2025-05-25,11:16,3,7,10
181,2025-05-25T03:24:00+02:00,2025-05-25,11:24,16,10,26
180,2025-05-25T03:19:00+02:00,2025-05-25,11:19,0,1,1
180,2025-05-25T03:22:00+02:00,2025-05-25,11:22,2,1,3
3,2025-05-25T03:10:00+02:00,2025-05-25,11:10,9,5,14
3,2025-05-25T03:11:00+02:00,2025-05-25,11:11,8,10,18
3,2025-05-25T03:13:00+02:00,2025-05-25,11:13,6,1,7
3,2025-05-25T03:15:00+02:00,2025-05-25,11:15,9,9,18
3,2025-05-25T03:17:00+02:00,2025-05-25,11:17,3,8,11
4,2025-05-25T03:14:00+02:00,2025-05-25,11:14,20,23,43
4,2025-05-25T03:18:00+02:00,2025-05-25,11:18,27,16,43
4,2025-05-25T03:20:00+02:00,2025-05-25,11:20,27,7,34
4,2025-05-25T03:23:00+02:00,2025-05-25,11:23,9,8,17
4,2025-05-25T03:24:00+02:00,2025-05-25,11:24,26,13,39
5,2025-05-25T03:20:00+02:00,2025-05-25,11:20,55,75,130
6,2025-05-25T03:10:00+02:00,2025-05-25,11:10,18,6,24
6,2025-05-25T03:12:00+02:00,2025-05-25,11:12,21,7,28
6,2025-05-25T03:13:00+02:00,2025-05-25,11:13,11,13,24
6,2025-05-25T03:14:00+02:00,2025-05-25,11:14,13,20,33
6,2025-05-25T03:16:00+02:00,2025-05-25,11:16,16,3,19
6,2025-05-25T03:17:00+02:00,2025-05-25,11:17,14,24,38
6,2025-05-25T03:20:00+02:00,2025-05-25,11:20,9,13,22
6,2025-05-25T03:23:00+02:00,2025-05-25,11:23,12,13,25
6,2025-05-25T03:24:00+02:00,2025-05-25,11:24,8,9,17
8,2025-05-25T03:12:00+02:00,2025-05-25,11:12,0,2,2
8,2025-05-25T03:13:00+02:00,2025-05-25,11:13,0,1,1
8,2025-05-25T03:17:00+02:00,2025-05-25,11:17,1,15,16
28,2025-05-25T03:10:00+02:00,2025-05-25,11:10,11,6,17
28,2025-05-25T03:17:00+02:00,2025-05-25,11:17,8,4,12
28,2025-05-25T03:18:00+02:00,2025-05-25,11:18,0,12,12
28,2025-05-25T03:21:00+02:00,2025-05-25,11:21,6,2,8
29,2025-05-25T03:16:00+02:00,2025-05-25,11:16,10,5,15
29,2025-05-25T03:24:00+02:00,2025-05-25,11:24,5,2,7
31,2025-05-25T03:10:00+02:00,2025-05-25,11:10,2,4,6
31,2025-05-25T03:11:00+02:00,2025-05-25,11:11,0,1,1
31,2025-05-25T03:14:00+02:00,2025-05-25,11:14,4,1,5
31,2025-05-25T03:16:00+02:00,2025-05-25,11:16,6,0,6
31,2025-05-25T03:22:00+02:00,2025-05-25,11:22,2,1,3
31,2025-05-25T03:24:00+02:00,2025-05-25,11:24,2,4,6
36,2025-05-25T03:16:00+02:00,2025-05-25,11:16,1,0,1
36,2025-05-25T03:19:00+02:00,2025-05-25,11:19,4,2,6
36,2025-05-25T03:23:00+02:00,2025-05-25,11:23,0,3,3
37,2025-05-25T03:10:00+02:00,2025-05-25,11:10,4,0,4
37,2025-05-25T03:13:00+02:00,2025-05-25,11:13,1,1,2
37,2025-05-25T03:18:00+02:00,2025-05-25,11:18,3,0,3
37,2025-05-25T03:24:00+02:00,2025-05-25,11:24,0,1,1
39,2025-05-25T03:12:00+02:00,2025-05-25,11:12,2,0,2
40,2025-05-25T03:12:00+02:00,2025-05-25,11:12,4,9,13
40,2025-05-25T03:14:00+02:00,2025-05-25,11:14,3,0,3
40,2025-05-25T03:15:00+02:00,2025-05-25,11:15,3,1,4
41,2025-05-25T03:14:00+02:00,2025-05-25,11:14,0,6,6
41,2025-05-25T03:17:00+02:00,2025-05-25,11:17,3,4,7
41,2025-05-25T03:20:00+02:00,2025-05-25,11:20,3,0,3
41,2025-05-25T03:22:00+02:00,2025-05-25,11:22,5,0,5
41,2025-05-25T03:24:00+02:00,2025-05-25,11:24,1,4,5
43,2025-05-25T03:10:00+02:00,2025-05-25,11:10,2,11,13
44,2025-05-25T03:10:00+02:00,2025-05-25,11:10,3,11,14
44,2025-05-25T03:20:00+02:00,2025-05-25,11:20,2,2,4
45,2025-05-25T03:13:00+02:00,2025-05-25,11:13,11,6,17
45,2025-05-25T03:23:00+02:00,2025-05-25,11:23,16,8,24
45,2025-05-25T03:24:00+02:00,2025-05-25,11:24,14,8,22
47,2025-05-25T03:10:00+02:00,2025-05-25,11:10,17,12,29
47,2025-05-25T03:11:00+02:00,2025-05-25,11:11,17,10,27
47,2025-05-25T03:15:00+02:00,2025-05-25,11:15,5,17,22
50,2025-05-25T03:10:00+02:00,2025-05-25,11:10,2,5,7
50,2025-05-25T03:24:00+02:00,2025-05-25,11:24,0,8,8
54,2025-05-25T03:11:00+02:00,2025-05-25,11:11,2,0,2
54,2025-05-25T03:15:00+02:00,2025-05-25,11:15,0,2,2
54,2025-05-25T03:19:00+02:00,2025-05-25,11:19,3,1,4
54,2025-05-25T03:22:00+02:00,2025-05-25,11:22,1,0,1
59,2025-05-25T03:20:00+02:00,2025-05-25,11:20,7,24,31
61,2025-05-25T03:12:00+02:00,2025-05-25,11:12,4,5,9
61,2025-05-25T03:15:00+02:00,2025-05-25,11:15,8,6,14
61,2025-05-25T03:19:00+02:00,2025-05-25,11:19,5,12,17
61,2025-05-25T03:20:00+02:00,2025-05-25,11:20,3,9,12
61,2025-05-25T03:21:00+02:00,2025-05-25,11:21,5,5,10
61,2025-05-25T03:23:00+02:00,2025-05-25,11:23,11,1,12
61,2025-05-25T03:24:00+02:00,2025-05-25,11:24,10,8,18
66,2025-05-25T03:12:00+02:00,2025-05-25,11:12,5,13,18
66,2025-05-25T03:20:00+02:00,2025-05-25,11:20,28,16,44
66,2025-05-25T03:21:00+02:00,2025-05-25,11:21,4,13,17
66,2025-05-25T03:22:00+02:00,2025-05-25,11:22,11,8,19
66,2025-05-25T03:24:00+02:00,2025-05-25,11:24,11,7,18
69,2025-05-25T03:10:00+02:00,2025-05-25,11:10,4,4,8
69,2025-05-25T03:11:00+02:00,2025-05-25,11:11,5,4,9
69,2025-05-25T03:14:00+02:00,2025-05-25,11:14,11,0,11
69,2025-05-25T03:16:00+02:00,2025-05-25,11:16,9,4,13
69,2025-05-25T03:18:00+02:00,2025-05-25,11:18,4,3,7
69,2025-05-25T03:19:00+02:00,2025-05-25,11:19,6,5,11
69,2025-05-25T03:20:00+02:00,2025-05-25,11:20,5,0,5
69,2025-05-25T03:21:00+02:00,2025-05-25,11:21,3,3,6
70,2025-05-25T03:10:00+02:00,2025-05-25,11:10,3,3,6
70,2025-05-25T03:11:00+02:00,2025-05-25,11:11,2,1,3
70,2025-05-25T03:15:00+02:00,2025-05-25,11:15,2,1,3
70,2025-05-25T03:16:00+02:00,2025-05-25,11:16,2,1,3
70,2025-05-25T03:18:00+02:00,2025-05-25,11:18,1,0,1
71,2025-05-25T03:15:00+02:00,2025-05-25,11:15,0,1,1
75,2025-05-25T03:11:00+02:00,2025-05-25,11:11,4,0,4
75,2025-05-25T03:14:00+02:00,2025-05-25,11:14,0,1,1
75,2025-05-25T03:15:00+02:00,2025-05-25,11:15,4,0,4
75,2025-05-25T03:20:00+02:00,2025-05-25,11:20,4,0,4
75,2025-05-25T03:22:00+02:00,2025-05-25,11:22,2,0,2
78,2025-05-25T03:11:00+02:00,2025-05-25,11:11,0,1,1
78,2025-05-25T03:12:00+02:00,2025-05-25,11:12,1,2,3
78,2025-05-25T03:15:00+02:00,2025-05-25,11:15,0,2,2
78,2025-05-25T03:21:00+02:00,2025-05-25,11:21,1,1,2
78,2025-05-25T03:22:00+02:00,2025-05-25,11:22,0,1,1
78,2025-05-25T03:24:00+02:00,2025-05-25,11:24,1,3,4
84,2025-05-25T03:20:00+02:00,2025-05-25,11:20,52,55,107
87,2025-05-25T03:20:00+02:00,2025-05-25,11:20,1,6,7
87,2025-05-25T03:21:00+02:00,2025-05-25,11:21,3,0,3
108,2025-05-25T03:12:00+02:00,2025-05-25,11:12,0,4,4
108,2025-05-25T03:14:00+02:00,2025-05-25,11:14,2,1,3
108,2025-05-25T03:15:00+02:00,2025-05-25,11:15,2,0,2
108,2025-05-25T03:17:00+02:00,2025-05-25,11:17,9,3,12
108,2025-05-25T03:18:00+02:00,2025-05-25,11:18,3,1,4
108,2025-05-25T03:21:00+02:00,2025-05-25,11:21,2,5,7
108,2025-05-25T03:24:00+02:00,2025-05-25,11:24,2,3,5
118,2025-05-25T03:15:00+02:00,2025-05-25,11:15,2,0,2
131,2025-05-25T03:15:00+02:00,2025-05-25,11:15,4,11,15
132,2025-05-25T03:10:00+02:00,2025-05-25,11:10,16,3,19
132,2025-05-25T03:15:00+02:00,2025-05-25,11:15,24,3,27
133,2025-05-25T03:10:00+02:00,2025-05-25,11:10,41,39,80
134,2025-05-25T03:10:00+02:00,2025-05-25,11:10,24,47,71
134,2025-05-25T03:15:00+02:00,2025-05-25,11:15,33,26,59
135,2025-05-25T03:10:00+02:00,2025-05-25,11:10,17,39,56
135,2025-05-25T03:20:00+02:00,2025-05-25,11:20,19,32,51
162,2025-05-25T03:10:00+02:00,2025-05-25,11:10,38,55,93
162,2025-05-25T03:20:00+02:00,2025-05-25,11:20,56,76,132
166,2025-05-25T03:10:00+02:00,2025-05-25,11:10,5,3,8
167,2025-05-25T03:10:00+02:00,2025-05-25,11:10,3,8,11
167,2025-05-25T03:15:00+02:00,2025-05-25,11:15,1,5,6
1,2025-05-25T03:10:00+02:00,2025-05-25,11:10,6,17,23
1,2025-05-25T03:11:00+02:00,2025-05-25,11:11,19,31,50
1,2025-05-25T03:14:00+02:00,2025-05-25,11:14,10,20,30
1,2025-05-25T03:15:00+02:00,2025-05-25,11:15,17,7,24
1,2025-05-25T03:20:00+02:00,2025-05-25,11:20,11,19,30
1,2025-05-25T03:23:00+02:00,2025-05-25,11:23,24,14,38
2,2025-05-25T03:14:00+02:00,2025-05-25,11:14,6,10,16
2,2025-05-25T03:15:00+02:00,2025-05-25,11:15,8,13,21
2,2025-05-25T03:16:00+02:00,2025-05-25,11:16,12,4,16
2,2025-05-25T03:19:00+02:00,2025-05-25,11:19,12,6,18
2,2025-05-25T03:20:00+02:00,2025-05-25,11:20,8,9,17
2,2025-05-25T03:24:00+02:00,2025-05-25,11:24,11,10,21
9,2025-05-25T03:20:00+02:00,2025-05-25,11:20,2,2,4
9,2025-05-25T03:23:00+02:00,2025-05-25,11:23,1,0,1
9,2025-05-25T03:24:00+02:00,2025-05-25,11:24,0,1,1
10,2025-05-25T03:15:00+02:00,2025-05-25,11:15,2,0,2
10,2025-05-25T03:21:00+02:00,2025-05-25,11:21,3,0,3
11,2025-05-25T03:11:00+02:00,2025-05-25,11:11,3,3,6
11,2025-05-25T03:12:00+02:00,2025-05-25,11:12,0,1,1
11,2025-05-25T03:14:00+02:00,2025-05-25,11:14,3,0,3
11,2025-05-25T03:17:00+02:00,2025-05-25,11:17,1,0,1
11,2025-05-25T03:18:00+02:00,2025-05-25,11:18,0,2,2
12,2025-05-25T03:10:00+02:00,2025-05-25,11:10,2,8,10
12,2025-05-25T03:14:00+02:00,2025-05-25,11:14,1,4,5
12,2025-05-25T03:16:00+02:00,2025-05-25,11:16,6,10,16
12,2025-05-25T03:20:00+02:00,2025-05-25,11:20,4,1,5
12,2025-05-25T03:21:00+02:00,2025-05-25,11:21,0,7,7
12,2025-05-25T03:22:00+02:00,2025-05-25,11:22,3,2,5
12,2025-05-25T03:23:00+02:00,2025-05-25,11:23,1,3,4
12,2025-05-25T03:24:00+02:00,2025-05-25,11:24,4,3,7
17,2025-05-25T03:11:00+02:00,2025-05-25,11:11,1,8,9
17,2025-05-25T03:16:00+02:00,2025-05-25,11:16,1,1,2
17,2025-05-25T03:18:00+02:00,2025-05-25,11:18,2,1,3
17,2025-05-25T03:19:00+02:00,2025-05-25,11:19,1,0,1
17,2025-05-25T03:22:00+02:00,2025-05-25,11:22,0,3,3
18,2025-05-25T03:11:00+02:00,2025-05-25,11:11,4,1,5
19,2025-05-25T03:11:00+02:00,2025-05-25,11:11,6,6,12
19,2025-05-25T03:15:00+02:00,2025-05-25,11:15,0,12,12
19,2025-05-25T03:23:00+02:00,2025-05-25,11:23,3,3,6
20,2025-05-25T03:12:00+02:00,2025-05-25,11:12,0,6,6
20,2025-05-25T03:16:00+02:00,2025-05-25,11:16,1,2,3
20,2025-05-25T03:17:00+02:00,2025-05-25,11:17,1,0,1
20,2025-05-25T03:19:00+02:00,2025-05-25,11:19,0,4,4
23,2025-05-25T03:11:00+02:00,2025-05-25,11:11,0,5,5
23,2025-05-25T03:12:00+02:00,2025-05-25,11:12,2,0,2
23,2025-05-25T03:13:00+02:00,2025-05-25,11:13,0,3,3
23,2025-05-25T03:14:00+02:00,2025-05-25,11:14,3,2,5
23,2025-05-25T03:19:00+02:00,2025-05-25,11:19,8,3,11
23,2025-05-25T03:20:00+02:00,2025-05-25,11:20,1,8,9
23,2025-05-25T03:22:00+02:00,2025-05-25,11:22,1,5,6
23,2025-05-25T03:23:00+02:00,2025-05-25,11:23,7,5,12
24,2025-05-25T03:11:00+02:00,2025-05-25,11:11,8,6,14
24,2025-05-25T03:17:00+02:00,2025-05-25,11:17,5,5,10
24,2025-05-25T03:18:00+02:00,2025-05-25,11:18,3,8,11
24,2025-05-25T03:22:00+02:00,2025-05-25,11:22,5,2,7
24,2025-05-25T03:23:00+02:00,2025-05-25,11:23,5,6,11
24,2025-05-25T03:24:00+02:00,2025-05-25,11:24,8,5,13
25,2025-05-25T03:20:00+02:00,2025-05-25,11:20,33,82,115
27,2025-05-25T03:11:00+02:00,2025-05-25,11:11,1,6,7
27,2025-05-25T03:17:00+02:00,2025-05-25,11:17,2,9,11
27,2025-05-25T03:19:00+02:00,2025-05-25,11:19,7,9,16
27,2025-05-25T03:20:00+02:00,2025-05-25,11:20,6,5,11
27,2025-05-25T03:21:00+02:00,2025-05-25,11:21,7,0,7
27,2025-05-25T03:22:00+02:00,2025-05-25,11:22,2,9,11
27,2025-05-25T03:24:00+02:00,2025-05-25,11:24,6,5,11
30,2025-05-25T03:14:00+02:00,2025-05-25,11:14,3,2,5
30,2025-05-25T03:15:00+02:00,2025-05-25,11:15,1,2,3
30,2025-05-25T03:18:00+02:00,2025-05-25,11:18,3,1,4
30,2025-05-25T03:19:00+02:00,2025-05-25,11:19,2,0,2
35,2025-05-25T03:10:00+02:00,2025-05-25,11:10,19,23,42
35,2025-05-25T03:16:00+02:00,2025-05-25,11:16,20,16,36
35,2025-05-25T03:20:00+02:00,2025-05-25,11:20,22,12,34
35,2025-05-25T03:21:00+02:00,2025-05-25,11:21,7,18,25
46,2025-05-25T03:15:00+02:00,2025-05-25,11:15,3,3,6
48,2025-05-25T03:13:00+02:00,2025-05-25,11:13,9,8,17
48,2025-05-25T03:15:00+02:00,2025-05-25,11:15,11,0,11
48,2025-05-25T03:17:00+02:00,2025-05-25,11:17,7,7,14
48,2025-05-25T03:18:00+02:00,2025-05-25,11:18,1,4,5
49,2025-05-25T03:10:00+02:00,2025-05-25,11:10,9,12,21
49,2025-05-25T03:14:00+02:00,2025-05-25,11:14,2,7,9
49,2025-05-25T03:15:00+02:00,2025-05-25,11:15,6,2,8
49,2025-05-25T03:20:00+02:00,2025-05-25,11:20,10,7,17
49,2025-05-25T03:22:00+02:00,2025-05-25,11:22,8,14,22
49,2025-05-25T03:24:00+02:00,2025-05-25,11:24,15,12,27
51,2025-05-25T03:13:00+02:00,2025-05-25,11:13,1,1,2
51,2025-05-25T03:14:00+02:00,2025-05-25,11:14,2,0,2
51,2025-05-25T03:15:00+02:00,2025-05-25,11:15,3,4,7
51,2025-05-25T03:18:00+02:00,2025-05-25,11:18,1,6,7
51,2025-05-25T03:19:00+02:00,2025-05-25,11:19,7,3,10
51,2025-05-25T03:23:00+02:00,2025-05-25,11:23,2,9,11
52,2025-05-25T03:10:00+02:00,2025-05-25,11:10,2,0,2
52,2025-05-25T03:15:00+02:00,2025-05-25,11:15,2,5,7
52,2025-05-25T03:16:00+02:00,2025-05-25,11:16,4,1,5
52,2025-05-25T03:19:00+02:00,2025-05-25,11:19,2,5,7
52,2025-05-25T03:22:00+02:00,2025-05-25,11:22,2,0,2
53,2025-05-25T03:11:00+02:00,2025-05-25,11:11,8,11,19
53,2025-05-25T03:15:00+02:00,2025-05-25,11:15,9,6,15
53,2025-05-25T03:21:00+02:00,2025-05-25,11:21,12,5,17
53,2025-05-25T03:22:00+02:00,2025-05-25,11:22,1,3,4
53,2025-05-25T03:23:00+02:00,2025-05-25,11:23,6,3,9
53,2025-05-25T03:24:00+02:00,2025-05-25,11:24,10,9,19
56,2025-05-25T03:15:00+02:00,2025-05-25,11:15,8,5,13
56,2025-05-25T03:17:00+02:00,2025-05-25,11:17,5,6,11
56,2025-05-25T03:20:00+02:00,2025-05-25,11:20,3,7,10
56,2025-05-25T03:22:00+02:00,2025-05-25,11:22,3,3,6
58,2025-05-25T03:10:00+02:00,2025-05-25,11:10,2,1,3
58,2025-05-25T03:12:00+02:00,2025-05-25,11:12,15,1,16
58,2025-05-25T03:17:00+02:00,2025-05-25,11:17,6,1,7
58,2025-05-25T03:21:00+02:00,2025-05-25,11:21,18,5,23
62,2025-05-25T03:10:00+02:00,2025-05-25,11:10,2,0,2
62,2025-05-25T03:14:00+02:00,2025-05-25,11:14,0,3,3
62,2025-05-25T03:16:00+02:00,2025-05-25,11:16,1,0,1
62,2025-05-25T03:19:00+02:00,2025-05-25,11:19,4,0,4
62,2025-05-25T03:22:00+02:00,2025-05-25,11:22,2,4,6
63,2025-05-25T03:11:00+02:00,2025-05-25,11:11,5,1,6
63,2025-05-25T03:12:00+02:00,2025-05-25,11:12,5,5,10
63,2025-05-25T03:16:00+02:00,2025-05-25,11:16,4,5,9
67,2025-05-25T03:12:00+02:00,2025-05-25,11:12,4,8,12
67,2025-05-25T03:15:00+02:00,2025-05-25,11:15,4,2,6
67,2025-05-25T03:16:00+02:00,2025-05-25,11:16,4,5,9
67,2025-05-25T03:19:00+02:00,2025-05-25,11:19,4,4,8
67,2025-05-25T03:23:00+02:00,2025-05-25,11:23,10,4,14
68,2025-05-25T03:15:00+02:00,2025-05-25,11:15,5,5,10
68,2025-05-25T03:17:00+02:00,2025-05-25,11:17,4,1,5
68,2025-05-25T03:20:00+02:00,2025-05-25,11:20,10,3,13
68,2025-05-25T03:22:00+02:00,2025-05-25,11:22,6,8,14
68,2025-05-25T03:24:00+02:00,2025-05-25,11:24,3,2,5
72,2025-05-25T03:19:00+02:00,2025-05-25,11:19,4,4,8
72,2025-05-25T03:20:00+02:00,2025-05-25,11:20,4,8,12
76,2025-05-25T03:11:00+02:00,2025-05-25,11:11,1,1,2
76,2025-05-25T03:15:00+02:00,2025-05-25,11:15,5,2,7
76,2025-05-25T03:16:00+02:00,2025-05-25,11:16,1,2,3
76,2025-05-25T03:21:00+02:00,2025-05-25,11:21,2,2,4
76,2025-05-25T03:24:00+02:00,2025-05-25,11:24,0,1,1
79,2025-05-25T03:16:00+02:00,2025-05-25,11:16,13,4,17
79,2025-05-25T03:19:00+02:00,2025-05-25,11:19,10,2,12
79,2025-05-25T03:22:00+02:00,2025-05-25,11:22,10,3,13
79,2025-05-25T03:24:00+02:00,2025-05-25,11:24,8,6,14
85,2025-05-25T03:10:00+02:00,2025-05-25,11:10,6,2,8
85,2025-05-25T03:11:00+02:00,2025-05-25,11:11,6,0,6
85,2025-05-25T03:12:00+02:00,2025-05-25,11:12,0,3,3
85,2025-05-25T03:22:00+02:00,2025-05-25,11:22,2,2,4
85,2025-05-25T03:24:00+02:00,2025-05-25,11:24,3,1,4
86,2025-05-25T03:11:00+02:00,2025-05-25,11:11,2,1,3
86,2025-05-25T03:18:00+02:00,2025-05-25,11:18,0,1,1
86,2025-05-25T03:23:00+02:00,2025-05-25,11:23,3,1,4
109,2025-05-25T03:20:00+02:00,2025-05-25,11:20,1,9,10
117,2025-05-25T03:15:00+02:00,2025-05-25,11:15,14,11,25
136,2025-05-25T03:15:00+02:00,2025-05-25,11:15,12,6,18
139,2025-05-25T03:10:00+02:00,2025-05-25,11:10,6,8,14
139,2025-05-25T03:15:00+02:00,2025-05-25,11:15,6,4,10
142,2025-05-25T03:10:00+02:00,2025-05-25,11:10,56,50,106
164,2025-05-25T03:10:00+02:00,2025-05-25,11:10,10,6,16
164,2025-05-25T03:20:00+02:00,2025-05-25,11:20,4,6,10
181,2025-05-25T03:25:00+02:00,2025-05-25,11:25,16,8,24
181,2025-05-25T03:28:00+02:00,2025-05-25,11:28,3,18,21
181,2025-05-25T03:35:00+02:00,2025-05-25,11:35,7,11,18
181,2025-05-25T03:36:00+02:00,2025-05-25,11:36,4,8,12
181,2025-05-25T03:37:00+02:00,2025-05-25,11:37,1,17,18
180,2025-05-25T03:27:00+02:00,2025-05-25,11:27,0,2,2
180,2025-05-25T03:33:00+02:00,2025-05-25,11:33,1,0,1
180,2025-05-25T03:35:00+02:00,2025-05-25,11:35,2,0,2
3,2025-05-25T03:25:00+02:00,2025-05-25,11:25,10,5,15
3,2025-05-25T03:26:00+02:00,2025-05-25,11:26,9,4,13
3,2025-05-25T03:28:00+02:00,2025-05-25,11:28,9,11,20
3,2025-05-25T03:33:00+02:00,2025-05-25,11:33,17,10,27
3,2025-05-25T03:37:00+02:00,2025-05-25,11:37,2,8,10
4,2025-05-25T03:25:00+02:00,2025-05-25,11:25,28,14,42
4,2025-05-25T03:26:00+02:00,2025-05-25,11:26,31,15,46
4,2025-05-25T03:30:00+02:00,2025-05-25,11:30,23,20,43
4,2025-05-25T03:36:00+02:00,2025-05-25,11:36,10,8,18
4,2025-05-25T03:39:00+02:00,2025-05-25,11:39,18,17,35
5,2025-05-25T03:30:00+02:00,2025-05-25,11:30,72,44,116
5,2025-05-25T03:35:00+02:00,2025-05-25,11:35,59,73,132
6,2025-05-25T03:25:00+02:00,2025-05-25,11:25,18,15,33
6,2025-05-25T03:28:00+02:00,2025-05-25,11:28,17,9,26
6,2025-05-25T03:32:00+02:00,2025-05-25,11:32,12,17,29
6,2025-05-25T03:35:00+02:00,2025-05-25,11:35,18,11,29
6,2025-05-25T03:36:00+02:00,2025-05-25,11:36,15,14,29
6,2025-05-25T03:38:00+02:00,2025-05-25,11:38,8,15,23
6,2025-05-25T03:39:00+02:00,2025-05-25,11:39,6,13,19
8,2025-05-25T03:25:00+02:00,2025-05-25,11:25,4,6,10
8,2025-05-25T03:27:00+02:00,2025-05-25,11:27,0,2,2
8,2025-05-25T03:28:00+02:00,2025-05-25,11:28,2,1,3
8,2025-05-25T03:29:00+02:00,2025-05-25,11:29,3,4,7
8,2025-05-25T03:37:00+02:00,2025-05-25,11:37,3,4,7
28,2025-05-25T03:32:00+02:00,2025-05-25,11:32,15,15,30
28,2025-05-25T03:37:00+02:00,2025-05-25,11:37,9,4,13
29,2025-05-25T03:33:00+02:00,2025-05-25,11:33,9,14,23
29,2025-05-25T03:36:00+02:00,2025-05-25,11:36,4,10,14
29,2025-05-25T03:37:00+02:00,2025-05-25,11:37,7,12,19
31,2025-05-25T03:26:00+02:00,2025-05-25,11:26,3,0,3
31,2025-05-25T03:29:00+02:00,2025-05-25,11:29,4,1,5
31,2025-05-25T03:35:00+02:00,2025-05-25,11:35,8,2,10
36,2025-05-25T03:25:00+02:00,2025-05-25,11:25,0,1,1
36,2025-05-25T03:32:00+02:00,2025-05-25,11:32,3,1,4
36,2025-05-25T03:34:00+02:00,2025-05-25,11:34,2,3,5
37,2025-05-25T03:25:00+02:00,2025-05-25,11:25,2,2,4
37,2025-05-25T03:35:00+02:00,2025-05-25,11:35,2,0,2
37,2025-05-25T03:39:00+02:00,2025-05-25,11:39,1,1,2
39,2025-05-25T03:27:00+02:00,2025-05-25,11:27,3,1,4
39,2025-05-25T03:33:00+02:00,2025-05-25,11:33,0,1,1
39,2025-05-25T03:35:00+02:00,2025-05-25,11:35,0,2,2
39,2025-05-25T03:38:00+02:00,2025-05-25,11:38,0,1,1
40,2025-05-25T03:26:00+02:00,2025-05-25,11:26,1,1,2
40,2025-05-25T03:28:00+02:00,2025-05-25,11:28,2,3,5
40,2025-05-25T03:30:00+02:00,2025-05-25,11:30,0,2,2
40,2025-05-25T03:31:00+02:00,2025-05-25,11:31,6,2,8
40,2025-05-25T03:32:00+02:00,2025-05-25,11:32,4,4,8
40,2025-05-25T03:33:00+02:00,2025-05-25,11:33,5,3,8
40,2025-05-25T03:34:00+02:00,2025-05-25,11:34,4,2,6
40,2025-05-25T03:35:00+02:00,2025-05-25,11:35,3,4,7
40,2025-05-25T03:36:00+02:00,2025-05-25,11:36,1,1,2
40,2025-05-25T03:39:00+02:00,2025-05-25,11:39,1,6,7
41,2025-05-25T03:25:00+02:00,2025-05-25,11:25,7,1,8
41,2025-05-25T03:29:00+02:00,2025-05-25,11:29,2,1,3
41,2025-05-25T03:30:00+02:00,2025-05-25,11:30,0,4,4
41,2025-05-25T03:32:00+02:00,2025-05-25,11:32,1,1,2
41,2025-05-25T03:36:00+02:00,2025-05-25,11:36,4,0,4
41,2025-05-25T03:39:00+02:00,2025-05-25,11:39,10,3,13
43,2025-05-25T03:35:00+02:00,2025-05-25,11:35,0,3,3
44,2025-05-25T03:25:00+02:00,2025-05-25,11:25,0,2,2
45,2025-05-25T03:25:00+02:00,2025-05-25,11:25,10,11,21
45,2025-05-25T03:29:00+02:00,2025-05-25,11:29,7,7,14
45,2025-05-25T03:31:00+02:00,2025-05-25,11:31,10,14,24
45,2025-05-25T03:33:00+02:00,2025-05-25,11:33,6,14,20
45,2025-05-25T03:36:00+02:00,2025-05-25,11:36,15,3,18
45,2025-05-25T03:38:00+02:00,2025-05-25,11:38,10,8,18
45,2025-05-25T03:39:00+02:00,2025-05-25,11:39,15,13,28
47,2025-05-25T03:26:00+02:00,2025-05-25,11:26,6,13,19
47,2025-05-25T03:27:00+02:00,2025-05-25,11:27,10,14,24
47,2025-05-25T03:36:00+02:00,2025-05-25,11:36,12,12,24
47,2025-05-25T03:37:00+02:00,2025-05-25,11:37,14,15,29
50,2025-05-25T03:28:00+02:00,2025-05-25,11:28,1,3,4
50,2025-05-25T03:34:00+02:00,2025-05-25,11:34,5,9,14
50,2025-05-25T03:37:00+02:00,2025-05-25,11:37,3,3,6
50,2025-05-25T03:39:00+02:00,2025-05-25,11:39,2,1,3
54,2025-05-25T03:25:00+02:00,2025-05-25,11:25,1,3,4
54,2025-05-25T03:26:00+02:00,2025-05-25,11:26,1,1,2
54,2025-05-25T03:33:00+02:00,2025-05-25,11:33,1,0,1
54,2025-05-25T03:34:00+02:00,2025-05-25,11:34,0,1,1
61,2025-05-25T03:33:00+02:00,2025-05-25,11:33,3,8,11
61,2025-05-25T03:36:00+02:00,2025-05-25,11:36,3,9,12
61,2025-05-25T03:39:00+02:00,2025-05-25,11:39,1,8,9
66,2025-05-25T03:25:00+02:00,2025-05-25,11:25,8,13,21
66,2025-05-25T03:26:00+02:00,2025-05-25,11:26,22,8,30
66,2025-05-25T03:28:00+02:00,2025-05-25,11:28,12,13,25
66,2025-05-25T03:29:00+02:00,2025-05-25,11:29,20,12,32
66,2025-05-25T03:30:00+02:00,2025-05-25,11:30,15,20,35
66,2025-05-25T03:32:00+02:00,2025-05-25,11:32,17,17,34
66,2025-05-25T03:36:00+02:00,2025-05-25,11:36,13,10,23
69,2025-05-25T03:25:00+02:00,2025-05-25,11:25,4,3,7
69,2025-05-25T03:28:00+02:00,2025-05-25,11:28,8,1,9
69,2025-05-25T03:29:00+02:00,2025-05-25,11:29,4,2,6
69,2025-05-25T03:31:00+02:00,2025-05-25,11:31,4,6,10
69,2025-05-25T03:34:00+02:00,2025-05-25,11:34,8,4,12
69,2025-05-25T03:35:00+02:00,2025-05-25,11:35,11,5,16
69,2025-05-25T03:38:00+02:00,2025-05-25,11:38,3,2,5
70,2025-05-25T03:27:00+02:00,2025-05-25,11:27,2,0,2
70,2025-05-25T03:30:00+02:00,2025-05-25,11:30,1,0,1
70,2025-05-25T03:31:00+02:00,2025-05-25,11:31,0,4,4
70,2025-05-25T03:32:00+02:00,2025-05-25,11:32,0,4,4
70,2025-05-25T03:37:00+02:00,2025-05-25,11:37,2,1,3
70,2025-05-25T03:38:00+02:00,2025-05-25,11:38,3,5,8
71,2025-05-25T03:30:00+02:00,2025-05-25,11:30,0,1,1
75,2025-05-25T03:32:00+02:00,2025-05-25,11:32,1,2,3
78,2025-05-25T03:27:00+02:00,2025-05-25,11:27,1,0,1
78,2025-05-25T03:31:00+02:00,2025-05-25,11:31,0,1,1
78,2025-05-25T03:35:00+02:00,2025-05-25,11:35,1,3,4
78,2025-05-25T03:37:00+02:00,2025-05-25,11:37,0,2,2
78,2025-05-25T03:38:00+02:00,2025-05-25,11:38,1,0,1
78,2025-05-25T03:39:00+02:00,2025-05-25,11:39,0,5,5
84,2025-05-25T03:30:00+02:00,2025-05-25,11:30,69,69,138
87,2025-05-25T03:30:00+02:00,2025-05-25,11:30,1,2,3
87,2025-05-25T03:33:00+02:00,2025-05-25,11:33,0,2,2
87,2025-05-25T03:37:00+02:00,2025-05-25,11:37,1,1,2
87,2025-05-25T03:39:00+02:00,2025-05-25,11:39,5,5,10
107,2025-05-25T03:35:00+02:00,2025-05-25,11:35,13,10,23
108,2025-05-25T03:27:00+02:00,2025-05-25,11:27,6,3,9
108,2025-05-25T03:31:00+02:00,2025-05-25,11:31,3,0,3
108,2025-05-25T03:33:00+02:00,2025-05-25,11:33,1,0,1
108,2025-05-25T03:34:00+02:00,2025-05-25,11:34,0,1,1
108,2025-05-25T03:38:00+02:00,2025-05-25,11:38,2,3,5
131,2025-05-25T03:35:00+02:00,2025-05-25,11:35,2,7,9
132,2025-05-25T03:25:00+02:00,2025-05-25,11:25,9,9,18
132,2025-05-25T03:30:00+02:00,2025-05-25,11:30,19,12,31
134,2025-05-25T03:25:00+02:00,2025-05-25,11:25,25,24,49
134,2025-05-25T03:35:00+02:00,2025-05-25,11:35,40,45,85
135,2025-05-25T03:30:00+02:00,2025-05-25,11:30,46,44,90
135,2025-05-25T03:35:00+02:00,2025-05-25,11:35,33,37,70
165,2025-05-25T03:30:00+02:00,2025-05-25,11:30,1,6,7
165,2025-05-25T03:35:00+02:00,2025-05-25,11:35,3,5,8
166,2025-05-25T03:25:00+02:00,2025-05-25,11:25,5,3,8
167,2025-05-25T03:25:00+02:00,2025-05-25,11:25,2,14,16
167,2025-05-25T03:30:00+02:00,2025-05-25,11:30,4,6,10
179,2025-05-25T03:25:00+02:00,2025-05-25,11:25,4,1,5
1,2025-05-25T03:25:00+02:00,2025-05-25,11:25,9,19,28
1,2025-05-25T03:26:00+02:00,2025-05-25,11:26,19,12,31
1,2025-05-25T03:30:00+02:00,2025-05-25,11:30,21,19,40
1,2025-05-25T03:31:00+02:00,2025-05-25,11:31,20,19,39
1,2025-05-25T03:32:00+02:00,2025-05-25,11:32,21,9,30
2,2025-05-25T03:25:00+02:00,2025-05-25,11:25,6,11,17
2,2025-05-25T03:31:00+02:00,2025-05-25,11:31,13,8,21
2,2025-05-25T03:37:00+02:00,2025-05-25,11:37,7,3,10
9,2025-05-25T03:26:00+02:00,2025-05-25,11:26,2,1,3
9,2025-05-25T03:28:00+02:00,2025-05-25,11:28,1,1,2
9,2025-05-25T03:30:00+02:00,2025-05-25,11:30,1,2,3
9,2025-05-25T03:33:00+02:00,2025-05-25,11:33,2,5,7
9,2025-05-25T03:38:00+02:00,2025-05-25,11:38,1,1,2
10,2025-05-25T03:26:00+02:00,2025-05-25,11:26,1,0,1
10,2025-05-25T03:30:00+02:00,2025-05-25,11:30,3,0,3
10,2025-05-25T03:34:00+02:00,2025-05-25,11:34,2,1,3
10,2025-05-25T03:37:00+02:00,2025-05-25,11:37,1,0,1
10,2025-05-25T03:39:00+02:00,2025-05-25,11:39,1,0,1
11,2025-05-25T03:27:00+02:00,2025-05-25,11:27,0,4,4
11,2025-05-25T03:30:00+02:00,2025-05-25,11:30,2,7,9
11,2025-05-25T03:36:00+02:00,2025-05-25,11:36,0,2,2
12,2025-05-25T03:26:00+02:00,2025-05-25,11:26,4,1,5
12,2025-05-25T03:33:00+02:00,2025-05-25,11:33,5,2,7
12,2025-05-25T03:34:00+02:00,2025-05-25,11:34,4,0,4
12,2025-05-25T03:37:00+02:00,2025-05-25,11:37,2,4,6
12,2025-05-25T03:39:00+02:00,2025-05-25,11:39,0,5,5
17,2025-05-25T03:26:00+02:00,2025-05-25,11:26,0,5,5
17,2025-05-25T03:27:00+02:00,2025-05-25,11:27,1,0,1
17,2025-05-25T03:30:00+02:00,2025-05-25,11:30,2,0,2
17,2025-05-25T03:35:00+02:00,2025-05-25,11:35,8,2,10
17,2025-05-25T03:36:00+02:00,2025-05-25,11:36,9,1,10
18,2025-05-25T03:26:00+02:00,2025-05-25,11:26,1,1,2
18,2025-05-25T03:28:00+02:00,2025-05-25,11:28,0,2,2
18,2025-05-25T03:39:00+02:00,2025-05-25,11:39,2,1,3
19,2025-05-25T03:25:00+02:00,2025-05-25,11:25,3,4,7
19,2025-05-25T03:34:00+02:00,2025-05-25,11:34,9,1,10
19,2025-05-25T03:36:00+02:00,2025-05-25,11:36,3,2,5
19,2025-05-25T03:37:00+02:00,2025-05-25,11:37,5,2,7
20,2025-05-25T03:26:00+02:00,2025-05-25,11:26,3,4,7
20,2025-05-25T03:28:00+02:00,2025-05-25,11:28,6,2,8
20,2025-05-25T03:29:00+02:00,2025-05-25,11:29,4,2,6
20,2025-05-25T03:32:00+02:00,2025-05-25,11:32,1,0,1
20,2025-05-25T03:33:00+02:00,2025-05-25,11:33,4,0,4
20,2025-05-25T03:34:00+02:00,2025-05-25,11:34,12,1,13
20,2025-05-25T03:35:00+02:00,2025-05-25,11:35,11,9,20
20,2025-05-25T03:36:00+02:00,2025-05-25,11:36,1,5,6
20,2025-05-25T03:37:00+02:00,2025-05-25,11:37,0,7,7
23,2025-05-25T03:28:00+02:00,2025-05-25,11:28,2,1,3
23,2025-05-25T03:36:00+02:00,2025-05-25,11:36,1,4,5
24,2025-05-25T03:25:00+02:00,2025-05-25,11:25,5,9,14
24,2025-05-25T03:26:00+02:00,2025-05-25,11:26,4,2,6
24,2025-05-25T03:27:00+02:00,2025-05-25,11:27,22,3,25
24,2025-05-25T03:28:00+02:00,2025-05-25,11:28,5,3,8
24,2025-05-25T03:32:00+02:00,2025-05-25,11:32,7,12,19
24,2025-05-25T03:37:00+02:00,2025-05-25,11:37,23,1,24
24,2025-05-25T03:38:00+02:00,2025-05-25,11:38,14,8,22
25,2025-05-25T03:35:00+02:00,2025-05-25,11:35,47,50,97
27,2025-05-25T03:25:00+02:00,2025-05-25,11:25,2,1,3
27,2025-05-25T03:26:00+02:00,2025-05-25,11:26,4,2,6
27,2025-05-25T03:28:00+02:00,2025-05-25,11:28,3,2,5
27,2025-05-25T03:33:00+02:00,2025-05-25,11:33,8,7,15
27,2025-05-25T03:34:00+02:00,2025-05-25,11:34,7,2,9
27,2025-05-25T03:35:00+02:00,2025-05-25,11:35,5,5,10
27,2025-05-25T03:38:00+02:00,2025-05-25,11:38,6,4,10
27,2025-05-25T03:39:00+02:00,2025-05-25,11:39,8,1,9
30,2025-05-25T03:26:00+02:00,2025-05-25,11:26,3,2,5
30,2025-05-25T03:27:00+02:00,2025-05-25,11:27,5,5,10
30,2025-05-25T03:28:00+02:00,2025-05-25,11:28,5,0,5
30,2025-05-25T03:36:00+02:00,2025-05-25,11:36,1,6,7
30,2025-05-25T03:37:00+02:00,2025-05-25,11:37,2,2,4
35,2025-05-25T03:26:00+02:00,2025-05-25,11:26,20,17,37
35,2025-05-25T03:31:00+02:00,2025-05-25,11:31,16,9,25
35,2025-05-25T03:34:00+02:00,2025-05-25,11:34,22,17,39
35,2025-05-25T03:37:00+02:00,2025-05-25,11:37,27,17,44
46,2025-05-25T03:25:00+02:00,2025-05-25,11:25,4,3,7
48,2025-05-25T03:27:00+02:00,2025-05-25,11:27,23,9,32
48,2025-05-25T03:30:00+02:00,2025-05-25,11:30,19,5,24
48,2025-05-25T03:38:00+02:00,2025-05-25,11:38,10,7,17
49,2025-05-25T03:26:00+02:00,2025-05-25,11:26,1,7,8
49,2025-05-25T03:28:00+02:00,2025-05-25,11:28,13,6,19
49,2025-05-25T03:29:00+02:00,2025-05-25,11:29,3,8,11
49,2025-05-25T03:30:00+02:00,2025-05-25,11:30,10,15,25
49,2025-05-25T03:36:00+02:00,2025-05-25,11:36,3,13,16
51,2025-05-25T03:35:00+02:00,2025-05-25,11:35,1,5,6
52,2025-05-25T03:26:00+02:00,2025-05-25,11:26,7,5,12
52,2025-05-25T03:30:00+02:00,2025-05-25,11:30,3,5,8
52,2025-05-25T03:31:00+02:00,2025-05-25,11:31,5,0,5
52,2025-05-25T03:36:00+02:00,2025-05-25,11:36,2,2,4
53,2025-05-25T03:27:00+02:00,2025-05-25,11:27,16,6,22
53,2025-05-25T03:30:00+02:00,2025-05-25,11:30,7,4,11
53,2025-05-25T03:31:00+02:00,2025-05-25,11:31,10,5,15
53,2025-05-25T03:36:00+02:00,2025-05-25,11:36,18,10,28
53,2025-05-25T03:38:00+02:00,2025-05-25,11:38,7,7,14
56,2025-05-25T03:27:00+02:00,2025-05-25,11:27,3,6,9
56,2025-05-25T03:28:00+02:00,2025-05-25,11:28,0,6,6
56,2025-05-25T03:29:00+02:00,2025-05-25,11:29,9,9,18
56,2025-05-25T03:31:00+02:00,2025-05-25,11:31,3,4,7
56,2025-05-25T03:34:00+02:00,2025-05-25,11:34,11,4,15
56,2025-05-25T03:35:00+02:00,2025-05-25,11:35,5,2,7
56,2025-05-25T03:38:00+02:00,2025-05-25,11:38,2,6,8
56,2025-05-25T03:39:00+02:00,2025-05-25,11:39,3,7,10
58,2025-05-25T03:25:00+02:00,2025-05-25,11:25,13,2,15
58,2025-05-25T03:29:00+02:00,2025-05-25,11:29,28,2,30
58,2025-05-25T03:38:00+02:00,2025-05-25,11:38,21,6,27
62,2025-05-25T03:35:00+02:00,2025-05-25,11:35,7,0,7
63,2025-05-25T03:25:00+02:00,2025-05-25,11:25,8,1,9
63,2025-05-25T03:26:00+02:00,2025-05-25,11:26,2,5,7
63,2025-05-25T03:27:00+02:00,2025-05-25,11:27,7,4,11
63,2025-05-25T03:28:00+02:00,2025-05-25,11:28,6,4,10
63,2025-05-25T03:31:00+02:00,2025-05-25,11:31,5,8,13
63,2025-05-25T03:36:00+02:00,2025-05-25,11:36,6,0,6
67,2025-05-25T03:28:00+02:00,2025-05-25,11:28,2,6,8
67,2025-05-25T03:29:00+02:00,2025-05-25,11:29,5,9,14
67,2025-05-25T03:34:00+02:00,2025-05-25,11:34,8,8,16
67,2025-05-25T03:38:00+02:00,2025-05-25,11:38,9,9,18
68,2025-05-25T03:26:00+02:00,2025-05-25,11:26,7,9,16
68,2025-05-25T03:27:00+02:00,2025-05-25,11:27,5,4,9
68,2025-05-25T03:30:00+02:00,2025-05-25,11:30,7,10,17
68,2025-05-25T03:31:00+02:00,2025-05-25,11:31,6,6,12
68,2025-05-25T03:32:00+02:00,2025-05-25,11:32,6,6,12
68,2025-05-25T03:33:00+02:00,2025-05-25,11:33,1,3,4
68,2025-05-25T03:36:00+02:00,2025-05-25,11:36,4,3,7
72,2025-05-25T03:25:00+02:00,2025-05-25,11:25,1,2,3
72,2025-05-25T03:27:00+02:00,2025-05-25,11:27,3,5,8
72,2025-05-25T03:28:00+02:00,2025-05-25,11:28,4,5,9
72,2025-05-25T03:30:00+02:00,2025-05-25,11:30,6,10,16
72,2025-05-25T03:35:00+02:00,2025-05-25,11:35,11,14,25
72,2025-05-25T03:36:00+02:00,2025-05-25,11:36,1,6,7
72,2025-05-25T03:37:00+02:00,2025-05-25,11:37,2,5,7
76,2025-05-25T03:29:00+02:00,2025-05-25,11:29,2,2,4
76,2025-05-25T03:32:00+02:00,2025-05-25,11:32,0,4,4
79,2025-05-25T03:26:00+02:00,2025-05-25,11:26,6,7,13
79,2025-05-25T03:34:00+02:00,2025-05-25,11:34,8,4,12
79,2025-05-25T03:36:00+02:00,2025-05-25,11:36,20,7,27
79,2025-05-25T03:38:00+02:00,2025-05-25,11:38,11,4,15
85,2025-05-25T03:26:00+02:00,2025-05-25,11:26,0,1,1
85,2025-05-25T03:27:00+02:00,2025-05-25,11:27,5,0,5
85,2025-05-25T03:28:00+02:00,2025-05-25,11:28,1,0,1
85,2025-05-25T03:30:00+02:00,2025-05-25,11:30,6,3,9
85,2025-05-25T03:33:00+02:00,2025-05-25,11:33,2,1,3
85,2025-05-25T03:35:00+02:00,2025-05-25,11:35,2,2,4
85,2025-05-25T03:36:00+02:00,2025-05-25,11:36,6,0,6
86,2025-05-25T03:26:00+02:00,2025-05-25,11:26,1,0,1
86,2025-05-25T03:28:00+02:00,2025-05-25,11:28,2,0,2
86,2025-05-25T03:30:00+02:00,2025-05-25,11:30,0,2,2
86,2025-05-25T03:35:00+02:00,2025-05-25,11:35,0,1,1
86,2025-05-25T03:36:00+02:00,2025-05-25,11:36,0,2,2
117,2025-05-25T03:25:00+02:00,2025-05-25,11:25,10,12,22
117,2025-05-25T03:35:00+02:00,2025-05-25,11:35,11,12,23
123,2025-05-25T03:25:00+02:00,2025-05-25,11:25,2,0,2
123,2025-05-25T03:35:00+02:00,2025-05-25,11:35,1,1,2
137,2025-05-25T03:35:00+02:00,2025-05-25,11:35,0,5,5
138,2025-05-25T03:30:00+02:00,2025-05-25,11:30,0,6,6
139,2025-05-25T03:25:00+02:00,2025-05-25,11:25,5,6,11
139,2025-05-25T03:35:00+02:00,2025-05-25,11:35,2,1,3
141,2025-05-25T03:25:00+02:00,2025-05-25,11:25,6,13,19
141,2025-05-25T03:35:00+02:00,2025-05-25,11:35,16,7,23
161,2025-05-25T03:30:00+02:00,2025-05-25,11:30,21,8,29
164,2025-05-25T03:30:00+02:00,2025-05-25,11:30,16,2,18
181,2025-05-25T03:41:00+02:00,2025-05-25,11:41,1,29,30
181,2025-05-25T03:43:00+02:00,2025-05-25,11:43,12,15,27
181,2025-05-25T03:45:00+02:00,2025-05-25,11:45,4,24,28
181,2025-05-25T03:49:00+02:00,2025-05-25,11:49,9,25,34
181,2025-05-25T03:51:00+02:00,2025-05-25,11:51,1,22,23
181,2025-05-25T03:54:00+02:00,2025-05-25,11:54,4,28,32
180,2025-05-25T03:44:00+02:00,2025-05-25,11:44,0,2,2
180,2025-05-25T03:45:00+02:00,2025-05-25,11:45,4,0,4
180,2025-05-25T03:46:00+02:00,2025-05-25,11:46,1,0,1
180,2025-05-25T03:51:00+02:00,2025-05-25,11:51,2,0,2
3,2025-05-25T03:43:00+02:00,2025-05-25,11:43,12,22,34
3,2025-05-25T03:47:00+02:00,2025-05-25,11:47,5,6,11
3,2025-05-25T03:49:00+02:00,2025-05-25,11:49,11,6,17
4,2025-05-25T03:41:00+02:00,2025-05-25,11:41,35,21,56
4,2025-05-25T03:42:00+02:00,2025-05-25,11:42,14,21,35
5,2025-05-25T03:50:00+02:00,2025-05-25,11:50,78,84,162
6,2025-05-25T03:40:00+02:00,2025-05-25,11:40,8,7,15
6,2025-05-25T03:44:00+02:00,2025-05-25,11:44,19,12,31
6,2025-05-25T03:45:00+02:00,2025-05-25,11:45,13,23,36
6,2025-05-25T03:46:00+02:00,2025-05-25,11:46,23,4,27
6,2025-05-25T03:50:00+02:00,2025-05-25,11:50,14,14,28
6,2025-05-25T03:53:00+02:00,2025-05-25,11:53,18,7,25
6,2025-05-25T03:54:00+02:00,2025-05-25,11:54,11,9,20
8,2025-05-25T03:40:00+02:00,2025-05-25,11:40,2,10,12
8,2025-05-25T03:44:00+02:00,2025-05-25,11:44,3,1,4
8,2025-05-25T03:46:00+02:00,2025-05-25,11:46,5,3,8
8,2025-05-25T03:47:00+02:00,2025-05-25,11:47,3,2,5
8,2025-05-25T03:49:00+02:00,2025-05-25,11:49,5,7,12
8,2025-05-25T03:51:00+02:00,2025-05-25,11:51,3,17,20
8,2025-05-25T03:53:00+02:00,2025-05-25,11:53,6,6,12
8,2025-05-25T03:54:00+02:00,2025-05-25,11:54,4,6,10
28,2025-05-25T03:48:00+02:00,2025-05-25,11:48,2,9,11
28,2025-05-25T03:52:00+02:00,2025-05-25,11:52,15,6,21
28,2025-05-25T03:53:00+02:00,2025-05-25,11:53,9,10,19
29,2025-05-25T03:42:00+02:00,2025-05-25,11:42,4,5,9
29,2025-05-25T03:43:00+02:00,2025-05-25,11:43,8,2,10
31,2025-05-25T03:41:00+02:00,2025-05-25,11:41,4,2,6
31,2025-05-25T03:42:00+02:00,2025-05-25,11:42,2,0,2
31,2025-05-25T03:50:00+02:00,2025-05-25,11:50,3,7,10
36,2025-05-25T03:44:00+02:00,2025-05-25,11:44,2,2,4
36,2025-05-25T03:46:00+02:00,2025-05-25,11:46,2,1,3
36,2025-05-25T03:50:00+02:00,2025-05-25,11:50,1,2,3
36,2025-05-25T03:53:00+02:00,2025-05-25,11:53,1,2,3
36,2025-05-25T03:54:00+02:00,2025-05-25,11:54,0,1,1
37,2025-05-25T03:40:00+02:00,2025-05-25,11:40,0,3,3
37,2025-05-25T03:43:00+02:00,2025-05-25,11:43,0,2,2
37,2025-05-25T03:44:00+02:00,2025-05-25,11:44,6,0,6
37,2025-05-25T03:45:00+02:00,2025-05-25,11:45,1,1,2
37,2025-05-25T03:46:00+02:00,2025-05-25,11:46,3,0,3
37,2025-05-25T03:49:00+02:00,2025-05-25,11:49,4,3,7
37,2025-05-25T03:50:00+02:00,2025-05-25,11:50,1,0,1
37,2025-05-25T03:51:00+02:00,2025-05-25,11:51,5,0,5
39,2025-05-25T03:46:00+02:00,2025-05-25,11:46,2,0,2
39,2025-05-25T03:53:00+02:00,2025-05-25,11:53,1,0,1
40,2025-05-25T03:42:00+02:00,2025-05-25,11:42,5,1,6
40,2025-05-25T03:44:00+02:00,2025-05-25,11:44,7,4,11
40,2025-05-25T03:45:00+02:00,2025-05-25,11:45,3,1,4
40,2025-05-25T03:46:00+02:00,2025-05-25,11:46,2,7,9
40,2025-05-25T03:48:00+02:00,2025-05-25,11:48,2,1,3
40,2025-05-25T03:51:00+02:00,2025-05-25,11:51,3,0,3
41,2025-05-25T03:42:00+02:00,2025-05-25,11:42,14,10,24
41,2025-05-25T03:44:00+02:00,2025-05-25,11:44,4,6,10
41,2025-05-25T03:46:00+02:00,2025-05-25,11:46,1,4,5
41,2025-05-25T03:53:00+02:00,2025-05-25,11:53,1,0,1
44,2025-05-25T03:40:00+02:00,2025-05-25,11:40,0,1,1
44,2025-05-25T03:50:00+02:00,2025-05-25,11:50,1,5,6
45,2025-05-25T03:42:00+02:00,2025-05-25,11:42,12,2,14
45,2025-05-25T03:45:00+02:00,2025-05-25,11:45,11,3,14
45,2025-05-25T03:46:00+02:00,2025-05-25,11:46,25,4,29
45,2025-05-25T03:48:00+02:00,2025-05-25,11:48,19,3,22
47,2025-05-25T03:41:00+02:00,2025-05-25,11:41,9,1,10
47,2025-05-25T03:45:00+02:00,2025-05-25,11:45,8,13,21
47,2025-05-25T03:50:00+02:00,2025-05-25,11:50,18,14,32
50,2025-05-25T03:41:00+02:00,2025-05-25,11:41,8,8,16
50,2025-05-25T03:46:00+02:00,2025-05-25,11:46,4,8,12
50,2025-05-25T03:47:00+02:00,2025-05-25,11:47,5,2,7
50,2025-05-25T03:52:00+02:00,2025-05-25,11:52,5,5,10
50,2025-05-25T03:53:00+02:00,2025-05-25,11:53,4,1,5
54,2025-05-25T03:44:00+02:00,2025-05-25,11:44,4,0,4
54,2025-05-25T03:50:00+02:00,2025-05-25,11:50,1,0,1
54,2025-05-25T03:54:00+02:00,2025-05-25,11:54,2,0,2
59,2025-05-25T03:45:00+02:00,2025-05-25,11:45,24,26,50
59,2025-05-25T03:50:00+02:00,2025-05-25,11:50,18,26,44
61,2025-05-25T03:41:00+02:00,2025-05-25,11:41,9,6,15
61,2025-05-25T03:45:00+02:00,2025-05-25,11:45,8,10,18
61,2025-05-25T03:48:00+02:00,2025-05-25,11:48,3,2,5
61,2025-05-25T03:54:00+02:00,2025-05-25,11:54,4,9,13
66,2025-05-25T03:40:00+02:00,2025-05-25,11:40,10,11,21
66,2025-05-25T03:48:00+02:00,2025-05-25,11:48,15,16,31
66,2025-05-25T03:51:00+02:00,2025-05-25,11:51,10,16,26
66,2025-05-25T03:53:00+02:00,2025-05-25,11:53,13,28,41
69,2025-05-25T03:40:00+02:00,2025-05-25,11:40,8,1,9
69,2025-05-25T03:43:00+02:00,2025-05-25,11:43,7,4,11
69,2025-05-25T03:44:00+02:00,2025-05-25,11:44,9,1,10
69,2025-05-25T03:45:00+02:00,2025-05-25,11:45,0,6,6
69,2025-05-25T03:46:00+02:00,2025-05-25,11:46,6,17,23
69,2025-05-25T03:47:00+02:00,2025-05-25,11:47,0,4,4
69,2025-05-25T03:48:00+02:00,2025-05-25,11:48,5,4,9
69,2025-05-25T03:50:00+02:00,2025-05-25,11:50,3,2,5
69,2025-05-25T03:52:00+02:00,2025-05-25,11:52,5,3,8
70,2025-05-25T03:41:00+02:00,2025-05-25,11:41,2,2,4
70,2025-05-25T03:43:00+02:00,2025-05-25,11:43,4,4,8
70,2025-05-25T03:44:00+02:00,2025-05-25,11:44,2,3,5
70,2025-05-25T03:48:00+02:00,2025-05-25,11:48,1,0,1
70,2025-05-25T03:54:00+02:00,2025-05-25,11:54,2,0,2
75,2025-05-25T03:41:00+02:00,2025-05-25,11:41,2,0,2
77,2025-05-25T03:45:00+02:00,2025-05-25,11:45,22,12,34
77,2025-05-25T03:50:00+02:00,2025-05-25,11:50,32,11,43
78,2025-05-25T03:41:00+02:00,2025-05-25,11:41,2,4,6
78,2025-05-25T03:46:00+02:00,2025-05-25,11:46,0,1,1
78,2025-05-25T03:47:00+02:00,2025-05-25,11:47,0,1,1
78,2025-05-25T03:52:00+02:00,2025-05-25,11:52,0,1,1
78,2025-05-25T03:53:00+02:00,2025-05-25,11:53,2,5,7
87,2025-05-25T03:40:00+02:00,2025-05-25,11:40,1,3,4
87,2025-05-25T03:41:00+02:00,2025-05-25,11:41,3,2,5
87,2025-05-25T03:45:00+02:00,2025-05-25,11:45,2,2,4
87,2025-05-25T03:49:00+02:00,2025-05-25,11:49,2,4,6
87,2025-05-25T03:51:00+02:00,2025-05-25,11:51,2,2,4
107,2025-05-25T03:45:00+02:00,2025-05-25,11:45,9,5,14
108,2025-05-25T03:40:00+02:00,2025-05-25,11:40,0,2,2
108,2025-05-25T03:53:00+02:00,2025-05-25,11:53,1,1,2
118,2025-05-25T03:45:00+02:00,2025-05-25,11:45,4,0,4
118,2025-05-25T03:50:00+02:00,2025-05-25,11:50,3,0,3
131,2025-05-25T03:50:00+02:00,2025-05-25,11:50,11,11,22
132,2025-05-25T03:45:00+02:00,2025-05-25,11:45,20,6,26
132,2025-05-25T03:50:00+02:00,2025-05-25,11:50,21,9,30
134,2025-05-25T03:45:00+02:00,2025-05-25,11:45,26,30,56
165,2025-05-25T03:40:00+02:00,2025-05-25,11:40,2,2,4
165,2025-05-25T03:45:00+02:00,2025-05-25,11:45,4,6,10
166,2025-05-25T03:40:00+02:00,2025-05-25,11:40,4,8,12
166,2025-05-25T03:45:00+02:00,2025-05-25,11:45,7,8,15
167,2025-05-25T03:40:00+02:00,2025-05-25,11:40,1,4,5
179,2025-05-25T03:50:00+02:00,2025-05-25,11:50,4,4,8
1,2025-05-25T03:40:00+02:00,2025-05-25,11:40,38,9,47
1,2025-05-25T03:44:00+02:00,2025-05-25,11:44,19,5,24
1,2025-05-25T03:45:00+02:00,2025-05-25,11:45,21,26,47
1,2025-05-25T03:49:00+02:00,2025-05-25,11:49,15,18,33
1,2025-05-25T03:51:00+02:00,2025-05-25,11:51,24,19,43
1,2025-05-25T03:52:00+02:00,2025-05-25,11:52,17,19,36
2,2025-05-25T03:40:00+02:00,2025-05-25,11:40,8,8,16
2,2025-05-25T03:42:00+02:00,2025-05-25,11:42,7,13,20
2,2025-05-25T03:44:00+02:00,2025-05-25,11:44,7,7,14
2,2025-05-25T03:51:00+02:00,2025-05-25,11:51,4,13,17
2,2025-05-25T03:53:00+02:00,2025-05-25,11:53,21,6,27
9,2025-05-25T03:41:00+02:00,2025-05-25,11:41,7,0,7
9,2025-05-25T03:44:00+02:00,2025-05-25,11:44,1,4,5
9,2025-05-25T03:52:00+02:00,2025-05-25,11:52,1,0,1
9,2025-05-25T03:53:00+02:00,2025-05-25,11:53,0,2,2
10,2025-05-25T03:42:00+02:00,2025-05-25,11:42,1,0,1
10,2025-05-25T03:50:00+02:00,2025-05-25,11:50,0,2,2
10,2025-05-25T03:53:00+02:00,2025-05-25,11:53,0,2,2
11,2025-05-25T03:40:00+02:00,2025-05-25,11:40,8,3,11
11,2025-05-25T03:43:00+02:00,2025-05-25,11:43,0,1,1
11,2025-05-25T03:47:00+02:00,2025-05-25,11:47,1,1,2
11,2025-05-25T03:53:00+02:00,2025-05-25,11:53,1,2,3
12,2025-05-25T03:40:00+02:00,2025-05-25,11:40,3,3,6
12,2025-05-25T03:41:00+02:00,2025-05-25,11:41,1,4,5
17,2025-05-25T03:48:00+02:00,2025-05-25,11:48,9,11,20
17,2025-05-25T03:49:00+02:00,2025-05-25,11:49,2,5,7
17,2025-05-25T03:53:00+02:00,2025-05-25,11:53,1,5,6
18,2025-05-25T03:40:00+02:00,2025-05-25,11:40,3,0,3
18,2025-05-25T03:41:00+02:00,2025-05-25,11:41,2,3,5
18,2025-05-25T03:49:00+02:00,2025-05-25,11:49,0,2,2
18,2025-05-25T03:50:00+02:00,2025-05-25,11:50,0,2,2
18,2025-05-25T03:54:00+02:00,2025-05-25,11:54,2,2,4
19,2025-05-25T03:42:00+02:00,2025-05-25,11:42,3,7,10
19,2025-05-25T03:49:00+02:00,2025-05-25,11:49,22,2,24
19,2025-05-25T03:51:00+02:00,2025-05-25,11:51,15,5,20
20,2025-05-25T03:40:00+02:00,2025-05-25,11:40,0,6,6
20,2025-05-25T03:42:00+02:00,2025-05-25,11:42,2,6,8
23,2025-05-25T03:41:00+02:00,2025-05-25,11:41,5,3,8
23,2025-05-25T03:43:00+02:00,2025-05-25,11:43,0,4,4
23,2025-05-25T03:49:00+02:00,2025-05-25,11:49,1,3,4
23,2025-05-25T03:50:00+02:00,2025-05-25,11:50,2,2,4
23,2025-05-25T03:51:00+02:00,2025-05-25,11:51,4,2,6
24,2025-05-25T03:40:00+02:00,2025-05-25,11:40,17,0,17
24,2025-05-25T03:41:00+02:00,2025-05-25,11:41,9,0,9
24,2025-05-25T03:42:00+02:00,2025-05-25,11:42,14,15,29
24,2025-05-25T03:46:00+02:00,2025-05-25,11:46,7,9,16
24,2025-05-25T03:49:00+02:00,2025-05-25,11:49,17,4,21
24,2025-05-25T03:53:00+02:00,2025-05-25,11:53,8,12,20
24,2025-05-25T03:54:00+02:00,2025-05-25,11:54,23,7,30
25,2025-05-25T03:40:00+02:00,2025-05-25,11:40,64,69,133
27,2025-05-25T03:41:00+02:00,2025-05-25,11:41,8,4,12
27,2025-05-25T03:42:00+02:00,2025-05-25,11:42,4,0,4
27,2025-05-25T03:48:00+02:00,2025-05-25,11:48,3,2,5
27,2025-05-25T03:53:00+02:00,2025-05-25,11:53,3,6,9
30,2025-05-25T03:40:00+02:00,2025-05-25,11:40,3,7,10
30,2025-05-25T03:42:00+02:00,2025-05-25,11:42,2,4,6
30,2025-05-25T03:43:00+02:00,2025-05-25,11:43,2,0,2
35,2025-05-25T03:40:00+02:00,2025-05-25,11:40,14,19,33
35,2025-05-25T03:43:00+02:00,2025-05-25,11:43,19,18,37
35,2025-05-25T03:49:00+02:00,2025-05-25,11:49,32,19,51
35,2025-05-25T03:51:00+02:00,2025-05-25,11:51,21,11,32
35,2025-05-25T03:52:00+02:00,2025-05-25,11:52,13,23,36
46,2025-05-25T03:40:00+02:00,2025-05-25,11:40,3,1,4
46,2025-05-25T03:45:00+02:00,2025-05-25,11:45,4,4,8
46,2025-05-25T03:50:00+02:00,2025-05-25,11:50,2,7,9
48,2025-05-25T03:43:00+02:00,2025-05-25,11:43,6,12,18
49,2025-05-25T03:50:00+02:00,2025-05-25,11:50,7,10,17
49,2025-05-25T03:52:00+02:00,2025-05-25,11:52,7,15,22
51,2025-05-25T03:40:00+02:00,2025-05-25,11:40,5,1,6
51,2025-05-25T03:43:00+02:00,2025-05-25,11:43,7,5,12
51,2025-05-25T03:47:00+02:00,2025-05-25,11:47,2,1,3
51,2025-05-25T03:48:00+02:00,2025-05-25,11:48,7,0,7
52,2025-05-25T03:41:00+02:00,2025-05-25,11:41,5,3,8
52,2025-05-25T03:42:00+02:00,2025-05-25,11:42,4,1,5
52,2025-05-25T03:44:00+02:00,2025-05-25,11:44,4,5,9
52,2025-05-25T03:45:00+02:00,2025-05-25,11:45,8,8,16
52,2025-05-25T03:48:00+02:00,2025-05-25,11:48,5,3,8
52,2025-05-25T03:49:00+02:00,2025-05-25,11:49,9,7,16
52,2025-05-25T03:53:00+02:00,2025-05-25,11:53,2,5,7
53,2025-05-25T03:44:00+02:00,2025-05-25,11:44,6,5,11
53,2025-05-25T03:45:00+02:00,2025-05-25,11:45,13,12,25
53,2025-05-25T03:46:00+02:00,2025-05-25,11:46,6,5,11
53,2025-05-25T03:50:00+02:00,2025-05-25,11:50,7,4,11
53,2025-05-25T03:51:00+02:00,2025-05-25,11:51,14,10,24
56,2025-05-25T03:41:00+02:00,2025-05-25,11:41,7,4,11
56,2025-05-25T03:44:00+02:00,2025-05-25,11:44,7,6,13
56,2025-05-25T03:54:00+02:00,2025-05-25,11:54,3,14,17
58,2025-05-25T03:40:00+02:00,2025-05-25,11:40,6,4,10
58,2025-05-25T03:41:00+02:00,2025-05-25,11:41,25,6,31
58,2025-05-25T03:51:00+02:00,2025-05-25,11:51,8,11,19
58,2025-05-25T03:52:00+02:00,2025-05-25,11:52,15,16,31
58,2025-05-25T03:54:00+02:00,2025-05-25,11:54,12,9,21
62,2025-05-25T03:42:00+02:00,2025-05-25,11:42,0,2,2
62,2025-05-25T03:43:00+02:00,2025-05-25,11:43,10,1,11
62,2025-05-25T03:45:00+02:00,2025-05-25,11:45,2,3,5
62,2025-05-25T03:53:00+02:00,2025-05-25,11:53,2,3,5
62,2025-05-25T03:54:00+02:00,2025-05-25,11:54,9,3,12
63,2025-05-25T03:43:00+02:00,2025-05-25,11:43,7,3,10
63,2025-05-25T03:45:00+02:00,2025-05-25,11:45,4,8,12
63,2025-05-25T03:46:00+02:00,2025-05-25,11:46,6,1,7
63,2025-05-25T03:47:00+02:00,2025-05-25,11:47,7,3,10
63,2025-05-25T03:50:00+02:00,2025-05-25,11:50,10,7,17
63,2025-05-25T03:51:00+02:00,2025-05-25,11:51,5,2,7
63,2025-05-25T03:52:00+02:00,2025-05-25,11:52,3,9,12
63,2025-05-25T03:53:00+02:00,2025-05-25,11:53,8,0,8
63,2025-05-25T03:54:00+02:00,2025-05-25,11:54,3,5,8
67,2025-05-25T03:41:00+02:00,2025-05-25,11:41,5,4,9
67,2025-05-25T03:44:00+02:00,2025-05-25,11:44,2,9,11
67,2025-05-25T03:52:00+02:00,2025-05-25,11:52,8,14,22
67,2025-05-25T03:53:00+02:00,2025-05-25,11:53,7,6,13
68,2025-05-25T03:44:00+02:00,2025-05-25,11:44,10,5,15
68,2025-05-25T03:45:00+02:00,2025-05-25,11:45,0,3,3
68,2025-05-25T03:48:00+02:00,2025-05-25,11:48,6,2,8
68,2025-05-25T03:49:00+02:00,2025-05-25,11:49,4,4,8
68,2025-05-25T03:50:00+02:00,2025-05-25,11:50,4,8,12
68,2025-05-25T03:53:00+02:00,2025-05-25,11:53,7,1,8
68,2025-05-25T03:54:00+02:00,2025-05-25,11:54,7,8,15
72,2025-05-25T03:44:00+02:00,2025-05-25,11:44,9,6,15
72,2025-05-25T03:45:00+02:00,2025-05-25,11:45,5,7,12
72,2025-05-25T03:47:00+02:00,2025-05-25,11:47,5,5,10
72,2025-05-25T03:48:00+02:00,2025-05-25,11:48,5,8,13
72,2025-05-25T03:53:00+02:00,2025-05-25,11:53,3,18,21
72,2025-05-25T03:54:00+02:00,2025-05-25,11:54,1,5,6
76,2025-05-25T03:47:00+02:00,2025-05-25,11:47,3,1,4
76,2025-05-25T03:48:00+02:00,2025-05-25,11:48,0,1,1
76,2025-05-25T03:49:00+02:00,2025-05-25,11:49,0,1,1
76,2025-05-25T03:50:00+02:00,2025-05-25,11:50,1,0,1
76,2025-05-25T03:52:00+02:00,2025-05-25,11:52,3,0,3
76,2025-05-25T03:53:00+02:00,2025-05-25,11:53,2,0,2
79,2025-05-25T03:42:00+02:00,2025-05-25,11:42,7,6,13
79,2025-05-25T03:43:00+02:00,2025-05-25,11:43,6,2,8
79,2025-05-25T03:46:00+02:00,2025-05-25,11:46,17,2,19
79,2025-05-25T03:48:00+02:00,2025-05-25,11:48,28,3,31
79,2025-05-25T03:51:00+02:00,2025-05-25,11:51,4,7,11
79,2025-05-25T03:54:00+02:00,2025-05-25,11:54,4,7,11
85,2025-05-25T03:40:00+02:00,2025-05-25,11:40,0,3,3
85,2025-05-25T03:41:00+02:00,2025-05-25,11:41,1,2,3
85,2025-05-25T03:45:00+02:00,2025-05-25,11:45,4,0,4
85,2025-05-25T03:46:00+02:00,2025-05-25,11:46,2,0,2
85,2025-05-25T03:51:00+02:00,2025-05-25,11:51,0,2,2
86,2025-05-25T03:41:00+02:00,2025-05-25,11:41,3,0,3
86,2025-05-25T03:46:00+02:00,2025-05-25,11:46,1,0,1
109,2025-05-25T03:45:00+02:00,2025-05-25,11:45,7,5,12
117,2025-05-25T03:40:00+02:00,2025-05-25,11:40,8,13,21
117,2025-05-25T03:50:00+02:00,2025-05-25,11:50,9,14,23
130,2025-05-25T03:50:00+02:00,2025-05-25,11:50,7,8,15
137,2025-05-25T03:40:00+02:00,2025-05-25,11:40,1,2,3
138,2025-05-25T03:40:00+02:00,2025-05-25,11:40,1,2,3
138,2025-05-25T03:45:00+02:00,2025-05-25,11:45,2,3,5
138,2025-05-25T03:50:00+02:00,2025-05-25,11:50,6,0,6
139,2025-05-25T03:50:00+02:00,2025-05-25,11:50,2,0,2
142,2025-05-25T03:40:00+02:00,2025-05-25,11:40,63,54,117
161,2025-05-25T03:40:00+02:00,2025-05-25,11:40,19,24,43
161,2025-05-25T03:45:00+02:00,2025-05-25,11:45,42,10,52
164,2025-05-25T03:45:00+02:00,2025-05-25,11:45,5,3,8
181,2025-05-25T03:55:00+02:00,2025-05-25,11:55,5,10,15
181,2025-05-25T03:58:00+02:00,2025-05-25,11:58,9,17,26
181,2025-05-25T04:00:00+02:00,2025-05-25,12:00,13,17,30
181,2025-05-25T04:05:00+02:00,2025-05-25,12:05,11,26,37
181,2025-05-25T04:06:00+02:00,2025-05-25,12:06,2,14,16
181,2025-05-25T04:07:00+02:00,2025-05-25,12:07,10,17,27
180,2025-05-25T03:56:00+02:00,2025-05-25,11:56,1,1,2
180,2025-05-25T03:58:00+02:00,2025-05-25,11:58,1,0,1
180,2025-05-25T04:06:00+02:00,2025-05-25,12:06,0,2,2
180,2025-05-25T04:08:00+02:00,2025-05-25,12:08,1,2,3
3,2025-05-25T03:55:00+02:00,2025-05-25,11:55,16,6,22
3,2025-05-25T03:58:00+02:00,2025-05-25,11:58,9,16,25
3,2025-05-25T04:04:00+02:00,2025-05-25,12:04,15,9,24
3,2025-05-25T04:08:00+02:00,2025-05-25,12:08,14,11,25
3,2025-05-25T04:09:00+02:00,2025-05-25,12:09,6,17,23
4,2025-05-25T03:56:00+02:00,2025-05-25,11:56,37,13,50
4,2025-05-25T03:58:00+02:00,2025-05-25,11:58,35,18,53
4,2025-05-25T04:01:00+02:00,2025-05-25,12:01,24,21,45
4,2025-05-25T04:03:00+02:00,2025-05-25,12:03,21,14,35
4,2025-05-25T04:06:00+02:00,2025-05-25,12:06,33,20,53
4,2025-05-25T04:07:00+02:00,2025-05-25,12:07,43,16,59
5,2025-05-25T04:00:00+02:00,2025-05-25,12:00,76,83,159
6,2025-05-25T04:02:00+02:00,2025-05-25,12:02,8,22,30
6,2025-05-25T04:03:00+02:00,2025-05-25,12:03,12,7,19
6,2025-05-25T04:05:00+02:00,2025-05-25,12:05,11,15,26
8,2025-05-25T03:55:00+02:00,2025-05-25,11:55,0,3,3
8,2025-05-25T03:59:00+02:00,2025-05-25,11:59,2,3,5
8,2025-05-25T04:00:00+02:00,2025-05-25,12:00,3,6,9
8,2025-05-25T04:02:00+02:00,2025-05-25,12:02,8,4,12
28,2025-05-25T03:57:00+02:00,2025-05-25,11:57,7,3,10
28,2025-05-25T03:59:00+02:00,2025-05-25,11:59,21,8,29
28,2025-05-25T04:08:00+02:00,2025-05-25,12:08,11,4,15
29,2025-05-25T03:57:00+02:00,2025-05-25,11:57,1,11,12
29,2025-05-25T04:04:00+02:00,2025-05-25,12:04,17,16,33
29,2025-05-25T04:07:00+02:00,2025-05-25,12:07,17,15,32
31,2025-05-25T03:55:00+02:00,2025-05-25,11:55,0,7,7
31,2025-05-25T04:05:00+02:00,2025-05-25,12:05,4,2,6
31,2025-05-25T04:07:00+02:00,2025-05-25,12:07,6,3,9
36,2025-05-25T03:57:00+02:00,2025-05-25,11:57,0,1,1
36,2025-05-25T04:03:00+02:00,2025-05-25,12:03,5,0,5
36,2025-05-25T04:07:00+02:00,2025-05-25,12:07,0,6,6
37,2025-05-25T03:56:00+02:00,2025-05-25,11:56,1,0,1
37,2025-05-25T04:00:00+02:00,2025-05-25,12:00,2,3,5
37,2025-05-25T04:01:00+02:00,2025-05-25,12:01,3,2,5
37,2025-05-25T04:02:00+02:00,2025-05-25,12:02,0,1,1
37,2025-05-25T04:08:00+02:00,2025-05-25,12:08,3,2,5
37,2025-05-25T04:09:00+02:00,2025-05-25,12:09,0,2,2
39,2025-05-25T04:03:00+02:00,2025-05-25,12:03,1,2,3
40,2025-05-25T03:58:00+02:00,2025-05-25,11:58,3,4,7
40,2025-05-25T04:00:00+02:00,2025-05-25,12:00,5,4,9
40,2025-05-25T04:01:00+02:00,2025-05-25,12:01,3,2,5
40,2025-05-25T04:04:00+02:00,2025-05-25,12:04,1,8,9
40,2025-05-25T04:07:00+02:00,2025-05-25,12:07,7,9,16
40,2025-05-25T04:09:00+02:00,2025-05-25,12:09,4,4,8
41,2025-05-25T03:58:00+02:00,2025-05-25,11:58,3,2,5
41,2025-05-25T03:59:00+02:00,2025-05-25,11:59,6,6,12
41,2025-05-25T04:01:00+02:00,2025-05-25,12:01,12,3,15
41,2025-05-25T04:05:00+02:00,2025-05-25,12:05,5,11,16
41,2025-05-25T04:09:00+02:00,2025-05-25,12:09,7,7,14
43,2025-05-25T04:00:00+02:00,2025-05-25,12:00,5,7,12
44,2025-05-25T03:55:00+02:00,2025-05-25,11:55,5,7,12
44,2025-05-25T04:05:00+02:00,2025-05-25,12:05,9,8,17
45,2025-05-25T03:57:00+02:00,2025-05-25,11:57,11,13,24
45,2025-05-25T04:01:00+02:00,2025-05-25,12:01,9,17,26
45,2025-05-25T04:05:00+02:00,2025-05-25,12:05,16,23,39
45,2025-05-25T04:08:00+02:00,2025-05-25,12:08,27,4,31
45,2025-05-25T04:09:00+02:00,2025-05-25,12:09,13,10,23
47,2025-05-25T04:00:00+02:00,2025-05-25,12:00,11,22,33
47,2025-05-25T04:01:00+02:00,2025-05-25,12:01,11,18,29
47,2025-05-25T04:02:00+02:00,2025-05-25,12:02,16,6,22
47,2025-05-25T04:06:00+02:00,2025-05-25,12:06,10,26,36
47,2025-05-25T04:08:00+02:00,2025-05-25,12:08,13,10,23
47,2025-05-25T04:09:00+02:00,2025-05-25,12:09,19,19,38
50,2025-05-25T03:55:00+02:00,2025-05-25,11:55,3,3,6
50,2025-05-25T03:57:00+02:00,2025-05-25,11:57,7,13,20
50,2025-05-25T04:04:00+02:00,2025-05-25,12:04,0,3,3
50,2025-05-25T04:08:00+02:00,2025-05-25,12:08,6,4,10
54,2025-05-25T03:58:00+02:00,2025-05-25,11:58,0,5,5
54,2025-05-25T04:00:00+02:00,2025-05-25,12:00,1,4,5
54,2025-05-25T04:08:00+02:00,2025-05-25,12:08,1,0,1
59,2025-05-25T03:55:00+02:00,2025-05-25,11:55,10,22,32
61,2025-05-25T03:55:00+02:00,2025-05-25,11:55,4,5,9
61,2025-05-25T03:56:00+02:00,2025-05-25,11:56,8,6,14
61,2025-05-25T03:57:00+02:00,2025-05-25,11:57,8,9,17
61,2025-05-25T03:58:00+02:00,2025-05-25,11:58,3,5,8
61,2025-05-25T03:59:00+02:00,2025-05-25,11:59,2,8,10
61,2025-05-25T04:00:00+02:00,2025-05-25,12:00,7,2,9
61,2025-05-25T04:04:00+02:00,2025-05-25,12:04,10,4,14
61,2025-05-25T04:05:00+02:00,2025-05-25,12:05,3,4,7
61,2025-05-25T04:06:00+02:00,2025-05-25,12:06,6,7,13
61,2025-05-25T04:08:00+02:00,2025-05-25,12:08,2,10,12
66,2025-05-25T03:55:00+02:00,2025-05-25,11:55,13,23,36
66,2025-05-25T03:59:00+02:00,2025-05-25,11:59,28,18,46
66,2025-05-25T04:05:00+02:00,2025-05-25,12:05,26,19,45
66,2025-05-25T04:06:00+02:00,2025-05-25,12:06,15,34,49
66,2025-05-25T04:07:00+02:00,2025-05-25,12:07,26,19,45
69,2025-05-25T03:58:00+02:00,2025-05-25,11:58,6,14,20
69,2025-05-25T04:00:00+02:00,2025-05-25,12:00,3,2,5
69,2025-05-25T04:01:00+02:00,2025-05-25,12:01,1,6,7
69,2025-05-25T04:06:00+02:00,2025-05-25,12:06,2,1,3
69,2025-05-25T04:07:00+02:00,2025-05-25,12:07,3,9,12
69,2025-05-25T04:08:00+02:00,2025-05-25,12:08,4,3,7
70,2025-05-25T03:57:00+02:00,2025-05-25,11:57,4,0,4
70,2025-05-25T03:58:00+02:00,2025-05-25,11:58,2,2,4
70,2025-05-25T04:05:00+02:00,2025-05-25,12:05,1,1,2
70,2025-05-25T04:06:00+02:00,2025-05-25,12:06,2,6,8
70,2025-05-25T04:09:00+02:00,2025-05-25,12:09,1,3,4
71,2025-05-25T04:02:00+02:00,2025-05-25,12:02,0,1,1
75,2025-05-25T03:57:00+02:00,2025-05-25,11:57,0,1,1
75,2025-05-25T03:58:00+02:00,2025-05-25,11:58,0,1,1
75,2025-05-25T04:01:00+02:00,2025-05-25,12:01,1,0,1
75,2025-05-25T04:02:00+02:00,2025-05-25,12:02,1,3,4
75,2025-05-25T04:07:00+02:00,2025-05-25,12:07,2,0,2
77,2025-05-25T03:55:00+02:00,2025-05-25,11:55,16,14,30
77,2025-05-25T04:00:00+02:00,2025-05-25,12:00,12,18,30
78,2025-05-25T03:58:00+02:00,2025-05-25,11:58,0,1,1
78,2025-05-25T04:01:00+02:00,2025-05-25,12:01,1,0,1
78,2025-05-25T04:06:00+02:00,2025-05-25,12:06,2,4,6
78,2025-05-25T04:09:00+02:00,2025-05-25,12:09,0,1,1
84,2025-05-25T04:05:00+02:00,2025-05-25,12:05,99,52,151
87,2025-05-25T04:00:00+02:00,2025-05-25,12:00,1,4,5
87,2025-05-25T04:01:00+02:00,2025-05-25,12:01,0,10,10
87,2025-05-25T04:03:00+02:00,2025-05-25,12:03,2,2,4
87,2025-05-25T04:08:00+02:00,2025-05-25,12:08,5,2,7
107,2025-05-25T03:55:00+02:00,2025-05-25,11:55,4,9,13
107,2025-05-25T04:00:00+02:00,2025-05-25,12:00,5,12,17
107,2025-05-25T04:05:00+02:00,2025-05-25,12:05,11,8,19
108,2025-05-25T03:55:00+02:00,2025-05-25,11:55,2,0,2
108,2025-05-25T03:57:00+02:00,2025-05-25,11:57,1,3,4
108,2025-05-25T03:58:00+02:00,2025-05-25,11:58,2,5,7
108,2025-05-25T03:59:00+02:00,2025-05-25,11:59,5,2,7
108,2025-05-25T04:07:00+02:00,2025-05-25,12:07,1,2,3
118,2025-05-25T04:00:00+02:00,2025-05-25,12:00,2,0,2
118,2025-05-25T04:05:00+02:00,2025-05-25,12:05,0,2,2
124,2025-05-25T04:05:00+02:00,2025-05-25,12:05,1,1,2
132,2025-05-25T03:55:00+02:00,2025-05-25,11:55,12,25,37
133,2025-05-25T03:55:00+02:00,2025-05-25,11:55,41,47,88
134,2025-05-25T04:00:00+02:00,2025-05-25,12:00,26,42,68
135,2025-05-25T03:55:00+02:00,2025-05-25,11:55,30,30,60
140,2025-05-25T03:55:00+02:00,2025-05-25,11:55,9,5,14
140,2025-05-25T04:00:00+02:00,2025-05-25,12:00,8,2,10
140,2025-05-25T04:05:00+02:00,2025-05-25,12:05,4,5,9
162,2025-05-25T04:05:00+02:00,2025-05-25,12:05,57,86,143
167,2025-05-25T04:00:00+02:00,2025-05-25,12:00,2,5,7
1,2025-05-25T03:55:00+02:00,2025-05-25,11:55,27,7,34
1,2025-05-25T03:57:00+02:00,2025-05-25,11:57,35,28,63
1,2025-05-25T03:58:00+02:00,2025-05-25,11:58,28,16,44
1,2025-05-25T04:00:00+02:00,2025-05-25,12:00,30,13,43
1,2025-05-25T04:03:00+02:00,2025-05-25,12:03,20,6,26
1,2025-05-25T04:04:00+02:00,2025-05-25,12:04,15,31,46
1,2025-05-25T04:05:00+02:00,2025-05-25,12:05,27,20,47
1,2025-05-25T04:09:00+02:00,2025-05-25,12:09,20,30,50
2,2025-05-25T03:57:00+02:00,2025-05-25,11:57,12,10,22
2,2025-05-25T03:59:00+02:00,2025-05-25,11:59,6,12,18
2,2025-05-25T04:00:00+02:00,2025-05-25,12:00,9,13,22
2,2025-05-25T04:03:00+02:00,2025-05-25,12:03,4,14,18
2,2025-05-25T04:05:00+02:00,2025-05-25,12:05,7,6,13
2,2025-05-25T04:06:00+02:00,2025-05-25,12:06,11,3,14
2,2025-05-25T04:07:00+02:00,2025-05-25,12:07,11,7,18
9,2025-05-25T03:58:00+02:00,2025-05-25,11:58,0,2,2
9,2025-05-25T04:02:00+02:00,2025-05-25,12:02,1,1,2
10,2025-05-25T04:01:00+02:00,2025-05-25,12:01,0,2,2
10,2025-05-25T04:02:00+02:00,2025-05-25,12:02,0,2,2
10,2025-05-25T04:05:00+02:00,2025-05-25,12:05,0,1,1
10,2025-05-25T04:09:00+02:00,2025-05-25,12:09,0,2,2
11,2025-05-25T03:55:00+02:00,2025-05-25,11:55,6,2,8
11,2025-05-25T03:57:00+02:00,2025-05-25,11:57,0,2,2
11,2025-05-25T03:58:00+02:00,2025-05-25,11:58,4,0,4
11,2025-05-25T04:00:00+02:00,2025-05-25,12:00,4,6,10
11,2025-05-25T04:02:00+02:00,2025-05-25,12:02,1,5,6
11,2025-05-25T04:05:00+02:00,2025-05-25,12:05,7,5,12
11,2025-05-25T04:06:00+02:00,2025-05-25,12:06,1,2,3
12,2025-05-25T03:56:00+02:00,2025-05-25,11:56,4,5,9
12,2025-05-25T04:05:00+02:00,2025-05-25,12:05,1,1,2
17,2025-05-25T03:57:00+02:00,2025-05-25,11:57,6,8,14
17,2025-05-25T04:04:00+02:00,2025-05-25,12:04,8,4,12
17,2025-05-25T04:05:00+02:00,2025-05-25,12:05,3,2,5
17,2025-05-25T04:06:00+02:00,2025-05-25,12:06,11,0,11
17,2025-05-25T04:08:00+02:00,2025-05-25,12:08,6,4,10
17,2025-05-25T04:09:00+02:00,2025-05-25,12:09,3,7,10
18,2025-05-25T03:55:00+02:00,2025-05-25,11:55,5,3,8
18,2025-05-25T03:57:00+02:00,2025-05-25,11:57,1,2,3
18,2025-05-25T03:58:00+02:00,2025-05-25,11:58,0,1,1
18,2025-05-25T04:00:00+02:00,2025-05-25,12:00,6,11,17
18,2025-05-25T04:03:00+02:00,2025-05-25,12:03,0,3,3
18,2025-05-25T04:04:00+02:00,2025-05-25,12:04,1,4,5
19,2025-05-25T03:56:00+02:00,2025-05-25,11:56,6,7,13
19,2025-05-25T03:59:00+02:00,2025-05-25,11:59,9,6,15
19,2025-05-25T04:02:00+02:00,2025-05-25,12:02,13,7,20
19,2025-05-25T04:04:00+02:00,2025-05-25,12:04,12,8,20
19,2025-05-25T04:05:00+02:00,2025-05-25,12:05,9,4,13
19,2025-05-25T04:06:00+02:00,2025-05-25,12:06,8,4,12
19,2025-05-25T04:08:00+02:00,2025-05-25,12:08,22,2,24
19,2025-05-25T04:09:00+02:00,2025-05-25,12:09,11,6,17
23,2025-05-25T03:57:00+02:00,2025-05-25,11:57,0,3,3
23,2025-05-25T04:03:00+02:00,2025-05-25,12:03,0,8,8
23,2025-05-25T04:08:00+02:00,2025-05-25,12:08,3,1,4
24,2025-05-25T04:01:00+02:00,2025-05-25,12:01,4,13,17
25,2025-05-25T04:00:00+02:00,2025-05-25,12:00,58,71,129
25,2025-05-25T04:05:00+02:00,2025-05-25,12:05,58,49,107
27,2025-05-25T03:57:00+02:00,2025-05-25,11:57,3,2,5
27,2025-05-25T04:01:00+02:00,2025-05-25,12:01,2,5,7
27,2025-05-25T04:03:00+02:00,2025-05-25,12:03,6,3,9
27,2025-05-25T04:07:00+02:00,2025-05-25,12:07,5,0,5
30,2025-05-25T03:55:00+02:00,2025-05-25,11:55,10,7,17
30,2025-05-25T03:56:00+02:00,2025-05-25,11:56,3,6,9
30,2025-05-25T04:00:00+02:00,2025-05-25,12:00,1,10,11
30,2025-05-25T04:05:00+02:00,2025-05-25,12:05,5,5,10
30,2025-05-25T04:08:00+02:00,2025-05-25,12:08,8,5,13
35,2025-05-25T03:58:00+02:00,2025-05-25,11:58,20,17,37
35,2025-05-25T04:03:00+02:00,2025-05-25,12:03,29,14,43
35,2025-05-25T04:06:00+02:00,2025-05-25,12:06,12,21,33
35,2025-05-25T04:07:00+02:00,2025-05-25,12:07,17,29,46
35,2025-05-25T04:08:00+02:00,2025-05-25,12:08,29,10,39
48,2025-05-25T03:55:00+02:00,2025-05-25,11:55,11,2,13
48,2025-05-25T03:56:00+02:00,2025-05-25,11:56,7,8,15
48,2025-05-25T03:59:00+02:00,2025-05-25,11:59,10,7,17
48,2025-05-25T04:00:00+02:00,2025-05-25,12:00,9,5,14
48,2025-05-25T04:02:00+02:00,2025-05-25,12:02,11,7,18
48,2025-05-25T04:03:00+02:00,2025-05-25,12:03,21,6,27
49,2025-05-25T03:55:00+02:00,2025-05-25,11:55,6,9,15
49,2025-05-25T03:56:00+02:00,2025-05-25,11:56,12,9,21
49,2025-05-25T04:03:00+02:00,2025-05-25,12:03,5,28,33
49,2025-05-25T04:04:00+02:00,2025-05-25,12:04,11,10,21
49,2025-05-25T04:06:00+02:00,2025-05-25,12:06,4,12,16
49,2025-05-25T04:08:00+02:00,2025-05-25,12:08,13,9,22
51,2025-05-25T03:55:00+02:00,2025-05-25,11:55,0,1,1
51,2025-05-25T03:56:00+02:00,2025-05-25,11:56,7,2,9
51,2025-05-25T03:59:00+02:00,2025-05-25,11:59,2,1,3
51,2025-05-25T04:01:00+02:00,2025-05-25,12:01,0,1,1
51,2025-05-25T04:02:00+02:00,2025-05-25,12:02,4,3,7
51,2025-05-25T04:03:00+02:00,2025-05-25,12:03,6,3,9
51,2025-05-25T04:05:00+02:00,2025-05-25,12:05,3,3,6
51,2025-05-25T04:07:00+02:00,2025-05-25,12:07,0,1,1
51,2025-05-25T04:08:00+02:00,2025-05-25,12:08,0,1,1
51,2025-05-25T04:09:00+02:00,2025-05-25,12:09,0,5,5
52,2025-05-25T03:55:00+02:00,2025-05-25,11:55,7,6,13
52,2025-05-25T03:57:00+02:00,2025-05-25,11:57,3,1,4
52,2025-05-25T04:02:00+02:00,2025-05-25,12:02,8,4,12
52,2025-05-25T04:03:00+02:00,2025-05-25,12:03,8,6,14
52,2025-05-25T04:04:00+02:00,2025-05-25,12:04,7,1,8
52,2025-05-25T04:08:00+02:00,2025-05-25,12:08,7,9,16
53,2025-05-25T03:57:00+02:00,2025-05-25,11:57,7,7,14
53,2025-05-25T03:58:00+02:00,2025-05-25,11:58,9,8,17
53,2025-05-25T04:00:00+02:00,2025-05-25,12:00,15,9,24
53,2025-05-25T04:04:00+02:00,2025-05-25,12:04,5,9,14
53,2025-05-25T04:06:00+02:00,2025-05-25,12:06,19,7,26
56,2025-05-25T03:56:00+02:00,2025-05-25,11:56,2,6,8
56,2025-05-25T04:06:00+02:00,2025-05-25,12:06,8,1,9
56,2025-05-25T04:08:00+02:00,2025-05-25,12:08,6,9,15
58,2025-05-25T03:55:00+02:00,2025-05-25,11:55,6,12,18
58,2025-05-25T03:56:00+02:00,2025-05-25,11:56,15,8,23
58,2025-05-25T03:57:00+02:00,2025-05-25,11:57,16,9,25
58,2025-05-25T03:58:00+02:00,2025-05-25,11:58,4,9,13
58,2025-05-25T04:08:00+02:00,2025-05-25,12:08,1,8,9
62,2025-05-25T03:58:00+02:00,2025-05-25,11:58,3,1,4
62,2025-05-25T04:00:00+02:00,2025-05-25,12:00,6,2,8
62,2025-05-25T04:01:00+02:00,2025-05-25,12:01,6,2,8
62,2025-05-25T04:04:00+02:00,2025-05-25,12:04,1,0,1
62,2025-05-25T04:07:00+02:00,2025-05-25,12:07,1,4,5
63,2025-05-25T03:59:00+02:00,2025-05-25,11:59,3,6,9
63,2025-05-25T04:03:00+02:00,2025-05-25,12:03,5,0,5
63,2025-05-25T04:04:00+02:00,2025-05-25,12:04,4,1,5
63,2025-05-25T04:09:00+02:00,2025-05-25,12:09,1,19,20
67,2025-05-25T04:01:00+02:00,2025-05-25,12:01,2,0,2
67,2025-05-25T04:03:00+02:00,2025-05-25,12:03,6,11,17
68,2025-05-25T03:55:00+02:00,2025-05-25,11:55,5,4,9
68,2025-05-25T03:56:00+02:00,2025-05-25,11:56,6,5,11
68,2025-05-25T03:57:00+02:00,2025-05-25,11:57,10,10,20
68,2025-05-25T03:58:00+02:00,2025-05-25,11:58,3,5,8
68,2025-05-25T04:04:00+02:00,2025-05-25,12:04,4,2,6
68,2025-05-25T04:08:00+02:00,2025-05-25,12:08,7,2,9
72,2025-05-25T03:55:00+02:00,2025-05-25,11:55,7,13,20
72,2025-05-25T03:57:00+02:00,2025-05-25,11:57,2,2,4
72,2025-05-25T04:00:00+02:00,2025-05-25,12:00,3,5,8
72,2025-05-25T04:01:00+02:00,2025-05-25,12:01,3,11,14
72,2025-05-25T04:04:00+02:00,2025-05-25,12:04,5,5,10
72,2025-05-25T04:05:00+02:00,2025-05-25,12:05,0,7,7
72,2025-05-25T04:09:00+02:00,2025-05-25,12:09,2,8,10
76,2025-05-25T03:56:00+02:00,2025-05-25,11:56,0,3,3
76,2025-05-25T03:57:00+02:00,2025-05-25,11:57,2,0,2
76,2025-05-25T04:06:00+02:00,2025-05-25,12:06,0,1,1
79,2025-05-25T03:57:00+02:00,2025-05-25,11:57,33,10,43
79,2025-05-25T04:00:00+02:00,2025-05-25,12:00,7,4,11
79,2025-05-25T04:08:00+02:00,2025-05-25,12:08,6,6,12
79,2025-05-25T04:09:00+02:00,2025-05-25,12:09,7,5,12
85,2025-05-25T03:55:00+02:00,2025-05-25,11:55,1,0,1
85,2025-05-25T04:03:00+02:00,2025-05-25,12:03,2,0,2
86,2025-05-25T03:55:00+02:00,2025-05-25,11:55,1,0,1
86,2025-05-25T03:58:00+02:00,2025-05-25,11:58,2,2,4
86,2025-05-25T04:00:00+02:00,2025-05-25,12:00,0,3,3
86,2025-05-25T04:08:00+02:00,2025-05-25,12:08,1,0,1
109,2025-05-25T04:00:00+02:00,2025-05-25,12:00,9,3,12
117,2025-05-25T03:55:00+02:00,2025-05-25,11:55,8,22,30
137,2025-05-25T03:55:00+02:00,2025-05-25,11:55,0,3,3
137,2025-05-25T04:05:00+02:00,2025-05-25,12:05,1,0,1
138,2025-05-25T04:00:00+02:00,2025-05-25,12:00,2,0,2
139,2025-05-25T03:55:00+02:00,2025-05-25,11:55,11,2,13
142,2025-05-25T04:05:00+02:00,2025-05-25,12:05,58,50,108
161,2025-05-25T04:05:00+02:00,2025-05-25,12:05,37,23,60
164,2025-05-25T04:05:00+02:00,2025-05-25,12:05,6,2,8
181,2025-05-25T04:10:00+02:00,2025-05-25,12:10,2,11,13
181,2025-05-25T04:12:00+02:00,2025-05-25,12:12,5,7,12
181,2025-05-25T04:23:00+02:00,2025-05-25,12:23,14,13,27
181,2025-05-25T04:24:00+02:00,2025-05-25,12:24,4,23,27
180,2025-05-25T04:10:00+02:00,2025-05-25,12:10,0,2,2
180,2025-05-25T04:11:00+02:00,2025-05-25,12:11,1,2,3
180,2025-05-25T04:13:00+02:00,2025-05-25,12:13,6,0,6
180,2025-05-25T04:17:00+02:00,2025-05-25,12:17,1,0,1
3,2025-05-25T04:10:00+02:00,2025-05-25,12:10,7,24,31
3,2025-05-25T04:13:00+02:00,2025-05-25,12:13,10,29,39
3,2025-05-25T04:15:00+02:00,2025-05-25,12:15,9,20,29
3,2025-05-25T04:16:00+02:00,2025-05-25,12:16,6,14,20
3,2025-05-25T04:17:00+02:00,2025-05-25,12:17,4,12,16
3,2025-05-25T04:19:00+02:00,2025-05-25,12:19,14,14,28
3,2025-05-25T04:23:00+02:00,2025-05-25,12:23,11,18,29
4,2025-05-25T04:11:00+02:00,2025-05-25,12:11,22,11,33
4,2025-05-25T04:15:00+02:00,2025-05-25,12:15,52,26,78
4,2025-05-25T04:20:00+02:00,2025-05-25,12:20,15,17,32
4,2025-05-25T04:21:00+02:00,2025-05-25,12:21,32,33,65
5,2025-05-25T04:15:00+02:00,2025-05-25,12:15,69,79,148
5,2025-05-25T04:20:00+02:00,2025-05-25,12:20,97,89,186
6,2025-05-25T04:12:00+02:00,2025-05-25,12:12,23,12,35
6,2025-05-25T04:17:00+02:00,2025-05-25,12:17,10,20,30
6,2025-05-25T04:24:00+02:00,2025-05-25,12:24,11,16,27
8,2025-05-25T04:10:00+02:00,2025-05-25,12:10,0,7,7
8,2025-05-25T04:11:00+02:00,2025-05-25,12:11,0,6,6
8,2025-05-25T04:16:00+02:00,2025-05-25,12:16,3,1,4
8,2025-05-25T04:17:00+02:00,2025-05-25,12:17,1,1,2
8,2025-05-25T04:21:00+02:00,2025-05-25,12:21,7,3,10
28,2025-05-25T04:11:00+02:00,2025-05-25,12:11,6,11,17
28,2025-05-25T04:14:00+02:00,2025-05-25,12:14,8,6,14
28,2025-05-25T04:16:00+02:00,2025-05-25,12:16,5,9,14
28,2025-05-25T04:21:00+02:00,2025-05-25,12:21,5,2,7
28,2025-05-25T04:24:00+02:00,2025-05-25,12:24,21,4,25
29,2025-05-25T04:14:00+02:00,2025-05-25,12:14,14,6,20
29,2025-05-25T04:15:00+02:00,2025-05-25,12:15,14,11,25
29,2025-05-25T04:16:00+02:00,2025-05-25,12:16,15,5,20
29,2025-05-25T04:19:00+02:00,2025-05-25,12:19,7,3,10
29,2025-05-25T04:24:00+02:00,2025-05-25,12:24,9,11,20
31,2025-05-25T04:10:00+02:00,2025-05-25,12:10,8,5,13
31,2025-05-25T04:14:00+02:00,2025-05-25,12:14,3,2,5
31,2025-05-25T04:16:00+02:00,2025-05-25,12:16,0,4,4
31,2025-05-25T04:17:00+02:00,2025-05-25,12:17,7,1,8
31,2025-05-25T04:23:00+02:00,2025-05-25,12:23,2,1,3
31,2025-05-25T04:24:00+02:00,2025-05-25,12:24,5,0,5
36,2025-05-25T04:11:00+02:00,2025-05-25,12:11,7,1,8
36,2025-05-25T04:13:00+02:00,2025-05-25,12:13,6,1,7
36,2025-05-25T04:15:00+02:00,2025-05-25,12:15,0,6,6
36,2025-05-25T04:22:00+02:00,2025-05-25,12:22,0,1,1
36,2025-05-25T04:24:00+02:00,2025-05-25,12:24,1,0,1
37,2025-05-25T04:20:00+02:00,2025-05-25,12:20,6,0,6
37,2025-05-25T04:22:00+02:00,2025-05-25,12:22,10,1,11
37,2025-05-25T04:23:00+02:00,2025-05-25,12:23,3,2,5
39,2025-05-25T04:15:00+02:00,2025-05-25,12:15,1,4,5
39,2025-05-25T04:16:00+02:00,2025-05-25,12:16,2,1,3
39,2025-05-25T04:20:00+02:00,2025-05-25,12:20,1,0,1
39,2025-05-25T04:23:00+02:00,2025-05-25,12:23,0,2,2
40,2025-05-25T04:10:00+02:00,2025-05-25,12:10,6,5,11
40,2025-05-25T04:23:00+02:00,2025-05-25,12:23,3,7,10
40,2025-05-25T04:24:00+02:00,2025-05-25,12:24,2,5,7
41,2025-05-25T04:11:00+02:00,2025-05-25,12:11,5,4,9
41,2025-05-25T04:12:00+02:00,2025-05-25,12:12,6,2,8
41,2025-05-25T04:19:00+02:00,2025-05-25,12:19,4,1,5
41,2025-05-25T04:21:00+02:00,2025-05-25,12:21,8,12,20
41,2025-05-25T04:24:00+02:00,2025-05-25,12:24,11,7,18
43,2025-05-25T04:20:00+02:00,2025-05-25,12:20,7,2,9
44,2025-05-25T04:10:00+02:00,2025-05-25,12:10,3,8,11
45,2025-05-25T04:11:00+02:00,2025-05-25,12:11,17,31,48
45,2025-05-25T04:16:00+02:00,2025-05-25,12:16,29,22,51
45,2025-05-25T04:17:00+02:00,2025-05-25,12:17,15,16,31
45,2025-05-25T04:18:00+02:00,2025-05-25,12:18,6,13,19
45,2025-05-25T04:19:00+02:00,2025-05-25,12:19,21,16,37
45,2025-05-25T04:22:00+02:00,2025-05-25,12:22,15,10,25
45,2025-05-25T04:24:00+02:00,2025-05-25,12:24,29,11,40
47,2025-05-25T04:12:00+02:00,2025-05-25,12:12,10,23,33
47,2025-05-25T04:13:00+02:00,2025-05-25,12:13,7,34,41
47,2025-05-25T04:14:00+02:00,2025-05-25,12:14,17,11,28
47,2025-05-25T04:22:00+02:00,2025-05-25,12:22,5,20,25
50,2025-05-25T04:14:00+02:00,2025-05-25,12:14,2,5,7
50,2025-05-25T04:15:00+02:00,2025-05-25,12:15,4,6,10
50,2025-05-25T04:18:00+02:00,2025-05-25,12:18,8,5,13
50,2025-05-25T04:19:00+02:00,2025-05-25,12:19,2,4,6
50,2025-05-25T04:20:00+02:00,2025-05-25,12:20,8,3,11
50,2025-05-25T04:22:00+02:00,2025-05-25,12:22,2,3,5
54,2025-05-25T04:10:00+02:00,2025-05-25,12:10,0,2,2
54,2025-05-25T04:15:00+02:00,2025-05-25,12:15,4,1,5
54,2025-05-25T04:16:00+02:00,2025-05-25,12:16,1,0,1
54,2025-05-25T04:19:00+02:00,2025-05-25,12:19,1,6,7
59,2025-05-25T04:20:00+02:00,2025-05-25,12:20,17,39,56
61,2025-05-25T04:10:00+02:00,2025-05-25,12:10,8,13,21
61,2025-05-25T04:15:00+02:00,2025-05-25,12:15,11,13,24
61,2025-05-25T04:18:00+02:00,2025-05-25,12:18,6,0,6
61,2025-05-25T04:22:00+02:00,2025-05-25,12:22,8,7,15
61,2025-05-25T04:23:00+02:00,2025-05-25,12:23,4,10,14
61,2025-05-25T04:24:00+02:00,2025-05-25,12:24,7,5,12
66,2025-05-25T04:19:00+02:00,2025-05-25,12:19,27,5,32
66,2025-05-25T04:22:00+02:00,2025-05-25,12:22,24,18,42
69,2025-05-25T04:10:00+02:00,2025-05-25,12:10,6,3,9
69,2025-05-25T04:11:00+02:00,2025-05-25,12:11,8,1,9
69,2025-05-25T04:19:00+02:00,2025-05-25,12:19,6,7,13
69,2025-05-25T04:22:00+02:00,2025-05-25,12:22,3,1,4
69,2025-05-25T04:23:00+02:00,2025-05-25,12:23,8,1,9
70,2025-05-25T04:12:00+02:00,2025-05-25,12:12,2,3,5
70,2025-05-25T04:16:00+02:00,2025-05-25,12:16,3,0,3
70,2025-05-25T04:17:00+02:00,2025-05-25,12:17,1,0,1
70,2025-05-25T04:19:00+02:00,2025-05-25,12:19,3,3,6
70,2025-05-25T04:22:00+02:00,2025-05-25,12:22,2,0,2
71,2025-05-25T04:16:00+02:00,2025-05-25,12:16,1,0,1
71,2025-05-25T04:21:00+02:00,2025-05-25,12:21,1,0,1
75,2025-05-25T04:16:00+02:00,2025-05-25,12:16,0,4,4
75,2025-05-25T04:21:00+02:00,2025-05-25,12:21,3,0,3
78,2025-05-25T04:11:00+02:00,2025-05-25,12:11,3,2,5
78,2025-05-25T04:12:00+02:00,2025-05-25,12:12,2,0,2
78,2025-05-25T04:15:00+02:00,2025-05-25,12:15,2,0,2
78,2025-05-25T04:17:00+02:00,2025-05-25,12:17,2,2,4
78,2025-05-25T04:19:00+02:00,2025-05-25,12:19,0,7,7
84,2025-05-25T04:20:00+02:00,2025-05-25,12:20,93,61,154
87,2025-05-25T04:12:00+02:00,2025-05-25,12:12,1,5,6
87,2025-05-25T04:13:00+02:00,2025-05-25,12:13,7,2,9
87,2025-05-25T04:14:00+02:00,2025-05-25,12:14,0,1,1
87,2025-05-25T04:19:00+02:00,2025-05-25,12:19,1,1,2
87,2025-05-25T04:21:00+02:00,2025-05-25,12:21,2,4,6
87,2025-05-25T04:24:00+02:00,2025-05-25,12:24,1,4,5
107,2025-05-25T04:10:00+02:00,2025-05-25,12:10,2,9,11
108,2025-05-25T04:10:00+02:00,2025-05-25,12:10,0,1,1
108,2025-05-25T04:13:00+02:00,2025-05-25,12:13,2,3,5
108,2025-05-25T04:17:00+02:00,2025-05-25,12:17,4,4,8
108,2025-05-25T04:18:00+02:00,2025-05-25,12:18,6,0,6
108,2025-05-25T04:22:00+02:00,2025-05-25,12:22,0,2,2
118,2025-05-25T04:10:00+02:00,2025-05-25,12:10,0,3,3
131,2025-05-25T04:20:00+02:00,2025-05-25,12:20,20,10,30
132,2025-05-25T04:15:00+02:00,2025-05-25,12:15,13,12,25
132,2025-05-25T04:20:00+02:00,2025-05-25,12:20,17,17,34
133,2025-05-25T04:15:00+02:00,2025-05-25,12:15,29,45,74
134,2025-05-25T04:10:00+02:00,2025-05-25,12:10,21,34,55
134,2025-05-25T04:15:00+02:00,2025-05-25,12:15,50,30,80
135,2025-05-25T04:10:00+02:00,2025-05-25,12:10,32,29,61
135,2025-05-25T04:20:00+02:00,2025-05-25,12:20,20,51,71
140,2025-05-25T04:15:00+02:00,2025-05-25,12:15,11,2,13
162,2025-05-25T04:20:00+02:00,2025-05-25,12:20,65,79,144
165,2025-05-25T04:20:00+02:00,2025-05-25,12:20,0,7,7
179,2025-05-25T04:10:00+02:00,2025-05-25,12:10,13,3,16
1,2025-05-25T04:12:00+02:00,2025-05-25,12:12,34,9,43
1,2025-05-25T04:13:00+02:00,2025-05-25,12:13,28,6,34
1,2025-05-25T04:16:00+02:00,2025-05-25,12:16,25,20,45
1,2025-05-25T04:17:00+02:00,2025-05-25,12:17,29,31,60
1,2025-05-25T04:19:00+02:00,2025-05-25,12:19,23,14,37
1,2025-05-25T04:21:00+02:00,2025-05-25,12:21,13,8,21
1,2025-05-25T04:22:00+02:00,2025-05-25,12:22,35,16,51
1,2025-05-25T04:23:00+02:00,2025-05-25,12:23,30,13,43
2,2025-05-25T04:11:00+02:00,2025-05-25,12:11,7,8,15
2,2025-05-25T04:16:00+02:00,2025-05-25,12:16,14,10,24
9,2025-05-25T04:10:00+02:00,2025-05-25,12:10,2,0,2
9,2025-05-25T04:12:00+02:00,2025-05-25,12:12,0,2,2
9,2025-05-25T04:13:00+02:00,2025-05-25,12:13,3,0,3
9,2025-05-25T04:14:00+02:00,2025-05-25,12:14,1,0,1
10,2025-05-25T04:10:00+02:00,2025-05-25,12:10,0,1,1
10,2025-05-25T04:19:00+02:00,2025-05-25,12:19,1,1,2
10,2025-05-25T04:21:00+02:00,2025-05-25,12:21,3,0,3
11,2025-05-25T04:11:00+02:00,2025-05-25,12:11,2,1,3
11,2025-05-25T04:14:00+02:00,2025-05-25,12:14,1,4,5
11,2025-05-25T04:18:00+02:00,2025-05-25,12:18,1,0,1
12,2025-05-25T04:11:00+02:00,2025-05-25,12:11,4,1,5
12,2025-05-25T04:12:00+02:00,2025-05-25,12:12,8,5,13
12,2025-05-25T04:18:00+02:00,2025-05-25,12:18,2,9,11
12,2025-05-25T04:19:00+02:00,2025-05-25,12:19,6,5,11
12,2025-05-25T04:22:00+02:00,2025-05-25,12:22,5,9,14
12,2025-05-25T04:24:00+02:00,2025-05-25,12:24,2,1,3
17,2025-05-25T04:19:00+02:00,2025-05-25,12:19,2,2,4
17,2025-05-25T04:22:00+02:00,2025-05-25,12:22,6,0,6
17,2025-05-25T04:24:00+02:00,2025-05-25,12:24,5,2,7
18,2025-05-25T04:12:00+02:00,2025-05-25,12:12,5,0,5
18,2025-05-25T04:17:00+02:00,2025-05-25,12:17,0,4,4
18,2025-05-25T04:18:00+02:00,2025-05-25,12:18,5,5,10
18,2025-05-25T04:21:00+02:00,2025-05-25,12:21,3,5,8
18,2025-05-25T04:23:00+02:00,2025-05-25,12:23,0,1,1
18,2025-05-25T04:24:00+02:00,2025-05-25,12:24,0,1,1
19,2025-05-25T04:12:00+02:00,2025-05-25,12:12,8,2,10
19,2025-05-25T04:13:00+02:00,2025-05-25,12:13,6,5,11
19,2025-05-25T04:19:00+02:00,2025-05-25,12:19,5,8,13
19,2025-05-25T04:20:00+02:00,2025-05-25,12:20,4,3,7
19,2025-05-25T04:22:00+02:00,2025-05-25,12:22,15,12,27
20,2025-05-25T04:14:00+02:00,2025-05-25,12:14,5,5,10
23,2025-05-25T04:10:00+02:00,2025-05-25,12:10,3,2,5
23,2025-05-25T04:11:00+02:00,2025-05-25,12:11,1,1,2
23,2025-05-25T04:12:00+02:00,2025-05-25,12:12,2,2,4
23,2025-05-25T04:13:00+02:00,2025-05-25,12:13,7,4,11
23,2025-05-25T04:14:00+02:00,2025-05-25,12:14,1,7,8
23,2025-05-25T04:15:00+02:00,2025-05-25,12:15,2,6,8
23,2025-05-25T04:16:00+02:00,2025-05-25,12:16,0,4,4
23,2025-05-25T04:17:00+02:00,2025-05-25,12:17,6,3,9
23,2025-05-25T04:18:00+02:00,2025-05-25,12:18,1,4,5
23,2025-05-25T04:19:00+02:00,2025-05-25,12:19,0,4,4
24,2025-05-25T04:10:00+02:00,2025-05-25,12:10,20,0,20
24,2025-05-25T04:15:00+02:00,2025-05-25,12:15,15,36,51
24,2025-05-25T04:18:00+02:00,2025-05-25,12:18,6,9,15
24,2025-05-25T04:23:00+02:00,2025-05-25,12:23,14,9,23
25,2025-05-25T04:10:00+02:00,2025-05-25,12:10,77,71,148
27,2025-05-25T04:11:00+02:00,2025-05-25,12:11,4,0,4
27,2025-05-25T04:14:00+02:00,2025-05-25,12:14,3,10,13
27,2025-05-25T04:20:00+02:00,2025-05-25,12:20,2,2,4
27,2025-05-25T04:24:00+02:00,2025-05-25,12:24,2,4,6
30,2025-05-25T04:10:00+02:00,2025-05-25,12:10,8,2,10
30,2025-05-25T04:11:00+02:00,2025-05-25,12:11,8,7,15
30,2025-05-25T04:20:00+02:00,2025-05-25,12:20,8,8,16
35,2025-05-25T04:10:00+02:00,2025-05-25,12:10,26,21,47
35,2025-05-25T04:12:00+02:00,2025-05-25,12:12,11,17,28
35,2025-05-25T04:13:00+02:00,2025-05-25,12:13,24,23,47
35,2025-05-25T04:14:00+02:00,2025-05-25,12:14,16,19,35
35,2025-05-25T04:15:00+02:00,2025-05-25,12:15,7,15,22
35,2025-05-25T04:22:00+02:00,2025-05-25,12:22,23,23,46
35,2025-05-25T04:23:00+02:00,2025-05-25,12:23,29,20,49
48,2025-05-25T04:11:00+02:00,2025-05-25,12:11,13,4,17
48,2025-05-25T04:12:00+02:00,2025-05-25,12:12,22,16,38
48,2025-05-25T04:15:00+02:00,2025-05-25,12:15,14,0,14
48,2025-05-25T04:17:00+02:00,2025-05-25,12:17,17,0,17
48,2025-05-25T04:20:00+02:00,2025-05-25,12:20,2,9,11
48,2025-05-25T04:23:00+02:00,2025-05-25,12:23,22,5,27
49,2025-05-25T04:12:00+02:00,2025-05-25,12:12,5,15,20
49,2025-05-25T04:15:00+02:00,2025-05-25,12:15,10,13,23
49,2025-05-25T04:16:00+02:00,2025-05-25,12:16,5,12,17
49,2025-05-25T04:19:00+02:00,2025-05-25,12:19,13,6,19
49,2025-05-25T04:20:00+02:00,2025-05-25,12:20,13,9,22
49,2025-05-25T04:22:00+02:00,2025-05-25,12:22,21,7,28
49,2025-05-25T04:23:00+02:00,2025-05-25,12:23,7,10,17
51,2025-05-25T04:11:00+02:00,2025-05-25,12:11,2,3,5
51,2025-05-25T04:13:00+02:00,2025-05-25,12:13,0,1,1
51,2025-05-25T04:14:00+02:00,2025-05-25,12:14,2,0,2
51,2025-05-25T04:18:00+02:00,2025-05-25,12:18,2,1,3
51,2025-05-25T04:19:00+02:00,2025-05-25,12:19,2,2,4
51,2025-05-25T04:20:00+02:00,2025-05-25,12:20,3,4,7
51,2025-05-25T04:22:00+02:00,2025-05-25,12:22,0,6,6
51,2025-05-25T04:23:00+02:00,2025-05-25,12:23,4,5,9
52,2025-05-25T04:11:00+02:00,2025-05-25,12:11,7,2,9
52,2025-05-25T04:13:00+02:00,2025-05-25,12:13,6,9,15
52,2025-05-25T04:16:00+02:00,2025-05-25,12:16,3,0,3
52,2025-05-25T04:22:00+02:00,2025-05-25,12:22,4,5,9
53,2025-05-25T04:10:00+02:00,2025-05-25,12:10,17,4,21
53,2025-05-25T04:12:00+02:00,2025-05-25,12:12,18,8,26
53,2025-05-25T04:13:00+02:00,2025-05-25,12:13,9,6,15
53,2025-05-25T04:14:00+02:00,2025-05-25,12:14,13,4,17
53,2025-05-25T04:16:00+02:00,2025-05-25,12:16,11,3,14
53,2025-05-25T04:20:00+02:00,2025-05-25,12:20,5,4,9
53,2025-05-25T04:21:00+02:00,2025-05-25,12:21,10,3,13
53,2025-05-25T04:22:00+02:00,2025-05-25,12:22,16,2,18
53,2025-05-25T04:23:00+02:00,2025-05-25,12:23,13,9,22
53,2025-05-25T04:24:00+02:00,2025-05-25,12:24,12,7,19
56,2025-05-25T04:14:00+02:00,2025-05-25,12:14,16,7,23
56,2025-05-25T04:17:00+02:00,2025-05-25,12:17,11,8,19
56,2025-05-25T04:21:00+02:00,2025-05-25,12:21,5,6,11
56,2025-05-25T04:23:00+02:00,2025-05-25,12:23,12,5,17
58,2025-05-25T04:14:00+02:00,2025-05-25,12:14,30,2,32
58,2025-05-25T04:15:00+02:00,2025-05-25,12:15,17,2,19
58,2025-05-25T04:17:00+02:00,2025-05-25,12:17,27,10,37
58,2025-05-25T04:22:00+02:00,2025-05-25,12:22,24,4,28
58,2025-05-25T04:24:00+02:00,2025-05-25,12:24,25,3,28
62,2025-05-25T04:12:00+02:00,2025-05-25,12:12,0,3,3
62,2025-05-25T04:13:00+02:00,2025-05-25,12:13,4,1,5
62,2025-05-25T04:16:00+02:00,2025-05-25,12:16,1,0,1
62,2025-05-25T04:18:00+02:00,2025-05-25,12:18,1,0,1
62,2025-05-25T04:19:00+02:00,2025-05-25,12:19,4,0,4
62,2025-05-25T04:20:00+02:00,2025-05-25,12:20,1,0,1
62,2025-05-25T04:23:00+02:00,2025-05-25,12:23,5,0,5
63,2025-05-25T04:11:00+02:00,2025-05-25,12:11,6,2,8
63,2025-05-25T04:14:00+02:00,2025-05-25,12:14,8,3,11
63,2025-05-25T04:24:00+02:00,2025-05-25,12:24,6,2,8
67,2025-05-25T04:10:00+02:00,2025-05-25,12:10,4,5,9
67,2025-05-25T04:12:00+02:00,2025-05-25,12:12,11,11,22
67,2025-05-25T04:18:00+02:00,2025-05-25,12:18,20,5,25
67,2025-05-25T04:19:00+02:00,2025-05-25,12:19,4,4,8
68,2025-05-25T04:13:00+02:00,2025-05-25,12:13,18,5,23
68,2025-05-25T04:17:00+02:00,2025-05-25,12:17,2,2,4
68,2025-05-25T04:19:00+02:00,2025-05-25,12:19,3,7,10
68,2025-05-25T04:20:00+02:00,2025-05-25,12:20,9,7,16
68,2025-05-25T04:21:00+02:00,2025-05-25,12:21,4,3,7
72,2025-05-25T04:11:00+02:00,2025-05-25,12:11,9,8,17
72,2025-05-25T04:13:00+02:00,2025-05-25,12:13,4,5,9
72,2025-05-25T04:15:00+02:00,2025-05-25,12:15,11,9,20
72,2025-05-25T04:18:00+02:00,2025-05-25,12:18,10,8,18
72,2025-05-25T04:19:00+02:00,2025-05-25,12:19,13,6,19
72,2025-05-25T04:20:00+02:00,2025-05-25,12:20,6,10,16
72,2025-05-25T04:22:00+02:00,2025-05-25,12:22,2,19,21
72,2025-05-25T04:24:00+02:00,2025-05-25,12:24,3,7,10
76,2025-05-25T04:11:00+02:00,2025-05-25,12:11,1,1,2
76,2025-05-25T04:12:00+02:00,2025-05-25,12:12,2,0,2
76,2025-05-25T04:17:00+02:00,2025-05-25,12:17,2,1,3
76,2025-05-25T04:22:00+02:00,2025-05-25,12:22,1,0,1
76,2025-05-25T04:24:00+02:00,2025-05-25,12:24,0,1,1
79,2025-05-25T04:13:00+02:00,2025-05-25,12:13,10,7,17
79,2025-05-25T04:16:00+02:00,2025-05-25,12:16,9,4,13
79,2025-05-25T04:17:00+02:00,2025-05-25,12:17,12,7,19
79,2025-05-25T04:20:00+02:00,2025-05-25,12:20,22,3,25
79,2025-05-25T04:22:00+02:00,2025-05-25,12:22,11,16,27
85,2025-05-25T04:11:00+02:00,2025-05-25,12:11,0,3,3
85,2025-05-25T04:12:00+02:00,2025-05-25,12:12,0,1,1
85,2025-05-25T04:15:00+02:00,2025-05-25,12:15,0,2,2
85,2025-05-25T04:16:00+02:00,2025-05-25,12:16,0,4,4
85,2025-05-25T04:17:00+02:00,2025-05-25,12:17,0,2,2
85,2025-05-25T04:18:00+02:00,2025-05-25,12:18,0,3,3
85,2025-05-25T04:24:00+02:00,2025-05-25,12:24,0,13,13
86,2025-05-25T04:10:00+02:00,2025-05-25,12:10,1,2,3
86,2025-05-25T04:16:00+02:00,2025-05-25,12:16,1,0,1
86,2025-05-25T04:19:00+02:00,2025-05-25,12:19,2,2,4
86,2025-05-25T04:22:00+02:00,2025-05-25,12:22,0,3,3
109,2025-05-25T04:20:00+02:00,2025-05-25,12:20,7,8,15
123,2025-05-25T04:10:00+02:00,2025-05-25,12:10,1,5,6
123,2025-05-25T04:15:00+02:00,2025-05-25,12:15,7,2,9
130,2025-05-25T04:15:00+02:00,2025-05-25,12:15,2,3,5
130,2025-05-25T04:20:00+02:00,2025-05-25,12:20,6,1,7
139,2025-05-25T04:20:00+02:00,2025-05-25,12:20,4,2,6
142,2025-05-25T04:15:00+02:00,2025-05-25,12:15,41,57,98
142,2025-05-25T04:20:00+02:00,2025-05-25,12:20,44,62,106
161,2025-05-25T04:15:00+02:00,2025-05-25,12:15,70,3,73
161,2025-05-25T04:20:00+02:00,2025-05-25,12:20,75,12,87
164,2025-05-25T04:15:00+02:00,2025-05-25,12:15,11,3,14
3,2025-05-25T01:41:00+02:00,2025-05-25,09:41,5,1,6
3,2025-05-25T01:42:00+02:00,2025-05-25,09:42,2,7,9
3,2025-05-25T01:45:00+02:00,2025-05-25,09:45,3,4,7
3,2025-05-25T01:47:00+02:00,2025-05-25,09:47,1,9,10
3,2025-05-25T01:48:00+02:00,2025-05-25,09:48,1,0,1
3,2025-05-25T01:50:00+02:00,2025-05-25,09:50,2,6,8
3,2025-05-25T01:51:00+02:00,2025-05-25,09:51,1,10,11
3,2025-05-25T01:53:00+02:00,2025-05-25,09:53,5,3,8
4,2025-05-25T01:41:00+02:00,2025-05-25,09:41,4,4,8
4,2025-05-25T01:43:00+02:00,2025-05-25,09:43,5,9,14
4,2025-05-25T01:45:00+02:00,2025-05-25,09:45,6,1,7
6,2025-05-25T01:40:00+02:00,2025-05-25,09:40,10,4,14
6,2025-05-25T01:41:00+02:00,2025-05-25,09:41,10,9,19
6,2025-05-25T01:46:00+02:00,2025-05-25,09:46,18,12,30
6,2025-05-25T01:48:00+02:00,2025-05-25,09:48,5,10,15
6,2025-05-25T01:49:00+02:00,2025-05-25,09:49,7,1,8
8,2025-05-25T01:41:00+02:00,2025-05-25,09:41,3,2,5
8,2025-05-25T01:43:00+02:00,2025-05-25,09:43,2,5,7
8,2025-05-25T01:45:00+02:00,2025-05-25,09:45,2,3,5
8,2025-05-25T01:53:00+02:00,2025-05-25,09:53,2,6,8
28,2025-05-25T01:42:00+02:00,2025-05-25,09:42,1,3,4
28,2025-05-25T01:44:00+02:00,2025-05-25,09:44,1,0,1
28,2025-05-25T01:48:00+02:00,2025-05-25,09:48,5,9,14
28,2025-05-25T01:50:00+02:00,2025-05-25,09:50,2,1,3
28,2025-05-25T01:52:00+02:00,2025-05-25,09:52,2,5,7
28,2025-05-25T01:53:00+02:00,2025-05-25,09:53,3,5,8
29,2025-05-25T01:42:00+02:00,2025-05-25,09:42,3,0,3
29,2025-05-25T01:45:00+02:00,2025-05-25,09:45,3,6,9
29,2025-05-25T01:48:00+02:00,2025-05-25,09:48,2,7,9
29,2025-05-25T01:49:00+02:00,2025-05-25,09:49,4,5,9
29,2025-05-25T01:50:00+02:00,2025-05-25,09:50,2,3,5
29,2025-05-25T01:54:00+02:00,2025-05-25,09:54,2,1,3
31,2025-05-25T01:43:00+02:00,2025-05-25,09:43,1,1,2
31,2025-05-25T01:49:00+02:00,2025-05-25,09:49,4,1,5
31,2025-05-25T01:50:00+02:00,2025-05-25,09:50,1,0,1
31,2025-05-25T01:52:00+02:00,2025-05-25,09:52,0,3,3
31,2025-05-25T01:54:00+02:00,2025-05-25,09:54,0,3,3
36,2025-05-25T01:42:00+02:00,2025-05-25,09:42,7,0,7
36,2025-05-25T01:44:00+02:00,2025-05-25,09:44,0,2,2
36,2025-05-25T01:46:00+02:00,2025-05-25,09:46,0,4,4
37,2025-05-25T01:43:00+02:00,2025-05-25,09:43,1,2,3
37,2025-05-25T01:44:00+02:00,2025-05-25,09:44,1,4,5
37,2025-05-25T01:46:00+02:00,2025-05-25,09:46,2,0,2
37,2025-05-25T01:47:00+02:00,2025-05-25,09:47,1,3,4
37,2025-05-25T01:49:00+02:00,2025-05-25,09:49,1,1,2
37,2025-05-25T01:53:00+02:00,2025-05-25,09:53,0,1,1
39,2025-05-25T01:40:00+02:00,2025-05-25,09:40,1,3,4
39,2025-05-25T01:41:00+02:00,2025-05-25,09:41,2,0,2
39,2025-05-25T01:43:00+02:00,2025-05-25,09:43,1,0,1
40,2025-05-25T01:44:00+02:00,2025-05-25,09:44,1,0,1
40,2025-05-25T01:48:00+02:00,2025-05-25,09:48,1,2,3
40,2025-05-25T01:51:00+02:00,2025-05-25,09:51,3,2,5
40,2025-05-25T01:52:00+02:00,2025-05-25,09:52,2,1,3
41,2025-05-25T01:49:00+02:00,2025-05-25,09:49,2,1,3
41,2025-05-25T01:50:00+02:00,2025-05-25,09:50,1,0,1
44,2025-05-25T01:50:00+02:00,2025-05-25,09:50,5,3,8
45,2025-05-25T01:41:00+02:00,2025-05-25,09:41,2,5,7
45,2025-05-25T01:42:00+02:00,2025-05-25,09:42,5,7,12
45,2025-05-25T01:44:00+02:00,2025-05-25,09:44,10,2,12
45,2025-05-25T01:48:00+02:00,2025-05-25,09:48,5,2,7
45,2025-05-25T01:50:00+02:00,2025-05-25,09:50,4,3,7
47,2025-05-25T01:42:00+02:00,2025-05-25,09:42,6,15,21
47,2025-05-25T01:43:00+02:00,2025-05-25,09:43,9,4,13
47,2025-05-25T01:44:00+02:00,2025-05-25,09:44,8,5,13
47,2025-05-25T01:47:00+02:00,2025-05-25,09:47,7,3,10
50,2025-05-25T01:53:00+02:00,2025-05-25,09:53,0,1,1
50,2025-05-25T01:54:00+02:00,2025-05-25,09:54,1,6,7
54,2025-05-25T01:45:00+02:00,2025-05-25,09:45,0,1,1
54,2025-05-25T01:46:00+02:00,2025-05-25,09:46,0,1,1
54,2025-05-25T01:51:00+02:00,2025-05-25,09:51,2,2,4
54,2025-05-25T01:53:00+02:00,2025-05-25,09:53,1,2,3
61,2025-05-25T01:42:00+02:00,2025-05-25,09:42,3,0,3
61,2025-05-25T01:47:00+02:00,2025-05-25,09:47,4,3,7
61,2025-05-25T01:50:00+02:00,2025-05-25,09:50,13,2,15
61,2025-05-25T01:52:00+02:00,2025-05-25,09:52,2,11,13
66,2025-05-25T01:40:00+02:00,2025-05-25,09:40,0,3,3
66,2025-05-25T01:44:00+02:00,2025-05-25,09:44,3,1,4
66,2025-05-25T01:49:00+02:00,2025-05-25,09:49,10,1,11
69,2025-05-25T01:41:00+02:00,2025-05-25,09:41,3,3,6
69,2025-05-25T01:43:00+02:00,2025-05-25,09:43,1,4,5
69,2025-05-25T01:44:00+02:00,2025-05-25,09:44,4,4,8
69,2025-05-25T01:47:00+02:00,2025-05-25,09:47,4,3,7
69,2025-05-25T01:48:00+02:00,2025-05-25,09:48,8,0,8
69,2025-05-25T01:54:00+02:00,2025-05-25,09:54,11,2,13
70,2025-05-25T01:41:00+02:00,2025-05-25,09:41,2,1,3
70,2025-05-25T01:42:00+02:00,2025-05-25,09:42,2,2,4
70,2025-05-25T01:43:00+02:00,2025-05-25,09:43,4,6,10
70,2025-05-25T01:46:00+02:00,2025-05-25,09:46,2,0,2
70,2025-05-25T01:53:00+02:00,2025-05-25,09:53,2,0,2
75,2025-05-25T01:40:00+02:00,2025-05-25,09:40,0,2,2
75,2025-05-25T01:45:00+02:00,2025-05-25,09:45,0,1,1
75,2025-05-25T01:46:00+02:00,2025-05-25,09:46,2,1,3
77,2025-05-25T01:40:00+02:00,2025-05-25,09:40,16,18,34
78,2025-05-25T01:42:00+02:00,2025-05-25,09:42,0,1,1
78,2025-05-25T01:43:00+02:00,2025-05-25,09:43,4,0,4
78,2025-05-25T01:48:00+02:00,2025-05-25,09:48,1,0,1
78,2025-05-25T01:53:00+02:00,2025-05-25,09:53,3,0,3
84,2025-05-25T01:45:00+02:00,2025-05-25,09:45,81,24,105
84,2025-05-25T01:50:00+02:00,2025-05-25,09:50,43,47,90
87,2025-05-25T01:41:00+02:00,2025-05-25,09:41,0,2,2
87,2025-05-25T01:46:00+02:00,2025-05-25,09:46,1,2,3
87,2025-05-25T01:47:00+02:00,2025-05-25,09:47,2,0,2
87,2025-05-25T01:49:00+02:00,2025-05-25,09:49,1,0,1
87,2025-05-25T01:50:00+02:00,2025-05-25,09:50,5,0,5
87,2025-05-25T01:54:00+02:00,2025-05-25,09:54,2,1,3
107,2025-05-25T01:40:00+02:00,2025-05-25,09:40,4,7,11
107,2025-05-25T01:45:00+02:00,2025-05-25,09:45,4,13,17
108,2025-05-25T01:42:00+02:00,2025-05-25,09:42,4,1,5
108,2025-05-25T01:44:00+02:00,2025-05-25,09:44,0,2,2
108,2025-05-25T01:48:00+02:00,2025-05-25,09:48,0,2,2
108,2025-05-25T01:50:00+02:00,2025-05-25,09:50,3,1,4
118,2025-05-25T01:45:00+02:00,2025-05-25,09:45,5,1,6
131,2025-05-25T01:50:00+02:00,2025-05-25,09:50,11,16,27
132,2025-05-25T01:50:00+02:00,2025-05-25,09:50,22,0,22
134,2025-05-25T01:40:00+02:00,2025-05-25,09:40,20,41,61
135,2025-05-25T01:40:00+02:00,2025-05-25,09:40,14,25,39
135,2025-05-25T01:45:00+02:00,2025-05-25,09:45,27,24,51
135,2025-05-25T01:50:00+02:00,2025-05-25,09:50,27,32,59
140,2025-05-25T01:45:00+02:00,2025-05-25,09:45,5,5,10
162,2025-05-25T01:45:00+02:00,2025-05-25,09:45,55,36,91
166,2025-05-25T01:40:00+02:00,2025-05-25,09:40,6,5,11
166,2025-05-25T01:45:00+02:00,2025-05-25,09:45,3,5,8
166,2025-05-25T01:50:00+02:00,2025-05-25,09:50,0,4,4
167,2025-05-25T01:45:00+02:00,2025-05-25,09:45,4,12,16
167,2025-05-25T01:50:00+02:00,2025-05-25,09:50,4,8,12
1,2025-05-25T01:46:00+02:00,2025-05-25,09:46,5,9,14
1,2025-05-25T01:48:00+02:00,2025-05-25,09:48,2,3,5
1,2025-05-25T01:50:00+02:00,2025-05-25,09:50,4,10,14
1,2025-05-25T01:52:00+02:00,2025-05-25,09:52,7,7,14
2,2025-05-25T01:40:00+02:00,2025-05-25,09:40,3,1,4
2,2025-05-25T01:41:00+02:00,2025-05-25,09:41,0,3,3
2,2025-05-25T01:44:00+02:00,2025-05-25,09:44,3,5,8
2,2025-05-25T01:47:00+02:00,2025-05-25,09:47,2,6,8
2,2025-05-25T01:50:00+02:00,2025-05-25,09:50,2,1,3
2,2025-05-25T01:51:00+02:00,2025-05-25,09:51,1,8,9
2,2025-05-25T01:52:00+02:00,2025-05-25,09:52,2,6,8
2,2025-05-25T01:54:00+02:00,2025-05-25,09:54,1,4,5
9,2025-05-25T01:45:00+02:00,2025-05-25,09:45,3,0,3
9,2025-05-25T01:52:00+02:00,2025-05-25,09:52,0,2,2
10,2025-05-25T01:43:00+02:00,2025-05-25,09:43,0,1,1
10,2025-05-25T01:47:00+02:00,2025-05-25,09:47,2,1,3
11,2025-05-25T01:49:00+02:00,2025-05-25,09:49,0,1,1
11,2025-05-25T01:54:00+02:00,2025-05-25,09:54,0,1,1
12,2025-05-25T01:42:00+02:00,2025-05-25,09:42,1,5,6
12,2025-05-25T01:43:00+02:00,2025-05-25,09:43,4,3,7
12,2025-05-25T01:48:00+02:00,2025-05-25,09:48,1,2,3
17,2025-05-25T01:42:00+02:00,2025-05-25,09:42,1,1,2
17,2025-05-25T01:50:00+02:00,2025-05-25,09:50,2,0,2
18,2025-05-25T01:42:00+02:00,2025-05-25,09:42,0,1,1
18,2025-05-25T01:46:00+02:00,2025-05-25,09:46,1,0,1
18,2025-05-25T01:49:00+02:00,2025-05-25,09:49,2,4,6
18,2025-05-25T01:50:00+02:00,2025-05-25,09:50,1,0,1
19,2025-05-25T01:46:00+02:00,2025-05-25,09:46,1,1,2
19,2025-05-25T01:47:00+02:00,2025-05-25,09:47,4,0,4
19,2025-05-25T01:52:00+02:00,2025-05-25,09:52,7,0,7
19,2025-05-25T01:54:00+02:00,2025-05-25,09:54,4,8,12
20,2025-05-25T01:40:00+02:00,2025-05-25,09:40,1,0,1
20,2025-05-25T01:46:00+02:00,2025-05-25,09:46,0,1,1
20,2025-05-25T01:50:00+02:00,2025-05-25,09:50,0,2,2
20,2025-05-25T01:51:00+02:00,2025-05-25,09:51,2,0,2
20,2025-05-25T01:52:00+02:00,2025-05-25,09:52,0,1,1
20,2025-05-25T01:53:00+02:00,2025-05-25,09:53,0,2,2
20,2025-05-25T01:54:00+02:00,2025-05-25,09:54,1,1,2
23,2025-05-25T01:40:00+02:00,2025-05-25,09:40,3,3,6
23,2025-05-25T01:41:00+02:00,2025-05-25,09:41,3,0,3
23,2025-05-25T01:48:00+02:00,2025-05-25,09:48,1,1,2
23,2025-05-25T01:51:00+02:00,2025-05-25,09:51,1,4,5
23,2025-05-25T01:52:00+02:00,2025-05-25,09:52,2,0,2
23,2025-05-25T01:53:00+02:00,2025-05-25,09:53,1,4,5
23,2025-05-25T01:54:00+02:00,2025-05-25,09:54,3,0,3
24,2025-05-25T01:40:00+02:00,2025-05-25,09:40,8,14,22
24,2025-05-25T01:47:00+02:00,2025-05-25,09:47,18,2,20
27,2025-05-25T01:44:00+02:00,2025-05-25,09:44,4,3,7
27,2025-05-25T01:46:00+02:00,2025-05-25,09:46,2,0,2
30,2025-05-25T01:41:00+02:00,2025-05-25,09:41,1,0,1
30,2025-05-25T01:42:00+02:00,2025-05-25,09:42,1,3,4
30,2025-05-25T01:50:00+02:00,2025-05-25,09:50,1,13,14
30,2025-05-25T01:51:00+02:00,2025-05-25,09:51,0,7,7
35,2025-05-25T01:42:00+02:00,2025-05-25,09:42,15,15,30
35,2025-05-25T01:45:00+02:00,2025-05-25,09:45,8,6,14
35,2025-05-25T01:46:00+02:00,2025-05-25,09:46,15,8,23
35,2025-05-25T01:47:00+02:00,2025-05-25,09:47,17,5,22
35,2025-05-25T01:50:00+02:00,2025-05-25,09:50,19,10,29
35,2025-05-25T01:53:00+02:00,2025-05-25,09:53,12,7,19
48,2025-05-25T01:42:00+02:00,2025-05-25,09:42,6,4,10
48,2025-05-25T01:50:00+02:00,2025-05-25,09:50,10,7,17
48,2025-05-25T01:54:00+02:00,2025-05-25,09:54,6,10,16
49,2025-05-25T01:49:00+02:00,2025-05-25,09:49,10,2,12
49,2025-05-25T01:50:00+02:00,2025-05-25,09:50,9,8,17
49,2025-05-25T01:51:00+02:00,2025-05-25,09:51,0,4,4
49,2025-05-25T01:52:00+02:00,2025-05-25,09:52,3,9,12
49,2025-05-25T01:53:00+02:00,2025-05-25,09:53,2,7,9
51,2025-05-25T01:41:00+02:00,2025-05-25,09:41,1,6,7
51,2025-05-25T01:44:00+02:00,2025-05-25,09:44,4,4,8
51,2025-05-25T01:45:00+02:00,2025-05-25,09:45,0,1,1
51,2025-05-25T01:48:00+02:00,2025-05-25,09:48,2,0,2
51,2025-05-25T01:49:00+02:00,2025-05-25,09:49,0,6,6
51,2025-05-25T01:51:00+02:00,2025-05-25,09:51,1,0,1
53,2025-05-25T01:45:00+02:00,2025-05-25,09:45,4,3,7
53,2025-05-25T01:51:00+02:00,2025-05-25,09:51,11,1,12
53,2025-05-25T01:54:00+02:00,2025-05-25,09:54,11,4,15
56,2025-05-25T01:42:00+02:00,2025-05-25,09:42,3,2,5
56,2025-05-25T01:44:00+02:00,2025-05-25,09:44,1,4,5
58,2025-05-25T01:43:00+02:00,2025-05-25,09:43,6,6,12
58,2025-05-25T01:44:00+02:00,2025-05-25,09:44,13,13,26
58,2025-05-25T01:47:00+02:00,2025-05-25,09:47,22,8,30
58,2025-05-25T01:48:00+02:00,2025-05-25,09:48,1,3,4
58,2025-05-25T01:50:00+02:00,2025-05-25,09:50,5,1,6
58,2025-05-25T01:52:00+02:00,2025-05-25,09:52,9,6,15
62,2025-05-25T01:44:00+02:00,2025-05-25,09:44,1,0,1
62,2025-05-25T01:47:00+02:00,2025-05-25,09:47,2,0,2
62,2025-05-25T01:48:00+02:00,2025-05-25,09:48,0,1,1
62,2025-05-25T01:50:00+02:00,2025-05-25,09:50,2,3,5
62,2025-05-25T01:53:00+02:00,2025-05-25,09:53,0,1,1
63,2025-05-25T01:43:00+02:00,2025-05-25,09:43,2,4,6
63,2025-05-25T01:44:00+02:00,2025-05-25,09:44,0,5,5
63,2025-05-25T01:49:00+02:00,2025-05-25,09:49,1,6,7
63,2025-05-25T01:52:00+02:00,2025-05-25,09:52,7,4,11
67,2025-05-25T01:44:00+02:00,2025-05-25,09:44,2,5,7
67,2025-05-25T01:46:00+02:00,2025-05-25,09:46,0,5,5
67,2025-05-25T01:52:00+02:00,2025-05-25,09:52,13,1,14
67,2025-05-25T01:53:00+02:00,2025-05-25,09:53,3,3,6
68,2025-05-25T01:41:00+02:00,2025-05-25,09:41,2,4,6
68,2025-05-25T01:44:00+02:00,2025-05-25,09:44,4,0,4
68,2025-05-25T01:47:00+02:00,2025-05-25,09:47,5,7,12
68,2025-05-25T01:51:00+02:00,2025-05-25,09:51,2,7,9
72,2025-05-25T01:41:00+02:00,2025-05-25,09:41,1,6,7
72,2025-05-25T01:43:00+02:00,2025-05-25,09:43,4,3,7
72,2025-05-25T01:49:00+02:00,2025-05-25,09:49,2,2,4
72,2025-05-25T01:51:00+02:00,2025-05-25,09:51,3,1,4
72,2025-05-25T01:52:00+02:00,2025-05-25,09:52,2,0,2
76,2025-05-25T01:44:00+02:00,2025-05-25,09:44,0,2,2
76,2025-05-25T01:45:00+02:00,2025-05-25,09:45,3,3,6
76,2025-05-25T01:47:00+02:00,2025-05-25,09:47,2,3,5
76,2025-05-25T01:50:00+02:00,2025-05-25,09:50,1,1,2
76,2025-05-25T01:53:00+02:00,2025-05-25,09:53,2,0,2
79,2025-05-25T01:40:00+02:00,2025-05-25,09:40,3,1,4
79,2025-05-25T01:43:00+02:00,2025-05-25,09:43,3,1,4
79,2025-05-25T01:45:00+02:00,2025-05-25,09:45,2,3,5
79,2025-05-25T01:50:00+02:00,2025-05-25,09:50,2,5,7
79,2025-05-25T01:52:00+02:00,2025-05-25,09:52,0,2,2
79,2025-05-25T01:53:00+02:00,2025-05-25,09:53,6,1,7
85,2025-05-25T01:40:00+02:00,2025-05-25,09:40,1,4,5
85,2025-05-25T01:45:00+02:00,2025-05-25,09:45,1,0,1
85,2025-05-25T01:51:00+02:00,2025-05-25,09:51,0,2,2
85,2025-05-25T01:53:00+02:00,2025-05-25,09:53,2,3,5
86,2025-05-25T01:41:00+02:00,2025-05-25,09:41,3,4,7
86,2025-05-25T01:42:00+02:00,2025-05-25,09:42,3,2,5
86,2025-05-25T01:44:00+02:00,2025-05-25,09:44,1,3,4
86,2025-05-25T01:48:00+02:00,2025-05-25,09:48,0,1,1
86,2025-05-25T01:51:00+02:00,2025-05-25,09:51,1,0,1
86,2025-05-25T01:53:00+02:00,2025-05-25,09:53,0,4,4
86,2025-05-25T01:54:00+02:00,2025-05-25,09:54,2,1,3
109,2025-05-25T01:45:00+02:00,2025-05-25,09:45,7,1,8
117,2025-05-25T01:45:00+02:00,2025-05-25,09:45,5,11,16
123,2025-05-25T01:40:00+02:00,2025-05-25,09:40,6,1,7
130,2025-05-25T01:40:00+02:00,2025-05-25,09:40,7,4,11
130,2025-05-25T01:45:00+02:00,2025-05-25,09:45,2,8,10
130,2025-05-25T01:50:00+02:00,2025-05-25,09:50,8,2,10
136,2025-05-25T01:40:00+02:00,2025-05-25,09:40,9,12,21
136,2025-05-25T01:45:00+02:00,2025-05-25,09:45,3,6,9
136,2025-05-25T01:50:00+02:00,2025-05-25,09:50,7,10,17
137,2025-05-25T01:45:00+02:00,2025-05-25,09:45,1,1,2
138,2025-05-25T01:40:00+02:00,2025-05-25,09:40,0,1,1
138,2025-05-25T01:50:00+02:00,2025-05-25,09:50,1,0,1
161,2025-05-25T01:40:00+02:00,2025-05-25,09:40,6,20,26
180,2025-05-25T01:43:00+02:00,2025-05-25,09:43,0,1,1
180,2025-05-25T01:44:00+02:00,2025-05-25,09:44,0,2,2
180,2025-05-25T01:52:00+02:00,2025-05-25,09:52,3,0,3
181,2025-05-25T01:57:00+02:00,2025-05-25,09:57,11,4,15
181,2025-05-25T01:59:00+02:00,2025-05-25,09:59,1,16,17
181,2025-05-25T02:00:00+02:00,2025-05-25,10:00,4,20,24
181,2025-05-25T02:09:00+02:00,2025-05-25,10:09,3,11,14
182,2025-05-25T02:05:00+02:00,2025-05-25,10:05,9,5,14
180,2025-05-25T01:55:00+02:00,2025-05-25,09:55,1,0,1
180,2025-05-25T02:05:00+02:00,2025-05-25,10:05,2,0,2
180,2025-05-25T02:09:00+02:00,2025-05-25,10:09,1,0,1
3,2025-05-25T01:55:00+02:00,2025-05-25,09:55,7,0,7
3,2025-05-25T01:56:00+02:00,2025-05-25,09:56,9,7,16
3,2025-05-25T01:58:00+02:00,2025-05-25,09:58,7,5,12
3,2025-05-25T02:02:00+02:00,2025-05-25,10:02,10,3,13
3,2025-05-25T02:03:00+02:00,2025-05-25,10:03,6,7,13
3,2025-05-25T02:05:00+02:00,2025-05-25,10:05,8,5,13
3,2025-05-25T02:06:00+02:00,2025-05-25,10:06,4,6,10
3,2025-05-25T02:07:00+02:00,2025-05-25,10:07,6,3,9
3,2025-05-25T02:09:00+02:00,2025-05-25,10:09,3,2,5
4,2025-05-25T01:55:00+02:00,2025-05-25,09:55,11,3,14
4,2025-05-25T01:56:00+02:00,2025-05-25,09:56,4,5,9
4,2025-05-25T02:02:00+02:00,2025-05-25,10:02,8,6,14
4,2025-05-25T02:03:00+02:00,2025-05-25,10:03,20,2,22
4,2025-05-25T02:05:00+02:00,2025-05-25,10:05,14,19,33
4,2025-05-25T02:07:00+02:00,2025-05-25,10:07,13,3,16
4,2025-05-25T02:08:00+02:00,2025-05-25,10:08,8,3,11
5,2025-05-25T02:05:00+02:00,2025-05-25,10:05,30,33,63
6,2025-05-25T01:58:00+02:00,2025-05-25,09:58,5,14,19
6,2025-05-25T02:00:00+02:00,2025-05-25,10:00,7,5,12
6,2025-05-25T02:01:00+02:00,2025-05-25,10:01,5,7,12
6,2025-05-25T02:02:00+02:00,2025-05-25,10:02,8,0,8
6,2025-05-25T02:04:00+02:00,2025-05-25,10:04,3,5,8
6,2025-05-25T02:05:00+02:00,2025-05-25,10:05,4,8,12
6,2025-05-25T02:07:00+02:00,2025-05-25,10:07,5,10,15
6,2025-05-25T02:08:00+02:00,2025-05-25,10:08,3,5,8
6,2025-05-25T02:09:00+02:00,2025-05-25,10:09,8,0,8
8,2025-05-25T01:55:00+02:00,2025-05-25,09:55,0,2,2
8,2025-05-25T01:57:00+02:00,2025-05-25,09:57,3,5,8
8,2025-05-25T01:58:00+02:00,2025-05-25,09:58,1,10,11
8,2025-05-25T01:59:00+02:00,2025-05-25,09:59,3,3,6
8,2025-05-25T02:05:00+02:00,2025-05-25,10:05,3,0,3
8,2025-05-25T02:06:00+02:00,2025-05-25,10:06,1,1,2
28,2025-05-25T01:56:00+02:00,2025-05-25,09:56,4,2,6
28,2025-05-25T02:01:00+02:00,2025-05-25,10:01,3,3,6
28,2025-05-25T02:02:00+02:00,2025-05-25,10:02,2,7,9
28,2025-05-25T02:03:00+02:00,2025-05-25,10:03,7,4,11
28,2025-05-25T02:07:00+02:00,2025-05-25,10:07,0,2,2
29,2025-05-25T01:57:00+02:00,2025-05-25,09:57,8,9,17
29,2025-05-25T01:59:00+02:00,2025-05-25,09:59,0,5,5
29,2025-05-25T02:00:00+02:00,2025-05-25,10:00,3,0,3
29,2025-05-25T02:04:00+02:00,2025-05-25,10:04,2,4,6
29,2025-05-25T02:05:00+02:00,2025-05-25,10:05,2,3,5
31,2025-05-25T01:55:00+02:00,2025-05-25,09:55,2,0,2
31,2025-05-25T01:56:00+02:00,2025-05-25,09:56,1,1,2
31,2025-05-25T02:00:00+02:00,2025-05-25,10:00,1,0,1
31,2025-05-25T02:01:00+02:00,2025-05-25,10:01,1,0,1
31,2025-05-25T02:03:00+02:00,2025-05-25,10:03,2,0,2
31,2025-05-25T02:06:00+02:00,2025-05-25,10:06,3,4,7
31,2025-05-25T02:07:00+02:00,2025-05-25,10:07,1,0,1
31,2025-05-25T02:09:00+02:00,2025-05-25,10:09,4,4,8
36,2025-05-25T01:56:00+02:00,2025-05-25,09:56,2,1,3
36,2025-05-25T01:59:00+02:00,2025-05-25,09:59,1,0,1
36,2025-05-25T02:03:00+02:00,2025-05-25,10:03,1,1,2
36,2025-05-25T02:09:00+02:00,2025-05-25,10:09,3,0,3
37,2025-05-25T01:55:00+02:00,2025-05-25,09:55,1,1,2
37,2025-05-25T01:56:00+02:00,2025-05-25,09:56,1,2,3
37,2025-05-25T02:05:00+02:00,2025-05-25,10:05,1,0,1
39,2025-05-25T01:55:00+02:00,2025-05-25,09:55,0,3,3
40,2025-05-25T01:56:00+02:00,2025-05-25,09:56,1,0,1
40,2025-05-25T02:04:00+02:00,2025-05-25,10:04,1,2,3
40,2025-05-25T02:05:00+02:00,2025-05-25,10:05,1,3,4
41,2025-05-25T01:55:00+02:00,2025-05-25,09:55,3,0,3
41,2025-05-25T01:56:00+02:00,2025-05-25,09:56,0,2,2
44,2025-05-25T01:55:00+02:00,2025-05-25,09:55,2,0,2
45,2025-05-25T01:56:00+02:00,2025-05-25,09:56,0,1,1
45,2025-05-25T01:58:00+02:00,2025-05-25,09:58,1,2,3
45,2025-05-25T02:08:00+02:00,2025-05-25,10:08,8,6,14
47,2025-05-25T01:58:00+02:00,2025-05-25,09:58,4,11,15
47,2025-05-25T01:59:00+02:00,2025-05-25,09:59,11,11,22
47,2025-05-25T02:02:00+02:00,2025-05-25,10:02,4,8,12
47,2025-05-25T02:03:00+02:00,2025-05-25,10:03,8,7,15
47,2025-05-25T02:06:00+02:00,2025-05-25,10:06,4,19,23
50,2025-05-25T02:00:00+02:00,2025-05-25,10:00,0,4,4
50,2025-05-25T02:05:00+02:00,2025-05-25,10:05,0,1,1
50,2025-05-25T02:08:00+02:00,2025-05-25,10:08,1,0,1
54,2025-05-25T01:55:00+02:00,2025-05-25,09:55,3,1,4
54,2025-05-25T02:04:00+02:00,2025-05-25,10:04,1,1,2
54,2025-05-25T02:05:00+02:00,2025-05-25,10:05,4,2,6
54,2025-05-25T02:07:00+02:00,2025-05-25,10:07,2,0,2
54,2025-05-25T02:08:00+02:00,2025-05-25,10:08,1,0,1
59,2025-05-25T02:05:00+02:00,2025-05-25,10:05,14,17,31
61,2025-05-25T01:57:00+02:00,2025-05-25,09:57,6,8,14
61,2025-05-25T01:58:00+02:00,2025-05-25,09:58,0,5,5
61,2025-05-25T02:07:00+02:00,2025-05-25,10:07,9,5,14
66,2025-05-25T01:57:00+02:00,2025-05-25,09:57,7,6,13
66,2025-05-25T01:58:00+02:00,2025-05-25,09:58,1,3,4
66,2025-05-25T02:01:00+02:00,2025-05-25,10:01,1,6,7
66,2025-05-25T02:02:00+02:00,2025-05-25,10:02,5,6,11
66,2025-05-25T02:03:00+02:00,2025-05-25,10:03,9,5,14
66,2025-05-25T02:06:00+02:00,2025-05-25,10:06,10,2,12
66,2025-05-25T02:08:00+02:00,2025-05-25,10:08,8,4,12
69,2025-05-25T01:55:00+02:00,2025-05-25,09:55,5,4,9
69,2025-05-25T02:03:00+02:00,2025-05-25,10:03,1,1,2
69,2025-05-25T02:08:00+02:00,2025-05-25,10:08,2,2,4
70,2025-05-25T01:58:00+02:00,2025-05-25,09:58,0,2,2
70,2025-05-25T02:00:00+02:00,2025-05-25,10:00,2,2,4
70,2025-05-25T02:04:00+02:00,2025-05-25,10:04,2,2,4
70,2025-05-25T02:07:00+02:00,2025-05-25,10:07,0,4,4
70,2025-05-25T02:09:00+02:00,2025-05-25,10:09,1,1,2
75,2025-05-25T01:59:00+02:00,2025-05-25,09:59,1,0,1
75,2025-05-25T02:01:00+02:00,2025-05-25,10:01,5,0,5
75,2025-05-25T02:02:00+02:00,2025-05-25,10:02,2,0,2
75,2025-05-25T02:06:00+02:00,2025-05-25,10:06,1,0,1
75,2025-05-25T02:08:00+02:00,2025-05-25,10:08,3,0,3
77,2025-05-25T02:00:00+02:00,2025-05-25,10:00,12,7,19
78,2025-05-25T01:56:00+02:00,2025-05-25,09:56,1,0,1
78,2025-05-25T02:00:00+02:00,2025-05-25,10:00,1,1,2
78,2025-05-25T02:03:00+02:00,2025-05-25,10:03,0,2,2
78,2025-05-25T02:07:00+02:00,2025-05-25,10:07,1,0,1
78,2025-05-25T02:08:00+02:00,2025-05-25,10:08,0,3,3
84,2025-05-25T02:00:00+02:00,2025-05-25,10:00,45,33,78
84,2025-05-25T02:05:00+02:00,2025-05-25,10:05,43,27,70
87,2025-05-25T01:57:00+02:00,2025-05-25,09:57,3,3,6
87,2025-05-25T02:02:00+02:00,2025-05-25,10:02,1,1,2
87,2025-05-25T02:03:00+02:00,2025-05-25,10:03,0,1,1
107,2025-05-25T02:00:00+02:00,2025-05-25,10:00,7,9,16
107,2025-05-25T02:05:00+02:00,2025-05-25,10:05,4,15,19
108,2025-05-25T01:56:00+02:00,2025-05-25,09:56,1,1,2
108,2025-05-25T02:02:00+02:00,2025-05-25,10:02,2,2,4
108,2025-05-25T02:03:00+02:00,2025-05-25,10:03,0,2,2
108,2025-05-25T02:07:00+02:00,2025-05-25,10:07,1,0,1
108,2025-05-25T02:08:00+02:00,2025-05-25,10:08,7,2,9
118,2025-05-25T02:00:00+02:00,2025-05-25,10:00,0,1,1
131,2025-05-25T02:05:00+02:00,2025-05-25,10:05,2,7,9
132,2025-05-25T02:05:00+02:00,2025-05-25,10:05,15,6,21
133,2025-05-25T01:55:00+02:00,2025-05-25,09:55,36,41,77
133,2025-05-25T02:05:00+02:00,2025-05-25,10:05,23,33,56
134,2025-05-25T01:55:00+02:00,2025-05-25,09:55,20,38,58
134,2025-05-25T02:05:00+02:00,2025-05-25,10:05,41,32,73
140,2025-05-25T02:05:00+02:00,2025-05-25,10:05,8,7,15
165,2025-05-25T01:55:00+02:00,2025-05-25,09:55,5,1,6
165,2025-05-25T02:05:00+02:00,2025-05-25,10:05,1,2,3
167,2025-05-25T02:05:00+02:00,2025-05-25,10:05,6,4,10
1,2025-05-25T01:59:00+02:00,2025-05-25,09:59,4,8,12
1,2025-05-25T02:07:00+02:00,2025-05-25,10:07,12,6,18
2,2025-05-25T01:55:00+02:00,2025-05-25,09:55,6,3,9
2,2025-05-25T01:58:00+02:00,2025-05-25,09:58,0,3,3
2,2025-05-25T02:01:00+02:00,2025-05-25,10:01,1,6,7
2,2025-05-25T02:03:00+02:00,2025-05-25,10:03,2,10,12
2,2025-05-25T02:05:00+02:00,2025-05-25,10:05,2,3,5
2,2025-05-25T02:09:00+02:00,2025-05-25,10:09,3,3,6
9,2025-05-25T01:55:00+02:00,2025-05-25,09:55,2,1,3
9,2025-05-25T01:57:00+02:00,2025-05-25,09:57,1,0,1
9,2025-05-25T02:05:00+02:00,2025-05-25,10:05,2,2,4
9,2025-05-25T02:07:00+02:00,2025-05-25,10:07,0,2,2
10,2025-05-25T01:56:00+02:00,2025-05-25,09:56,0,1,1
10,2025-05-25T02:06:00+02:00,2025-05-25,10:06,2,0,2
11,2025-05-25T01:59:00+02:00,2025-05-25,09:59,0,3,3
11,2025-05-25T02:00:00+02:00,2025-05-25,10:00,4,4,8
11,2025-05-25T02:04:00+02:00,2025-05-25,10:04,1,4,5
12,2025-05-25T01:55:00+02:00,2025-05-25,09:55,0,1,1
12,2025-05-25T01:57:00+02:00,2025-05-25,09:57,1,5,6
12,2025-05-25T01:58:00+02:00,2025-05-25,09:58,0,4,4
12,2025-05-25T02:01:00+02:00,2025-05-25,10:01,0,5,5
12,2025-05-25T02:02:00+02:00,2025-05-25,10:02,0,1,1
12,2025-05-25T02:06:00+02:00,2025-05-25,10:06,3,0,3
17,2025-05-25T01:55:00+02:00,2025-05-25,09:55,1,2,3
17,2025-05-25T01:56:00+02:00,2025-05-25,09:56,5,1,6
17,2025-05-25T02:07:00+02:00,2025-05-25,10:07,0,4,4
18,2025-05-25T01:58:00+02:00,2025-05-25,09:58,1,2,3
18,2025-05-25T02:05:00+02:00,2025-05-25,10:05,4,0,4
18,2025-05-25T02:08:00+02:00,2025-05-25,10:08,0,1,1
19,2025-05-25T01:55:00+02:00,2025-05-25,09:55,1,2,3
19,2025-05-25T01:59:00+02:00,2025-05-25,09:59,2,2,4
19,2025-05-25T02:02:00+02:00,2025-05-25,10:02,0,1,1
19,2025-05-25T02:04:00+02:00,2025-05-25,10:04,0,1,1
19,2025-05-25T02:07:00+02:00,2025-05-25,10:07,0,2,2
20,2025-05-25T01:55:00+02:00,2025-05-25,09:55,1,1,2
20,2025-05-25T02:02:00+02:00,2025-05-25,10:02,3,1,4
20,2025-05-25T02:04:00+02:00,2025-05-25,10:04,3,1,4
20,2025-05-25T02:05:00+02:00,2025-05-25,10:05,2,3,5
20,2025-05-25T02:06:00+02:00,2025-05-25,10:06,1,1,2
20,2025-05-25T02:08:00+02:00,2025-05-25,10:08,3,2,5
23,2025-05-25T01:56:00+02:00,2025-05-25,09:56,4,1,5
23,2025-05-25T02:00:00+02:00,2025-05-25,10:00,3,1,4
23,2025-05-25T02:02:00+02:00,2025-05-25,10:02,5,0,5
24,2025-05-25T01:55:00+02:00,2025-05-25,09:55,5,8,13
24,2025-05-25T01:56:00+02:00,2025-05-25,09:56,5,7,12
24,2025-05-25T02:00:00+02:00,2025-05-25,10:00,5,16,21
24,2025-05-25T02:03:00+02:00,2025-05-25,10:03,5,2,7
24,2025-05-25T02:04:00+02:00,2025-05-25,10:04,14,4,18
24,2025-05-25T02:06:00+02:00,2025-05-25,10:06,5,1,6
24,2025-05-25T02:09:00+02:00,2025-05-25,10:09,6,2,8
25,2025-05-25T01:55:00+02:00,2025-05-25,09:55,13,61,74
27,2025-05-25T01:55:00+02:00,2025-05-25,09:55,1,5,6
27,2025-05-25T01:56:00+02:00,2025-05-25,09:56,8,7,15
27,2025-05-25T01:59:00+02:00,2025-05-25,09:59,3,8,11
27,2025-05-25T02:01:00+02:00,2025-05-25,10:01,3,4,7
27,2025-05-25T02:03:00+02:00,2025-05-25,10:03,0,3,3
27,2025-05-25T02:04:00+02:00,2025-05-25,10:04,4,7,11
27,2025-05-25T02:07:00+02:00,2025-05-25,10:07,5,5,10
30,2025-05-25T01:55:00+02:00,2025-05-25,09:55,1,6,7
30,2025-05-25T01:57:00+02:00,2025-05-25,09:57,3,2,5
30,2025-05-25T02:00:00+02:00,2025-05-25,10:00,0,3,3
30,2025-05-25T02:01:00+02:00,2025-05-25,10:01,1,1,2
30,2025-05-25T02:02:00+02:00,2025-05-25,10:02,1,0,1
30,2025-05-25T02:03:00+02:00,2025-05-25,10:03,2,2,4
30,2025-05-25T02:06:00+02:00,2025-05-25,10:06,0,3,3
30,2025-05-25T02:07:00+02:00,2025-05-25,10:07,0,3,3
30,2025-05-25T02:09:00+02:00,2025-05-25,10:09,2,3,5
35,2025-05-25T01:58:00+02:00,2025-05-25,09:58,13,13,26
35,2025-05-25T01:59:00+02:00,2025-05-25,09:59,16,9,25
35,2025-05-25T02:04:00+02:00,2025-05-25,10:04,7,3,10
35,2025-05-25T02:06:00+02:00,2025-05-25,10:06,10,17,27
35,2025-05-25T02:08:00+02:00,2025-05-25,10:08,18,3,21
35,2025-05-25T02:09:00+02:00,2025-05-25,10:09,16,16,32
46,2025-05-25T01:55:00+02:00,2025-05-25,09:55,5,3,8
48,2025-05-25T02:01:00+02:00,2025-05-25,10:01,2,11,13
48,2025-05-25T02:02:00+02:00,2025-05-25,10:02,5,4,9
48,2025-05-25T02:06:00+02:00,2025-05-25,10:06,7,2,9
49,2025-05-25T01:56:00+02:00,2025-05-25,09:56,13,6,19
49,2025-05-25T02:00:00+02:00,2025-05-25,10:00,6,10,16
49,2025-05-25T02:02:00+02:00,2025-05-25,10:02,12,10,22
49,2025-05-25T02:06:00+02:00,2025-05-25,10:06,11,3,14
51,2025-05-25T01:57:00+02:00,2025-05-25,09:57,6,0,6
51,2025-05-25T02:04:00+02:00,2025-05-25,10:04,1,0,1
51,2025-05-25T02:06:00+02:00,2025-05-25,10:06,2,0,2
52,2025-05-25T01:55:00+02:00,2025-05-25,09:55,4,1,5
52,2025-05-25T01:56:00+02:00,2025-05-25,09:56,2,2,4
52,2025-05-25T02:06:00+02:00,2025-05-25,10:06,6,1,7
52,2025-05-25T02:09:00+02:00,2025-05-25,10:09,9,1,10
53,2025-05-25T01:57:00+02:00,2025-05-25,09:57,7,5,12
53,2025-05-25T01:59:00+02:00,2025-05-25,09:59,8,5,13
53,2025-05-25T02:01:00+02:00,2025-05-25,10:01,16,3,19
53,2025-05-25T02:02:00+02:00,2025-05-25,10:02,4,4,8
53,2025-05-25T02:03:00+02:00,2025-05-25,10:03,8,13,21
53,2025-05-25T02:04:00+02:00,2025-05-25,10:04,8,6,14
53,2025-05-25T02:07:00+02:00,2025-05-25,10:07,1,1,2
56,2025-05-25T01:55:00+02:00,2025-05-25,09:55,3,1,4
56,2025-05-25T01:58:00+02:00,2025-05-25,09:58,7,4,11
56,2025-05-25T01:59:00+02:00,2025-05-25,09:59,2,3,5
56,2025-05-25T02:08:00+02:00,2025-05-25,10:08,13,1,14
58,2025-05-25T01:58:00+02:00,2025-05-25,09:58,9,0,9
58,2025-05-25T01:59:00+02:00,2025-05-25,09:59,15,7,22
58,2025-05-25T02:01:00+02:00,2025-05-25,10:01,22,3,25
58,2025-05-25T02:03:00+02:00,2025-05-25,10:03,11,5,16
62,2025-05-25T02:01:00+02:00,2025-05-25,10:01,4,1,5
62,2025-05-25T02:05:00+02:00,2025-05-25,10:05,3,0,3
62,2025-05-25T02:08:00+02:00,2025-05-25,10:08,2,1,3
62,2025-05-25T02:09:00+02:00,2025-05-25,10:09,3,1,4
63,2025-05-25T01:55:00+02:00,2025-05-25,09:55,3,10,13
63,2025-05-25T01:56:00+02:00,2025-05-25,09:56,3,2,5
63,2025-05-25T02:00:00+02:00,2025-05-25,10:00,7,9,16
63,2025-05-25T02:01:00+02:00,2025-05-25,10:01,1,11,12
63,2025-05-25T02:02:00+02:00,2025-05-25,10:02,2,4,6
63,2025-05-25T02:03:00+02:00,2025-05-25,10:03,0,6,6
63,2025-05-25T02:07:00+02:00,2025-05-25,10:07,2,3,5
67,2025-05-25T01:59:00+02:00,2025-05-25,09:59,7,6,13
67,2025-05-25T02:00:00+02:00,2025-05-25,10:00,4,9,13
67,2025-05-25T02:02:00+02:00,2025-05-25,10:02,7,6,13
67,2025-05-25T02:03:00+02:00,2025-05-25,10:03,5,6,11
68,2025-05-25T01:55:00+02:00,2025-05-25,09:55,3,9,12
68,2025-05-25T01:59:00+02:00,2025-05-25,09:59,3,4,7
68,2025-05-25T02:00:00+02:00,2025-05-25,10:00,3,0,3
68,2025-05-25T02:01:00+02:00,2025-05-25,10:01,6,1,7
68,2025-05-25T02:02:00+02:00,2025-05-25,10:02,2,4,6
68,2025-05-25T02:09:00+02:00,2025-05-25,10:09,9,5,14
72,2025-05-25T01:57:00+02:00,2025-05-25,09:57,1,0,1
72,2025-05-25T01:59:00+02:00,2025-05-25,09:59,1,7,8
72,2025-05-25T02:05:00+02:00,2025-05-25,10:05,2,1,3
76,2025-05-25T01:55:00+02:00,2025-05-25,09:55,1,1,2
76,2025-05-25T01:58:00+02:00,2025-05-25,09:58,2,3,5
76,2025-05-25T02:03:00+02:00,2025-05-25,10:03,2,1,3
76,2025-05-25T02:04:00+02:00,2025-05-25,10:04,0,1,1
76,2025-05-25T02:07:00+02:00,2025-05-25,10:07,2,1,3
76,2025-05-25T02:08:00+02:00,2025-05-25,10:08,1,0,1
79,2025-05-25T01:58:00+02:00,2025-05-25,09:58,16,3,19
79,2025-05-25T02:01:00+02:00,2025-05-25,10:01,1,0,1
79,2025-05-25T02:06:00+02:00,2025-05-25,10:06,4,2,6
85,2025-05-25T01:57:00+02:00,2025-05-25,09:57,3,1,4
85,2025-05-25T02:01:00+02:00,2025-05-25,10:01,2,1,3
85,2025-05-25T02:03:00+02:00,2025-05-25,10:03,1,3,4
85,2025-05-25T02:05:00+02:00,2025-05-25,10:05,1,1,2
85,2025-05-25T02:09:00+02:00,2025-05-25,10:09,2,2,4
86,2025-05-25T01:55:00+02:00,2025-05-25,09:55,1,0,1
86,2025-05-25T01:57:00+02:00,2025-05-25,09:57,0,5,5
86,2025-05-25T02:00:00+02:00,2025-05-25,10:00,1,0,1
86,2025-05-25T02:03:00+02:00,2025-05-25,10:03,1,0,1
86,2025-05-25T02:05:00+02:00,2025-05-25,10:05,0,1,1
109,2025-05-25T02:00:00+02:00,2025-05-25,10:00,3,9,12
117,2025-05-25T02:05:00+02:00,2025-05-25,10:05,5,15,20
123,2025-05-25T02:00:00+02:00,2025-05-25,10:00,7,6,13
123,2025-05-25T02:05:00+02:00,2025-05-25,10:05,8,1,9
130,2025-05-25T01:55:00+02:00,2025-05-25,09:55,7,5,12
130,2025-05-25T02:00:00+02:00,2025-05-25,10:00,3,4,7
130,2025-05-25T02:05:00+02:00,2025-05-25,10:05,1,2,3
136,2025-05-25T01:55:00+02:00,2025-05-25,09:55,3,1,4
136,2025-05-25T02:00:00+02:00,2025-05-25,10:00,17,10,27
139,2025-05-25T02:00:00+02:00,2025-05-25,10:00,2,0,2
141,2025-05-25T02:00:00+02:00,2025-05-25,10:00,38,8,46
161,2025-05-25T02:00:00+02:00,2025-05-25,10:00,22,26,48
161,2025-05-25T02:05:00+02:00,2025-05-25,10:05,11,10,21
164,2025-05-25T01:55:00+02:00,2025-05-25,09:55,2,3,5
164,2025-05-25T02:05:00+02:00,2025-05-25,10:05,13,1,14
181,2025-05-25T02:11:00+02:00,2025-05-25,10:11,9,9,18
181,2025-05-25T02:14:00+02:00,2025-05-25,10:14,0,15,15
181,2025-05-25T02:16:00+02:00,2025-05-25,10:16,8,2,10
181,2025-05-25T02:20:00+02:00,2025-05-25,10:20,9,14,23
182,2025-05-25T02:20:00+02:00,2025-05-25,10:20,6,14,20
180,2025-05-25T02:10:00+02:00,2025-05-25,10:10,1,0,1
180,2025-05-25T02:12:00+02:00,2025-05-25,10:12,0,2,2
180,2025-05-25T02:14:00+02:00,2025-05-25,10:14,1,0,1
180,2025-05-25T02:19:00+02:00,2025-05-25,10:19,1,0,1
3,2025-05-25T02:12:00+02:00,2025-05-25,10:12,9,6,15
3,2025-05-25T02:14:00+02:00,2025-05-25,10:14,2,3,5
3,2025-05-25T02:15:00+02:00,2025-05-25,10:15,4,7,11
3,2025-05-25T02:19:00+02:00,2025-05-25,10:19,1,8,9
3,2025-05-25T02:22:00+02:00,2025-05-25,10:22,1,4,5
4,2025-05-25T02:11:00+02:00,2025-05-25,10:11,6,4,10
4,2025-05-25T02:12:00+02:00,2025-05-25,10:12,2,6,8
4,2025-05-25T02:18:00+02:00,2025-05-25,10:18,23,4,27
5,2025-05-25T02:15:00+02:00,2025-05-25,10:15,29,55,84
6,2025-05-25T02:19:00+02:00,2025-05-25,10:19,8,7,15
6,2025-05-25T02:20:00+02:00,2025-05-25,10:20,17,15,32
6,2025-05-25T02:24:00+02:00,2025-05-25,10:24,6,3,9
8,2025-05-25T02:13:00+02:00,2025-05-25,10:13,3,7,10
8,2025-05-25T02:23:00+02:00,2025-05-25,10:23,1,5,6
28,2025-05-25T02:14:00+02:00,2025-05-25,10:14,2,2,4
28,2025-05-25T02:19:00+02:00,2025-05-25,10:19,4,9,13
28,2025-05-25T02:22:00+02:00,2025-05-25,10:22,10,11,21
29,2025-05-25T02:10:00+02:00,2025-05-25,10:10,4,7,11
29,2025-05-25T02:13:00+02:00,2025-05-25,10:13,4,7,11
29,2025-05-25T02:14:00+02:00,2025-05-25,10:14,3,12,15
29,2025-05-25T02:15:00+02:00,2025-05-25,10:15,7,4,11
29,2025-05-25T02:16:00+02:00,2025-05-25,10:16,8,3,11
29,2025-05-25T02:17:00+02:00,2025-05-25,10:17,10,6,16
29,2025-05-25T02:21:00+02:00,2025-05-25,10:21,6,7,13
29,2025-05-25T02:24:00+02:00,2025-05-25,10:24,6,5,11
31,2025-05-25T02:16:00+02:00,2025-05-25,10:16,0,2,2
31,2025-05-25T02:21:00+02:00,2025-05-25,10:21,0,2,2
36,2025-05-25T02:19:00+02:00,2025-05-25,10:19,3,0,3
36,2025-05-25T02:20:00+02:00,2025-05-25,10:20,2,2,4
36,2025-05-25T02:21:00+02:00,2025-05-25,10:21,0,2,2
36,2025-05-25T02:22:00+02:00,2025-05-25,10:22,2,0,2
36,2025-05-25T02:24:00+02:00,2025-05-25,10:24,0,3,3
37,2025-05-25T02:10:00+02:00,2025-05-25,10:10,1,1,2
37,2025-05-25T02:13:00+02:00,2025-05-25,10:13,0,2,2
37,2025-05-25T02:19:00+02:00,2025-05-25,10:19,1,0,1
39,2025-05-25T02:12:00+02:00,2025-05-25,10:12,0,1,1
39,2025-05-25T02:15:00+02:00,2025-05-25,10:15,3,0,3
39,2025-05-25T02:21:00+02:00,2025-05-25,10:21,0,1,1
39,2025-05-25T02:22:00+02:00,2025-05-25,10:22,0,1,1
40,2025-05-25T02:10:00+02:00,2025-05-25,10:10,0,1,1
40,2025-05-25T02:11:00+02:00,2025-05-25,10:11,2,5,7
40,2025-05-25T02:14:00+02:00,2025-05-25,10:14,2,1,3
40,2025-05-25T02:23:00+02:00,2025-05-25,10:23,2,1,3
40,2025-05-25T02:24:00+02:00,2025-05-25,10:24,3,4,7
41,2025-05-25T02:10:00+02:00,2025-05-25,10:10,3,3,6
41,2025-05-25T02:18:00+02:00,2025-05-25,10:18,1,1,2
41,2025-05-25T02:24:00+02:00,2025-05-25,10:24,0,3,3
43,2025-05-25T02:10:00+02:00,2025-05-25,10:10,6,7,13
43,2025-05-25T02:20:00+02:00,2025-05-25,10:20,4,3,7
45,2025-05-25T02:10:00+02:00,2025-05-25,10:10,2,4,6
45,2025-05-25T02:13:00+02:00,2025-05-25,10:13,9,3,12
45,2025-05-25T02:14:00+02:00,2025-05-25,10:14,10,2,12
45,2025-05-25T02:18:00+02:00,2025-05-25,10:18,16,5,21
45,2025-05-25T02:20:00+02:00,2025-05-25,10:20,4,10,14
45,2025-05-25T02:21:00+02:00,2025-05-25,10:21,5,10,15
45,2025-05-25T02:22:00+02:00,2025-05-25,10:22,7,3,10
47,2025-05-25T02:10:00+02:00,2025-05-25,10:10,3,15,18
47,2025-05-25T02:11:00+02:00,2025-05-25,10:11,15,23,38
47,2025-05-25T02:14:00+02:00,2025-05-25,10:14,8,4,12
47,2025-05-25T02:22:00+02:00,2025-05-25,10:22,7,7,14
47,2025-05-25T02:24:00+02:00,2025-05-25,10:24,11,10,21
50,2025-05-25T02:12:00+02:00,2025-05-25,10:12,1,0,1
50,2025-05-25T02:17:00+02:00,2025-05-25,10:17,2,0,2
50,2025-05-25T02:18:00+02:00,2025-05-25,10:18,0,1,1
50,2025-05-25T02:19:00+02:00,2025-05-25,10:19,1,0,1
50,2025-05-25T02:22:00+02:00,2025-05-25,10:22,1,5,6
50,2025-05-25T02:23:00+02:00,2025-05-25,10:23,1,2,3
54,2025-05-25T02:12:00+02:00,2025-05-25,10:12,1,3,4
54,2025-05-25T02:14:00+02:00,2025-05-25,10:14,7,0,7
54,2025-05-25T02:15:00+02:00,2025-05-25,10:15,0,3,3
54,2025-05-25T02:18:00+02:00,2025-05-25,10:18,1,0,1
54,2025-05-25T02:20:00+02:00,2025-05-25,10:20,1,1,2
54,2025-05-25T02:21:00+02:00,2025-05-25,10:21,2,6,8
59,2025-05-25T02:15:00+02:00,2025-05-25,10:15,6,12,18
61,2025-05-25T02:10:00+02:00,2025-05-25,10:10,1,6,7
61,2025-05-25T02:14:00+02:00,2025-05-25,10:14,2,13,15
61,2025-05-25T02:15:00+02:00,2025-05-25,10:15,1,4,5
61,2025-05-25T02:20:00+02:00,2025-05-25,10:20,3,6,9
61,2025-05-25T02:21:00+02:00,2025-05-25,10:21,4,6,10
61,2025-05-25T02:24:00+02:00,2025-05-25,10:24,4,4,8
66,2025-05-25T02:15:00+02:00,2025-05-25,10:15,8,10,18
66,2025-05-25T02:18:00+02:00,2025-05-25,10:18,4,2,6
66,2025-05-25T02:22:00+02:00,2025-05-25,10:22,5,9,14
66,2025-05-25T02:23:00+02:00,2025-05-25,10:23,12,8,20
69,2025-05-25T02:12:00+02:00,2025-05-25,10:12,1,1,2
69,2025-05-25T02:14:00+02:00,2025-05-25,10:14,2,0,2
69,2025-05-25T02:16:00+02:00,2025-05-25,10:16,9,3,12
69,2025-05-25T02:18:00+02:00,2025-05-25,10:18,3,2,5
69,2025-05-25T02:20:00+02:00,2025-05-25,10:20,5,4,9
69,2025-05-25T02:22:00+02:00,2025-05-25,10:22,6,1,7
70,2025-05-25T02:10:00+02:00,2025-05-25,10:10,1,1,2
70,2025-05-25T02:13:00+02:00,2025-05-25,10:13,4,0,4
70,2025-05-25T02:15:00+02:00,2025-05-25,10:15,0,1,1
70,2025-05-25T02:21:00+02:00,2025-05-25,10:21,2,2,4
70,2025-05-25T02:23:00+02:00,2025-05-25,10:23,0,3,3
75,2025-05-25T02:16:00+02:00,2025-05-25,10:16,1,1,2
75,2025-05-25T02:17:00+02:00,2025-05-25,10:17,1,2,3
75,2025-05-25T02:19:00+02:00,2025-05-25,10:19,1,0,1
77,2025-05-25T02:20:00+02:00,2025-05-25,10:20,5,19,24
78,2025-05-25T02:10:00+02:00,2025-05-25,10:10,1,1,2
78,2025-05-25T02:13:00+02:00,2025-05-25,10:13,3,1,4
78,2025-05-25T02:18:00+02:00,2025-05-25,10:18,1,1,2
78,2025-05-25T02:19:00+02:00,2025-05-25,10:19,0,1,1
78,2025-05-25T02:23:00+02:00,2025-05-25,10:23,0,6,6
87,2025-05-25T02:10:00+02:00,2025-05-25,10:10,0,1,1
87,2025-05-25T02:11:00+02:00,2025-05-25,10:11,1,0,1
87,2025-05-25T02:14:00+02:00,2025-05-25,10:14,5,1,6
87,2025-05-25T02:15:00+02:00,2025-05-25,10:15,0,1,1
87,2025-05-25T02:19:00+02:00,2025-05-25,10:19,2,2,4
87,2025-05-25T02:22:00+02:00,2025-05-25,10:22,2,3,5
107,2025-05-25T02:10:00+02:00,2025-05-25,10:10,5,10,15
107,2025-05-25T02:15:00+02:00,2025-05-25,10:15,6,1,7
108,2025-05-25T02:15:00+02:00,2025-05-25,10:15,4,0,4
108,2025-05-25T02:18:00+02:00,2025-05-25,10:18,3,1,4
108,2025-05-25T02:19:00+02:00,2025-05-25,10:19,4,2,6
108,2025-05-25T02:21:00+02:00,2025-05-25,10:21,5,4,9
131,2025-05-25T02:10:00+02:00,2025-05-25,10:10,0,7,7
131,2025-05-25T02:20:00+02:00,2025-05-25,10:20,4,12,16
132,2025-05-25T02:15:00+02:00,2025-05-25,10:15,13,1,14
133,2025-05-25T02:15:00+02:00,2025-05-25,10:15,36,43,79
133,2025-05-25T02:20:00+02:00,2025-05-25,10:20,40,38,78
134,2025-05-25T02:20:00+02:00,2025-05-25,10:20,25,50,75
135,2025-05-25T02:15:00+02:00,2025-05-25,10:15,34,31,65
179,2025-05-25T02:10:00+02:00,2025-05-25,10:10,6,6,12
1,2025-05-25T02:10:00+02:00,2025-05-25,10:10,5,12,17
1,2025-05-25T02:12:00+02:00,2025-05-25,10:12,5,10,15
1,2025-05-25T02:13:00+02:00,2025-05-25,10:13,3,7,10
1,2025-05-25T02:15:00+02:00,2025-05-25,10:15,7,8,15
1,2025-05-25T02:22:00+02:00,2025-05-25,10:22,9,10,19
1,2025-05-25T02:24:00+02:00,2025-05-25,10:24,6,12,18
2,2025-05-25T02:17:00+02:00,2025-05-25,10:17,2,2,4
2,2025-05-25T02:18:00+02:00,2025-05-25,10:18,0,8,8
2,2025-05-25T02:22:00+02:00,2025-05-25,10:22,0,11,11
2,2025-05-25T02:24:00+02:00,2025-05-25,10:24,1,3,4
9,2025-05-25T02:11:00+02:00,2025-05-25,10:11,2,0,2
9,2025-05-25T02:14:00+02:00,2025-05-25,10:14,0,2,2
9,2025-05-25T02:19:00+02:00,2025-05-25,10:19,3,0,3
9,2025-05-25T02:21:00+02:00,2025-05-25,10:21,1,0,1
10,2025-05-25T02:13:00+02:00,2025-05-25,10:13,0,3,3
11,2025-05-25T02:11:00+02:00,2025-05-25,10:11,3,0,3
11,2025-05-25T02:18:00+02:00,2025-05-25,10:18,0,2,2
11,2025-05-25T02:19:00+02:00,2025-05-25,10:19,0,3,3
11,2025-05-25T02:21:00+02:00,2025-05-25,10:21,1,0,1
11,2025-05-25T02:22:00+02:00,2025-05-25,10:22,1,0,1
11,2025-05-25T02:24:00+02:00,2025-05-25,10:24,0,4,4
17,2025-05-25T02:11:00+02:00,2025-05-25,10:11,1,1,2
17,2025-05-25T02:12:00+02:00,2025-05-25,10:12,2,1,3
17,2025-05-25T02:13:00+02:00,2025-05-25,10:13,2,0,2
17,2025-05-25T02:14:00+02:00,2025-05-25,10:14,1,0,1
17,2025-05-25T02:22:00+02:00,2025-05-25,10:22,6,4,10
18,2025-05-25T02:10:00+02:00,2025-05-25,10:10,1,2,3
18,2025-05-25T02:18:00+02:00,2025-05-25,10:18,0,1,1
18,2025-05-25T02:21:00+02:00,2025-05-25,10:21,3,0,3
18,2025-05-25T02:22:00+02:00,2025-05-25,10:22,0,1,1
19,2025-05-25T02:13:00+02:00,2025-05-25,10:13,2,4,6
19,2025-05-25T02:14:00+02:00,2025-05-25,10:14,1,1,2
19,2025-05-25T02:19:00+02:00,2025-05-25,10:19,8,3,11
19,2025-05-25T02:20:00+02:00,2025-05-25,10:20,1,0,1
19,2025-05-25T02:21:00+02:00,2025-05-25,10:21,4,5,9
20,2025-05-25T02:10:00+02:00,2025-05-25,10:10,0,1,1
20,2025-05-25T02:12:00+02:00,2025-05-25,10:12,3,5,8
20,2025-05-25T02:14:00+02:00,2025-05-25,10:14,1,1,2
20,2025-05-25T02:16:00+02:00,2025-05-25,10:16,1,0,1
20,2025-05-25T02:18:00+02:00,2025-05-25,10:18,1,2,3
20,2025-05-25T02:21:00+02:00,2025-05-25,10:21,1,0,1
20,2025-05-25T02:23:00+02:00,2025-05-25,10:23,1,2,3
20,2025-05-25T02:24:00+02:00,2025-05-25,10:24,0,1,1
23,2025-05-25T02:17:00+02:00,2025-05-25,10:17,4,0,4
23,2025-05-25T02:18:00+02:00,2025-05-25,10:18,6,0,6
23,2025-05-25T02:19:00+02:00,2025-05-25,10:19,13,6,19
23,2025-05-25T02:21:00+02:00,2025-05-25,10:21,0,2,2
23,2025-05-25T02:23:00+02:00,2025-05-25,10:23,2,5,7
24,2025-05-25T02:11:00+02:00,2025-05-25,10:11,6,1,7
24,2025-05-25T02:12:00+02:00,2025-05-25,10:12,4,0,4
24,2025-05-25T02:13:00+02:00,2025-05-25,10:13,9,15,24
24,2025-05-25T02:17:00+02:00,2025-05-25,10:17,3,1,4
24,2025-05-25T02:19:00+02:00,2025-05-25,10:19,8,6,14
24,2025-05-25T02:20:00+02:00,2025-05-25,10:20,6,19,25
25,2025-05-25T02:10:00+02:00,2025-05-25,10:10,36,73,109
25,2025-05-25T02:15:00+02:00,2025-05-25,10:15,25,96,121
27,2025-05-25T02:10:00+02:00,2025-05-25,10:10,12,0,12
27,2025-05-25T02:11:00+02:00,2025-05-25,10:11,4,8,12
27,2025-05-25T02:12:00+02:00,2025-05-25,10:12,6,4,10
27,2025-05-25T02:16:00+02:00,2025-05-25,10:16,0,5,5
27,2025-05-25T02:17:00+02:00,2025-05-25,10:17,2,0,2
27,2025-05-25T02:18:00+02:00,2025-05-25,10:18,2,5,7
27,2025-05-25T02:23:00+02:00,2025-05-25,10:23,4,2,6
30,2025-05-25T02:12:00+02:00,2025-05-25,10:12,1,1,2
30,2025-05-25T02:17:00+02:00,2025-05-25,10:17,0,4,4
35,2025-05-25T02:10:00+02:00,2025-05-25,10:10,24,8,32
35,2025-05-25T02:12:00+02:00,2025-05-25,10:12,17,4,21
35,2025-05-25T02:13:00+02:00,2025-05-25,10:13,18,6,24
35,2025-05-25T02:14:00+02:00,2025-05-25,10:14,15,12,27
35,2025-05-25T02:15:00+02:00,2025-05-25,10:15,10,10,20
35,2025-05-25T02:21:00+02:00,2025-05-25,10:21,11,19,30
35,2025-05-25T02:22:00+02:00,2025-05-25,10:22,13,21,34
48,2025-05-25T02:11:00+02:00,2025-05-25,10:11,7,0,7
48,2025-05-25T02:16:00+02:00,2025-05-25,10:16,7,7,14
48,2025-05-25T02:17:00+02:00,2025-05-25,10:17,6,8,14
48,2025-05-25T02:21:00+02:00,2025-05-25,10:21,13,4,17
48,2025-05-25T02:23:00+02:00,2025-05-25,10:23,4,3,7
49,2025-05-25T02:11:00+02:00,2025-05-25,10:11,11,9,20
49,2025-05-25T02:14:00+02:00,2025-05-25,10:14,5,5,10
49,2025-05-25T02:17:00+02:00,2025-05-25,10:17,5,4,9
49,2025-05-25T02:18:00+02:00,2025-05-25,10:18,5,2,7
49,2025-05-25T02:19:00+02:00,2025-05-25,10:19,8,5,13
49,2025-05-25T02:20:00+02:00,2025-05-25,10:20,0,10,10
49,2025-05-25T02:24:00+02:00,2025-05-25,10:24,1,5,6
51,2025-05-25T02:10:00+02:00,2025-05-25,10:10,4,0,4
51,2025-05-25T02:12:00+02:00,2025-05-25,10:12,0,2,2
51,2025-05-25T02:13:00+02:00,2025-05-25,10:13,1,3,4
51,2025-05-25T02:15:00+02:00,2025-05-25,10:15,4,2,6
51,2025-05-25T02:17:00+02:00,2025-05-25,10:17,2,0,2
51,2025-05-25T02:19:00+02:00,2025-05-25,10:19,2,5,7
51,2025-05-25T02:20:00+02:00,2025-05-25,10:20,1,0,1
51,2025-05-25T02:22:00+02:00,2025-05-25,10:22,1,1,2
52,2025-05-25T02:10:00+02:00,2025-05-25,10:10,3,3,6
52,2025-05-25T02:21:00+02:00,2025-05-25,10:21,5,0,5
52,2025-05-25T02:24:00+02:00,2025-05-25,10:24,4,0,4
53,2025-05-25T02:12:00+02:00,2025-05-25,10:12,6,2,8
53,2025-05-25T02:13:00+02:00,2025-05-25,10:13,5,0,5
53,2025-05-25T02:20:00+02:00,2025-05-25,10:20,3,1,4
53,2025-05-25T02:22:00+02:00,2025-05-25,10:22,1,8,9
53,2025-05-25T02:23:00+02:00,2025-05-25,10:23,11,2,13
56,2025-05-25T02:10:00+02:00,2025-05-25,10:10,9,1,10
56,2025-05-25T02:12:00+02:00,2025-05-25,10:12,3,0,3
56,2025-05-25T02:16:00+02:00,2025-05-25,10:16,4,6,10
56,2025-05-25T02:17:00+02:00,2025-05-25,10:17,2,6,8
56,2025-05-25T02:21:00+02:00,2025-05-25,10:21,4,8,12
56,2025-05-25T02:22:00+02:00,2025-05-25,10:22,6,13,19
56,2025-05-25T02:23:00+02:00,2025-05-25,10:23,8,0,8
56,2025-05-25T02:24:00+02:00,2025-05-25,10:24,5,5,10
58,2025-05-25T02:11:00+02:00,2025-05-25,10:11,6,1,7
58,2025-05-25T02:15:00+02:00,2025-05-25,10:15,13,5,18
58,2025-05-25T02:17:00+02:00,2025-05-25,10:17,3,3,6
58,2025-05-25T02:24:00+02:00,2025-05-25,10:24,14,1,15
62,2025-05-25T02:10:00+02:00,2025-05-25,10:10,0,4,4
62,2025-05-25T02:11:00+02:00,2025-05-25,10:11,2,0,2
62,2025-05-25T02:12:00+02:00,2025-05-25,10:12,3,0,3
62,2025-05-25T02:14:00+02:00,2025-05-25,10:14,3,0,3
62,2025-05-25T02:17:00+02:00,2025-05-25,10:17,4,1,5
62,2025-05-25T02:21:00+02:00,2025-05-25,10:21,0,1,1
63,2025-05-25T02:10:00+02:00,2025-05-25,10:10,1,5,6
63,2025-05-25T02:11:00+02:00,2025-05-25,10:11,1,2,3
63,2025-05-25T02:13:00+02:00,2025-05-25,10:13,2,4,6
63,2025-05-25T02:19:00+02:00,2025-05-25,10:19,2,7,9
63,2025-05-25T02:22:00+02:00,2025-05-25,10:22,6,7,13
67,2025-05-25T02:10:00+02:00,2025-05-25,10:10,2,6,8
67,2025-05-25T02:11:00+02:00,2025-05-25,10:11,2,6,8
67,2025-05-25T02:17:00+02:00,2025-05-25,10:17,4,5,9
67,2025-05-25T02:18:00+02:00,2025-05-25,10:18,2,3,5
67,2025-05-25T02:20:00+02:00,2025-05-25,10:20,6,3,9
67,2025-05-25T02:22:00+02:00,2025-05-25,10:22,2,15,17
68,2025-05-25T02:14:00+02:00,2025-05-25,10:14,4,3,7
68,2025-05-25T02:17:00+02:00,2025-05-25,10:17,6,8,14
68,2025-05-25T02:20:00+02:00,2025-05-25,10:20,5,4,9
68,2025-05-25T02:24:00+02:00,2025-05-25,10:24,3,2,5
72,2025-05-25T02:13:00+02:00,2025-05-25,10:13,0,1,1
76,2025-05-25T02:10:00+02:00,2025-05-25,10:10,0,1,1
76,2025-05-25T02:12:00+02:00,2025-05-25,10:12,1,2,3
76,2025-05-25T02:19:00+02:00,2025-05-25,10:19,2,2,4
76,2025-05-25T02:21:00+02:00,2025-05-25,10:21,1,1,2
79,2025-05-25T02:10:00+02:00,2025-05-25,10:10,3,9,12
79,2025-05-25T02:12:00+02:00,2025-05-25,10:12,1,4,5
79,2025-05-25T02:13:00+02:00,2025-05-25,10:13,6,2,8
79,2025-05-25T02:14:00+02:00,2025-05-25,10:14,4,0,4
79,2025-05-25T02:15:00+02:00,2025-05-25,10:15,0,7,7
79,2025-05-25T02:17:00+02:00,2025-05-25,10:17,4,5,9
79,2025-05-25T02:19:00+02:00,2025-05-25,10:19,7,5,12
79,2025-05-25T02:23:00+02:00,2025-05-25,10:23,5,2,7
85,2025-05-25T02:10:00+02:00,2025-05-25,10:10,3,5,8
85,2025-05-25T02:17:00+02:00,2025-05-25,10:17,2,2,4
85,2025-05-25T02:20:00+02:00,2025-05-25,10:20,1,2,3
85,2025-05-25T02:21:00+02:00,2025-05-25,10:21,3,0,3
85,2025-05-25T02:22:00+02:00,2025-05-25,10:22,2,0,2
85,2025-05-25T02:23:00+02:00,2025-05-25,10:23,1,0,1
117,2025-05-25T02:15:00+02:00,2025-05-25,10:15,5,4,9
117,2025-05-25T02:20:00+02:00,2025-05-25,10:20,4,21,25
123,2025-05-25T02:10:00+02:00,2025-05-25,10:10,9,4,13
123,2025-05-25T02:15:00+02:00,2025-05-25,10:15,2,2,4
123,2025-05-25T02:20:00+02:00,2025-05-25,10:20,1,2,3
136,2025-05-25T02:20:00+02:00,2025-05-25,10:20,6,6,12
137,2025-05-25T02:10:00+02:00,2025-05-25,10:10,1,4,5
137,2025-05-25T02:20:00+02:00,2025-05-25,10:20,0,1,1
142,2025-05-25T02:10:00+02:00,2025-05-25,10:10,51,19,70
142,2025-05-25T02:20:00+02:00,2025-05-25,10:20,30,15,45
181,2025-05-25T02:26:00+02:00,2025-05-25,10:26,9,17,26
181,2025-05-25T02:27:00+02:00,2025-05-25,10:27,8,10,18
181,2025-05-25T02:32:00+02:00,2025-05-25,10:32,2,4,6
181,2025-05-25T02:35:00+02:00,2025-05-25,10:35,7,10,17
182,2025-05-25T02:25:00+02:00,2025-05-25,10:25,9,10,19
182,2025-05-25T02:35:00+02:00,2025-05-25,10:35,6,14,20
180,2025-05-25T02:31:00+02:00,2025-05-25,10:31,0,1,1
180,2025-05-25T02:35:00+02:00,2025-05-25,10:35,0,2,2
3,2025-05-25T04:32:00+02:00,2025-05-25,12:32,5,19,24
3,2025-05-25T04:36:00+02:00,2025-05-25,12:36,18,12,30
4,2025-05-25T04:25:00+02:00,2025-05-25,12:25,36,26,62
4,2025-05-25T04:27:00+02:00,2025-05-25,12:27,26,20,46
4,2025-05-25T04:30:00+02:00,2025-05-25,12:30,44,24,68
4,2025-05-25T04:32:00+02:00,2025-05-25,12:32,32,34,66
4,2025-05-25T04:37:00+02:00,2025-05-25,12:37,25,11,36
4,2025-05-25T04:38:00+02:00,2025-05-25,12:38,30,27,57
4,2025-05-25T04:39:00+02:00,2025-05-25,12:39,26,19,45
5,2025-05-25T04:25:00+02:00,2025-05-25,12:25,61,103,164
5,2025-05-25T04:30:00+02:00,2025-05-25,12:30,98,66,164
6,2025-05-25T04:30:00+02:00,2025-05-25,12:30,26,9,35
6,2025-05-25T04:31:00+02:00,2025-05-25,12:31,6,11,17
6,2025-05-25T04:37:00+02:00,2025-05-25,12:37,13,12,25
6,2025-05-25T04:39:00+02:00,2025-05-25,12:39,17,29,46
8,2025-05-25T04:25:00+02:00,2025-05-25,12:25,1,7,8
8,2025-05-25T04:35:00+02:00,2025-05-25,12:35,3,5,8
8,2025-05-25T04:36:00+02:00,2025-05-25,12:36,3,3,6
8,2025-05-25T04:37:00+02:00,2025-05-25,12:37,1,7,8
28,2025-05-25T04:25:00+02:00,2025-05-25,12:25,10,7,17
28,2025-05-25T04:28:00+02:00,2025-05-25,12:28,11,14,25
28,2025-05-25T04:30:00+02:00,2025-05-25,12:30,5,26,31
28,2025-05-25T04:31:00+02:00,2025-05-25,12:31,9,43,52
28,2025-05-25T04:32:00+02:00,2025-05-25,12:32,11,26,37
28,2025-05-25T04:35:00+02:00,2025-05-25,12:35,7,19,26
28,2025-05-25T04:37:00+02:00,2025-05-25,12:37,7,3,10
28,2025-05-25T04:39:00+02:00,2025-05-25,12:39,9,4,13
29,2025-05-25T04:28:00+02:00,2025-05-25,12:28,13,11,24
29,2025-05-25T04:29:00+02:00,2025-05-25,12:29,6,7,13
29,2025-05-25T04:31:00+02:00,2025-05-25,12:31,23,2,25
29,2025-05-25T04:35:00+02:00,2025-05-25,12:35,7,15,22
29,2025-05-25T04:36:00+02:00,2025-05-25,12:36,9,8,17
29,2025-05-25T04:39:00+02:00,2025-05-25,12:39,7,12,19
31,2025-05-25T04:26:00+02:00,2025-05-25,12:26,6,2,8
31,2025-05-25T04:31:00+02:00,2025-05-25,12:31,5,4,9
31,2025-05-25T04:35:00+02:00,2025-05-25,12:35,2,0,2
36,2025-05-25T04:29:00+02:00,2025-05-25,12:29,1,0,1
36,2025-05-25T04:33:00+02:00,2025-05-25,12:33,3,1,4
36,2025-05-25T04:35:00+02:00,2025-05-25,12:35,3,0,3
36,2025-05-25T04:39:00+02:00,2025-05-25,12:39,1,2,3
37,2025-05-25T04:26:00+02:00,2025-05-25,12:26,2,0,2
37,2025-05-25T04:27:00+02:00,2025-05-25,12:27,2,2,4
37,2025-05-25T04:30:00+02:00,2025-05-25,12:30,3,3,6
39,2025-05-25T04:25:00+02:00,2025-05-25,12:25,0,1,1
39,2025-05-25T04:27:00+02:00,2025-05-25,12:27,2,1,3
39,2025-05-25T04:30:00+02:00,2025-05-25,12:30,0,1,1
39,2025-05-25T04:35:00+02:00,2025-05-25,12:35,0,1,1
40,2025-05-25T04:27:00+02:00,2025-05-25,12:27,0,9,9
40,2025-05-25T04:28:00+02:00,2025-05-25,12:28,1,12,13
40,2025-05-25T04:34:00+02:00,2025-05-25,12:34,0,11,11
41,2025-05-25T04:25:00+02:00,2025-05-25,12:25,13,4,17
41,2025-05-25T04:28:00+02:00,2025-05-25,12:28,4,3,7
41,2025-05-25T04:32:00+02:00,2025-05-25,12:32,11,8,19
41,2025-05-25T04:33:00+02:00,2025-05-25,12:33,9,4,13
41,2025-05-25T04:35:00+02:00,2025-05-25,12:35,9,3,12
41,2025-05-25T04:37:00+02:00,2025-05-25,12:37,5,5,10
41,2025-05-25T04:38:00+02:00,2025-05-25,12:38,2,6,8
45,2025-05-25T04:26:00+02:00,2025-05-25,12:26,14,6,20
45,2025-05-25T04:33:00+02:00,2025-05-25,12:33,25,16,41
45,2025-05-25T04:35:00+02:00,2025-05-25,12:35,35,18,53
45,2025-05-25T04:38:00+02:00,2025-05-25,12:38,17,24,41
45,2025-05-25T04:39:00+02:00,2025-05-25,12:39,29,29,58
47,2025-05-25T04:29:00+02:00,2025-05-25,12:29,19,6,25
47,2025-05-25T04:32:00+02:00,2025-05-25,12:32,10,15,25
47,2025-05-25T04:33:00+02:00,2025-05-25,12:33,11,25,36
47,2025-05-25T04:35:00+02:00,2025-05-25,12:35,14,6,20
47,2025-05-25T04:36:00+02:00,2025-05-25,12:36,14,15,29
47,2025-05-25T04:37:00+02:00,2025-05-25,12:37,11,15,26
50,2025-05-25T04:30:00+02:00,2025-05-25,12:30,2,4,6
50,2025-05-25T04:33:00+02:00,2025-05-25,12:33,1,6,7
50,2025-05-25T04:35:00+02:00,2025-05-25,12:35,2,5,7
50,2025-05-25T04:36:00+02:00,2025-05-25,12:36,4,1,5
50,2025-05-25T04:39:00+02:00,2025-05-25,12:39,7,4,11
54,2025-05-25T04:25:00+02:00,2025-05-25,12:25,2,0,2
54,2025-05-25T04:28:00+02:00,2025-05-25,12:28,1,0,1
54,2025-05-25T04:30:00+02:00,2025-05-25,12:30,1,1,2
54,2025-05-25T04:32:00+02:00,2025-05-25,12:32,5,1,6
54,2025-05-25T04:35:00+02:00,2025-05-25,12:35,3,0,3
59,2025-05-25T04:25:00+02:00,2025-05-25,12:25,23,24,47
61,2025-05-25T04:28:00+02:00,2025-05-25,12:28,8,1,9
61,2025-05-25T04:33:00+02:00,2025-05-25,12:33,14,9,23
61,2025-05-25T04:34:00+02:00,2025-05-25,12:34,8,4,12
61,2025-05-25T04:36:00+02:00,2025-05-25,12:36,4,3,7
61,2025-05-25T04:37:00+02:00,2025-05-25,12:37,23,16,39
66,2025-05-25T04:26:00+02:00,2025-05-25,12:26,25,6,31
66,2025-05-25T04:29:00+02:00,2025-05-25,12:29,25,39,64
66,2025-05-25T04:30:00+02:00,2025-05-25,12:30,13,24,37
66,2025-05-25T04:35:00+02:00,2025-05-25,12:35,23,20,43
66,2025-05-25T04:36:00+02:00,2025-05-25,12:36,18,22,40
66,2025-05-25T04:37:00+02:00,2025-05-25,12:37,27,16,43
66,2025-05-25T04:39:00+02:00,2025-05-25,12:39,17,21,38
69,2025-05-25T04:26:00+02:00,2025-05-25,12:26,6,5,11
69,2025-05-25T04:28:00+02:00,2025-05-25,12:28,0,1,1
69,2025-05-25T04:30:00+02:00,2025-05-25,12:30,2,4,6
69,2025-05-25T04:39:00+02:00,2025-05-25,12:39,3,4,7
70,2025-05-25T04:30:00+02:00,2025-05-25,12:30,2,0,2
70,2025-05-25T04:31:00+02:00,2025-05-25,12:31,2,1,3
70,2025-05-25T04:36:00+02:00,2025-05-25,12:36,4,2,6
70,2025-05-25T04:39:00+02:00,2025-05-25,12:39,2,5,7
71,2025-05-25T04:34:00+02:00,2025-05-25,12:34,1,0,1
71,2025-05-25T04:38:00+02:00,2025-05-25,12:38,1,0,1
75,2025-05-25T04:26:00+02:00,2025-05-25,12:26,0,5,5
75,2025-05-25T04:29:00+02:00,2025-05-25,12:29,3,5,8
75,2025-05-25T04:37:00+02:00,2025-05-25,12:37,1,0,1
75,2025-05-25T04:38:00+02:00,2025-05-25,12:38,1,0,1
75,2025-05-25T04:39:00+02:00,2025-05-25,12:39,0,1,1
78,2025-05-25T04:27:00+02:00,2025-05-25,12:27,0,2,2
78,2025-05-25T04:30:00+02:00,2025-05-25,12:30,1,4,5
78,2025-05-25T04:33:00+02:00,2025-05-25,12:33,3,3,6
78,2025-05-25T04:36:00+02:00,2025-05-25,12:36,0,2,2
78,2025-05-25T04:38:00+02:00,2025-05-25,12:38,4,3,7
87,2025-05-25T04:31:00+02:00,2025-05-25,12:31,2,3,5
87,2025-05-25T04:36:00+02:00,2025-05-25,12:36,3,1,4
87,2025-05-25T04:39:00+02:00,2025-05-25,12:39,2,0,2
107,2025-05-25T04:30:00+02:00,2025-05-25,12:30,9,15,24
108,2025-05-25T04:26:00+02:00,2025-05-25,12:26,2,7,9
108,2025-05-25T04:32:00+02:00,2025-05-25,12:32,1,1,2
108,2025-05-25T04:36:00+02:00,2025-05-25,12:36,3,3,6
108,2025-05-25T04:38:00+02:00,2025-05-25,12:38,1,2,3
133,2025-05-25T04:30:00+02:00,2025-05-25,12:30,37,33,70
133,2025-05-25T04:35:00+02:00,2025-05-25,12:35,44,38,82
162,2025-05-25T04:25:00+02:00,2025-05-25,12:25,51,66,117
162,2025-05-25T04:30:00+02:00,2025-05-25,12:30,61,80,141
165,2025-05-25T04:25:00+02:00,2025-05-25,12:25,2,0,2
166,2025-05-25T04:25:00+02:00,2025-05-25,12:25,6,5,11
167,2025-05-25T04:35:00+02:00,2025-05-25,12:35,3,5,8
179,2025-05-25T04:35:00+02:00,2025-05-25,12:35,6,0,6
1,2025-05-25T04:25:00+02:00,2025-05-25,12:25,13,19,32
1,2025-05-25T04:28:00+02:00,2025-05-25,12:28,34,10,44
1,2025-05-25T04:30:00+02:00,2025-05-25,12:30,13,17,30
1,2025-05-25T04:32:00+02:00,2025-05-25,12:32,32,18,50
1,2025-05-25T04:33:00+02:00,2025-05-25,12:33,19,16,35
1,2025-05-25T04:35:00+02:00,2025-05-25,12:35,29,27,56
1,2025-05-25T04:36:00+02:00,2025-05-25,12:36,46,21,67
2,2025-05-25T04:28:00+02:00,2025-05-25,12:28,15,5,20
2,2025-05-25T04:30:00+02:00,2025-05-25,12:30,8,9,17
9,2025-05-25T04:29:00+02:00,2025-05-25,12:29,1,0,1
9,2025-05-25T04:36:00+02:00,2025-05-25,12:36,0,2,2
11,2025-05-25T04:31:00+02:00,2025-05-25,12:31,2,3,5
11,2025-05-25T04:32:00+02:00,2025-05-25,12:32,1,0,1
11,2025-05-25T04:33:00+02:00,2025-05-25,12:33,0,1,1
12,2025-05-25T04:27:00+02:00,2025-05-25,12:27,2,1,3
12,2025-05-25T04:29:00+02:00,2025-05-25,12:29,3,0,3
12,2025-05-25T04:31:00+02:00,2025-05-25,12:31,2,6,8
12,2025-05-25T04:32:00+02:00,2025-05-25,12:32,1,15,16
12,2025-05-25T04:38:00+02:00,2025-05-25,12:38,12,1,13
12,2025-05-25T04:39:00+02:00,2025-05-25,12:39,4,6,10
17,2025-05-25T04:26:00+02:00,2025-05-25,12:26,7,11,18
17,2025-05-25T04:29:00+02:00,2025-05-25,12:29,19,0,19
17,2025-05-25T04:32:00+02:00,2025-05-25,12:32,5,1,6
17,2025-05-25T04:33:00+02:00,2025-05-25,12:33,5,0,5
17,2025-05-25T04:34:00+02:00,2025-05-25,12:34,0,1,1
17,2025-05-25T04:36:00+02:00,2025-05-25,12:36,4,1,5
17,2025-05-25T04:38:00+02:00,2025-05-25,12:38,2,1,3
18,2025-05-25T04:32:00+02:00,2025-05-25,12:32,1,0,1
18,2025-05-25T04:35:00+02:00,2025-05-25,12:35,4,1,5
18,2025-05-25T04:37:00+02:00,2025-05-25,12:37,0,1,1
18,2025-05-25T04:39:00+02:00,2025-05-25,12:39,0,1,1
19,2025-05-25T04:27:00+02:00,2025-05-25,12:27,4,6,10
19,2025-05-25T04:30:00+02:00,2025-05-25,12:30,7,9,16
19,2025-05-25T04:31:00+02:00,2025-05-25,12:31,21,10,31
19,2025-05-25T04:32:00+02:00,2025-05-25,12:32,14,8,22
19,2025-05-25T04:34:00+02:00,2025-05-25,12:34,12,4,16
19,2025-05-25T04:35:00+02:00,2025-05-25,12:35,12,8,20
19,2025-05-25T04:37:00+02:00,2025-05-25,12:37,12,4,16
20,2025-05-25T04:30:00+02:00,2025-05-25,12:30,2,2,4
20,2025-05-25T04:31:00+02:00,2025-05-25,12:31,2,10,12
20,2025-05-25T04:36:00+02:00,2025-05-25,12:36,7,7,14
20,2025-05-25T04:38:00+02:00,2025-05-25,12:38,1,7,8
23,2025-05-25T04:28:00+02:00,2025-05-25,12:28,4,3,7
23,2025-05-25T04:35:00+02:00,2025-05-25,12:35,5,1,6
23,2025-05-25T04:36:00+02:00,2025-05-25,12:36,2,1,3
23,2025-05-25T04:38:00+02:00,2025-05-25,12:38,0,3,3
24,2025-05-25T04:25:00+02:00,2025-05-25,12:25,19,10,29
24,2025-05-25T04:33:00+02:00,2025-05-25,12:33,3,9,12
24,2025-05-25T04:35:00+02:00,2025-05-25,12:35,7,0,7
24,2025-05-25T04:36:00+02:00,2025-05-25,12:36,4,5,9
24,2025-05-25T04:38:00+02:00,2025-05-25,12:38,2,5,7
25,2025-05-25T04:30:00+02:00,2025-05-25,12:30,95,63,158
25,2025-05-25T04:35:00+02:00,2025-05-25,12:35,96,82,178
27,2025-05-25T04:27:00+02:00,2025-05-25,12:27,3,5,8
27,2025-05-25T04:38:00+02:00,2025-05-25,12:38,4,7,11
30,2025-05-25T04:28:00+02:00,2025-05-25,12:28,4,3,7
30,2025-05-25T04:30:00+02:00,2025-05-25,12:30,7,4,11
30,2025-05-25T04:31:00+02:00,2025-05-25,12:31,7,15,22
30,2025-05-25T04:32:00+02:00,2025-05-25,12:32,8,7,15
30,2025-05-25T04:34:00+02:00,2025-05-25,12:34,2,9,11
30,2025-05-25T04:37:00+02:00,2025-05-25,12:37,7,12,19
35,2025-05-25T04:34:00+02:00,2025-05-25,12:34,22,42,64
35,2025-05-25T04:35:00+02:00,2025-05-25,12:35,20,38,58
35,2025-05-25T04:38:00+02:00,2025-05-25,12:38,10,20,30
35,2025-05-25T04:39:00+02:00,2025-05-25,12:39,16,23,39
48,2025-05-25T04:28:00+02:00,2025-05-25,12:28,9,1,10
49,2025-05-25T04:29:00+02:00,2025-05-25,12:29,20,13,33
49,2025-05-25T04:32:00+02:00,2025-05-25,12:32,13,10,23
49,2025-05-25T04:35:00+02:00,2025-05-25,12:35,9,22,31
49,2025-05-25T04:38:00+02:00,2025-05-25,12:38,2,8,10
51,2025-05-25T04:25:00+02:00,2025-05-25,12:25,1,1,2
51,2025-05-25T04:27:00+02:00,2025-05-25,12:27,4,0,4
51,2025-05-25T04:31:00+02:00,2025-05-25,12:31,9,29,38
51,2025-05-25T04:37:00+02:00,2025-05-25,12:37,8,1,9
51,2025-05-25T04:38:00+02:00,2025-05-25,12:38,3,8,11
52,2025-05-25T04:28:00+02:00,2025-05-25,12:28,8,6,14
52,2025-05-25T04:32:00+02:00,2025-05-25,12:32,3,3,6
52,2025-05-25T04:38:00+02:00,2025-05-25,12:38,4,2,6
53,2025-05-25T04:26:00+02:00,2025-05-25,12:26,10,6,16
53,2025-05-25T04:31:00+02:00,2025-05-25,12:31,10,7,17
53,2025-05-25T04:35:00+02:00,2025-05-25,12:35,18,7,25
53,2025-05-25T04:36:00+02:00,2025-05-25,12:36,11,8,19
53,2025-05-25T04:39:00+02:00,2025-05-25,12:39,31,16,47
56,2025-05-25T04:25:00+02:00,2025-05-25,12:25,5,1,6
56,2025-05-25T04:26:00+02:00,2025-05-25,12:26,5,6,11
56,2025-05-25T04:28:00+02:00,2025-05-25,12:28,7,6,13
56,2025-05-25T04:31:00+02:00,2025-05-25,12:31,9,3,12
56,2025-05-25T04:34:00+02:00,2025-05-25,12:34,9,5,14
56,2025-05-25T04:37:00+02:00,2025-05-25,12:37,1,14,15
56,2025-05-25T04:38:00+02:00,2025-05-25,12:38,13,8,21
58,2025-05-25T04:27:00+02:00,2025-05-25,12:27,12,14,26
58,2025-05-25T04:34:00+02:00,2025-05-25,12:34,3,6,9
58,2025-05-25T04:38:00+02:00,2025-05-25,12:38,11,4,15
62,2025-05-25T04:35:00+02:00,2025-05-25,12:35,2,5,7
63,2025-05-25T04:25:00+02:00,2025-05-25,12:25,6,5,11
63,2025-05-25T04:27:00+02:00,2025-05-25,12:27,3,4,7
63,2025-05-25T04:31:00+02:00,2025-05-25,12:31,7,5,12
63,2025-05-25T04:32:00+02:00,2025-05-25,12:32,2,7,9
63,2025-05-25T04:38:00+02:00,2025-05-25,12:38,12,14,26
67,2025-05-25T04:37:00+02:00,2025-05-25,12:37,6,7,13
67,2025-05-25T04:38:00+02:00,2025-05-25,12:38,13,7,20
68,2025-05-25T04:28:00+02:00,2025-05-25,12:28,6,5,11
68,2025-05-25T04:30:00+02:00,2025-05-25,12:30,9,9,18
68,2025-05-25T04:32:00+02:00,2025-05-25,12:32,2,1,3
68,2025-05-25T04:35:00+02:00,2025-05-25,12:35,18,4,22
68,2025-05-25T04:36:00+02:00,2025-05-25,12:36,3,2,5
68,2025-05-25T04:38:00+02:00,2025-05-25,12:38,4,1,5
72,2025-05-25T04:27:00+02:00,2025-05-25,12:27,0,22,22
72,2025-05-25T04:32:00+02:00,2025-05-25,12:32,6,9,15
72,2025-05-25T04:33:00+02:00,2025-05-25,12:33,7,2,9
76,2025-05-25T04:25:00+02:00,2025-05-25,12:25,4,0,4
76,2025-05-25T04:26:00+02:00,2025-05-25,12:26,1,1,2
76,2025-05-25T04:27:00+02:00,2025-05-25,12:27,3,0,3
76,2025-05-25T04:28:00+02:00,2025-05-25,12:28,1,0,1
76,2025-05-25T04:31:00+02:00,2025-05-25,12:31,1,2,3
76,2025-05-25T04:38:00+02:00,2025-05-25,12:38,0,1,1
79,2025-05-25T04:30:00+02:00,2025-05-25,12:30,18,10,28
79,2025-05-25T04:34:00+02:00,2025-05-25,12:34,3,7,10
79,2025-05-25T04:35:00+02:00,2025-05-25,12:35,13,15,28
79,2025-05-25T04:37:00+02:00,2025-05-25,12:37,28,3,31
85,2025-05-25T04:25:00+02:00,2025-05-25,12:25,3,2,5
85,2025-05-25T04:28:00+02:00,2025-05-25,12:28,1,3,4
85,2025-05-25T04:33:00+02:00,2025-05-25,12:33,0,3,3
85,2025-05-25T04:34:00+02:00,2025-05-25,12:34,3,1,4
85,2025-05-25T04:35:00+02:00,2025-05-25,12:35,0,2,2
85,2025-05-25T04:36:00+02:00,2025-05-25,12:36,2,0,2
85,2025-05-25T04:38:00+02:00,2025-05-25,12:38,2,0,2
86,2025-05-25T04:36:00+02:00,2025-05-25,12:36,0,1,1
86,2025-05-25T04:39:00+02:00,2025-05-25,12:39,0,1,1
117,2025-05-25T04:35:00+02:00,2025-05-25,12:35,12,23,35
123,2025-05-25T04:30:00+02:00,2025-05-25,12:30,8,2,10
130,2025-05-25T04:30:00+02:00,2025-05-25,12:30,4,0,4
137,2025-05-25T04:35:00+02:00,2025-05-25,12:35,0,2,2
139,2025-05-25T04:25:00+02:00,2025-05-25,12:25,10,3,13
139,2025-05-25T04:30:00+02:00,2025-05-25,12:30,4,1,5
142,2025-05-25T04:25:00+02:00,2025-05-25,12:25,60,45,105
142,2025-05-25T04:30:00+02:00,2025-05-25,12:30,58,60,118
142,2025-05-25T04:35:00+02:00,2025-05-25,12:35,62,72,134
181,2025-05-25T04:28:00+02:00,2025-05-25,12:28,10,27,37
181,2025-05-25T04:30:00+02:00,2025-05-25,12:30,11,11,22
181,2025-05-25T04:31:00+02:00,2025-05-25,12:31,17,12,29
181,2025-05-25T04:36:00+02:00,2025-05-25,12:36,9,15,24
181,2025-05-25T04:39:00+02:00,2025-05-25,12:39,3,8,11
180,2025-05-25T04:25:00+02:00,2025-05-25,12:25,1,2,3
180,2025-05-25T04:29:00+02:00,2025-05-25,12:29,1,2,3
180,2025-05-25T04:30:00+02:00,2025-05-25,12:30,2,0,2
180,2025-05-25T04:38:00+02:00,2025-05-25,12:38,1,0,1
3,2025-05-25T04:41:00+02:00,2025-05-25,12:41,6,29,35
3,2025-05-25T04:42:00+02:00,2025-05-25,12:42,12,27,39
3,2025-05-25T04:43:00+02:00,2025-05-25,12:43,23,28,51
3,2025-05-25T04:47:00+02:00,2025-05-25,12:47,12,12,24
3,2025-05-25T04:50:00+02:00,2025-05-25,12:50,13,30,43
3,2025-05-25T04:51:00+02:00,2025-05-25,12:51,18,47,65
3,2025-05-25T04:54:00+02:00,2025-05-25,12:54,29,20,49
4,2025-05-25T04:42:00+02:00,2025-05-25,12:42,46,24,70
4,2025-05-25T04:43:00+02:00,2025-05-25,12:43,54,12,66
4,2025-05-25T04:46:00+02:00,2025-05-25,12:46,34,16,50
4,2025-05-25T04:48:00+02:00,2025-05-25,12:48,30,21,51
4,2025-05-25T04:52:00+02:00,2025-05-25,12:52,35,20,55
4,2025-05-25T04:53:00+02:00,2025-05-25,12:53,42,36,78
5,2025-05-25T04:45:00+02:00,2025-05-25,12:45,40,65,105
5,2025-05-25T04:50:00+02:00,2025-05-25,12:50,113,80,193
6,2025-05-25T04:44:00+02:00,2025-05-25,12:44,7,9,16
6,2025-05-25T04:50:00+02:00,2025-05-25,12:50,14,24,38
6,2025-05-25T04:51:00+02:00,2025-05-25,12:51,7,8,15
6,2025-05-25T04:52:00+02:00,2025-05-25,12:52,15,9,24
8,2025-05-25T04:41:00+02:00,2025-05-25,12:41,3,13,16
8,2025-05-25T04:43:00+02:00,2025-05-25,12:43,4,3,7
8,2025-05-25T04:44:00+02:00,2025-05-25,12:44,2,5,7
8,2025-05-25T04:45:00+02:00,2025-05-25,12:45,3,0,3
28,2025-05-25T04:40:00+02:00,2025-05-25,12:40,3,11,14
28,2025-05-25T04:44:00+02:00,2025-05-25,12:44,8,3,11
28,2025-05-25T04:46:00+02:00,2025-05-25,12:46,8,8,16
28,2025-05-25T04:47:00+02:00,2025-05-25,12:47,13,9,22
28,2025-05-25T04:48:00+02:00,2025-05-25,12:48,0,31,31
28,2025-05-25T04:50:00+02:00,2025-05-25,12:50,8,22,30
28,2025-05-25T04:52:00+02:00,2025-05-25,12:52,15,12,27
29,2025-05-25T04:40:00+02:00,2025-05-25,12:40,7,16,23
29,2025-05-25T04:42:00+02:00,2025-05-25,12:42,7,11,18
29,2025-05-25T04:46:00+02:00,2025-05-25,12:46,9,5,14
29,2025-05-25T04:49:00+02:00,2025-05-25,12:49,10,9,19
29,2025-05-25T04:51:00+02:00,2025-05-25,12:51,5,7,12
29,2025-05-25T04:52:00+02:00,2025-05-25,12:52,10,12,22
29,2025-05-25T04:53:00+02:00,2025-05-25,12:53,9,19,28
31,2025-05-25T04:46:00+02:00,2025-05-25,12:46,0,7,7
31,2025-05-25T04:48:00+02:00,2025-05-25,12:48,10,2,12
31,2025-05-25T04:53:00+02:00,2025-05-25,12:53,4,9,13
36,2025-05-25T04:41:00+02:00,2025-05-25,12:41,1,3,4
36,2025-05-25T04:42:00+02:00,2025-05-25,12:42,1,0,1
39,2025-05-25T04:40:00+02:00,2025-05-25,12:40,3,0,3
39,2025-05-25T04:42:00+02:00,2025-05-25,12:42,0,4,4
39,2025-05-25T04:47:00+02:00,2025-05-25,12:47,0,1,1
40,2025-05-25T04:40:00+02:00,2025-05-25,12:40,1,8,9
40,2025-05-25T04:41:00+02:00,2025-05-25,12:41,1,6,7
40,2025-05-25T04:44:00+02:00,2025-05-25,12:44,0,5,5
40,2025-05-25T04:46:00+02:00,2025-05-25,12:46,0,8,8
40,2025-05-25T04:49:00+02:00,2025-05-25,12:49,3,2,5
41,2025-05-25T04:45:00+02:00,2025-05-25,12:45,1,0,1
41,2025-05-25T04:46:00+02:00,2025-05-25,12:46,6,4,10
41,2025-05-25T04:51:00+02:00,2025-05-25,12:51,2,6,8
41,2025-05-25T04:52:00+02:00,2025-05-25,12:52,5,21,26
41,2025-05-25T04:53:00+02:00,2025-05-25,12:53,10,3,13
44,2025-05-25T04:45:00+02:00,2025-05-25,12:45,10,8,18
45,2025-05-25T04:40:00+02:00,2025-05-25,12:40,23,10,33
45,2025-05-25T04:42:00+02:00,2025-05-25,12:42,14,17,31
45,2025-05-25T04:43:00+02:00,2025-05-25,12:43,17,14,31
45,2025-05-25T04:48:00+02:00,2025-05-25,12:48,24,25,49
45,2025-05-25T04:51:00+02:00,2025-05-25,12:51,26,20,46
45,2025-05-25T04:52:00+02:00,2025-05-25,12:52,47,17,64
45,2025-05-25T04:54:00+02:00,2025-05-25,12:54,30,26,56
47,2025-05-25T04:46:00+02:00,2025-05-25,12:46,15,14,29
47,2025-05-25T04:47:00+02:00,2025-05-25,12:47,17,20,37
50,2025-05-25T04:40:00+02:00,2025-05-25,12:40,2,5,7
50,2025-05-25T04:42:00+02:00,2025-05-25,12:42,5,8,13
50,2025-05-25T04:43:00+02:00,2025-05-25,12:43,2,9,11
50,2025-05-25T04:46:00+02:00,2025-05-25,12:46,0,8,8
50,2025-05-25T04:47:00+02:00,2025-05-25,12:47,5,8,13
50,2025-05-25T04:48:00+02:00,2025-05-25,12:48,9,4,13
50,2025-05-25T04:53:00+02:00,2025-05-25,12:53,1,3,4
54,2025-05-25T04:53:00+02:00,2025-05-25,12:53,1,0,1
54,2025-05-25T04:54:00+02:00,2025-05-25,12:54,2,4,6
59,2025-05-25T04:40:00+02:00,2025-05-25,12:40,25,31,56
61,2025-05-25T04:40:00+02:00,2025-05-25,12:40,6,9,15
61,2025-05-25T04:42:00+02:00,2025-05-25,12:42,12,5,17
61,2025-05-25T04:44:00+02:00,2025-05-25,12:44,12,10,22
61,2025-05-25T04:45:00+02:00,2025-05-25,12:45,9,11,20
61,2025-05-25T04:48:00+02:00,2025-05-25,12:48,12,14,26
66,2025-05-25T04:47:00+02:00,2025-05-25,12:47,15,20,35
69,2025-05-25T04:41:00+02:00,2025-05-25,12:41,3,1,4
69,2025-05-25T04:44:00+02:00,2025-05-25,12:44,1,7,8
69,2025-05-25T04:46:00+02:00,2025-05-25,12:46,1,2,3
69,2025-05-25T04:48:00+02:00,2025-05-25,12:48,4,0,4
69,2025-05-25T04:49:00+02:00,2025-05-25,12:49,8,1,9
69,2025-05-25T04:53:00+02:00,2025-05-25,12:53,4,5,9
70,2025-05-25T04:41:00+02:00,2025-05-25,12:41,4,4,8
70,2025-05-25T04:45:00+02:00,2025-05-25,12:45,1,0,1
70,2025-05-25T04:49:00+02:00,2025-05-25,12:49,4,10,14
70,2025-05-25T04:52:00+02:00,2025-05-25,12:52,1,2,3
70,2025-05-25T04:53:00+02:00,2025-05-25,12:53,1,2,3
70,2025-05-25T04:54:00+02:00,2025-05-25,12:54,1,7,8
75,2025-05-25T04:41:00+02:00,2025-05-25,12:41,0,1,1
75,2025-05-25T04:44:00+02:00,2025-05-25,12:44,1,0,1
75,2025-05-25T04:45:00+02:00,2025-05-25,12:45,0,2,2
75,2025-05-25T04:50:00+02:00,2025-05-25,12:50,1,0,1
78,2025-05-25T04:40:00+02:00,2025-05-25,12:40,2,0,2
78,2025-05-25T04:42:00+02:00,2025-05-25,12:42,1,0,1
78,2025-05-25T04:47:00+02:00,2025-05-25,12:47,2,2,4
78,2025-05-25T04:49:00+02:00,2025-05-25,12:49,0,4,4
78,2025-05-25T04:50:00+02:00,2025-05-25,12:50,2,1,3
78,2025-05-25T04:52:00+02:00,2025-05-25,12:52,1,6,7
78,2025-05-25T04:54:00+02:00,2025-05-25,12:54,2,1,3
84,2025-05-25T04:50:00+02:00,2025-05-25,12:50,97,66,163
87,2025-05-25T04:41:00+02:00,2025-05-25,12:41,9,1,10
87,2025-05-25T04:45:00+02:00,2025-05-25,12:45,0,1,1
87,2025-05-25T04:46:00+02:00,2025-05-25,12:46,1,0,1
87,2025-05-25T04:48:00+02:00,2025-05-25,12:48,2,3,5
87,2025-05-25T04:52:00+02:00,2025-05-25,12:52,2,2,4
108,2025-05-25T04:46:00+02:00,2025-05-25,12:46,3,1,4
118,2025-05-25T04:45:00+02:00,2025-05-25,12:45,0,2,2
131,2025-05-25T04:45:00+02:00,2025-05-25,12:45,15,17,32
131,2025-05-25T04:50:00+02:00,2025-05-25,12:50,13,12,25
132,2025-05-25T04:40:00+02:00,2025-05-25,12:40,14,9,23
132,2025-05-25T04:45:00+02:00,2025-05-25,12:45,11,5,16
132,2025-05-25T04:50:00+02:00,2025-05-25,12:50,19,12,31
133,2025-05-25T04:40:00+02:00,2025-05-25,12:40,24,48,72
133,2025-05-25T04:50:00+02:00,2025-05-25,12:50,46,45,91
134,2025-05-25T04:40:00+02:00,2025-05-25,12:40,37,31,68
135,2025-05-25T04:40:00+02:00,2025-05-25,12:40,45,26,71
135,2025-05-25T04:45:00+02:00,2025-05-25,12:45,29,43,72
140,2025-05-25T04:50:00+02:00,2025-05-25,12:50,6,2,8
162,2025-05-25T04:40:00+02:00,2025-05-25,12:40,72,85,157
162,2025-05-25T04:50:00+02:00,2025-05-25,12:50,73,59,132
165,2025-05-25T04:45:00+02:00,2025-05-25,12:45,3,2,5
165,2025-05-25T04:50:00+02:00,2025-05-25,12:50,1,3,4
166,2025-05-25T04:50:00+02:00,2025-05-25,12:50,7,2,9
1,2025-05-25T04:40:00+02:00,2025-05-25,12:40,35,30,65
1,2025-05-25T04:41:00+02:00,2025-05-25,12:41,28,21,49
1,2025-05-25T04:44:00+02:00,2025-05-25,12:44,21,15,36
1,2025-05-25T04:47:00+02:00,2025-05-25,12:47,18,27,45
2,2025-05-25T04:45:00+02:00,2025-05-25,12:45,20,10,30
2,2025-05-25T04:46:00+02:00,2025-05-25,12:46,9,35,44
2,2025-05-25T04:48:00+02:00,2025-05-25,12:48,10,8,18
2,2025-05-25T04:50:00+02:00,2025-05-25,12:50,7,20,27
2,2025-05-25T04:52:00+02:00,2025-05-25,12:52,10,7,17
2,2025-05-25T04:53:00+02:00,2025-05-25,12:53,5,15,20
2,2025-05-25T04:54:00+02:00,2025-05-25,12:54,10,15,25
9,2025-05-25T04:42:00+02:00,2025-05-25,12:42,0,1,1
9,2025-05-25T04:46:00+02:00,2025-05-25,12:46,3,3,6
9,2025-05-25T04:47:00+02:00,2025-05-25,12:47,4,1,5
9,2025-05-25T04:48:00+02:00,2025-05-25,12:48,2,0,2
9,2025-05-25T04:49:00+02:00,2025-05-25,12:49,1,1,2
9,2025-05-25T04:50:00+02:00,2025-05-25,12:50,3,0,3
9,2025-05-25T04:51:00+02:00,2025-05-25,12:51,1,0,1
9,2025-05-25T04:53:00+02:00,2025-05-25,12:53,1,2,3
9,2025-05-25T04:54:00+02:00,2025-05-25,12:54,0,2,2
10,2025-05-25T04:42:00+02:00,2025-05-25,12:42,3,0,3
10,2025-05-25T04:47:00+02:00,2025-05-25,12:47,1,3,4
10,2025-05-25T04:48:00+02:00,2025-05-25,12:48,3,0,3
10,2025-05-25T04:51:00+02:00,2025-05-25,12:51,0,2,2
11,2025-05-25T04:42:00+02:00,2025-05-25,12:42,2,0,2
11,2025-05-25T04:45:00+02:00,2025-05-25,12:45,4,4,8
12,2025-05-25T04:45:00+02:00,2025-05-25,12:45,3,8,11
12,2025-05-25T04:46:00+02:00,2025-05-25,12:46,2,11,13
12,2025-05-25T04:48:00+02:00,2025-05-25,12:48,4,6,10
12,2025-05-25T04:50:00+02:00,2025-05-25,12:50,5,3,8
12,2025-05-25T04:52:00+02:00,2025-05-25,12:52,2,5,7
12,2025-05-25T04:54:00+02:00,2025-05-25,12:54,0,1,1
17,2025-05-25T04:40:00+02:00,2025-05-25,12:40,7,0,7
17,2025-05-25T04:49:00+02:00,2025-05-25,12:49,2,2,4
17,2025-05-25T04:52:00+02:00,2025-05-25,12:52,2,0,2
18,2025-05-25T04:41:00+02:00,2025-05-25,12:41,2,0,2
18,2025-05-25T04:44:00+02:00,2025-05-25,12:44,0,1,1
18,2025-05-25T04:51:00+02:00,2025-05-25,12:51,1,1,2
19,2025-05-25T04:40:00+02:00,2025-05-25,12:40,8,6,14
19,2025-05-25T04:42:00+02:00,2025-05-25,12:42,13,32,45
19,2025-05-25T04:43:00+02:00,2025-05-25,12:43,9,18,27
19,2025-05-25T04:44:00+02:00,2025-05-25,12:44,12,7,19
19,2025-05-25T04:51:00+02:00,2025-05-25,12:51,11,9,20
19,2025-05-25T04:52:00+02:00,2025-05-25,12:52,6,4,10
20,2025-05-25T04:45:00+02:00,2025-05-25,12:45,14,0,14
20,2025-05-25T04:46:00+02:00,2025-05-25,12:46,0,8,8
20,2025-05-25T04:51:00+02:00,2025-05-25,12:51,7,1,8
20,2025-05-25T04:53:00+02:00,2025-05-25,12:53,7,18,25
23,2025-05-25T04:41:00+02:00,2025-05-25,12:41,2,0,2
23,2025-05-25T04:46:00+02:00,2025-05-25,12:46,4,0,4
23,2025-05-25T04:48:00+02:00,2025-05-25,12:48,0,5,5
23,2025-05-25T04:49:00+02:00,2025-05-25,12:49,3,12,15
24,2025-05-25T04:40:00+02:00,2025-05-25,12:40,9,8,17
24,2025-05-25T04:47:00+02:00,2025-05-25,12:47,8,8,16
25,2025-05-25T04:40:00+02:00,2025-05-25,12:40,72,86,158
25,2025-05-25T04:50:00+02:00,2025-05-25,12:50,82,67,149
27,2025-05-25T04:40:00+02:00,2025-05-25,12:40,8,1,9
27,2025-05-25T04:42:00+02:00,2025-05-25,12:42,5,3,8
27,2025-05-25T04:46:00+02:00,2025-05-25,12:46,7,9,16
27,2025-05-25T04:52:00+02:00,2025-05-25,12:52,7,3,10
27,2025-05-25T04:53:00+02:00,2025-05-25,12:53,1,1,2
30,2025-05-25T04:40:00+02:00,2025-05-25,12:40,7,6,13
30,2025-05-25T04:41:00+02:00,2025-05-25,12:41,10,11,21
30,2025-05-25T04:42:00+02:00,2025-05-25,12:42,5,14,19
30,2025-05-25T04:46:00+02:00,2025-05-25,12:46,2,3,5
30,2025-05-25T04:47:00+02:00,2025-05-25,12:47,3,18,21
30,2025-05-25T04:48:00+02:00,2025-05-25,12:48,5,9,14
30,2025-05-25T04:49:00+02:00,2025-05-25,12:49,6,8,14
30,2025-05-25T04:51:00+02:00,2025-05-25,12:51,4,10,14
30,2025-05-25T04:52:00+02:00,2025-05-25,12:52,6,7,13
30,2025-05-25T04:53:00+02:00,2025-05-25,12:53,1,16,17
30,2025-05-25T04:54:00+02:00,2025-05-25,12:54,6,7,13
35,2025-05-25T04:43:00+02:00,2025-05-25,12:43,17,29,46
35,2025-05-25T04:44:00+02:00,2025-05-25,12:44,20,24,44
35,2025-05-25T04:47:00+02:00,2025-05-25,12:47,18,35,53
35,2025-05-25T04:50:00+02:00,2025-05-25,12:50,22,28,50
35,2025-05-25T04:51:00+02:00,2025-05-25,12:51,20,14,34
35,2025-05-25T04:54:00+02:00,2025-05-25,12:54,28,19,47
46,2025-05-25T04:45:00+02:00,2025-05-25,12:45,4,6,10
46,2025-05-25T04:50:00+02:00,2025-05-25,12:50,7,3,10
48,2025-05-25T04:40:00+02:00,2025-05-25,12:40,11,17,28
48,2025-05-25T04:44:00+02:00,2025-05-25,12:44,11,14,25
48,2025-05-25T04:45:00+02:00,2025-05-25,12:45,1,13,14
48,2025-05-25T04:47:00+02:00,2025-05-25,12:47,14,4,18
48,2025-05-25T04:52:00+02:00,2025-05-25,12:52,11,13,24
49,2025-05-25T04:40:00+02:00,2025-05-25,12:40,5,9,14
49,2025-05-25T04:43:00+02:00,2025-05-25,12:43,17,11,28
49,2025-05-25T04:45:00+02:00,2025-05-25,12:45,2,19,21
49,2025-05-25T04:46:00+02:00,2025-05-25,12:46,13,4,17
49,2025-05-25T04:48:00+02:00,2025-05-25,12:48,12,7,19
49,2025-05-25T04:49:00+02:00,2025-05-25,12:49,11,18,29
49,2025-05-25T04:51:00+02:00,2025-05-25,12:51,15,15,30
51,2025-05-25T04:40:00+02:00,2025-05-25,12:40,4,4,8
51,2025-05-25T04:42:00+02:00,2025-05-25,12:42,1,1,2
51,2025-05-25T04:49:00+02:00,2025-05-25,12:49,5,3,8
52,2025-05-25T04:41:00+02:00,2025-05-25,12:41,0,3,3
52,2025-05-25T04:42:00+02:00,2025-05-25,12:42,7,9,16
52,2025-05-25T04:50:00+02:00,2025-05-25,12:50,10,3,13
52,2025-05-25T04:52:00+02:00,2025-05-25,12:52,14,2,16
52,2025-05-25T04:53:00+02:00,2025-05-25,12:53,20,6,26
53,2025-05-25T04:40:00+02:00,2025-05-25,12:40,13,5,18
53,2025-05-25T04:43:00+02:00,2025-05-25,12:43,5,7,12
53,2025-05-25T04:49:00+02:00,2025-05-25,12:49,15,4,19
53,2025-05-25T04:51:00+02:00,2025-05-25,12:51,15,8,23
53,2025-05-25T04:54:00+02:00,2025-05-25,12:54,17,7,24
56,2025-05-25T04:41:00+02:00,2025-05-25,12:41,11,6,17
56,2025-05-25T04:43:00+02:00,2025-05-25,12:43,7,3,10
56,2025-05-25T04:44:00+02:00,2025-05-25,12:44,10,11,21
56,2025-05-25T04:45:00+02:00,2025-05-25,12:45,7,6,13
56,2025-05-25T04:46:00+02:00,2025-05-25,12:46,11,14,25
56,2025-05-25T04:48:00+02:00,2025-05-25,12:48,8,6,14
56,2025-05-25T04:49:00+02:00,2025-05-25,12:49,5,12,17
56,2025-05-25T04:51:00+02:00,2025-05-25,12:51,8,1,9
56,2025-05-25T04:52:00+02:00,2025-05-25,12:52,11,4,15
56,2025-05-25T04:54:00+02:00,2025-05-25,12:54,8,2,10
58,2025-05-25T04:40:00+02:00,2025-05-25,12:40,14,5,19
58,2025-05-25T04:42:00+02:00,2025-05-25,12:42,11,3,14
58,2025-05-25T04:43:00+02:00,2025-05-25,12:43,6,3,9
58,2025-05-25T04:44:00+02:00,2025-05-25,12:44,18,9,27
58,2025-05-25T04:45:00+02:00,2025-05-25,12:45,11,7,18
58,2025-05-25T04:50:00+02:00,2025-05-25,12:50,4,4,8
58,2025-05-25T04:53:00+02:00,2025-05-25,12:53,20,5,25
62,2025-05-25T04:40:00+02:00,2025-05-25,12:40,1,1,2
62,2025-05-25T04:43:00+02:00,2025-05-25,12:43,0,2,2
62,2025-05-25T04:51:00+02:00,2025-05-25,12:51,1,8,9
62,2025-05-25T04:53:00+02:00,2025-05-25,12:53,3,0,3
63,2025-05-25T04:42:00+02:00,2025-05-25,12:42,10,6,16
63,2025-05-25T04:45:00+02:00,2025-05-25,12:45,6,4,10
63,2025-05-25T04:47:00+02:00,2025-05-25,12:47,10,5,15
67,2025-05-25T04:40:00+02:00,2025-05-25,12:40,2,4,6
67,2025-05-25T04:46:00+02:00,2025-05-25,12:46,4,10,14
67,2025-05-25T04:49:00+02:00,2025-05-25,12:49,3,3,6
67,2025-05-25T04:52:00+02:00,2025-05-25,12:52,5,5,10
68,2025-05-25T04:41:00+02:00,2025-05-25,12:41,12,6,18
68,2025-05-25T04:48:00+02:00,2025-05-25,12:48,5,2,7
68,2025-05-25T04:54:00+02:00,2025-05-25,12:54,4,5,9
72,2025-05-25T04:41:00+02:00,2025-05-25,12:41,7,7,14
72,2025-05-25T04:44:00+02:00,2025-05-25,12:44,4,5,9
72,2025-05-25T04:52:00+02:00,2025-05-25,12:52,6,5,11
72,2025-05-25T04:53:00+02:00,2025-05-25,12:53,8,2,10
72,2025-05-25T04:54:00+02:00,2025-05-25,12:54,5,4,9
76,2025-05-25T04:41:00+02:00,2025-05-25,12:41,4,2,6
76,2025-05-25T04:52:00+02:00,2025-05-25,12:52,1,0,1
79,2025-05-25T04:40:00+02:00,2025-05-25,12:40,11,7,18
79,2025-05-25T04:42:00+02:00,2025-05-25,12:42,13,18,31
79,2025-05-25T04:43:00+02:00,2025-05-25,12:43,7,4,11
79,2025-05-25T04:44:00+02:00,2025-05-25,12:44,8,4,12
79,2025-05-25T04:45:00+02:00,2025-05-25,12:45,34,7,41
79,2025-05-25T04:46:00+02:00,2025-05-25,12:46,9,7,16
79,2025-05-25T04:48:00+02:00,2025-05-25,12:48,36,13,49
79,2025-05-25T04:52:00+02:00,2025-05-25,12:52,11,11,22
79,2025-05-25T04:54:00+02:00,2025-05-25,12:54,7,10,17
85,2025-05-25T04:44:00+02:00,2025-05-25,12:44,2,0,2
85,2025-05-25T04:45:00+02:00,2025-05-25,12:45,1,1,2
85,2025-05-25T04:53:00+02:00,2025-05-25,12:53,1,1,2
86,2025-05-25T04:41:00+02:00,2025-05-25,12:41,1,0,1
86,2025-05-25T04:43:00+02:00,2025-05-25,12:43,1,2,3
86,2025-05-25T04:49:00+02:00,2025-05-25,12:49,0,1,1
86,2025-05-25T04:51:00+02:00,2025-05-25,12:51,1,0,1
109,2025-05-25T04:45:00+02:00,2025-05-25,12:45,6,6,12
117,2025-05-25T04:45:00+02:00,2025-05-25,12:45,14,16,30
117,2025-05-25T04:50:00+02:00,2025-05-25,12:50,9,8,17
123,2025-05-25T04:50:00+02:00,2025-05-25,12:50,6,3,9
136,2025-05-25T04:45:00+02:00,2025-05-25,12:45,38,5,43
136,2025-05-25T04:50:00+02:00,2025-05-25,12:50,28,6,34
141,2025-05-25T04:45:00+02:00,2025-05-25,12:45,8,12,20
141,2025-05-25T04:50:00+02:00,2025-05-25,12:50,9,9,18
142,2025-05-25T04:40:00+02:00,2025-05-25,12:40,38,48,86
142,2025-05-25T04:50:00+02:00,2025-05-25,12:50,61,41,102
161,2025-05-25T04:45:00+02:00,2025-05-25,12:45,49,14,63
161,2025-05-25T04:50:00+02:00,2025-05-25,12:50,25,23,48
164,2025-05-25T04:45:00+02:00,2025-05-25,12:45,5,6,11
164,2025-05-25T04:50:00+02:00,2025-05-25,12:50,13,23,36
181,2025-05-25T04:40:00+02:00,2025-05-25,12:40,11,29,40
181,2025-05-25T04:41:00+02:00,2025-05-25,12:41,14,28,42
181,2025-05-25T04:46:00+02:00,2025-05-25,12:46,15,26,41
181,2025-05-25T04:48:00+02:00,2025-05-25,12:48,11,26,37
181,2025-05-25T04:49:00+02:00,2025-05-25,12:49,14,21,35
181,2025-05-25T04:51:00+02:00,2025-05-25,12:51,25,18,43
181,2025-05-25T04:53:00+02:00,2025-05-25,12:53,5,25,30
181,2025-05-25T04:54:00+02:00,2025-05-25,12:54,14,16,30
180,2025-05-25T04:43:00+02:00,2025-05-25,12:43,1,2,3
180,2025-05-25T04:44:00+02:00,2025-05-25,12:44,1,4,5
180,2025-05-25T04:45:00+02:00,2025-05-25,12:45,1,1,2
180,2025-05-25T04:48:00+02:00,2025-05-25,12:48,1,0,1
3,2025-05-24T19:45:00+02:00,2025-05-25,03:45,2,0,2
3,2025-05-24T19:48:00+02:00,2025-05-25,03:48,2,0,2
3,2025-05-24T19:50:00+02:00,2025-05-25,03:50,0,3,3
3,2025-05-24T19:52:00+02:00,2025-05-25,03:52,0,1,1
4,2025-05-24T19:42:00+02:00,2025-05-25,03:42,2,1,3
4,2025-05-24T19:43:00+02:00,2025-05-25,03:43,0,1,1
4,2025-05-24T19:47:00+02:00,2025-05-25,03:47,1,2,3
4,2025-05-24T19:49:00+02:00,2025-05-25,03:49,3,0,3
4,2025-05-24T19:51:00+02:00,2025-05-25,03:51,0,1,1
4,2025-05-24T19:53:00+02:00,2025-05-25,03:53,0,3,3
6,2025-05-24T19:42:00+02:00,2025-05-25,03:42,1,7,8
6,2025-05-24T19:45:00+02:00,2025-05-25,03:45,2,0,2
8,2025-05-24T19:40:00+02:00,2025-05-25,03:40,1,0,1
28,2025-05-24T19:43:00+02:00,2025-05-25,03:43,1,0,1
29,2025-05-24T19:43:00+02:00,2025-05-25,03:43,0,1,1
31,2025-05-24T19:40:00+02:00,2025-05-25,03:40,1,0,1
31,2025-05-24T19:47:00+02:00,2025-05-25,03:47,1,0,1
36,2025-05-24T19:41:00+02:00,2025-05-25,03:41,0,4,4
36,2025-05-24T19:52:00+02:00,2025-05-25,03:52,1,3,4
36,2025-05-24T19:53:00+02:00,2025-05-25,03:53,0,5,5
36,2025-05-24T19:54:00+02:00,2025-05-25,03:54,2,6,8
37,2025-05-24T19:50:00+02:00,2025-05-25,03:50,0,2,2
37,2025-05-24T19:51:00+02:00,2025-05-25,03:51,3,0,3
41,2025-05-24T19:44:00+02:00,2025-05-25,03:44,0,1,1
41,2025-05-24T19:45:00+02:00,2025-05-25,03:45,0,2,2
41,2025-05-24T19:46:00+02:00,2025-05-25,03:46,2,0,2
41,2025-05-24T19:47:00+02:00,2025-05-25,03:47,0,3,3
41,2025-05-24T19:52:00+02:00,2025-05-25,03:52,1,10,11
45,2025-05-24T19:43:00+02:00,2025-05-25,03:43,2,4,6
45,2025-05-24T19:50:00+02:00,2025-05-25,03:50,0,1,1
47,2025-05-24T19:41:00+02:00,2025-05-25,03:41,0,1,1
47,2025-05-24T19:44:00+02:00,2025-05-25,03:44,0,5,5
47,2025-05-24T19:48:00+02:00,2025-05-25,03:48,5,1,6
47,2025-05-24T19:52:00+02:00,2025-05-25,03:52,0,3,3
47,2025-05-24T19:53:00+02:00,2025-05-25,03:53,1,0,1
47,2025-05-24T19:54:00+02:00,2025-05-25,03:54,2,2,4
50,2025-05-24T19:40:00+02:00,2025-05-25,03:40,5,0,5
50,2025-05-24T19:54:00+02:00,2025-05-25,03:54,1,0,1
54,2025-05-24T19:40:00+02:00,2025-05-25,03:40,0,1,1
59,2025-05-24T19:50:00+02:00,2025-05-25,03:50,4,1,5
61,2025-05-24T19:44:00+02:00,2025-05-25,03:44,1,0,1
66,2025-05-24T19:42:00+02:00,2025-05-25,03:42,1,0,1
66,2025-05-24T19:44:00+02:00,2025-05-25,03:44,0,3,3
70,2025-05-24T19:49:00+02:00,2025-05-25,03:49,1,0,1
78,2025-05-24T19:51:00+02:00,2025-05-25,03:51,0,2,2
107,2025-05-24T19:50:00+02:00,2025-05-25,03:50,2,0,2
108,2025-05-24T19:53:00+02:00,2025-05-25,03:53,0,1,1
108,2025-05-24T19:54:00+02:00,2025-05-25,03:54,4,0,4
131,2025-05-24T19:40:00+02:00,2025-05-25,03:40,2,5,7
132,2025-05-24T19:50:00+02:00,2025-05-25,03:50,0,1,1
134,2025-05-24T19:45:00+02:00,2025-05-25,03:45,1,2,3
135,2025-05-24T19:45:00+02:00,2025-05-25,03:45,6,6,12
179,2025-05-24T19:50:00+02:00,2025-05-25,03:50,3,0,3
2,2025-05-24T19:42:00+02:00,2025-05-25,03:42,0,3,3
2,2025-05-24T19:50:00+02:00,2025-05-25,03:50,0,2,2
19,2025-05-24T19:41:00+02:00,2025-05-25,03:41,7,0,7
19,2025-05-24T19:42:00+02:00,2025-05-25,03:42,0,7,7
19,2025-05-24T19:49:00+02:00,2025-05-25,03:49,0,2,2
19,2025-05-24T19:52:00+02:00,2025-05-25,03:52,0,2,2
20,2025-05-24T19:47:00+02:00,2025-05-25,03:47,0,2,2
23,2025-05-24T19:43:00+02:00,2025-05-25,03:43,0,4,4
24,2025-05-24T19:40:00+02:00,2025-05-25,03:40,1,0,1
24,2025-05-24T19:41:00+02:00,2025-05-25,03:41,1,0,1
24,2025-05-24T19:53:00+02:00,2025-05-25,03:53,1,1,2
30,2025-05-24T19:40:00+02:00,2025-05-25,03:40,0,3,3
30,2025-05-24T19:42:00+02:00,2025-05-25,03:42,3,0,3
30,2025-05-24T19:47:00+02:00,2025-05-25,03:47,4,2,6
30,2025-05-24T19:51:00+02:00,2025-05-25,03:51,2,4,6
30,2025-05-24T19:53:00+02:00,2025-05-25,03:53,1,1,2
35,2025-05-24T19:44:00+02:00,2025-05-25,03:44,1,1,2
49,2025-05-24T19:53:00+02:00,2025-05-25,03:53,7,0,7
51,2025-05-24T19:41:00+02:00,2025-05-25,03:41,3,0,3
51,2025-05-24T19:47:00+02:00,2025-05-25,03:47,1,0,1
52,2025-05-24T19:46:00+02:00,2025-05-25,03:46,2,1,3
53,2025-05-24T19:43:00+02:00,2025-05-25,03:43,1,0,1
56,2025-05-24T19:52:00+02:00,2025-05-25,03:52,0,2,2
58,2025-05-24T19:46:00+02:00,2025-05-25,03:46,1,0,1
58,2025-05-24T19:54:00+02:00,2025-05-25,03:54,2,1,3
62,2025-05-24T19:43:00+02:00,2025-05-25,03:43,4,0,4
62,2025-05-24T19:48:00+02:00,2025-05-25,03:48,2,0,2
62,2025-05-24T19:52:00+02:00,2025-05-25,03:52,0,1,1
62,2025-05-24T19:54:00+02:00,2025-05-25,03:54,1,0,1
63,2025-05-24T19:52:00+02:00,2025-05-25,03:52,1,0,1
67,2025-05-24T19:52:00+02:00,2025-05-25,03:52,0,3,3
79,2025-05-24T19:41:00+02:00,2025-05-25,03:41,0,1,1
109,2025-05-24T19:40:00+02:00,2025-05-25,03:40,1,2,3
109,2025-05-24T19:45:00+02:00,2025-05-25,03:45,0,2,2
141,2025-05-24T19:40:00+02:00,2025-05-25,03:40,7,3,10
142,2025-05-24T19:50:00+02:00,2025-05-25,03:50,0,1,1
181,2025-05-24T20:01:00+02:00,2025-05-25,04:01,2,8,10
181,2025-05-24T20:02:00+02:00,2025-05-25,04:02,0,7,7
181,2025-05-24T20:09:00+02:00,2025-05-25,04:09,0,1,1
3,2025-05-24T19:55:00+02:00,2025-05-25,03:55,3,2,5
3,2025-05-24T19:57:00+02:00,2025-05-25,03:57,0,2,2
3,2025-05-24T20:04:00+02:00,2025-05-25,04:04,8,0,8
3,2025-05-24T20:09:00+02:00,2025-05-25,04:09,2,1,3
4,2025-05-24T19:58:00+02:00,2025-05-25,03:58,1,1,2
4,2025-05-24T20:01:00+02:00,2025-05-25,04:01,0,2,2
6,2025-05-24T20:02:00+02:00,2025-05-25,04:02,3,1,4
6,2025-05-24T20:03:00+02:00,2025-05-25,04:03,0,1,1
28,2025-05-24T20:03:00+02:00,2025-05-25,04:03,2,0,2
28,2025-05-24T20:04:00+02:00,2025-05-25,04:04,1,0,1
36,2025-05-24T19:56:00+02:00,2025-05-25,03:56,0,2,2
36,2025-05-24T19:58:00+02:00,2025-05-25,03:58,0,4,4
36,2025-05-24T19:59:00+02:00,2025-05-25,03:59,2,2,4
36,2025-05-24T20:04:00+02:00,2025-05-25,04:04,1,10,11
37,2025-05-24T20:00:00+02:00,2025-05-25,04:00,1,0,1
41,2025-05-24T20:03:00+02:00,2025-05-25,04:03,0,1,1
41,2025-05-24T20:05:00+02:00,2025-05-25,04:05,0,2,2
41,2025-05-24T20:08:00+02:00,2025-05-25,04:08,0,1,1
45,2025-05-24T20:02:00+02:00,2025-05-25,04:02,0,2,2
45,2025-05-24T20:05:00+02:00,2025-05-25,04:05,0,1,1
47,2025-05-24T19:56:00+02:00,2025-05-25,03:56,1,0,1
47,2025-05-24T20:04:00+02:00,2025-05-25,04:04,3,1,4
47,2025-05-24T20:05:00+02:00,2025-05-25,04:05,1,1,2
47,2025-05-24T20:07:00+02:00,2025-05-25,04:07,0,2,2
47,2025-05-24T20:08:00+02:00,2025-05-25,04:08,1,0,1
47,2025-05-24T20:09:00+02:00,2025-05-25,04:09,2,0,2
54,2025-05-24T20:08:00+02:00,2025-05-25,04:08,1,0,1
59,2025-05-24T19:55:00+02:00,2025-05-25,03:55,1,3,4
61,2025-05-24T20:02:00+02:00,2025-05-25,04:02,5,0,5
61,2025-05-24T20:06:00+02:00,2025-05-25,04:06,1,2,3
66,2025-05-24T19:55:00+02:00,2025-05-25,03:55,0,1,1
66,2025-05-24T20:07:00+02:00,2025-05-25,04:07,2,0,2
84,2025-05-24T20:00:00+02:00,2025-05-25,04:00,2,9,11
107,2025-05-24T19:55:00+02:00,2025-05-25,03:55,1,0,1
107,2025-05-24T20:05:00+02:00,2025-05-25,04:05,1,0,1
108,2025-05-24T19:57:00+02:00,2025-05-25,03:57,2,0,2
108,2025-05-24T20:06:00+02:00,2025-05-25,04:06,1,0,1
131,2025-05-24T20:05:00+02:00,2025-05-25,04:05,1,3,4
132,2025-05-24T20:05:00+02:00,2025-05-25,04:05,1,0,1
133,2025-05-24T20:05:00+02:00,2025-05-25,04:05,6,1,7
134,2025-05-24T19:55:00+02:00,2025-05-25,03:55,11,1,12
162,2025-05-24T19:55:00+02:00,2025-05-25,03:55,3,1,4
162,2025-05-24T20:05:00+02:00,2025-05-25,04:05,1,4,5
165,2025-05-24T20:05:00+02:00,2025-05-25,04:05,1,0,1
1,2025-05-24T20:02:00+02:00,2025-05-25,04:02,0,3,3
1,2025-05-24T20:09:00+02:00,2025-05-25,04:09,0,1,1
9,2025-05-24T20:09:00+02:00,2025-05-25,04:09,1,2,3
10,2025-05-24T19:59:00+02:00,2025-05-25,03:59,3,0,3
12,2025-05-24T20:06:00+02:00,2025-05-25,04:06,0,1,1
20,2025-05-24T19:59:00+02:00,2025-05-25,03:59,1,0,1
20,2025-05-24T20:02:00+02:00,2025-05-25,04:02,1,1,2
20,2025-05-24T20:09:00+02:00,2025-05-25,04:09,1,0,1
23,2025-05-24T19:55:00+02:00,2025-05-25,03:55,0,1,1
24,2025-05-24T19:57:00+02:00,2025-05-25,03:57,0,1,1
24,2025-05-24T19:59:00+02:00,2025-05-25,03:59,6,3,9
24,2025-05-24T20:03:00+02:00,2025-05-25,04:03,4,2,6
25,2025-05-24T20:00:00+02:00,2025-05-25,04:00,0,4,4
27,2025-05-24T20:02:00+02:00,2025-05-25,04:02,1,0,1
30,2025-05-24T20:01:00+02:00,2025-05-25,04:01,2,2,4
30,2025-05-24T20:02:00+02:00,2025-05-25,04:02,3,1,4
30,2025-05-24T20:04:00+02:00,2025-05-25,04:04,0,3,3
30,2025-05-24T20:06:00+02:00,2025-05-25,04:06,2,6,8
35,2025-05-24T19:55:00+02:00,2025-05-25,03:55,1,1,2
35,2025-05-24T19:58:00+02:00,2025-05-25,03:58,7,0,7
35,2025-05-24T19:59:00+02:00,2025-05-25,03:59,0,1,1
35,2025-05-24T20:06:00+02:00,2025-05-25,04:06,1,0,1
35,2025-05-24T20:07:00+02:00,2025-05-25,04:07,0,1,1
35,2025-05-24T20:08:00+02:00,2025-05-25,04:08,0,1,1
49,2025-05-24T19:55:00+02:00,2025-05-25,03:55,4,2,6
49,2025-05-24T20:00:00+02:00,2025-05-25,04:00,8,1,9
51,2025-05-24T19:57:00+02:00,2025-05-25,03:57,2,0,2
52,2025-05-24T20:00:00+02:00,2025-05-25,04:00,1,0,1
52,2025-05-24T20:03:00+02:00,2025-05-25,04:03,1,1,2
52,2025-05-24T20:04:00+02:00,2025-05-25,04:04,9,0,9
52,2025-05-24T20:06:00+02:00,2025-05-25,04:06,2,0,2
52,2025-05-24T20:07:00+02:00,2025-05-25,04:07,12,0,12
52,2025-05-24T20:08:00+02:00,2025-05-25,04:08,4,0,4
53,2025-05-24T20:03:00+02:00,2025-05-25,04:03,1,1,2
53,2025-05-24T20:04:00+02:00,2025-05-25,04:04,3,0,3
56,2025-05-24T19:56:00+02:00,2025-05-25,03:56,0,3,3
58,2025-05-24T19:56:00+02:00,2025-05-25,03:56,0,1,1
67,2025-05-24T20:05:00+02:00,2025-05-25,04:05,0,1,1
72,2025-05-24T20:01:00+02:00,2025-05-25,04:01,0,3,3
79,2025-05-24T19:57:00+02:00,2025-05-25,03:57,1,2,3
79,2025-05-24T19:59:00+02:00,2025-05-25,03:59,2,5,7
79,2025-05-24T20:03:00+02:00,2025-05-25,04:03,0,1,1
117,2025-05-24T20:05:00+02:00,2025-05-25,04:05,0,1,1
141,2025-05-24T20:00:00+02:00,2025-05-25,04:00,6,3,9
181,2025-05-24T20:12:00+02:00,2025-05-25,04:12,2,4,6
181,2025-05-24T20:13:00+02:00,2025-05-25,04:13,0,3,3
181,2025-05-24T20:15:00+02:00,2025-05-25,04:15,3,0,3
181,2025-05-24T20:19:00+02:00,2025-05-25,04:19,0,2,2
181,2025-05-24T20:23:00+02:00,2025-05-25,04:23,3,4,7
182,2025-05-24T20:15:00+02:00,2025-05-25,04:15,1,6,7
3,2025-05-24T20:12:00+02:00,2025-05-25,04:12,1,0,1
4,2025-05-24T20:18:00+02:00,2025-05-25,04:18,3,1,4
4,2025-05-24T20:20:00+02:00,2025-05-25,04:20,6,0,6
6,2025-05-24T20:13:00+02:00,2025-05-25,04:13,0,1,1
6,2025-05-24T20:24:00+02:00,2025-05-25,04:24,0,1,1
36,2025-05-24T20:14:00+02:00,2025-05-25,04:14,0,1,1
36,2025-05-24T20:16:00+02:00,2025-05-25,04:16,1,0,1
36,2025-05-24T20:20:00+02:00,2025-05-25,04:20,0,1,1
36,2025-05-24T20:22:00+02:00,2025-05-25,04:22,1,2,3
41,2025-05-24T20:11:00+02:00,2025-05-25,04:11,2,2,4
41,2025-05-24T20:19:00+02:00,2025-05-25,04:19,0,4,4
41,2025-05-24T20:23:00+02:00,2025-05-25,04:23,0,2,2
45,2025-05-24T20:14:00+02:00,2025-05-25,04:14,1,0,1
45,2025-05-24T20:15:00+02:00,2025-05-25,04:15,0,2,2
45,2025-05-24T20:16:00+02:00,2025-05-25,04:16,0,1,1
45,2025-05-24T20:17:00+02:00,2025-05-25,04:17,2,1,3
45,2025-05-24T20:18:00+02:00,2025-05-25,04:18,0,1,1
45,2025-05-24T20:23:00+02:00,2025-05-25,04:23,1,0,1
47,2025-05-24T20:18:00+02:00,2025-05-25,04:18,1,0,1
47,2025-05-24T20:21:00+02:00,2025-05-25,04:21,4,0,4
59,2025-05-24T20:15:00+02:00,2025-05-25,04:15,1,1,2
61,2025-05-24T20:10:00+02:00,2025-05-25,04:10,1,0,1
61,2025-05-24T20:18:00+02:00,2025-05-25,04:18,2,0,2
61,2025-05-24T20:22:00+02:00,2025-05-25,04:22,2,0,2
66,2025-05-24T20:13:00+02:00,2025-05-25,04:13,3,0,3
66,2025-05-24T20:17:00+02:00,2025-05-25,04:17,2,1,3
66,2025-05-24T20:19:00+02:00,2025-05-25,04:19,1,0,1
66,2025-05-24T20:21:00+02:00,2025-05-25,04:21,2,0,2
78,2025-05-24T20:24:00+02:00,2025-05-25,04:24,0,1,1
84,2025-05-24T20:10:00+02:00,2025-05-25,04:10,7,5,12
84,2025-05-24T20:15:00+02:00,2025-05-25,04:15,2,2,4
107,2025-05-24T20:20:00+02:00,2025-05-25,04:20,1,0,1
108,2025-05-24T20:13:00+02:00,2025-05-25,04:13,0,1,1
108,2025-05-24T20:17:00+02:00,2025-05-25,04:17,2,2,4
131,2025-05-24T20:10:00+02:00,2025-05-25,04:10,7,2,9
131,2025-05-24T20:15:00+02:00,2025-05-25,04:15,7,1,8
132,2025-05-24T20:10:00+02:00,2025-05-25,04:10,0,1,1
133,2025-05-24T20:10:00+02:00,2025-05-25,04:10,2,0,2
135,2025-05-24T20:20:00+02:00,2025-05-25,04:20,2,1,3
162,2025-05-24T20:10:00+02:00,2025-05-25,04:10,0,2,2
162,2025-05-24T20:15:00+02:00,2025-05-25,04:15,13,0,13
162,2025-05-24T20:20:00+02:00,2025-05-25,04:20,1,0,1
167,2025-05-24T20:10:00+02:00,2025-05-25,04:10,1,0,1
1,2025-05-24T20:13:00+02:00,2025-05-25,04:13,0,1,1
2,2025-05-24T20:16:00+02:00,2025-05-25,04:16,0,4,4
2,2025-05-24T20:24:00+02:00,2025-05-25,04:24,1,0,1
10,2025-05-24T20:15:00+02:00,2025-05-25,04:15,1,0,1
11,2025-05-24T20:20:00+02:00,2025-05-25,04:20,0,2,2
19,2025-05-24T20:10:00+02:00,2025-05-25,04:10,1,0,1
19,2025-05-24T20:14:00+02:00,2025-05-25,04:14,0,1,1
19,2025-05-24T20:17:00+02:00,2025-05-25,04:17,0,1,1
20,2025-05-24T20:12:00+02:00,2025-05-25,04:12,1,5,6
20,2025-05-24T20:13:00+02:00,2025-05-25,04:13,2,7,9
20,2025-05-24T20:15:00+02:00,2025-05-25,04:15,1,2,3
20,2025-05-24T20:18:00+02:00,2025-05-25,04:18,1,1,2
20,2025-05-24T20:21:00+02:00,2025-05-25,04:21,1,0,1
24,2025-05-24T20:14:00+02:00,2025-05-25,04:14,0,1,1
27,2025-05-24T20:12:00+02:00,2025-05-25,04:12,1,0,1
27,2025-05-24T20:16:00+02:00,2025-05-25,04:16,1,0,1
27,2025-05-24T20:19:00+02:00,2025-05-25,04:19,2,0,2
30,2025-05-24T20:11:00+02:00,2025-05-25,04:11,1,6,7
30,2025-05-24T20:14:00+02:00,2025-05-25,04:14,4,2,6
30,2025-05-24T20:15:00+02:00,2025-05-25,04:15,3,0,3
30,2025-05-24T20:16:00+02:00,2025-05-25,04:16,2,3,5
30,2025-05-24T20:21:00+02:00,2025-05-25,04:21,3,0,3
30,2025-05-24T20:23:00+02:00,2025-05-25,04:23,6,0,6
30,2025-05-24T20:24:00+02:00,2025-05-25,04:24,1,3,4
35,2025-05-24T20:22:00+02:00,2025-05-25,04:22,0,5,5
49,2025-05-24T20:15:00+02:00,2025-05-25,04:15,0,1,1
49,2025-05-24T20:22:00+02:00,2025-05-25,04:22,4,2,6
51,2025-05-24T20:24:00+02:00,2025-05-25,04:24,0,1,1
52,2025-05-24T20:10:00+02:00,2025-05-25,04:10,14,0,14
52,2025-05-24T20:13:00+02:00,2025-05-25,04:13,0,2,2
52,2025-05-24T20:21:00+02:00,2025-05-25,04:21,1,0,1
53,2025-05-24T20:11:00+02:00,2025-05-25,04:11,1,1,2
53,2025-05-24T20:16:00+02:00,2025-05-25,04:16,0,2,2
58,2025-05-24T20:11:00+02:00,2025-05-25,04:11,1,0,1
58,2025-05-24T20:18:00+02:00,2025-05-25,04:18,0,1,1
62,2025-05-24T20:22:00+02:00,2025-05-25,04:22,1,0,1
67,2025-05-24T20:14:00+02:00,2025-05-25,04:14,1,0,1
67,2025-05-24T20:18:00+02:00,2025-05-25,04:18,0,2,2
72,2025-05-24T20:13:00+02:00,2025-05-25,04:13,2,0,2
76,2025-05-24T20:13:00+02:00,2025-05-25,04:13,1,0,1
76,2025-05-24T20:14:00+02:00,2025-05-25,04:14,0,1,1
79,2025-05-24T20:16:00+02:00,2025-05-25,04:16,1,1,2
79,2025-05-24T20:18:00+02:00,2025-05-25,04:18,0,2,2
79,2025-05-24T20:21:00+02:00,2025-05-25,04:21,1,0,1
109,2025-05-24T20:20:00+02:00,2025-05-25,04:20,1,0,1
117,2025-05-24T20:10:00+02:00,2025-05-25,04:10,2,0,2
141,2025-05-24T20:15:00+02:00,2025-05-25,04:15,1,1,2
142,2025-05-24T20:15:00+02:00,2025-05-25,04:15,1,0,1
181,2025-05-24T20:27:00+02:00,2025-05-25,04:27,1,0,1
181,2025-05-24T20:28:00+02:00,2025-05-25,04:28,2,3,5
181,2025-05-24T20:34:00+02:00,2025-05-25,04:34,4,0,4
182,2025-05-24T20:30:00+02:00,2025-05-25,04:30,3,8,11
3,2025-05-24T21:00:00+02:00,2025-05-25,05:00,0,1,1
3,2025-05-24T21:07:00+02:00,2025-05-25,05:07,0,1,1
4,2025-05-24T20:56:00+02:00,2025-05-25,04:56,0,4,4
4,2025-05-24T20:57:00+02:00,2025-05-25,04:57,0,1,1
4,2025-05-24T21:01:00+02:00,2025-05-25,05:01,1,0,1
4,2025-05-24T21:03:00+02:00,2025-05-25,05:03,0,2,2
6,2025-05-24T20:58:00+02:00,2025-05-25,04:58,1,1,2
6,2025-05-24T20:59:00+02:00,2025-05-25,04:59,0,2,2
6,2025-05-24T21:01:00+02:00,2025-05-25,05:01,0,2,2
6,2025-05-24T21:03:00+02:00,2025-05-25,05:03,2,1,3
6,2025-05-24T21:04:00+02:00,2025-05-25,05:04,1,0,1
6,2025-05-24T21:05:00+02:00,2025-05-25,05:05,1,3,4
6,2025-05-24T21:06:00+02:00,2025-05-25,05:06,0,3,3
28,2025-05-24T20:56:00+02:00,2025-05-25,04:56,0,1,1
29,2025-05-24T21:03:00+02:00,2025-05-25,05:03,1,0,1
40,2025-05-24T20:56:00+02:00,2025-05-25,04:56,1,0,1
40,2025-05-24T21:01:00+02:00,2025-05-25,05:01,1,0,1
41,2025-05-24T21:03:00+02:00,2025-05-25,05:03,2,4,6
44,2025-05-24T20:55:00+02:00,2025-05-25,04:55,0,1,1
45,2025-05-24T21:00:00+02:00,2025-05-25,05:00,0,1,1
45,2025-05-24T21:01:00+02:00,2025-05-25,05:01,1,0,1
45,2025-05-24T21:02:00+02:00,2025-05-25,05:02,0,1,1
45,2025-05-24T21:09:00+02:00,2025-05-25,05:09,0,5,5
47,2025-05-24T20:55:00+02:00,2025-05-25,04:55,1,0,1
50,2025-05-24T21:00:00+02:00,2025-05-25,05:00,5,0,5
84,2025-05-24T21:00:00+02:00,2025-05-25,05:00,0,4,4
108,2025-05-24T20:57:00+02:00,2025-05-25,04:57,0,1,1
108,2025-05-24T21:00:00+02:00,2025-05-25,05:00,1,0,1
108,2025-05-24T21:08:00+02:00,2025-05-25,05:08,2,0,2
134,2025-05-24T21:00:00+02:00,2025-05-25,05:00,4,3,7
134,2025-05-24T21:05:00+02:00,2025-05-25,05:05,13,8,21
135,2025-05-24T21:05:00+02:00,2025-05-25,05:05,3,5,8
162,2025-05-24T20:55:00+02:00,2025-05-25,04:55,1,0,1
167,2025-05-24T21:05:00+02:00,2025-05-25,05:05,1,0,1
179,2025-05-24T21:00:00+02:00,2025-05-25,05:00,0,1,1
1,2025-05-24T21:05:00+02:00,2025-05-25,05:05,1,0,1
1,2025-05-24T21:08:00+02:00,2025-05-25,05:08,4,0,4
2,2025-05-24T20:57:00+02:00,2025-05-25,04:57,0,2,2
2,2025-05-24T21:03:00+02:00,2025-05-25,05:03,0,1,1
17,2025-05-24T21:07:00+02:00,2025-05-25,05:07,0,1,1
19,2025-05-24T20:55:00+02:00,2025-05-25,04:55,0,1,1
19,2025-05-24T21:02:00+02:00,2025-05-25,05:02,0,2,2
19,2025-05-24T21:05:00+02:00,2025-05-25,05:05,0,2,2
19,2025-05-24T21:08:00+02:00,2025-05-25,05:08,0,2,2
20,2025-05-24T20:56:00+02:00,2025-05-25,04:56,4,3,7
20,2025-05-24T20:57:00+02:00,2025-05-25,04:57,1,6,7
20,2025-05-24T20:59:00+02:00,2025-05-25,04:59,3,0,3
23,2025-05-24T20:55:00+02:00,2025-05-25,04:55,0,1,1
23,2025-05-24T21:03:00+02:00,2025-05-25,05:03,0,3,3
24,2025-05-24T20:55:00+02:00,2025-05-25,04:55,2,0,2
24,2025-05-24T20:59:00+02:00,2025-05-25,04:59,1,0,1
25,2025-05-24T21:05:00+02:00,2025-05-25,05:05,0,1,1
27,2025-05-24T21:03:00+02:00,2025-05-25,05:03,1,0,1
30,2025-05-24T20:56:00+02:00,2025-05-25,04:56,0,3,3
30,2025-05-24T20:59:00+02:00,2025-05-25,04:59,6,5,11
30,2025-05-24T21:01:00+02:00,2025-05-25,05:01,0,5,5
30,2025-05-24T21:02:00+02:00,2025-05-25,05:02,0,3,3
30,2025-05-24T21:09:00+02:00,2025-05-25,05:09,0,4,4
35,2025-05-24T21:07:00+02:00,2025-05-25,05:07,0,1,1
49,2025-05-24T21:03:00+02:00,2025-05-25,05:03,2,2,4
52,2025-05-24T20:55:00+02:00,2025-05-25,04:55,0,1,1
52,2025-05-24T21:00:00+02:00,2025-05-25,05:00,0,2,2
52,2025-05-24T21:02:00+02:00,2025-05-25,05:02,0,2,2
52,2025-05-24T21:05:00+02:00,2025-05-25,05:05,1,0,1
53,2025-05-24T21:02:00+02:00,2025-05-25,05:02,0,2,2
56,2025-05-24T21:07:00+02:00,2025-05-25,05:07,1,0,1
58,2025-05-24T21:06:00+02:00,2025-05-25,05:06,0,2,2
62,2025-05-24T20:56:00+02:00,2025-05-25,04:56,1,0,1
79,2025-05-24T20:56:00+02:00,2025-05-25,04:56,1,0,1
79,2025-05-24T20:58:00+02:00,2025-05-25,04:58,0,3,3
79,2025-05-24T21:03:00+02:00,2025-05-25,05:03,2,1,3
79,2025-05-24T21:05:00+02:00,2025-05-25,05:05,1,0,1
117,2025-05-24T21:00:00+02:00,2025-05-25,05:00,0,1,1
130,2025-05-24T20:55:00+02:00,2025-05-25,04:55,0,1,1
139,2025-05-24T20:55:00+02:00,2025-05-25,04:55,0,1,1
141,2025-05-24T21:05:00+02:00,2025-05-25,05:05,5,1,6
181,2025-05-24T21:13:00+02:00,2025-05-25,05:13,1,0,1
181,2025-05-24T21:14:00+02:00,2025-05-25,05:14,0,1,1
181,2025-05-24T21:20:00+02:00,2025-05-25,05:20,1,1,2
181,2025-05-24T21:23:00+02:00,2025-05-25,05:23,1,0,1
3,2025-05-24T20:41:00+02:00,2025-05-25,04:41,6,0,6
4,2025-05-24T20:48:00+02:00,2025-05-25,04:48,1,0,1
4,2025-05-24T20:51:00+02:00,2025-05-25,04:51,1,2,3
5,2025-05-24T20:40:00+02:00,2025-05-25,04:40,0,2,2
28,2025-05-24T20:45:00+02:00,2025-05-25,04:45,0,1,1
28,2025-05-24T20:48:00+02:00,2025-05-25,04:48,1,0,1
37,2025-05-24T20:46:00+02:00,2025-05-25,04:46,1,0,1
37,2025-05-24T20:52:00+02:00,2025-05-25,04:52,2,0,2
41,2025-05-24T20:45:00+02:00,2025-05-25,04:45,1,0,1
41,2025-05-24T20:48:00+02:00,2025-05-25,04:48,0,2,2
41,2025-05-24T20:49:00+02:00,2025-05-25,04:49,1,1,2
41,2025-05-24T20:51:00+02:00,2025-05-25,04:51,0,1,1
45,2025-05-24T20:43:00+02:00,2025-05-25,04:43,0,2,2
45,2025-05-24T20:44:00+02:00,2025-05-25,04:44,1,0,1
45,2025-05-24T20:48:00+02:00,2025-05-25,04:48,0,1,1
45,2025-05-24T20:50:00+02:00,2025-05-25,04:50,0,1,1
47,2025-05-24T20:40:00+02:00,2025-05-25,04:40,0,1,1
47,2025-05-24T20:47:00+02:00,2025-05-25,04:47,3,6,9
50,2025-05-24T20:40:00+02:00,2025-05-25,04:40,0,1,1
50,2025-05-24T20:44:00+02:00,2025-05-25,04:44,1,0,1
61,2025-05-24T20:43:00+02:00,2025-05-25,04:43,1,0,1
61,2025-05-24T20:44:00+02:00,2025-05-25,04:44,2,0,2
61,2025-05-24T20:48:00+02:00,2025-05-25,04:48,1,1,2
66,2025-05-24T20:44:00+02:00,2025-05-25,04:44,0,1,1
66,2025-05-24T20:49:00+02:00,2025-05-25,04:49,0,3,3
84,2025-05-24T20:40:00+02:00,2025-05-25,04:40,4,9,13
107,2025-05-24T20:40:00+02:00,2025-05-25,04:40,0,2,2
131,2025-05-24T20:40:00+02:00,2025-05-25,04:40,1,6,7
131,2025-05-24T20:45:00+02:00,2025-05-25,04:45,1,4,5
131,2025-05-24T20:50:00+02:00,2025-05-25,04:50,5,3,8
133,2025-05-24T20:50:00+02:00,2025-05-25,04:50,1,0,1
134,2025-05-24T20:40:00+02:00,2025-05-25,04:40,1,2,3
134,2025-05-24T20:45:00+02:00,2025-05-25,04:45,7,3,10
134,2025-05-24T20:50:00+02:00,2025-05-25,04:50,2,2,4
135,2025-05-24T20:40:00+02:00,2025-05-25,04:40,1,3,4
135,2025-05-24T20:45:00+02:00,2025-05-25,04:45,2,1,3
165,2025-05-24T20:40:00+02:00,2025-05-25,04:40,2,0,2
166,2025-05-24T20:45:00+02:00,2025-05-25,04:45,1,0,1
1,2025-05-24T20:42:00+02:00,2025-05-25,04:42,0,2,2
1,2025-05-24T20:49:00+02:00,2025-05-25,04:49,1,0,1
19,2025-05-24T20:46:00+02:00,2025-05-25,04:46,2,0,2
20,2025-05-24T20:49:00+02:00,2025-05-25,04:49,3,0,3
20,2025-05-24T20:53:00+02:00,2025-05-25,04:53,0,3,3
23,2025-05-24T20:54:00+02:00,2025-05-25,04:54,0,8,8
24,2025-05-24T20:40:00+02:00,2025-05-25,04:40,4,0,4
24,2025-05-24T20:45:00+02:00,2025-05-25,04:45,1,0,1
24,2025-05-24T20:53:00+02:00,2025-05-25,04:53,0,1,1
24,2025-05-24T20:54:00+02:00,2025-05-25,04:54,2,3,5
25,2025-05-24T20:50:00+02:00,2025-05-25,04:50,1,1,2
30,2025-05-24T20:40:00+02:00,2025-05-25,04:40,3,4,7
30,2025-05-24T20:41:00+02:00,2025-05-25,04:41,1,1,2
30,2025-05-24T20:43:00+02:00,2025-05-25,04:43,6,0,6
30,2025-05-24T20:49:00+02:00,2025-05-25,04:49,0,3,3
30,2025-05-24T20:51:00+02:00,2025-05-25,04:51,1,1,2
49,2025-05-24T20:40:00+02:00,2025-05-25,04:40,0,3,3
49,2025-05-24T20:43:00+02:00,2025-05-25,04:43,0,1,1
49,2025-05-24T20:46:00+02:00,2025-05-25,04:46,0,7,7
49,2025-05-24T20:53:00+02:00,2025-05-25,04:53,1,0,1
49,2025-05-24T20:54:00+02:00,2025-05-25,04:54,0,1,1
51,2025-05-24T20:49:00+02:00,2025-05-25,04:49,3,0,3
52,2025-05-24T20:48:00+02:00,2025-05-25,04:48,0,1,1
52,2025-05-24T20:51:00+02:00,2025-05-25,04:51,4,0,4
53,2025-05-24T20:45:00+02:00,2025-05-25,04:45,1,0,1
56,2025-05-24T20:50:00+02:00,2025-05-25,04:50,0,1,1
56,2025-05-24T20:51:00+02:00,2025-05-25,04:51,2,0,2
58,2025-05-24T20:50:00+02:00,2025-05-25,04:50,0,1,1
58,2025-05-24T20:54:00+02:00,2025-05-25,04:54,0,2,2
67,2025-05-24T20:49:00+02:00,2025-05-25,04:49,1,0,1
67,2025-05-24T20:50:00+02:00,2025-05-25,04:50,0,2,2
72,2025-05-24T20:46:00+02:00,2025-05-25,04:46,0,1,1
72,2025-05-24T20:47:00+02:00,2025-05-25,04:47,0,1,1
79,2025-05-24T20:43:00+02:00,2025-05-25,04:43,0,1,1
79,2025-05-24T20:52:00+02:00,2025-05-25,04:52,0,1,1
141,2025-05-24T20:40:00+02:00,2025-05-25,04:40,0,1,1
142,2025-05-24T20:40:00+02:00,2025-05-25,04:40,1,0,1
181,2025-05-24T20:56:00+02:00,2025-05-25,04:56,1,0,1
181,2025-05-24T21:01:00+02:00,2025-05-25,05:01,0,3,3
181,2025-05-24T21:05:00+02:00,2025-05-25,05:05,3,0,3
181,2025-05-24T21:07:00+02:00,2025-05-25,05:07,1,0,1
182,2025-05-24T20:55:00+02:00,2025-05-25,04:55,2,12,14
3,2025-05-24T20:26:00+02:00,2025-05-25,04:26,6,2,8
3,2025-05-24T20:34:00+02:00,2025-05-25,04:34,2,0,2
3,2025-05-24T20:35:00+02:00,2025-05-25,04:35,0,2,2
4,2025-05-24T20:29:00+02:00,2025-05-25,04:29,0,1,1
4,2025-05-24T20:30:00+02:00,2025-05-25,04:30,0,1,1
4,2025-05-24T20:31:00+02:00,2025-05-25,04:31,0,1,1
6,2025-05-24T20:36:00+02:00,2025-05-25,04:36,1,0,1
29,2025-05-24T20:28:00+02:00,2025-05-25,04:28,3,0,3
36,2025-05-24T20:25:00+02:00,2025-05-25,04:25,2,4,6
36,2025-05-24T20:26:00+02:00,2025-05-25,04:26,0,1,1
36,2025-05-24T20:33:00+02:00,2025-05-25,04:33,0,1,1
41,2025-05-24T20:33:00+02:00,2025-05-25,04:33,1,0,1
41,2025-05-24T20:37:00+02:00,2025-05-25,04:37,1,0,1
45,2025-05-24T20:28:00+02:00,2025-05-25,04:28,2,0,2
45,2025-05-24T20:31:00+02:00,2025-05-25,04:31,0,2,2
47,2025-05-24T20:25:00+02:00,2025-05-25,04:25,1,0,1
47,2025-05-24T20:29:00+02:00,2025-05-25,04:29,0,1,1
47,2025-05-24T20:37:00+02:00,2025-05-25,04:37,1,1,2
59,2025-05-24T20:30:00+02:00,2025-05-25,04:30,0,1,1
61,2025-05-24T20:33:00+02:00,2025-05-25,04:33,0,1,1
61,2025-05-24T20:38:00+02:00,2025-05-25,04:38,1,0,1
66,2025-05-24T20:26:00+02:00,2025-05-25,04:26,0,4,4
66,2025-05-24T20:28:00+02:00,2025-05-25,04:28,3,0,3
66,2025-05-24T20:38:00+02:00,2025-05-25,04:38,0,1,1
77,2025-05-24T20:25:00+02:00,2025-05-25,04:25,1,0,1
78,2025-05-24T20:35:00+02:00,2025-05-25,04:35,0,1,1
84,2025-05-24T20:30:00+02:00,2025-05-25,04:30,3,5,8
107,2025-05-24T20:35:00+02:00,2025-05-25,04:35,2,1,3
108,2025-05-24T20:26:00+02:00,2025-05-25,04:26,1,0,1
132,2025-05-24T20:35:00+02:00,2025-05-25,04:35,0,1,1
133,2025-05-24T20:30:00+02:00,2025-05-25,04:30,3,3,6
133,2025-05-24T20:35:00+02:00,2025-05-25,04:35,1,4,5
135,2025-05-24T20:25:00+02:00,2025-05-25,04:25,3,0,3
162,2025-05-24T20:35:00+02:00,2025-05-25,04:35,2,0,2
165,2025-05-24T20:25:00+02:00,2025-05-25,04:25,0,1,1
179,2025-05-24T20:25:00+02:00,2025-05-25,04:25,0,2,2
12,2025-05-24T20:26:00+02:00,2025-05-25,04:26,0,2,2
12,2025-05-24T20:30:00+02:00,2025-05-25,04:30,0,1,1
17,2025-05-24T20:36:00+02:00,2025-05-25,04:36,1,0,1
20,2025-05-24T20:26:00+02:00,2025-05-25,04:26,0,3,3
23,2025-05-24T20:26:00+02:00,2025-05-25,04:26,0,3,3
24,2025-05-24T20:26:00+02:00,2025-05-25,04:26,0,1,1
24,2025-05-24T20:30:00+02:00,2025-05-25,04:30,0,4,4
24,2025-05-24T20:32:00+02:00,2025-05-25,04:32,1,0,1
24,2025-05-24T20:36:00+02:00,2025-05-25,04:36,0,3,3
25,2025-05-24T20:30:00+02:00,2025-05-25,04:30,0,1,1
25,2025-05-24T20:35:00+02:00,2025-05-25,04:35,2,1,3
27,2025-05-24T20:30:00+02:00,2025-05-25,04:30,0,1,1
30,2025-05-24T20:25:00+02:00,2025-05-25,04:25,0,3,3
30,2025-05-24T20:29:00+02:00,2025-05-25,04:29,3,3,6
35,2025-05-24T20:25:00+02:00,2025-05-25,04:25,0,1,1
49,2025-05-24T20:27:00+02:00,2025-05-25,04:27,4,0,4
52,2025-05-24T20:36:00+02:00,2025-05-25,04:36,0,4,4
56,2025-05-24T20:31:00+02:00,2025-05-25,04:31,2,0,2
56,2025-05-24T20:35:00+02:00,2025-05-25,04:35,1,0,1
58,2025-05-24T20:28:00+02:00,2025-05-25,04:28,1,0,1
58,2025-05-24T20:35:00+02:00,2025-05-25,04:35,0,1,1
62,2025-05-24T20:30:00+02:00,2025-05-25,04:30,1,0,1
62,2025-05-24T20:35:00+02:00,2025-05-25,04:35,0,1,1
67,2025-05-24T20:35:00+02:00,2025-05-25,04:35,0,1,1
67,2025-05-24T20:38:00+02:00,2025-05-25,04:38,4,0,4
72,2025-05-24T20:28:00+02:00,2025-05-25,04:28,1,0,1
79,2025-05-24T20:30:00+02:00,2025-05-25,04:30,0,2,2
79,2025-05-24T20:36:00+02:00,2025-05-25,04:36,0,2,2
79,2025-05-24T20:37:00+02:00,2025-05-25,04:37,0,1,1
109,2025-05-24T20:30:00+02:00,2025-05-25,04:30,1,0,1
109,2025-05-24T20:35:00+02:00,2025-05-25,04:35,1,1,2
141,2025-05-24T20:30:00+02:00,2025-05-25,04:30,3,0,3
141,2025-05-24T20:35:00+02:00,2025-05-25,04:35,4,5,9
142,2025-05-24T20:35:00+02:00,2025-05-25,04:35,1,0,1
164,2025-05-24T20:35:00+02:00,2025-05-25,04:35,1,0,1
181,2025-05-24T20:44:00+02:00,2025-05-25,04:44,0,3,3
181,2025-05-24T20:47:00+02:00,2025-05-25,04:47,1,1,2
181,2025-05-24T20:50:00+02:00,2025-05-25,04:50,1,0,1
182,2025-05-24T20:45:00+02:00,2025-05-25,04:45,6,7,13
3,2025-05-24T21:11:00+02:00,2025-05-25,05:11,1,0,1
3,2025-05-24T21:17:00+02:00,2025-05-25,05:17,2,0,2
3,2025-05-24T21:19:00+02:00,2025-05-25,05:19,3,0,3
3,2025-05-24T21:21:00+02:00,2025-05-25,05:21,0,1,1
3,2025-05-24T21:22:00+02:00,2025-05-25,05:22,3,2,5
3,2025-05-24T21:23:00+02:00,2025-05-25,05:23,0,1,1
4,2025-05-24T21:12:00+02:00,2025-05-25,05:12,2,0,2
4,2025-05-24T21:13:00+02:00,2025-05-25,05:13,0,2,2
4,2025-05-24T21:20:00+02:00,2025-05-25,05:20,0,1,1
5,2025-05-24T21:20:00+02:00,2025-05-25,05:20,5,0,5
6,2025-05-24T21:10:00+02:00,2025-05-25,05:10,1,1,2
6,2025-05-24T21:13:00+02:00,2025-05-25,05:13,0,1,1
6,2025-05-24T21:17:00+02:00,2025-05-25,05:17,3,0,3
6,2025-05-24T21:21:00+02:00,2025-05-25,05:21,2,4,6
6,2025-05-24T21:22:00+02:00,2025-05-25,05:22,0,4,4
6,2025-05-24T21:23:00+02:00,2025-05-25,05:23,0,1,1
6,2025-05-24T21:24:00+02:00,2025-05-25,05:24,0,4,4
28,2025-05-24T21:20:00+02:00,2025-05-25,05:20,0,3,3
28,2025-05-24T21:21:00+02:00,2025-05-25,05:21,1,0,1
36,2025-05-24T21:12:00+02:00,2025-05-25,05:12,0,4,4
36,2025-05-24T21:19:00+02:00,2025-05-25,05:19,4,2,6
36,2025-05-24T21:23:00+02:00,2025-05-25,05:23,0,1,1
41,2025-05-24T21:11:00+02:00,2025-05-25,05:11,1,0,1
41,2025-05-24T21:22:00+02:00,2025-05-25,05:22,1,2,3
45,2025-05-24T21:22:00+02:00,2025-05-25,05:22,0,1,1
47,2025-05-24T21:10:00+02:00,2025-05-25,05:10,0,1,1
47,2025-05-24T21:16:00+02:00,2025-05-25,05:16,0,1,1
47,2025-05-24T21:18:00+02:00,2025-05-25,05:18,0,1,1
47,2025-05-24T21:21:00+02:00,2025-05-25,05:21,0,1,1
54,2025-05-24T21:17:00+02:00,2025-05-25,05:17,1,0,1
59,2025-05-24T21:15:00+02:00,2025-05-25,05:15,5,2,7
66,2025-05-24T21:19:00+02:00,2025-05-25,05:19,1,0,1
66,2025-05-24T21:23:00+02:00,2025-05-25,05:23,0,1,1
75,2025-05-24T21:19:00+02:00,2025-05-25,05:19,0,1,1
84,2025-05-24T21:15:00+02:00,2025-05-25,05:15,2,1,3
107,2025-05-24T21:15:00+02:00,2025-05-25,05:15,1,0,1
133,2025-05-24T21:10:00+02:00,2025-05-25,05:10,0,4,4
133,2025-05-24T21:15:00+02:00,2025-05-25,05:15,0,4,4
134,2025-05-24T21:10:00+02:00,2025-05-25,05:10,3,0,3
135,2025-05-24T21:10:00+02:00,2025-05-25,05:10,0,1,1
179,2025-05-24T21:15:00+02:00,2025-05-25,05:15,0,1,1
179,2025-05-24T21:20:00+02:00,2025-05-25,05:20,0,1,1
1,2025-05-24T21:14:00+02:00,2025-05-25,05:14,1,0,1
19,2025-05-24T21:12:00+02:00,2025-05-25,05:12,4,0,4
19,2025-05-24T21:17:00+02:00,2025-05-25,05:17,0,1,1
19,2025-05-24T21:24:00+02:00,2025-05-25,05:24,2,0,2
20,2025-05-24T21:12:00+02:00,2025-05-25,05:12,4,0,4
20,2025-05-24T21:20:00+02:00,2025-05-25,05:20,2,0,2
20,2025-05-24T21:21:00+02:00,2025-05-25,05:21,4,0,4
20,2025-05-24T21:22:00+02:00,2025-05-25,05:22,2,0,2
20,2025-05-24T21:24:00+02:00,2025-05-25,05:24,3,1,4
23,2025-05-24T21:15:00+02:00,2025-05-25,05:15,0,1,1
24,2025-05-24T21:16:00+02:00,2025-05-25,05:16,0,2,2
24,2025-05-24T21:24:00+02:00,2025-05-25,05:24,0,7,7
25,2025-05-24T21:15:00+02:00,2025-05-25,05:15,1,1,2
30,2025-05-24T21:12:00+02:00,2025-05-25,05:12,0,2,2
30,2025-05-24T21:14:00+02:00,2025-05-25,05:14,0,3,3
30,2025-05-24T21:15:00+02:00,2025-05-25,05:15,0,4,4
30,2025-05-24T21:19:00+02:00,2025-05-25,05:19,0,1,1
49,2025-05-24T21:24:00+02:00,2025-05-25,05:24,5,0,5
51,2025-05-24T21:18:00+02:00,2025-05-25,05:18,4,0,4
52,2025-05-24T21:10:00+02:00,2025-05-25,05:10,3,0,3
52,2025-05-24T21:11:00+02:00,2025-05-25,05:11,1,1,2
52,2025-05-24T21:16:00+02:00,2025-05-25,05:16,0,6,6
52,2025-05-24T21:19:00+02:00,2025-05-25,05:19,1,0,1
56,2025-05-24T21:10:00+02:00,2025-05-25,05:10,2,0,2
56,2025-05-24T21:11:00+02:00,2025-05-25,05:11,0,1,1
56,2025-05-24T21:14:00+02:00,2025-05-25,05:14,2,0,2
56,2025-05-24T21:23:00+02:00,2025-05-25,05:23,2,0,2
58,2025-05-24T21:20:00+02:00,2025-05-25,05:20,0,2,2
58,2025-05-24T21:21:00+02:00,2025-05-25,05:21,0,2,2
62,2025-05-24T21:14:00+02:00,2025-05-25,05:14,0,2,2
67,2025-05-24T21:17:00+02:00,2025-05-25,05:17,0,1,1
72,2025-05-24T21:12:00+02:00,2025-05-25,05:12,1,0,1
79,2025-05-24T21:12:00+02:00,2025-05-25,05:12,0,1,1
79,2025-05-24T21:18:00+02:00,2025-05-25,05:18,3,2,5
109,2025-05-24T21:10:00+02:00,2025-05-25,05:10,0,1,1
141,2025-05-24T21:10:00+02:00,2025-05-25,05:10,5,0,5
3,2025-05-24T21:30:00+02:00,2025-05-25,05:30,1,0,1
3,2025-05-24T21:35:00+02:00,2025-05-25,05:35,2,0,2
4,2025-05-24T21:27:00+02:00,2025-05-25,05:27,0,1,1
4,2025-05-24T21:39:00+02:00,2025-05-25,05:39,0,5,5
6,2025-05-24T21:25:00+02:00,2025-05-25,05:25,2,3,5
6,2025-05-24T21:29:00+02:00,2025-05-25,05:29,1,0,1
28,2025-05-24T21:30:00+02:00,2025-05-25,05:30,0,2,2
29,2025-05-24T21:29:00+02:00,2025-05-25,05:29,2,0,2
29,2025-05-24T21:39:00+02:00,2025-05-25,05:39,0,1,1
36,2025-05-24T21:38:00+02:00,2025-05-25,05:38,0,1,1
40,2025-05-24T21:37:00+02:00,2025-05-25,05:37,1,0,1
41,2025-05-24T21:26:00+02:00,2025-05-25,05:26,1,2,3
41,2025-05-24T21:28:00+02:00,2025-05-25,05:28,0,1,1
41,2025-05-24T21:29:00+02:00,2025-05-25,05:29,0,1,1
41,2025-05-24T21:30:00+02:00,2025-05-25,05:30,2,1,3
41,2025-05-24T21:33:00+02:00,2025-05-25,05:33,2,0,2
41,2025-05-24T21:37:00+02:00,2025-05-25,05:37,0,1,1
43,2025-05-24T21:25:00+02:00,2025-05-25,05:25,0,1,1
45,2025-05-24T21:35:00+02:00,2025-05-25,05:35,0,1,1
47,2025-05-24T21:32:00+02:00,2025-05-25,05:32,1,0,1
47,2025-05-24T21:36:00+02:00,2025-05-25,05:36,0,3,3
59,2025-05-24T21:30:00+02:00,2025-05-25,05:30,3,0,3
59,2025-05-24T21:35:00+02:00,2025-05-25,05:35,4,0,4
61,2025-05-24T21:26:00+02:00,2025-05-25,05:26,1,0,1
61,2025-05-24T21:31:00+02:00,2025-05-25,05:31,0,1,1
66,2025-05-24T21:26:00+02:00,2025-05-25,05:26,0,1,1
66,2025-05-24T21:35:00+02:00,2025-05-25,05:35,0,1,1
84,2025-05-24T21:35:00+02:00,2025-05-25,05:35,3,2,5
87,2025-05-24T21:35:00+02:00,2025-05-25,05:35,0,1,1
108,2025-05-24T21:30:00+02:00,2025-05-25,05:30,0,2,2
131,2025-05-24T21:35:00+02:00,2025-05-25,05:35,1,5,6
133,2025-05-24T21:30:00+02:00,2025-05-25,05:30,1,1,2
133,2025-05-24T21:35:00+02:00,2025-05-25,05:35,2,3,5
134,2025-05-24T21:35:00+02:00,2025-05-25,05:35,8,3,11
162,2025-05-24T21:25:00+02:00,2025-05-25,05:25,3,2,5
166,2025-05-24T21:30:00+02:00,2025-05-25,05:30,1,0,1
167,2025-05-24T21:25:00+02:00,2025-05-25,05:25,0,1,1
1,2025-05-24T21:28:00+02:00,2025-05-25,05:28,0,3,3
1,2025-05-24T21:38:00+02:00,2025-05-25,05:38,0,1,1
19,2025-05-24T21:25:00+02:00,2025-05-25,05:25,0,1,1
19,2025-05-24T21:36:00+02:00,2025-05-25,05:36,1,0,1
20,2025-05-24T21:39:00+02:00,2025-05-25,05:39,1,0,1
23,2025-05-24T21:25:00+02:00,2025-05-25,05:25,0,2,2
23,2025-05-24T21:32:00+02:00,2025-05-25,05:32,2,0,2
23,2025-05-24T21:34:00+02:00,2025-05-25,05:34,1,0,1
23,2025-05-24T21:36:00+02:00,2025-05-25,05:36,2,0,2
24,2025-05-24T21:25:00+02:00,2025-05-25,05:25,0,1,1
24,2025-05-24T21:29:00+02:00,2025-05-25,05:29,1,0,1
24,2025-05-24T21:39:00+02:00,2025-05-25,05:39,1,0,1
25,2025-05-24T21:35:00+02:00,2025-05-25,05:35,1,1,2
27,2025-05-24T21:32:00+02:00,2025-05-25,05:32,1,0,1
30,2025-05-24T21:28:00+02:00,2025-05-25,05:28,1,0,1
30,2025-05-24T21:32:00+02:00,2025-05-25,05:32,0,6,6
30,2025-05-24T21:33:00+02:00,2025-05-25,05:33,0,1,1
30,2025-05-24T21:34:00+02:00,2025-05-25,05:34,1,5,6
30,2025-05-24T21:35:00+02:00,2025-05-25,05:35,2,0,2
30,2025-05-24T21:36:00+02:00,2025-05-25,05:36,2,4,6
35,2025-05-24T21:31:00+02:00,2025-05-25,05:31,1,0,1
49,2025-05-24T21:36:00+02:00,2025-05-25,05:36,2,0,2
52,2025-05-24T21:28:00+02:00,2025-05-25,05:28,0,1,1
56,2025-05-24T21:25:00+02:00,2025-05-25,05:25,2,0,2
56,2025-05-24T21:32:00+02:00,2025-05-25,05:32,1,0,1
56,2025-05-24T21:39:00+02:00,2025-05-25,05:39,3,0,3
58,2025-05-24T21:33:00+02:00,2025-05-25,05:33,0,1,1
62,2025-05-24T21:28:00+02:00,2025-05-25,05:28,1,0,1
62,2025-05-24T21:33:00+02:00,2025-05-25,05:33,2,0,2
62,2025-05-24T21:36:00+02:00,2025-05-25,05:36,1,0,1
63,2025-05-24T21:27:00+02:00,2025-05-25,05:27,0,1,1
67,2025-05-24T21:34:00+02:00,2025-05-25,05:34,1,0,1
72,2025-05-24T21:26:00+02:00,2025-05-25,05:26,0,1,1
72,2025-05-24T21:35:00+02:00,2025-05-25,05:35,2,0,2
79,2025-05-24T21:36:00+02:00,2025-05-25,05:36,1,3,4
79,2025-05-24T21:37:00+02:00,2025-05-25,05:37,2,0,2
79,2025-05-24T21:39:00+02:00,2025-05-25,05:39,2,0,2
109,2025-05-24T21:25:00+02:00,2025-05-25,05:25,2,0,2
109,2025-05-24T21:30:00+02:00,2025-05-25,05:30,1,3,4
141,2025-05-24T21:25:00+02:00,2025-05-25,05:25,3,1,4
141,2025-05-24T21:35:00+02:00,2025-05-25,05:35,9,5,14
181,2025-05-24T21:26:00+02:00,2025-05-25,05:26,0,3,3
181,2025-05-24T21:31:00+02:00,2025-05-25,05:31,0,1,1
181,2025-05-24T21:38:00+02:00,2025-05-25,05:38,0,1,1
182,2025-05-24T21:35:00+02:00,2025-05-25,05:35,1,2,3
181,2025-05-24T22:14:00+02:00,2025-05-25,06:14,0,2,2
181,2025-05-24T22:17:00+02:00,2025-05-25,06:17,0,2,2
181,2025-05-24T22:19:00+02:00,2025-05-25,06:19,0,1,1
181,2025-05-24T22:22:00+02:00,2025-05-25,06:22,1,6,7
182,2025-05-24T22:10:00+02:00,2025-05-25,06:10,5,3,8
182,2025-05-24T22:15:00+02:00,2025-05-25,06:15,3,4,7
3,2025-05-24T22:11:00+02:00,2025-05-25,06:11,1,1,2
3,2025-05-24T22:17:00+02:00,2025-05-25,06:17,2,0,2
4,2025-05-24T22:16:00+02:00,2025-05-25,06:16,1,1,2
4,2025-05-24T22:24:00+02:00,2025-05-25,06:24,0,2,2
5,2025-05-24T22:20:00+02:00,2025-05-25,06:20,0,2,2
6,2025-05-24T22:19:00+02:00,2025-05-25,06:19,0,1,1
6,2025-05-24T22:21:00+02:00,2025-05-25,06:21,0,1,1
6,2025-05-24T22:23:00+02:00,2025-05-25,06:23,1,0,1
28,2025-05-24T22:15:00+02:00,2025-05-25,06:15,0,1,1
28,2025-05-24T22:20:00+02:00,2025-05-25,06:20,1,0,1
28,2025-05-24T22:22:00+02:00,2025-05-25,06:22,0,1,1
29,2025-05-24T22:10:00+02:00,2025-05-25,06:10,1,0,1
36,2025-05-24T22:20:00+02:00,2025-05-25,06:20,0,1,1
41,2025-05-24T22:20:00+02:00,2025-05-25,06:20,1,0,1
45,2025-05-24T22:14:00+02:00,2025-05-25,06:14,1,1,2
45,2025-05-24T22:22:00+02:00,2025-05-25,06:22,1,0,1
47,2025-05-24T22:12:00+02:00,2025-05-25,06:12,0,1,1
47,2025-05-24T22:13:00+02:00,2025-05-25,06:13,0,2,2
59,2025-05-24T22:10:00+02:00,2025-05-25,06:10,2,0,2
59,2025-05-24T22:20:00+02:00,2025-05-25,06:20,0,1,1
61,2025-05-24T22:15:00+02:00,2025-05-25,06:15,0,1,1
61,2025-05-24T22:22:00+02:00,2025-05-25,06:22,0,1,1
69,2025-05-24T22:12:00+02:00,2025-05-25,06:12,2,0,2
69,2025-05-24T22:15:00+02:00,2025-05-25,06:15,1,0,1
70,2025-05-24T22:14:00+02:00,2025-05-25,06:14,0,1,1
71,2025-05-24T22:20:00+02:00,2025-05-25,06:20,1,0,1
71,2025-05-24T22:23:00+02:00,2025-05-25,06:23,0,2,2
75,2025-05-24T22:21:00+02:00,2025-05-25,06:21,1,0,1
78,2025-05-24T22:12:00+02:00,2025-05-25,06:12,2,0,2
84,2025-05-24T22:10:00+02:00,2025-05-25,06:10,2,1,3
84,2025-05-24T22:15:00+02:00,2025-05-25,06:15,0,5,5
84,2025-05-24T22:20:00+02:00,2025-05-25,06:20,4,3,7
87,2025-05-24T22:22:00+02:00,2025-05-25,06:22,1,0,1
108,2025-05-24T22:23:00+02:00,2025-05-25,06:23,1,1,2
133,2025-05-24T22:10:00+02:00,2025-05-25,06:10,3,5,8
133,2025-05-24T22:20:00+02:00,2025-05-25,06:20,2,8,10
134,2025-05-24T22:20:00+02:00,2025-05-25,06:20,12,7,19
135,2025-05-24T22:10:00+02:00,2025-05-25,06:10,8,6,14
135,2025-05-24T22:15:00+02:00,2025-05-25,06:15,3,2,5
135,2025-05-24T22:20:00+02:00,2025-05-25,06:20,2,2,4
162,2025-05-24T22:15:00+02:00,2025-05-25,06:15,0,3,3
162,2025-05-24T22:20:00+02:00,2025-05-25,06:20,4,0,4
1,2025-05-24T22:18:00+02:00,2025-05-25,06:18,0,2,2
9,2025-05-24T22:11:00+02:00,2025-05-25,06:11,1,0,1
9,2025-05-24T22:12:00+02:00,2025-05-25,06:12,1,0,1
17,2025-05-24T22:11:00+02:00,2025-05-25,06:11,0,1,1
20,2025-05-24T22:17:00+02:00,2025-05-25,06:17,1,0,1
20,2025-05-24T22:23:00+02:00,2025-05-25,06:23,0,1,1
24,2025-05-24T22:10:00+02:00,2025-05-25,06:10,0,1,1
24,2025-05-24T22:13:00+02:00,2025-05-25,06:13,0,1,1
24,2025-05-24T22:16:00+02:00,2025-05-25,06:16,1,4,5
24,2025-05-24T22:21:00+02:00,2025-05-25,06:21,4,0,4
24,2025-05-24T22:24:00+02:00,2025-05-25,06:24,0,5,5
27,2025-05-24T22:11:00+02:00,2025-05-25,06:11,1,0,1
27,2025-05-24T22:17:00+02:00,2025-05-25,06:17,1,0,1
27,2025-05-24T22:18:00+02:00,2025-05-25,06:18,1,0,1
30,2025-05-24T22:19:00+02:00,2025-05-25,06:19,1,1,2
35,2025-05-24T22:22:00+02:00,2025-05-25,06:22,1,0,1
49,2025-05-24T22:11:00+02:00,2025-05-25,06:11,1,0,1
51,2025-05-24T22:11:00+02:00,2025-05-25,06:11,1,0,1
51,2025-05-24T22:12:00+02:00,2025-05-25,06:12,0,2,2
51,2025-05-24T22:24:00+02:00,2025-05-25,06:24,0,2,2
52,2025-05-24T22:10:00+02:00,2025-05-25,06:10,1,0,1
56,2025-05-24T22:23:00+02:00,2025-05-25,06:23,1,0,1
56,2025-05-24T22:24:00+02:00,2025-05-25,06:24,0,6,6
58,2025-05-24T22:13:00+02:00,2025-05-25,06:13,1,0,1
58,2025-05-24T22:18:00+02:00,2025-05-25,06:18,1,1,2
58,2025-05-24T22:23:00+02:00,2025-05-25,06:23,2,1,3
58,2025-05-24T22:24:00+02:00,2025-05-25,06:24,1,0,1
62,2025-05-24T22:14:00+02:00,2025-05-25,06:14,0,1,1
72,2025-05-24T22:14:00+02:00,2025-05-25,06:14,0,1,1
79,2025-05-24T22:10:00+02:00,2025-05-25,06:10,0,1,1
79,2025-05-24T22:19:00+02:00,2025-05-25,06:19,0,2,2
79,2025-05-24T22:24:00+02:00,2025-05-25,06:24,0,1,1
109,2025-05-24T22:15:00+02:00,2025-05-25,06:15,2,0,2
139,2025-05-24T22:10:00+02:00,2025-05-25,06:10,1,1,2
141,2025-05-24T22:15:00+02:00,2025-05-25,06:15,1,0,1
3,2025-05-24T22:02:00+02:00,2025-05-25,06:02,1,1,2
3,2025-05-24T22:03:00+02:00,2025-05-25,06:03,1,0,1
4,2025-05-24T21:55:00+02:00,2025-05-25,05:55,1,1,2
4,2025-05-24T21:57:00+02:00,2025-05-25,05:57,0,2,2
4,2025-05-24T22:01:00+02:00,2025-05-25,06:01,1,0,1
4,2025-05-24T22:02:00+02:00,2025-05-25,06:02,2,1,3
4,2025-05-24T22:05:00+02:00,2025-05-25,06:05,0,2,2
6,2025-05-24T21:55:00+02:00,2025-05-25,05:55,7,2,9
6,2025-05-24T22:06:00+02:00,2025-05-25,06:06,0,2,2
28,2025-05-24T22:03:00+02:00,2025-05-25,06:03,0,1,1
31,2025-05-24T21:56:00+02:00,2025-05-25,05:56,0,2,2
36,2025-05-24T22:03:00+02:00,2025-05-25,06:03,2,0,2
37,2025-05-24T21:59:00+02:00,2025-05-25,05:59,2,0,2
37,2025-05-24T22:09:00+02:00,2025-05-25,06:09,0,1,1
45,2025-05-24T21:55:00+02:00,2025-05-25,05:55,1,0,1
45,2025-05-24T22:03:00+02:00,2025-05-25,06:03,1,0,1
45,2025-05-24T22:07:00+02:00,2025-05-25,06:07,0,2,2
45,2025-05-24T22:08:00+02:00,2025-05-25,06:08,2,0,2
47,2025-05-24T22:02:00+02:00,2025-05-25,06:02,0,1,1
59,2025-05-24T22:00:00+02:00,2025-05-25,06:00,0,1,1
59,2025-05-24T22:05:00+02:00,2025-05-25,06:05,3,0,3
61,2025-05-24T22:09:00+02:00,2025-05-25,06:09,1,1,2
69,2025-05-24T22:04:00+02:00,2025-05-25,06:04,1,0,1
69,2025-05-24T22:09:00+02:00,2025-05-25,06:09,1,0,1
77,2025-05-24T22:00:00+02:00,2025-05-25,06:00,0,1,1
84,2025-05-24T22:05:00+02:00,2025-05-25,06:05,5,3,8
87,2025-05-24T22:02:00+02:00,2025-05-25,06:02,1,0,1
107,2025-05-24T21:55:00+02:00,2025-05-25,05:55,0,2,2
108,2025-05-24T21:58:00+02:00,2025-05-25,05:58,0,3,3
108,2025-05-24T22:07:00+02:00,2025-05-25,06:07,0,1,1
132,2025-05-24T21:55:00+02:00,2025-05-25,05:55,1,0,1
132,2025-05-24T22:00:00+02:00,2025-05-25,06:00,1,0,1
134,2025-05-24T21:55:00+02:00,2025-05-25,05:55,6,6,12
135,2025-05-24T22:00:00+02:00,2025-05-25,06:00,2,4,6
135,2025-05-24T22:05:00+02:00,2025-05-25,06:05,7,2,9
162,2025-05-24T21:55:00+02:00,2025-05-25,05:55,9,0,9
2,2025-05-24T22:07:00+02:00,2025-05-25,06:07,1,0,1
12,2025-05-24T22:05:00+02:00,2025-05-25,06:05,0,1,1
12,2025-05-24T22:07:00+02:00,2025-05-25,06:07,1,0,1
17,2025-05-24T22:08:00+02:00,2025-05-25,06:08,1,0,1
19,2025-05-24T22:08:00+02:00,2025-05-25,06:08,0,1,1
19,2025-05-24T22:09:00+02:00,2025-05-25,06:09,2,0,2
20,2025-05-24T22:01:00+02:00,2025-05-25,06:01,0,2,2
20,2025-05-24T22:05:00+02:00,2025-05-25,06:05,1,0,1
23,2025-05-24T21:56:00+02:00,2025-05-25,05:56,1,0,1
23,2025-05-24T21:57:00+02:00,2025-05-25,05:57,0,1,1
24,2025-05-24T22:09:00+02:00,2025-05-25,06:09,0,1,1
25,2025-05-24T21:55:00+02:00,2025-05-25,05:55,1,5,6
27,2025-05-24T22:09:00+02:00,2025-05-25,06:09,1,0,1
30,2025-05-24T22:03:00+02:00,2025-05-25,06:03,3,2,5
35,2025-05-24T21:55:00+02:00,2025-05-25,05:55,3,0,3
35,2025-05-24T21:58:00+02:00,2025-05-25,05:58,1,2,3
35,2025-05-24T22:05:00+02:00,2025-05-25,06:05,1,0,1
35,2025-05-24T22:09:00+02:00,2025-05-25,06:09,1,0,1
48,2025-05-24T22:04:00+02:00,2025-05-25,06:04,0,1,1
48,2025-05-24T22:06:00+02:00,2025-05-25,06:06,1,2,3
48,2025-05-24T22:07:00+02:00,2025-05-25,06:07,0,1,1
49,2025-05-24T22:09:00+02:00,2025-05-25,06:09,0,1,1
51,2025-05-24T22:02:00+02:00,2025-05-25,06:02,0,1,1
52,2025-05-24T21:58:00+02:00,2025-05-25,05:58,1,0,1
53,2025-05-24T21:55:00+02:00,2025-05-25,05:55,0,1,1
53,2025-05-24T21:56:00+02:00,2025-05-25,05:56,0,1,1
53,2025-05-24T22:03:00+02:00,2025-05-25,06:03,1,1,2
56,2025-05-24T21:56:00+02:00,2025-05-25,05:56,0,2,2
56,2025-05-24T22:08:00+02:00,2025-05-25,06:08,0,1,1
58,2025-05-24T21:58:00+02:00,2025-05-25,05:58,2,0,2
58,2025-05-24T21:59:00+02:00,2025-05-25,05:59,1,0,1
58,2025-05-24T22:01:00+02:00,2025-05-25,06:01,3,0,3
63,2025-05-24T22:02:00+02:00,2025-05-25,06:02,0,1,1
67,2025-05-24T22:01:00+02:00,2025-05-25,06:01,0,1,1
72,2025-05-24T22:01:00+02:00,2025-05-25,06:01,1,0,1
79,2025-05-24T22:02:00+02:00,2025-05-25,06:02,1,0,1
117,2025-05-24T22:00:00+02:00,2025-05-25,06:00,1,0,1
141,2025-05-24T21:55:00+02:00,2025-05-25,05:55,3,2,5
181,2025-05-24T22:25:00+02:00,2025-05-25,06:25,0,1,1
181,2025-05-24T22:33:00+02:00,2025-05-25,06:33,1,0,1
181,2025-05-24T22:34:00+02:00,2025-05-25,06:34,1,1,2
182,2025-05-24T22:35:00+02:00,2025-05-25,06:35,1,1,2
180,2025-05-24T22:37:00+02:00,2025-05-25,06:37,1,0,1
3,2025-05-24T22:25:00+02:00,2025-05-25,06:25,0,1,1
3,2025-05-24T22:27:00+02:00,2025-05-25,06:27,2,0,2
3,2025-05-24T22:28:00+02:00,2025-05-25,06:28,0,1,1
3,2025-05-24T22:30:00+02:00,2025-05-25,06:30,1,0,1
3,2025-05-24T22:38:00+02:00,2025-05-25,06:38,2,0,2
4,2025-05-24T22:29:00+02:00,2025-05-25,06:29,5,0,5
4,2025-05-24T22:35:00+02:00,2025-05-25,06:35,1,0,1
4,2025-05-24T22:39:00+02:00,2025-05-25,06:39,3,2,5
5,2025-05-24T22:25:00+02:00,2025-05-25,06:25,0,2,2
6,2025-05-24T22:26:00+02:00,2025-05-25,06:26,2,1,3
6,2025-05-24T22:27:00+02:00,2025-05-25,06:27,1,0,1
6,2025-05-24T22:28:00+02:00,2025-05-25,06:28,2,0,2
6,2025-05-24T22:31:00+02:00,2025-05-25,06:31,6,1,7
6,2025-05-24T22:32:00+02:00,2025-05-25,06:32,1,2,3
6,2025-05-24T22:34:00+02:00,2025-05-25,06:34,1,3,4
6,2025-05-24T22:36:00+02:00,2025-05-25,06:36,1,0,1
6,2025-05-24T22:37:00+02:00,2025-05-25,06:37,1,0,1
6,2025-05-24T22:38:00+02:00,2025-05-25,06:38,1,3,4
28,2025-05-24T22:25:00+02:00,2025-05-25,06:25,1,0,1
28,2025-05-24T22:29:00+02:00,2025-05-25,06:29,2,1,3
28,2025-05-24T22:30:00+02:00,2025-05-25,06:30,0,1,1
28,2025-05-24T22:32:00+02:00,2025-05-25,06:32,1,0,1
28,2025-05-24T22:34:00+02:00,2025-05-25,06:34,0,2,2
28,2025-05-24T22:35:00+02:00,2025-05-25,06:35,0,1,1
28,2025-05-24T22:39:00+02:00,2025-05-25,06:39,2,1,3
29,2025-05-24T22:29:00+02:00,2025-05-25,06:29,0,1,1
31,2025-05-24T22:28:00+02:00,2025-05-25,06:28,7,0,7
36,2025-05-24T22:30:00+02:00,2025-05-25,06:30,0,1,1
37,2025-05-24T22:36:00+02:00,2025-05-25,06:36,0,6,6
39,2025-05-24T22:28:00+02:00,2025-05-25,06:28,1,0,1
39,2025-05-24T22:39:00+02:00,2025-05-25,06:39,0,1,1
40,2025-05-24T22:38:00+02:00,2025-05-25,06:38,1,0,1
41,2025-05-24T22:32:00+02:00,2025-05-25,06:32,1,2,3
44,2025-05-24T22:35:00+02:00,2025-05-25,06:35,1,0,1
45,2025-05-24T22:28:00+02:00,2025-05-25,06:28,2,0,2
45,2025-05-24T22:30:00+02:00,2025-05-25,06:30,0,2,2
45,2025-05-24T22:38:00+02:00,2025-05-25,06:38,2,0,2
47,2025-05-24T22:26:00+02:00,2025-05-25,06:26,0,1,1
47,2025-05-24T22:30:00+02:00,2025-05-25,06:30,0,3,3
54,2025-05-24T22:28:00+02:00,2025-05-25,06:28,0,1,1
54,2025-05-24T22:31:00+02:00,2025-05-25,06:31,1,0,1
54,2025-05-24T22:37:00+02:00,2025-05-25,06:37,0,1,1
59,2025-05-24T22:30:00+02:00,2025-05-25,06:30,0,3,3
61,2025-05-24T22:38:00+02:00,2025-05-25,06:38,1,0,1
66,2025-05-24T22:30:00+02:00,2025-05-25,06:30,0,1,1
66,2025-05-24T22:31:00+02:00,2025-05-25,06:31,1,0,1
66,2025-05-24T22:32:00+02:00,2025-05-25,06:32,0,2,2
66,2025-05-24T22:33:00+02:00,2025-05-25,06:33,0,2,2
66,2025-05-24T22:35:00+02:00,2025-05-25,06:35,1,1,2
66,2025-05-24T22:36:00+02:00,2025-05-25,06:36,0,1,1
70,2025-05-24T22:31:00+02:00,2025-05-25,06:31,0,1,1
75,2025-05-24T22:29:00+02:00,2025-05-25,06:29,0,1,1
78,2025-05-24T22:32:00+02:00,2025-05-25,06:32,0,1,1
78,2025-05-24T22:35:00+02:00,2025-05-25,06:35,0,1,1
84,2025-05-24T22:25:00+02:00,2025-05-25,06:25,1,11,12
84,2025-05-24T22:30:00+02:00,2025-05-25,06:30,4,2,6
84,2025-05-24T22:35:00+02:00,2025-05-25,06:35,4,4,8
107,2025-05-24T22:30:00+02:00,2025-05-25,06:30,1,0,1
108,2025-05-24T22:36:00+02:00,2025-05-25,06:36,1,0,1
108,2025-05-24T22:37:00+02:00,2025-05-25,06:37,0,1,1
131,2025-05-24T22:25:00+02:00,2025-05-25,06:25,0,3,3
131,2025-05-24T22:35:00+02:00,2025-05-25,06:35,0,1,1
132,2025-05-24T22:25:00+02:00,2025-05-25,06:25,4,1,5
135,2025-05-24T22:25:00+02:00,2025-05-25,06:25,12,1,13
135,2025-05-24T22:30:00+02:00,2025-05-25,06:30,8,5,13
162,2025-05-24T22:30:00+02:00,2025-05-25,06:30,1,5,6
162,2025-05-24T22:35:00+02:00,2025-05-25,06:35,1,1,2
179,2025-05-24T22:35:00+02:00,2025-05-25,06:35,2,0,2
1,2025-05-24T22:34:00+02:00,2025-05-25,06:34,0,1,1
2,2025-05-24T22:26:00+02:00,2025-05-25,06:26,1,1,2
9,2025-05-24T22:26:00+02:00,2025-05-25,06:26,0,1,1
12,2025-05-24T22:31:00+02:00,2025-05-25,06:31,0,3,3
12,2025-05-24T22:36:00+02:00,2025-05-25,06:36,1,0,1
12,2025-05-24T22:37:00+02:00,2025-05-25,06:37,4,0,4
17,2025-05-24T22:29:00+02:00,2025-05-25,06:29,0,1,1
17,2025-05-24T22:35:00+02:00,2025-05-25,06:35,0,1,1
17,2025-05-24T22:37:00+02:00,2025-05-25,06:37,1,0,1
19,2025-05-24T22:37:00+02:00,2025-05-25,06:37,0,1,1
20,2025-05-24T22:26:00+02:00,2025-05-25,06:26,0,2,2
23,2025-05-24T22:28:00+02:00,2025-05-25,06:28,1,0,1
23,2025-05-24T22:30:00+02:00,2025-05-25,06:30,1,3,4
24,2025-05-24T22:26:00+02:00,2025-05-25,06:26,1,0,1
24,2025-05-24T22:27:00+02:00,2025-05-25,06:27,1,2,3
25,2025-05-24T22:25:00+02:00,2025-05-25,06:25,5,6,11
30,2025-05-24T22:30:00+02:00,2025-05-25,06:30,0,1,1
30,2025-05-24T22:31:00+02:00,2025-05-25,06:31,2,0,2
30,2025-05-24T22:33:00+02:00,2025-05-25,06:33,3,0,3
30,2025-05-24T22:38:00+02:00,2025-05-25,06:38,1,2,3
30,2025-05-24T22:39:00+02:00,2025-05-25,06:39,0,1,1
35,2025-05-24T22:32:00+02:00,2025-05-25,06:32,1,1,2
35,2025-05-24T22:33:00+02:00,2025-05-25,06:33,2,0,2
48,2025-05-24T22:25:00+02:00,2025-05-25,06:25,0,3,3
48,2025-05-24T22:32:00+02:00,2025-05-25,06:32,0,1,1
48,2025-05-24T22:37:00+02:00,2025-05-25,06:37,0,3,3
49,2025-05-24T22:26:00+02:00,2025-05-25,06:26,0,2,2
49,2025-05-24T22:33:00+02:00,2025-05-25,06:33,3,0,3
49,2025-05-24T22:35:00+02:00,2025-05-25,06:35,0,3,3
49,2025-05-24T22:38:00+02:00,2025-05-25,06:38,3,0,3
51,2025-05-24T22:32:00+02:00,2025-05-25,06:32,0,1,1
52,2025-05-24T22:26:00+02:00,2025-05-25,06:26,2,0,2
53,2025-05-24T22:35:00+02:00,2025-05-25,06:35,0,1,1
53,2025-05-24T22:37:00+02:00,2025-05-25,06:37,0,1,1
56,2025-05-24T22:37:00+02:00,2025-05-25,06:37,0,1,1
58,2025-05-24T22:27:00+02:00,2025-05-25,06:27,1,0,1
58,2025-05-24T22:30:00+02:00,2025-05-25,06:30,1,0,1
62,2025-05-24T22:26:00+02:00,2025-05-25,06:26,2,0,2
67,2025-05-24T22:25:00+02:00,2025-05-25,06:25,1,0,1
79,2025-05-24T22:26:00+02:00,2025-05-25,06:26,0,2,2
79,2025-05-24T22:38:00+02:00,2025-05-25,06:38,1,0,1
109,2025-05-24T22:30:00+02:00,2025-05-25,06:30,1,1,2
117,2025-05-24T22:25:00+02:00,2025-05-25,06:25,0,2,2
130,2025-05-24T22:35:00+02:00,2025-05-25,06:35,1,0,1
139,2025-05-24T22:35:00+02:00,2025-05-25,06:35,1,0,1
3,2025-05-24T21:44:00+02:00,2025-05-25,05:44,1,0,1
3,2025-05-24T21:48:00+02:00,2025-05-25,05:48,0,1,1
4,2025-05-24T21:43:00+02:00,2025-05-25,05:43,0,1,1
4,2025-05-24T21:48:00+02:00,2025-05-25,05:48,0,1,1
5,2025-05-24T21:45:00+02:00,2025-05-25,05:45,0,1,1
6,2025-05-24T21:44:00+02:00,2025-05-25,05:44,1,1,2
6,2025-05-24T21:48:00+02:00,2025-05-25,05:48,0,1,1
6,2025-05-24T21:49:00+02:00,2025-05-25,05:49,0,1,1
6,2025-05-24T21:51:00+02:00,2025-05-25,05:51,0,4,4
28,2025-05-24T21:44:00+02:00,2025-05-25,05:44,3,1,4
28,2025-05-24T21:54:00+02:00,2025-05-25,05:54,0,1,1
29,2025-05-24T21:41:00+02:00,2025-05-25,05:41,0,1,1
31,2025-05-24T21:40:00+02:00,2025-05-25,05:40,0,1,1
31,2025-05-24T21:53:00+02:00,2025-05-25,05:53,0,1,1
36,2025-05-24T21:46:00+02:00,2025-05-25,05:46,1,0,1
36,2025-05-24T21:47:00+02:00,2025-05-25,05:47,2,0,2
39,2025-05-24T21:50:00+02:00,2025-05-25,05:50,1,0,1
40,2025-05-24T21:41:00+02:00,2025-05-25,05:41,0,1,1
40,2025-05-24T21:52:00+02:00,2025-05-25,05:52,1,0,1
41,2025-05-24T21:50:00+02:00,2025-05-25,05:50,1,0,1
41,2025-05-24T21:51:00+02:00,2025-05-25,05:51,0,1,1
45,2025-05-24T21:43:00+02:00,2025-05-25,05:43,1,0,1
47,2025-05-24T21:40:00+02:00,2025-05-25,05:40,0,1,1
47,2025-05-24T21:53:00+02:00,2025-05-25,05:53,0,1,1
59,2025-05-24T21:40:00+02:00,2025-05-25,05:40,0,1,1
59,2025-05-24T21:45:00+02:00,2025-05-25,05:45,0,2,2
61,2025-05-24T21:42:00+02:00,2025-05-25,05:42,0,1,1
66,2025-05-24T21:42:00+02:00,2025-05-25,05:42,1,0,1
66,2025-05-24T21:46:00+02:00,2025-05-25,05:46,0,1,1
71,2025-05-24T21:47:00+02:00,2025-05-25,05:47,1,0,1
71,2025-05-24T21:48:00+02:00,2025-05-25,05:48,0,1,1
77,2025-05-24T21:50:00+02:00,2025-05-25,05:50,1,0,1
84,2025-05-24T21:40:00+02:00,2025-05-25,05:40,3,0,3
87,2025-05-24T21:46:00+02:00,2025-05-25,05:46,2,0,2
108,2025-05-24T21:49:00+02:00,2025-05-25,05:49,1,1,2
131,2025-05-24T21:45:00+02:00,2025-05-25,05:45,3,10,13
131,2025-05-24T21:50:00+02:00,2025-05-25,05:50,1,2,3
132,2025-05-24T21:40:00+02:00,2025-05-25,05:40,2,0,2
133,2025-05-24T21:45:00+02:00,2025-05-25,05:45,7,4,11
134,2025-05-24T21:40:00+02:00,2025-05-25,05:40,3,4,7
135,2025-05-24T21:40:00+02:00,2025-05-25,05:40,3,1,4
162,2025-05-24T21:50:00+02:00,2025-05-25,05:50,3,2,5
179,2025-05-24T21:40:00+02:00,2025-05-25,05:40,0,1,1
1,2025-05-24T21:53:00+02:00,2025-05-25,05:53,1,1,2
2,2025-05-24T21:51:00+02:00,2025-05-25,05:51,2,1,3
9,2025-05-24T21:42:00+02:00,2025-05-25,05:42,0,1,1
11,2025-05-24T21:43:00+02:00,2025-05-25,05:43,2,0,2
12,2025-05-24T21:45:00+02:00,2025-05-25,05:45,0,1,1
17,2025-05-24T21:45:00+02:00,2025-05-25,05:45,0,1,1
19,2025-05-24T21:45:00+02:00,2025-05-25,05:45,0,2,2
20,2025-05-24T21:47:00+02:00,2025-05-25,05:47,1,2,3
23,2025-05-24T21:45:00+02:00,2025-05-25,05:45,0,1,1
24,2025-05-24T21:45:00+02:00,2025-05-25,05:45,0,1,1
24,2025-05-24T21:47:00+02:00,2025-05-25,05:47,1,0,1
24,2025-05-24T21:49:00+02:00,2025-05-25,05:49,0,1,1
25,2025-05-24T21:50:00+02:00,2025-05-25,05:50,1,1,2
30,2025-05-24T21:43:00+02:00,2025-05-25,05:43,0,2,2
30,2025-05-24T21:44:00+02:00,2025-05-25,05:44,1,3,4
30,2025-05-24T21:48:00+02:00,2025-05-25,05:48,0,2,2
35,2025-05-24T21:45:00+02:00,2025-05-25,05:45,1,0,1
35,2025-05-24T21:49:00+02:00,2025-05-25,05:49,1,1,2
35,2025-05-24T21:50:00+02:00,2025-05-25,05:50,0,1,1
49,2025-05-24T21:40:00+02:00,2025-05-25,05:40,1,0,1
49,2025-05-24T21:43:00+02:00,2025-05-25,05:43,0,5,5
49,2025-05-24T21:48:00+02:00,2025-05-25,05:48,1,0,1
49,2025-05-24T21:49:00+02:00,2025-05-25,05:49,0,1,1
49,2025-05-24T21:52:00+02:00,2025-05-25,05:52,1,0,1
51,2025-05-24T21:40:00+02:00,2025-05-25,05:40,0,1,1
53,2025-05-24T21:46:00+02:00,2025-05-25,05:46,0,1,1
53,2025-05-24T21:50:00+02:00,2025-05-25,05:50,1,0,1
53,2025-05-24T21:51:00+02:00,2025-05-25,05:51,1,0,1
56,2025-05-24T21:40:00+02:00,2025-05-25,05:40,0,3,3
56,2025-05-24T21:41:00+02:00,2025-05-25,05:41,3,0,3
56,2025-05-24T21:45:00+02:00,2025-05-25,05:45,0,1,1
56,2025-05-24T21:48:00+02:00,2025-05-25,05:48,1,0,1
58,2025-05-24T21:43:00+02:00,2025-05-25,05:43,1,0,1
58,2025-05-24T21:49:00+02:00,2025-05-25,05:49,1,1,2
62,2025-05-24T21:47:00+02:00,2025-05-25,05:47,1,0,1
62,2025-05-24T21:50:00+02:00,2025-05-25,05:50,0,1,1
63,2025-05-24T21:40:00+02:00,2025-05-25,05:40,0,1,1
76,2025-05-24T21:49:00+02:00,2025-05-25,05:49,2,0,2
79,2025-05-24T21:47:00+02:00,2025-05-25,05:47,1,0,1
109,2025-05-24T21:40:00+02:00,2025-05-25,05:40,0,1,1
141,2025-05-24T21:45:00+02:00,2025-05-25,05:45,0,1,1
141,2025-05-24T21:50:00+02:00,2025-05-25,05:50,2,0,2
181,2025-05-24T21:52:00+02:00,2025-05-25,05:52,1,2,3
181,2025-05-24T22:04:00+02:00,2025-05-25,06:04,1,0,1
181,2025-05-24T22:05:00+02:00,2025-05-25,06:05,1,0,1
181,2025-05-24T22:08:00+02:00,2025-05-25,06:08,0,1,1
3,2025-05-24T23:28:00+02:00,2025-05-25,07:28,2,0,2
3,2025-05-24T23:36:00+02:00,2025-05-25,07:36,1,1,2
4,2025-05-24T23:27:00+02:00,2025-05-25,07:27,1,0,1
4,2025-05-24T23:31:00+02:00,2025-05-25,07:31,1,0,1
4,2025-05-24T23:33:00+02:00,2025-05-25,07:33,2,4,6
4,2025-05-24T23:37:00+02:00,2025-05-25,07:37,3,1,4
4,2025-05-24T23:38:00+02:00,2025-05-25,07:38,1,0,1
6,2025-05-24T23:25:00+02:00,2025-05-25,07:25,4,8,12
6,2025-05-24T23:30:00+02:00,2025-05-25,07:30,2,0,2
6,2025-05-24T23:35:00+02:00,2025-05-25,07:35,5,1,6
6,2025-05-24T23:36:00+02:00,2025-05-25,07:36,0,1,1
6,2025-05-24T23:37:00+02:00,2025-05-25,07:37,1,1,2
6,2025-05-24T23:38:00+02:00,2025-05-25,07:38,2,1,3
8,2025-05-24T23:31:00+02:00,2025-05-25,07:31,2,0,2
8,2025-05-24T23:39:00+02:00,2025-05-25,07:39,0,2,2
28,2025-05-24T23:37:00+02:00,2025-05-25,07:37,1,5,6
28,2025-05-24T23:38:00+02:00,2025-05-25,07:38,1,1,2
29,2025-05-24T23:27:00+02:00,2025-05-25,07:27,1,3,4
29,2025-05-24T23:33:00+02:00,2025-05-25,07:33,0,2,2
29,2025-05-24T23:36:00+02:00,2025-05-25,07:36,1,1,2
29,2025-05-24T23:39:00+02:00,2025-05-25,07:39,2,2,4
31,2025-05-24T23:28:00+02:00,2025-05-25,07:28,1,0,1
36,2025-05-24T23:33:00+02:00,2025-05-25,07:33,0,2,2
36,2025-05-24T23:36:00+02:00,2025-05-25,07:36,1,0,1
39,2025-05-24T23:38:00+02:00,2025-05-25,07:38,1,0,1
41,2025-05-24T23:26:00+02:00,2025-05-25,07:26,0,1,1
41,2025-05-24T23:28:00+02:00,2025-05-25,07:28,2,0,2
45,2025-05-24T23:32:00+02:00,2025-05-25,07:32,1,5,6
45,2025-05-24T23:33:00+02:00,2025-05-25,07:33,2,0,2
45,2025-05-24T23:35:00+02:00,2025-05-25,07:35,2,1,3
47,2025-05-24T23:25:00+02:00,2025-05-25,07:25,2,0,2
47,2025-05-24T23:29:00+02:00,2025-05-25,07:29,3,1,4
47,2025-05-24T23:32:00+02:00,2025-05-25,07:32,5,1,6
47,2025-05-24T23:33:00+02:00,2025-05-25,07:33,1,2,3
50,2025-05-24T23:33:00+02:00,2025-05-25,07:33,1,0,1
50,2025-05-24T23:38:00+02:00,2025-05-25,07:38,1,1,2
54,2025-05-24T23:25:00+02:00,2025-05-25,07:25,0,1,1
54,2025-05-24T23:33:00+02:00,2025-05-25,07:33,0,1,1
54,2025-05-24T23:36:00+02:00,2025-05-25,07:36,2,0,2
59,2025-05-24T23:35:00+02:00,2025-05-25,07:35,0,7,7
61,2025-05-24T23:31:00+02:00,2025-05-25,07:31,0,1,1
66,2025-05-24T23:26:00+02:00,2025-05-25,07:26,1,0,1
66,2025-05-24T23:29:00+02:00,2025-05-25,07:29,0,2,2
66,2025-05-24T23:34:00+02:00,2025-05-25,07:34,0,1,1
69,2025-05-24T23:32:00+02:00,2025-05-25,07:32,1,1,2
69,2025-05-24T23:38:00+02:00,2025-05-25,07:38,1,0,1
70,2025-05-24T23:39:00+02:00,2025-05-25,07:39,0,3,3
75,2025-05-24T23:32:00+02:00,2025-05-25,07:32,1,0,1
77,2025-05-24T23:25:00+02:00,2025-05-25,07:25,1,3,4
78,2025-05-24T23:27:00+02:00,2025-05-25,07:27,1,0,1
87,2025-05-24T23:27:00+02:00,2025-05-25,07:27,1,0,1
108,2025-05-24T23:26:00+02:00,2025-05-25,07:26,0,1,1
108,2025-05-24T23:30:00+02:00,2025-05-25,07:30,0,5,5
108,2025-05-24T23:38:00+02:00,2025-05-25,07:38,0,1,1
132,2025-05-24T23:35:00+02:00,2025-05-25,07:35,2,2,4
133,2025-05-24T23:25:00+02:00,2025-05-25,07:25,12,16,28
133,2025-05-24T23:30:00+02:00,2025-05-25,07:30,7,21,28
133,2025-05-24T23:35:00+02:00,2025-05-25,07:35,15,24,39
134,2025-05-24T23:25:00+02:00,2025-05-25,07:25,11,10,21
134,2025-05-24T23:35:00+02:00,2025-05-25,07:35,22,9,31
135,2025-05-24T23:30:00+02:00,2025-05-25,07:30,10,6,16
135,2025-05-24T23:35:00+02:00,2025-05-25,07:35,13,5,18
140,2025-05-24T23:30:00+02:00,2025-05-25,07:30,2,2,4
162,2025-05-24T23:30:00+02:00,2025-05-25,07:30,9,2,11
162,2025-05-24T23:35:00+02:00,2025-05-25,07:35,5,2,7
165,2025-05-24T23:25:00+02:00,2025-05-25,07:25,2,0,2
165,2025-05-24T23:30:00+02:00,2025-05-25,07:30,0,3,3
179,2025-05-24T23:25:00+02:00,2025-05-25,07:25,0,1,1
179,2025-05-24T23:35:00+02:00,2025-05-25,07:35,1,0,1
1,2025-05-24T23:31:00+02:00,2025-05-25,07:31,1,0,1
2,2025-05-24T23:29:00+02:00,2025-05-25,07:29,0,1,1
2,2025-05-24T23:31:00+02:00,2025-05-25,07:31,1,0,1
2,2025-05-24T23:32:00+02:00,2025-05-25,07:32,0,1,1
9,2025-05-24T23:33:00+02:00,2025-05-25,07:33,0,1,1
9,2025-05-24T23:35:00+02:00,2025-05-25,07:35,4,1,5
9,2025-05-24T23:39:00+02:00,2025-05-25,07:39,0,1,1
10,2025-05-24T23:33:00+02:00,2025-05-25,07:33,1,0,1
11,2025-05-24T23:30:00+02:00,2025-05-25,07:30,0,1,1
11,2025-05-24T23:32:00+02:00,2025-05-25,07:32,2,0,2
12,2025-05-24T23:36:00+02:00,2025-05-25,07:36,1,1,2
18,2025-05-24T23:37:00+02:00,2025-05-25,07:37,0,1,1
19,2025-05-24T23:38:00+02:00,2025-05-25,07:38,0,1,1
23,2025-05-24T23:27:00+02:00,2025-05-25,07:27,1,0,1
23,2025-05-24T23:28:00+02:00,2025-05-25,07:28,2,2,4
23,2025-05-24T23:29:00+02:00,2025-05-25,07:29,0,1,1
23,2025-05-24T23:35:00+02:00,2025-05-25,07:35,0,2,2
23,2025-05-24T23:37:00+02:00,2025-05-25,07:37,0,2,2
23,2025-05-24T23:38:00+02:00,2025-05-25,07:38,1,4,5
24,2025-05-24T23:33:00+02:00,2025-05-25,07:33,4,0,4
24,2025-05-24T23:36:00+02:00,2025-05-25,07:36,1,4,5
24,2025-05-24T23:39:00+02:00,2025-05-25,07:39,4,2,6
27,2025-05-24T23:30:00+02:00,2025-05-25,07:30,0,1,1
27,2025-05-24T23:31:00+02:00,2025-05-25,07:31,1,0,1
30,2025-05-24T23:25:00+02:00,2025-05-25,07:25,0,1,1
30,2025-05-24T23:32:00+02:00,2025-05-25,07:32,0,5,5
30,2025-05-24T23:34:00+02:00,2025-05-25,07:34,0,2,2
35,2025-05-24T23:35:00+02:00,2025-05-25,07:35,3,3,6
35,2025-05-24T23:38:00+02:00,2025-05-25,07:38,3,1,4
48,2025-05-24T23:26:00+02:00,2025-05-25,07:26,1,0,1
48,2025-05-24T23:33:00+02:00,2025-05-25,07:33,1,0,1
48,2025-05-24T23:39:00+02:00,2025-05-25,07:39,0,1,1
49,2025-05-24T23:28:00+02:00,2025-05-25,07:28,1,0,1
49,2025-05-24T23:29:00+02:00,2025-05-25,07:29,1,2,3
49,2025-05-24T23:33:00+02:00,2025-05-25,07:33,1,1,2
49,2025-05-24T23:34:00+02:00,2025-05-25,07:34,1,0,1
51,2025-05-24T23:38:00+02:00,2025-05-25,07:38,2,0,2
52,2025-05-24T23:25:00+02:00,2025-05-25,07:25,1,0,1
52,2025-05-24T23:35:00+02:00,2025-05-25,07:35,0,1,1
52,2025-05-24T23:38:00+02:00,2025-05-25,07:38,1,0,1
53,2025-05-24T23:28:00+02:00,2025-05-25,07:28,0,3,3
53,2025-05-24T23:32:00+02:00,2025-05-25,07:32,2,0,2
53,2025-05-24T23:34:00+02:00,2025-05-25,07:34,0,3,3
53,2025-05-24T23:38:00+02:00,2025-05-25,07:38,0,1,1
53,2025-05-24T23:39:00+02:00,2025-05-25,07:39,0,1,1
56,2025-05-24T23:27:00+02:00,2025-05-25,07:27,1,1,2
56,2025-05-24T23:32:00+02:00,2025-05-25,07:32,0,1,1
56,2025-05-24T23:33:00+02:00,2025-05-25,07:33,1,1,2
58,2025-05-24T23:25:00+02:00,2025-05-25,07:25,1,1,2
58,2025-05-24T23:26:00+02:00,2025-05-25,07:26,1,0,1
58,2025-05-24T23:30:00+02:00,2025-05-25,07:30,1,1,2
58,2025-05-24T23:31:00+02:00,2025-05-25,07:31,2,3,5
58,2025-05-24T23:34:00+02:00,2025-05-25,07:34,4,6,10
58,2025-05-24T23:35:00+02:00,2025-05-25,07:35,0,1,1
58,2025-05-24T23:39:00+02:00,2025-05-25,07:39,4,3,7
62,2025-05-24T23:27:00+02:00,2025-05-25,07:27,1,2,3
62,2025-05-24T23:35:00+02:00,2025-05-25,07:35,1,0,1
62,2025-05-24T23:37:00+02:00,2025-05-25,07:37,0,1,1
62,2025-05-24T23:39:00+02:00,2025-05-25,07:39,0,1,1
63,2025-05-24T23:32:00+02:00,2025-05-25,07:32,0,2,2
63,2025-05-24T23:35:00+02:00,2025-05-25,07:35,0,1,1
63,2025-05-24T23:37:00+02:00,2025-05-25,07:37,0,1,1
67,2025-05-24T23:26:00+02:00,2025-05-25,07:26,3,1,4
67,2025-05-24T23:28:00+02:00,2025-05-25,07:28,0,1,1
67,2025-05-24T23:31:00+02:00,2025-05-25,07:31,0,3,3
67,2025-05-24T23:32:00+02:00,2025-05-25,07:32,0,6,6
67,2025-05-24T23:33:00+02:00,2025-05-25,07:33,0,1,1
67,2025-05-24T23:37:00+02:00,2025-05-25,07:37,1,2,3
68,2025-05-24T23:27:00+02:00,2025-05-25,07:27,1,0,1
72,2025-05-24T23:25:00+02:00,2025-05-25,07:25,1,0,1
72,2025-05-24T23:34:00+02:00,2025-05-25,07:34,0,2,2
72,2025-05-24T23:37:00+02:00,2025-05-25,07:37,1,0,1
79,2025-05-24T23:25:00+02:00,2025-05-25,07:25,0,1,1
79,2025-05-24T23:30:00+02:00,2025-05-25,07:30,1,0,1
79,2025-05-24T23:32:00+02:00,2025-05-25,07:32,2,1,3
79,2025-05-24T23:35:00+02:00,2025-05-25,07:35,0,2,2
79,2025-05-24T23:36:00+02:00,2025-05-25,07:36,0,1,1
79,2025-05-24T23:39:00+02:00,2025-05-25,07:39,1,0,1
85,2025-05-24T23:29:00+02:00,2025-05-25,07:29,1,0,1
86,2025-05-24T23:33:00+02:00,2025-05-25,07:33,1,0,1
117,2025-05-24T23:25:00+02:00,2025-05-25,07:25,2,2,4
117,2025-05-24T23:35:00+02:00,2025-05-25,07:35,0,3,3
123,2025-05-24T23:25:00+02:00,2025-05-25,07:25,2,0,2
130,2025-05-24T23:30:00+02:00,2025-05-25,07:30,1,3,4
136,2025-05-24T23:25:00+02:00,2025-05-25,07:25,25,4,29
141,2025-05-24T23:30:00+02:00,2025-05-25,07:30,0,1,1
142,2025-05-24T23:25:00+02:00,2025-05-25,07:25,24,9,33
142,2025-05-24T23:30:00+02:00,2025-05-25,07:30,17,4,21
161,2025-05-24T23:35:00+02:00,2025-05-25,07:35,6,13,19
181,2025-05-24T23:12:00+02:00,2025-05-25,07:12,2,3,5
181,2025-05-24T23:15:00+02:00,2025-05-25,07:15,1,2,3
181,2025-05-24T23:21:00+02:00,2025-05-25,07:21,2,2,4
181,2025-05-24T23:24:00+02:00,2025-05-25,07:24,1,2,3
182,2025-05-24T23:10:00+02:00,2025-05-25,07:10,3,3,6
181,2025-05-24T23:37:00+02:00,2025-05-25,07:37,3,5,8
181,2025-05-24T23:38:00+02:00,2025-05-25,07:38,0,3,3
182,2025-05-24T23:30:00+02:00,2025-05-25,07:30,2,6,8
180,2025-05-24T23:29:00+02:00,2025-05-25,07:29,2,0,2
3,2025-05-24T23:14:00+02:00,2025-05-25,07:14,2,0,2
3,2025-05-24T23:15:00+02:00,2025-05-25,07:15,0,2,2
3,2025-05-24T23:19:00+02:00,2025-05-25,07:19,1,0,1
3,2025-05-24T23:23:00+02:00,2025-05-25,07:23,1,3,4
4,2025-05-24T23:15:00+02:00,2025-05-25,07:15,1,0,1
4,2025-05-24T23:18:00+02:00,2025-05-25,07:18,2,1,3
4,2025-05-24T23:20:00+02:00,2025-05-25,07:20,2,1,3
4,2025-05-24T23:24:00+02:00,2025-05-25,07:24,0,1,1
5,2025-05-24T23:20:00+02:00,2025-05-25,07:20,2,1,3
6,2025-05-24T23:11:00+02:00,2025-05-25,07:11,0,1,1
6,2025-05-24T23:14:00+02:00,2025-05-25,07:14,2,1,3
6,2025-05-24T23:15:00+02:00,2025-05-25,07:15,2,5,7
6,2025-05-24T23:19:00+02:00,2025-05-25,07:19,2,2,4
6,2025-05-24T23:22:00+02:00,2025-05-25,07:22,5,0,5
6,2025-05-24T23:23:00+02:00,2025-05-25,07:23,1,1,2
6,2025-05-24T23:24:00+02:00,2025-05-25,07:24,0,1,1
8,2025-05-24T23:10:00+02:00,2025-05-25,07:10,0,1,1
8,2025-05-24T23:15:00+02:00,2025-05-25,07:15,1,1,2
8,2025-05-24T23:22:00+02:00,2025-05-25,07:22,0,1,1
8,2025-05-24T23:24:00+02:00,2025-05-25,07:24,2,1,3
28,2025-05-24T23:12:00+02:00,2025-05-25,07:12,2,0,2
28,2025-05-24T23:14:00+02:00,2025-05-25,07:14,2,1,3
29,2025-05-24T23:11:00+02:00,2025-05-25,07:11,0,1,1
29,2025-05-24T23:15:00+02:00,2025-05-25,07:15,0,1,1
29,2025-05-24T23:21:00+02:00,2025-05-25,07:21,2,0,2
29,2025-05-24T23:24:00+02:00,2025-05-25,07:24,1,2,3
31,2025-05-24T23:16:00+02:00,2025-05-25,07:16,0,2,2
31,2025-05-24T23:21:00+02:00,2025-05-25,07:21,1,0,1
40,2025-05-24T23:14:00+02:00,2025-05-25,07:14,1,0,1
40,2025-05-24T23:20:00+02:00,2025-05-25,07:20,0,3,3
40,2025-05-24T23:21:00+02:00,2025-05-25,07:21,1,0,1
41,2025-05-24T23:10:00+02:00,2025-05-25,07:10,1,1,2
41,2025-05-24T23:11:00+02:00,2025-05-25,07:11,0,1,1
41,2025-05-24T23:17:00+02:00,2025-05-25,07:17,2,8,10
43,2025-05-24T23:20:00+02:00,2025-05-25,07:20,2,1,3
45,2025-05-24T23:13:00+02:00,2025-05-25,07:13,0,2,2
45,2025-05-24T23:20:00+02:00,2025-05-25,07:20,1,1,2
45,2025-05-24T23:21:00+02:00,2025-05-25,07:21,0,2,2
45,2025-05-24T23:24:00+02:00,2025-05-25,07:24,2,3,5
47,2025-05-24T23:10:00+02:00,2025-05-25,07:10,1,3,4
47,2025-05-24T23:13:00+02:00,2025-05-25,07:13,1,0,1
47,2025-05-24T23:15:00+02:00,2025-05-25,07:15,2,4,6
47,2025-05-24T23:16:00+02:00,2025-05-25,07:16,2,0,2
47,2025-05-24T23:20:00+02:00,2025-05-25,07:20,0,3,3
50,2025-05-24T23:11:00+02:00,2025-05-25,07:11,1,0,1
54,2025-05-24T23:16:00+02:00,2025-05-25,07:16,3,0,3
54,2025-05-24T23:24:00+02:00,2025-05-25,07:24,0,1,1
61,2025-05-24T23:10:00+02:00,2025-05-25,07:10,0,1,1
66,2025-05-24T23:10:00+02:00,2025-05-25,07:10,0,4,4
66,2025-05-24T23:15:00+02:00,2025-05-25,07:15,2,3,5
66,2025-05-24T23:18:00+02:00,2025-05-25,07:18,0,1,1
66,2025-05-24T23:24:00+02:00,2025-05-25,07:24,0,1,1
69,2025-05-24T23:22:00+02:00,2025-05-25,07:22,1,0,1
69,2025-05-24T23:24:00+02:00,2025-05-25,07:24,3,0,3
77,2025-05-24T23:10:00+02:00,2025-05-25,07:10,2,4,6
77,2025-05-24T23:15:00+02:00,2025-05-25,07:15,1,2,3
78,2025-05-24T23:21:00+02:00,2025-05-25,07:21,4,1,5
84,2025-05-24T23:15:00+02:00,2025-05-25,07:15,6,7,13
84,2025-05-24T23:20:00+02:00,2025-05-25,07:20,19,5,24
87,2025-05-24T23:16:00+02:00,2025-05-25,07:16,1,1,2
131,2025-05-24T23:10:00+02:00,2025-05-25,07:10,0,3,3
132,2025-05-24T23:20:00+02:00,2025-05-25,07:20,1,0,1
133,2025-05-24T23:20:00+02:00,2025-05-25,07:20,11,25,36
135,2025-05-24T23:10:00+02:00,2025-05-25,07:10,3,2,5
135,2025-05-24T23:20:00+02:00,2025-05-25,07:20,5,11,16
162,2025-05-24T23:10:00+02:00,2025-05-25,07:10,5,5,10
162,2025-05-24T23:15:00+02:00,2025-05-25,07:15,3,1,4
165,2025-05-24T23:10:00+02:00,2025-05-25,07:10,1,1,2
166,2025-05-24T23:20:00+02:00,2025-05-25,07:20,1,2,3
167,2025-05-24T23:15:00+02:00,2025-05-25,07:15,0,1,1
2,2025-05-24T23:15:00+02:00,2025-05-25,07:15,0,2,2
9,2025-05-24T23:11:00+02:00,2025-05-25,07:11,1,1,2
11,2025-05-24T23:15:00+02:00,2025-05-25,07:15,2,0,2
11,2025-05-24T23:23:00+02:00,2025-05-25,07:23,1,0,1
12,2025-05-24T23:12:00+02:00,2025-05-25,07:12,1,0,1
12,2025-05-24T23:14:00+02:00,2025-05-25,07:14,2,0,2
12,2025-05-24T23:16:00+02:00,2025-05-25,07:16,1,0,1
12,2025-05-24T23:20:00+02:00,2025-05-25,07:20,0,1,1
17,2025-05-24T23:16:00+02:00,2025-05-25,07:16,5,0,5
17,2025-05-24T23:23:00+02:00,2025-05-25,07:23,1,0,1
17,2025-05-24T23:24:00+02:00,2025-05-25,07:24,1,1,2
23,2025-05-24T23:13:00+02:00,2025-05-25,07:13,1,1,2
23,2025-05-24T23:14:00+02:00,2025-05-25,07:14,1,1,2
23,2025-05-24T23:17:00+02:00,2025-05-25,07:17,0,1,1
24,2025-05-24T23:12:00+02:00,2025-05-25,07:12,1,5,6
24,2025-05-24T23:14:00+02:00,2025-05-25,07:14,2,1,3
24,2025-05-24T23:15:00+02:00,2025-05-25,07:15,0,1,1
24,2025-05-24T23:19:00+02:00,2025-05-25,07:19,0,1,1
24,2025-05-24T23:20:00+02:00,2025-05-25,07:20,2,0,2
25,2025-05-24T23:15:00+02:00,2025-05-25,07:15,12,10,22
27,2025-05-24T23:14:00+02:00,2025-05-25,07:14,0,2,2
27,2025-05-24T23:24:00+02:00,2025-05-25,07:24,3,3,6
30,2025-05-24T23:12:00+02:00,2025-05-25,07:12,2,0,2
30,2025-05-24T23:18:00+02:00,2025-05-25,07:18,1,0,1
30,2025-05-24T23:22:00+02:00,2025-05-25,07:22,0,1,1
30,2025-05-24T23:24:00+02:00,2025-05-25,07:24,2,0,2
35,2025-05-24T23:14:00+02:00,2025-05-25,07:14,1,4,5
35,2025-05-24T23:16:00+02:00,2025-05-25,07:16,4,3,7
35,2025-05-24T23:21:00+02:00,2025-05-25,07:21,2,2,4
35,2025-05-24T23:22:00+02:00,2025-05-25,07:22,4,3,7
48,2025-05-24T23:16:00+02:00,2025-05-25,07:16,1,0,1
48,2025-05-24T23:20:00+02:00,2025-05-25,07:20,0,3,3
48,2025-05-24T23:21:00+02:00,2025-05-25,07:21,2,2,4
48,2025-05-24T23:22:00+02:00,2025-05-25,07:22,0,1,1
49,2025-05-24T23:12:00+02:00,2025-05-25,07:12,4,0,4
49,2025-05-24T23:15:00+02:00,2025-05-25,07:15,0,2,2
49,2025-05-24T23:18:00+02:00,2025-05-25,07:18,1,0,1
49,2025-05-24T23:19:00+02:00,2025-05-25,07:19,3,0,3
52,2025-05-24T23:18:00+02:00,2025-05-25,07:18,0,1,1
52,2025-05-24T23:22:00+02:00,2025-05-25,07:22,4,0,4
53,2025-05-24T23:12:00+02:00,2025-05-25,07:12,0,1,1
53,2025-05-24T23:16:00+02:00,2025-05-25,07:16,0,1,1
53,2025-05-24T23:19:00+02:00,2025-05-25,07:19,0,2,2
53,2025-05-24T23:21:00+02:00,2025-05-25,07:21,0,1,1
56,2025-05-24T23:13:00+02:00,2025-05-25,07:13,0,1,1
56,2025-05-24T23:17:00+02:00,2025-05-25,07:17,1,0,1
58,2025-05-24T23:10:00+02:00,2025-05-25,07:10,5,0,5
58,2025-05-24T23:12:00+02:00,2025-05-25,07:12,0,1,1
58,2025-05-24T23:16:00+02:00,2025-05-25,07:16,3,0,3
58,2025-05-24T23:17:00+02:00,2025-05-25,07:17,2,2,4
58,2025-05-24T23:18:00+02:00,2025-05-25,07:18,1,0,1
58,2025-05-24T23:23:00+02:00,2025-05-25,07:23,0,6,6
62,2025-05-24T23:23:00+02:00,2025-05-25,07:23,1,1,2
63,2025-05-24T23:13:00+02:00,2025-05-25,07:13,0,2,2
63,2025-05-24T23:14:00+02:00,2025-05-25,07:14,0,2,2
63,2025-05-24T23:19:00+02:00,2025-05-25,07:19,0,1,1
63,2025-05-24T23:22:00+02:00,2025-05-25,07:22,1,1,2
67,2025-05-24T23:14:00+02:00,2025-05-25,07:14,0,4,4
67,2025-05-24T23:17:00+02:00,2025-05-25,07:17,4,0,4
67,2025-05-24T23:21:00+02:00,2025-05-25,07:21,2,1,3
68,2025-05-24T23:13:00+02:00,2025-05-25,07:13,1,0,1
72,2025-05-24T23:16:00+02:00,2025-05-25,07:16,0,1,1
72,2025-05-24T23:23:00+02:00,2025-05-25,07:23,0,2,2
72,2025-05-24T23:24:00+02:00,2025-05-25,07:24,0,1,1
76,2025-05-24T23:23:00+02:00,2025-05-25,07:23,0,1,1
79,2025-05-24T23:10:00+02:00,2025-05-25,07:10,0,4,4
79,2025-05-24T23:12:00+02:00,2025-05-25,07:12,1,0,1
79,2025-05-24T23:14:00+02:00,2025-05-25,07:14,1,0,1
79,2025-05-24T23:15:00+02:00,2025-05-25,07:15,0,1,1
79,2025-05-24T23:18:00+02:00,2025-05-25,07:18,1,0,1
86,2025-05-24T23:17:00+02:00,2025-05-25,07:17,1,0,1
86,2025-05-24T23:21:00+02:00,2025-05-25,07:21,0,2,2
117,2025-05-24T23:20:00+02:00,2025-05-25,07:20,1,1,2
130,2025-05-24T23:15:00+02:00,2025-05-25,07:15,2,1,3
136,2025-05-24T23:15:00+02:00,2025-05-25,07:15,0,2,2
136,2025-05-24T23:20:00+02:00,2025-05-25,07:20,3,5,8
138,2025-05-24T23:15:00+02:00,2025-05-25,07:15,0,1,1
141,2025-05-24T23:20:00+02:00,2025-05-25,07:20,5,2,7
142,2025-05-24T23:10:00+02:00,2025-05-25,07:10,9,3,12
164,2025-05-24T23:10:00+02:00,2025-05-25,07:10,2,0,2
3,2025-05-24T23:03:00+02:00,2025-05-25,07:03,3,3,6
3,2025-05-24T23:04:00+02:00,2025-05-25,07:04,0,1,1
3,2025-05-24T23:06:00+02:00,2025-05-25,07:06,1,0,1
3,2025-05-24T23:07:00+02:00,2025-05-25,07:07,2,1,3
3,2025-05-24T23:08:00+02:00,2025-05-25,07:08,2,0,2
4,2025-05-24T22:55:00+02:00,2025-05-25,06:55,0,2,2
4,2025-05-24T22:57:00+02:00,2025-05-25,06:57,1,0,1
4,2025-05-24T23:02:00+02:00,2025-05-25,07:02,1,0,1
4,2025-05-24T23:03:00+02:00,2025-05-25,07:03,2,1,3
4,2025-05-24T23:08:00+02:00,2025-05-25,07:08,1,4,5
4,2025-05-24T23:09:00+02:00,2025-05-25,07:09,1,2,3
6,2025-05-24T22:57:00+02:00,2025-05-25,06:57,2,2,4
6,2025-05-24T22:58:00+02:00,2025-05-25,06:58,4,1,5
6,2025-05-24T23:00:00+02:00,2025-05-25,07:00,0,4,4
6,2025-05-24T23:01:00+02:00,2025-05-25,07:01,1,1,2
6,2025-05-24T23:06:00+02:00,2025-05-25,07:06,1,0,1
6,2025-05-24T23:09:00+02:00,2025-05-25,07:09,1,0,1
8,2025-05-24T23:01:00+02:00,2025-05-25,07:01,19,2,21
28,2025-05-24T22:59:00+02:00,2025-05-25,06:59,1,1,2
28,2025-05-24T23:01:00+02:00,2025-05-25,07:01,0,1,1
29,2025-05-24T22:58:00+02:00,2025-05-25,06:58,1,0,1
29,2025-05-24T23:01:00+02:00,2025-05-25,07:01,1,0,1
29,2025-05-24T23:02:00+02:00,2025-05-25,07:02,0,1,1
29,2025-05-24T23:08:00+02:00,2025-05-25,07:08,0,1,1
31,2025-05-24T22:56:00+02:00,2025-05-25,06:56,0,1,1
31,2025-05-24T23:01:00+02:00,2025-05-25,07:01,0,1,1
36,2025-05-24T22:56:00+02:00,2025-05-25,06:56,1,0,1
37,2025-05-24T23:07:00+02:00,2025-05-25,07:07,1,0,1
40,2025-05-24T22:56:00+02:00,2025-05-25,06:56,0,3,3
41,2025-05-24T22:57:00+02:00,2025-05-25,06:57,0,3,3
41,2025-05-24T22:59:00+02:00,2025-05-25,06:59,0,1,1
41,2025-05-24T23:01:00+02:00,2025-05-25,07:01,0,1,1
41,2025-05-24T23:05:00+02:00,2025-05-25,07:05,0,1,1
41,2025-05-24T23:07:00+02:00,2025-05-25,07:07,3,2,5
43,2025-05-24T23:00:00+02:00,2025-05-25,07:00,0,1,1
44,2025-05-24T23:00:00+02:00,2025-05-25,07:00,0,1,1
45,2025-05-24T22:56:00+02:00,2025-05-25,06:56,0,1,1
45,2025-05-24T22:59:00+02:00,2025-05-25,06:59,1,3,4
45,2025-05-24T23:00:00+02:00,2025-05-25,07:00,1,1,2
45,2025-05-24T23:01:00+02:00,2025-05-25,07:01,4,1,5
47,2025-05-24T22:56:00+02:00,2025-05-25,06:56,2,0,2
47,2025-05-24T22:57:00+02:00,2025-05-25,06:57,2,1,3
47,2025-05-24T23:05:00+02:00,2025-05-25,07:05,2,1,3
50,2025-05-24T23:08:00+02:00,2025-05-25,07:08,0,1,1
54,2025-05-24T22:56:00+02:00,2025-05-25,06:56,0,1,1
54,2025-05-24T23:05:00+02:00,2025-05-25,07:05,0,3,3
54,2025-05-24T23:07:00+02:00,2025-05-25,07:07,1,2,3
61,2025-05-24T22:55:00+02:00,2025-05-25,06:55,0,1,1
61,2025-05-24T22:58:00+02:00,2025-05-25,06:58,0,1,1
61,2025-05-24T23:04:00+02:00,2025-05-25,07:04,5,1,6
61,2025-05-24T23:09:00+02:00,2025-05-25,07:09,0,1,1
66,2025-05-24T22:57:00+02:00,2025-05-25,06:57,0,1,1
66,2025-05-24T22:58:00+02:00,2025-05-25,06:58,2,0,2
66,2025-05-24T23:02:00+02:00,2025-05-25,07:02,0,2,2
66,2025-05-24T23:04:00+02:00,2025-05-25,07:04,1,1,2
66,2025-05-24T23:09:00+02:00,2025-05-25,07:09,1,0,1
77,2025-05-24T23:00:00+02:00,2025-05-25,07:00,1,2,3
78,2025-05-24T22:59:00+02:00,2025-05-25,06:59,0,1,1
107,2025-05-24T22:55:00+02:00,2025-05-25,06:55,0,2,2
108,2025-05-24T23:00:00+02:00,2025-05-25,07:00,1,0,1
108,2025-05-24T23:03:00+02:00,2025-05-25,07:03,1,0,1
108,2025-05-24T23:07:00+02:00,2025-05-25,07:07,0,1,1
108,2025-05-24T23:08:00+02:00,2025-05-25,07:08,1,1,2
118,2025-05-24T23:00:00+02:00,2025-05-25,07:00,1,0,1
132,2025-05-24T23:00:00+02:00,2025-05-25,07:00,9,0,9
133,2025-05-24T22:55:00+02:00,2025-05-25,06:55,9,6,15
133,2025-05-24T23:05:00+02:00,2025-05-25,07:05,10,7,17
134,2025-05-24T23:00:00+02:00,2025-05-25,07:00,9,9,18
134,2025-05-24T23:05:00+02:00,2025-05-25,07:05,18,8,26
135,2025-05-24T23:00:00+02:00,2025-05-25,07:00,5,5,10
135,2025-05-24T23:05:00+02:00,2025-05-25,07:05,6,5,11
165,2025-05-24T22:55:00+02:00,2025-05-25,06:55,0,1,1
165,2025-05-24T23:00:00+02:00,2025-05-25,07:00,0,1,1
165,2025-05-24T23:05:00+02:00,2025-05-25,07:05,1,0,1
179,2025-05-24T22:55:00+02:00,2025-05-25,06:55,1,1,2
2,2025-05-24T22:56:00+02:00,2025-05-25,06:56,1,0,1
2,2025-05-24T22:58:00+02:00,2025-05-25,06:58,0,4,4
2,2025-05-24T23:09:00+02:00,2025-05-25,07:09,0,1,1
9,2025-05-24T22:55:00+02:00,2025-05-25,06:55,0,2,2
11,2025-05-24T22:55:00+02:00,2025-05-25,06:55,2,2,4
11,2025-05-24T23:00:00+02:00,2025-05-25,07:00,0,1,1
12,2025-05-24T22:57:00+02:00,2025-05-25,06:57,3,0,3
12,2025-05-24T23:01:00+02:00,2025-05-25,07:01,1,0,1
12,2025-05-24T23:08:00+02:00,2025-05-25,07:08,1,1,2
17,2025-05-24T23:04:00+02:00,2025-05-25,07:04,1,0,1
19,2025-05-24T22:57:00+02:00,2025-05-25,06:57,0,1,1
19,2025-05-24T23:07:00+02:00,2025-05-25,07:07,1,2,3
23,2025-05-24T23:01:00+02:00,2025-05-25,07:01,9,1,10
23,2025-05-24T23:07:00+02:00,2025-05-25,07:07,2,0,2
23,2025-05-24T23:09:00+02:00,2025-05-25,07:09,0,1,1
24,2025-05-24T22:55:00+02:00,2025-05-25,06:55,1,1,2
24,2025-05-24T22:59:00+02:00,2025-05-25,06:59,0,10,10
24,2025-05-24T23:00:00+02:00,2025-05-25,07:00,1,5,6
24,2025-05-24T23:06:00+02:00,2025-05-25,07:06,0,1,1
24,2025-05-24T23:07:00+02:00,2025-05-25,07:07,2,0,2
24,2025-05-24T23:09:00+02:00,2025-05-25,07:09,1,0,1
25,2025-05-24T22:55:00+02:00,2025-05-25,06:55,3,38,41
25,2025-05-24T23:05:00+02:00,2025-05-25,07:05,7,6,13
27,2025-05-24T22:59:00+02:00,2025-05-25,06:59,0,3,3
27,2025-05-24T23:02:00+02:00,2025-05-25,07:02,1,0,1
30,2025-05-24T22:59:00+02:00,2025-05-25,06:59,0,2,2
30,2025-05-24T23:05:00+02:00,2025-05-25,07:05,0,1,1
35,2025-05-24T22:57:00+02:00,2025-05-25,06:57,2,0,2
35,2025-05-24T23:00:00+02:00,2025-05-25,07:00,0,1,1
35,2025-05-24T23:05:00+02:00,2025-05-25,07:05,3,0,3
35,2025-05-24T23:06:00+02:00,2025-05-25,07:06,5,2,7
35,2025-05-24T23:07:00+02:00,2025-05-25,07:07,3,1,4
35,2025-05-24T23:08:00+02:00,2025-05-25,07:08,2,5,7
35,2025-05-24T23:09:00+02:00,2025-05-25,07:09,3,3,6
48,2025-05-24T22:55:00+02:00,2025-05-25,06:55,1,0,1
48,2025-05-24T22:58:00+02:00,2025-05-25,06:58,2,1,3
48,2025-05-24T23:00:00+02:00,2025-05-25,07:00,2,1,3
48,2025-05-24T23:07:00+02:00,2025-05-25,07:07,0,1,1
49,2025-05-24T22:55:00+02:00,2025-05-25,06:55,3,0,3
49,2025-05-24T22:58:00+02:00,2025-05-25,06:58,2,1,3
49,2025-05-24T22:59:00+02:00,2025-05-25,06:59,2,0,2
49,2025-05-24T23:00:00+02:00,2025-05-25,07:00,1,2,3
49,2025-05-24T23:02:00+02:00,2025-05-25,07:02,1,2,3
49,2025-05-24T23:08:00+02:00,2025-05-25,07:08,0,1,1
51,2025-05-24T22:59:00+02:00,2025-05-25,06:59,0,1,1
51,2025-05-24T23:05:00+02:00,2025-05-25,07:05,0,1,1
52,2025-05-24T23:09:00+02:00,2025-05-25,07:09,0,2,2
53,2025-05-24T22:59:00+02:00,2025-05-25,06:59,4,0,4
56,2025-05-24T22:55:00+02:00,2025-05-25,06:55,1,0,1
56,2025-05-24T22:57:00+02:00,2025-05-25,06:57,0,1,1
58,2025-05-24T22:55:00+02:00,2025-05-25,06:55,2,0,2
58,2025-05-24T22:56:00+02:00,2025-05-25,06:56,6,0,6
58,2025-05-24T22:58:00+02:00,2025-05-25,06:58,0,1,1
58,2025-05-24T23:00:00+02:00,2025-05-25,07:00,0,1,1
62,2025-05-24T23:01:00+02:00,2025-05-25,07:01,1,0,1
62,2025-05-24T23:06:00+02:00,2025-05-25,07:06,2,0,2
62,2025-05-24T23:09:00+02:00,2025-05-25,07:09,2,1,3
63,2025-05-24T23:04:00+02:00,2025-05-25,07:04,2,0,2
63,2025-05-24T23:08:00+02:00,2025-05-25,07:08,0,2,2
67,2025-05-24T22:57:00+02:00,2025-05-25,06:57,0,1,1
67,2025-05-24T23:04:00+02:00,2025-05-25,07:04,1,0,1
67,2025-05-24T23:07:00+02:00,2025-05-25,07:07,0,1,1
72,2025-05-24T22:55:00+02:00,2025-05-25,06:55,0,2,2
72,2025-05-24T23:07:00+02:00,2025-05-25,07:07,1,1,2
72,2025-05-24T23:09:00+02:00,2025-05-25,07:09,0,1,1
76,2025-05-24T23:09:00+02:00,2025-05-25,07:09,0,1,1
79,2025-05-24T22:59:00+02:00,2025-05-25,06:59,0,1,1
79,2025-05-24T23:03:00+02:00,2025-05-25,07:03,0,2,2
85,2025-05-24T22:58:00+02:00,2025-05-25,06:58,1,2,3
85,2025-05-24T23:03:00+02:00,2025-05-25,07:03,0,1,1
85,2025-05-24T23:04:00+02:00,2025-05-25,07:04,0,1,1
86,2025-05-24T22:59:00+02:00,2025-05-25,06:59,1,0,1
136,2025-05-24T23:00:00+02:00,2025-05-25,07:00,2,0,2
136,2025-05-24T23:05:00+02:00,2025-05-25,07:05,1,0,1
141,2025-05-24T22:55:00+02:00,2025-05-25,06:55,3,1,4
141,2025-05-24T23:00:00+02:00,2025-05-25,07:00,3,1,4
142,2025-05-24T22:55:00+02:00,2025-05-25,06:55,3,0,3
142,2025-05-24T23:00:00+02:00,2025-05-25,07:00,3,0,3
164,2025-05-24T23:00:00+02:00,2025-05-25,07:00,2,0,2
164,2025-05-24T23:05:00+02:00,2025-05-25,07:05,0,1,1
181,2025-05-24T22:56:00+02:00,2025-05-25,06:56,0,1,1
181,2025-05-24T22:57:00+02:00,2025-05-25,06:57,0,2,2
181,2025-05-24T23:03:00+02:00,2025-05-25,07:03,1,1,2
181,2025-05-24T23:04:00+02:00,2025-05-25,07:04,0,1,1
181,2025-05-24T23:06:00+02:00,2025-05-25,07:06,1,3,4
181,2025-05-24T23:07:00+02:00,2025-05-25,07:07,2,0,2
182,2025-05-24T23:05:00+02:00,2025-05-25,07:05,2,5,7
3,2025-05-24T22:49:00+02:00,2025-05-25,06:49,3,0,3
3,2025-05-24T22:52:00+02:00,2025-05-25,06:52,0,1,1
4,2025-05-24T22:42:00+02:00,2025-05-25,06:42,0,1,1
4,2025-05-24T22:46:00+02:00,2025-05-25,06:46,0,1,1
4,2025-05-24T22:51:00+02:00,2025-05-25,06:51,2,1,3
4,2025-05-24T22:54:00+02:00,2025-05-25,06:54,2,1,3
6,2025-05-24T22:47:00+02:00,2025-05-25,06:47,2,1,3
6,2025-05-24T22:48:00+02:00,2025-05-25,06:48,1,10,11
6,2025-05-24T22:50:00+02:00,2025-05-25,06:50,4,2,6
28,2025-05-24T22:41:00+02:00,2025-05-25,06:41,0,2,2
28,2025-05-24T22:42:00+02:00,2025-05-25,06:42,0,2,2
28,2025-05-24T22:51:00+02:00,2025-05-25,06:51,1,0,1
29,2025-05-24T22:40:00+02:00,2025-05-25,06:40,0,3,3
29,2025-05-24T22:45:00+02:00,2025-05-25,06:45,0,2,2
36,2025-05-24T22:54:00+02:00,2025-05-25,06:54,1,0,1
37,2025-05-24T22:48:00+02:00,2025-05-25,06:48,0,1,1
40,2025-05-24T22:53:00+02:00,2025-05-25,06:53,1,0,1
41,2025-05-24T22:48:00+02:00,2025-05-25,06:48,9,0,9
45,2025-05-24T22:41:00+02:00,2025-05-25,06:41,0,1,1
45,2025-05-24T22:45:00+02:00,2025-05-25,06:45,1,0,1
45,2025-05-24T22:46:00+02:00,2025-05-25,06:46,1,0,1
45,2025-05-24T22:48:00+02:00,2025-05-25,06:48,0,4,4
45,2025-05-24T22:50:00+02:00,2025-05-25,06:50,1,0,1
45,2025-05-24T22:51:00+02:00,2025-05-25,06:51,0,1,1
45,2025-05-24T22:52:00+02:00,2025-05-25,06:52,0,2,2
45,2025-05-24T22:53:00+02:00,2025-05-25,06:53,1,2,3
47,2025-05-24T22:40:00+02:00,2025-05-25,06:40,2,1,3
47,2025-05-24T22:49:00+02:00,2025-05-25,06:49,0,1,1
47,2025-05-24T22:51:00+02:00,2025-05-25,06:51,0,2,2
47,2025-05-24T22:52:00+02:00,2025-05-25,06:52,1,2,3
50,2025-05-24T22:47:00+02:00,2025-05-25,06:47,0,1,1
54,2025-05-24T22:44:00+02:00,2025-05-25,06:44,4,0,4
59,2025-05-24T22:50:00+02:00,2025-05-25,06:50,0,1,1
61,2025-05-24T22:41:00+02:00,2025-05-25,06:41,0,1,1
61,2025-05-24T22:45:00+02:00,2025-05-25,06:45,1,0,1
61,2025-05-24T22:53:00+02:00,2025-05-25,06:53,0,1,1
66,2025-05-24T22:42:00+02:00,2025-05-25,06:42,0,2,2
66,2025-05-24T22:45:00+02:00,2025-05-25,06:45,0,2,2
66,2025-05-24T22:47:00+02:00,2025-05-25,06:47,0,3,3
66,2025-05-24T22:52:00+02:00,2025-05-25,06:52,0,1,1
66,2025-05-24T22:54:00+02:00,2025-05-25,06:54,0,1,1
75,2025-05-24T22:53:00+02:00,2025-05-25,06:53,0,1,1
77,2025-05-24T22:45:00+02:00,2025-05-25,06:45,0,1,1
87,2025-05-24T22:50:00+02:00,2025-05-25,06:50,1,0,1
108,2025-05-24T22:45:00+02:00,2025-05-25,06:45,1,0,1
108,2025-05-24T22:46:00+02:00,2025-05-25,06:46,1,1,2
108,2025-05-24T22:53:00+02:00,2025-05-25,06:53,0,1,1
132,2025-05-24T22:45:00+02:00,2025-05-25,06:45,2,0,2
135,2025-05-24T22:40:00+02:00,2025-05-25,06:40,4,2,6
135,2025-05-24T22:45:00+02:00,2025-05-25,06:45,5,3,8
162,2025-05-24T22:40:00+02:00,2025-05-25,06:40,1,0,1
162,2025-05-24T22:45:00+02:00,2025-05-25,06:45,2,1,3
1,2025-05-24T22:48:00+02:00,2025-05-25,06:48,0,1,1
2,2025-05-24T22:48:00+02:00,2025-05-25,06:48,1,0,1
11,2025-05-24T22:47:00+02:00,2025-05-25,06:47,1,2,3
12,2025-05-24T22:41:00+02:00,2025-05-25,06:41,1,0,1
17,2025-05-24T22:44:00+02:00,2025-05-25,06:44,1,0,1
17,2025-05-24T22:45:00+02:00,2025-05-25,06:45,3,0,3
17,2025-05-24T22:47:00+02:00,2025-05-25,06:47,0,1,1
19,2025-05-24T22:46:00+02:00,2025-05-25,06:46,0,1,1
19,2025-05-24T22:54:00+02:00,2025-05-25,06:54,1,1,2
20,2025-05-24T22:52:00+02:00,2025-05-25,06:52,2,0,2
20,2025-05-24T22:53:00+02:00,2025-05-25,06:53,2,0,2
24,2025-05-24T22:43:00+02:00,2025-05-25,06:43,3,0,3
24,2025-05-24T22:47:00+02:00,2025-05-25,06:47,2,0,2
24,2025-05-24T22:52:00+02:00,2025-05-25,06:52,1,1,2
24,2025-05-24T22:54:00+02:00,2025-05-25,06:54,1,1,2
25,2025-05-24T22:40:00+02:00,2025-05-25,06:40,5,3,8
25,2025-05-24T22:45:00+02:00,2025-05-25,06:45,3,11,14
27,2025-05-24T22:48:00+02:00,2025-05-25,06:48,0,1,1
27,2025-05-24T22:50:00+02:00,2025-05-25,06:50,0,3,3
35,2025-05-24T22:43:00+02:00,2025-05-25,06:43,1,1,2
35,2025-05-24T22:46:00+02:00,2025-05-25,06:46,0,1,1
35,2025-05-24T22:47:00+02:00,2025-05-25,06:47,0,1,1
35,2025-05-24T22:48:00+02:00,2025-05-25,06:48,2,2,4
35,2025-05-24T22:53:00+02:00,2025-05-25,06:53,0,2,2
35,2025-05-24T22:54:00+02:00,2025-05-25,06:54,3,1,4
48,2025-05-24T22:49:00+02:00,2025-05-25,06:49,0,1,1
48,2025-05-24T22:54:00+02:00,2025-05-25,06:54,3,4,7
49,2025-05-24T22:45:00+02:00,2025-05-25,06:45,2,1,3
49,2025-05-24T22:49:00+02:00,2025-05-25,06:49,0,1,1
49,2025-05-24T22:50:00+02:00,2025-05-25,06:50,0,2,2
49,2025-05-24T22:54:00+02:00,2025-05-25,06:54,5,0,5
52,2025-05-24T22:51:00+02:00,2025-05-25,06:51,1,0,1
53,2025-05-24T22:41:00+02:00,2025-05-25,06:41,0,1,1
53,2025-05-24T22:46:00+02:00,2025-05-25,06:46,1,1,2
53,2025-05-24T22:53:00+02:00,2025-05-25,06:53,3,0,3
56,2025-05-24T22:41:00+02:00,2025-05-25,06:41,0,1,1
56,2025-05-24T22:47:00+02:00,2025-05-25,06:47,0,1,1
56,2025-05-24T22:53:00+02:00,2025-05-25,06:53,1,0,1
58,2025-05-24T22:43:00+02:00,2025-05-25,06:43,0,1,1
58,2025-05-24T22:51:00+02:00,2025-05-25,06:51,3,4,7
58,2025-05-24T22:52:00+02:00,2025-05-25,06:52,1,1,2
63,2025-05-24T22:49:00+02:00,2025-05-25,06:49,0,1,1
67,2025-05-24T22:43:00+02:00,2025-05-25,06:43,1,0,1
67,2025-05-24T22:46:00+02:00,2025-05-25,06:46,0,1,1
67,2025-05-24T22:50:00+02:00,2025-05-25,06:50,0,1,1
72,2025-05-24T22:40:00+02:00,2025-05-25,06:40,1,0,1
76,2025-05-24T22:54:00+02:00,2025-05-25,06:54,1,0,1
79,2025-05-24T22:41:00+02:00,2025-05-25,06:41,0,1,1
79,2025-05-24T22:47:00+02:00,2025-05-25,06:47,3,5,8
79,2025-05-24T22:48:00+02:00,2025-05-25,06:48,1,0,1
79,2025-05-24T22:54:00+02:00,2025-05-25,06:54,1,1,2
85,2025-05-24T22:42:00+02:00,2025-05-25,06:42,0,1,1
117,2025-05-24T22:45:00+02:00,2025-05-25,06:45,0,1,1
139,2025-05-24T22:40:00+02:00,2025-05-25,06:40,0,1,1
142,2025-05-24T22:45:00+02:00,2025-05-25,06:45,0,2,2
164,2025-05-24T22:45:00+02:00,2025-05-25,06:45,1,0,1
181,2025-05-24T22:42:00+02:00,2025-05-25,06:42,4,3,7
181,2025-05-24T22:54:00+02:00,2025-05-25,06:54,1,4,5
182,2025-05-24T22:40:00+02:00,2025-05-25,06:40,1,2,3
180,2025-05-24T22:51:00+02:00,2025-05-25,06:51,0,1,1
3,2025-05-25T00:11:00+02:00,2025-05-25,08:11,0,1,1
3,2025-05-25T00:17:00+02:00,2025-05-25,08:17,2,1,3
3,2025-05-25T00:19:00+02:00,2025-05-25,08:19,1,1,2
4,2025-05-25T00:21:00+02:00,2025-05-25,08:21,1,6,7
4,2025-05-25T00:22:00+02:00,2025-05-25,08:22,3,1,4
4,2025-05-25T00:23:00+02:00,2025-05-25,08:23,0,1,1
5,2025-05-25T00:15:00+02:00,2025-05-25,08:15,5,4,9
6,2025-05-25T00:13:00+02:00,2025-05-25,08:13,2,1,3
6,2025-05-25T00:14:00+02:00,2025-05-25,08:14,2,3,5
6,2025-05-25T00:17:00+02:00,2025-05-25,08:17,1,0,1
6,2025-05-25T00:19:00+02:00,2025-05-25,08:19,5,1,6
8,2025-05-25T00:13:00+02:00,2025-05-25,08:13,1,2,3
8,2025-05-25T00:14:00+02:00,2025-05-25,08:14,0,1,1
8,2025-05-25T00:16:00+02:00,2025-05-25,08:16,0,1,1
8,2025-05-25T00:17:00+02:00,2025-05-25,08:17,1,5,6
8,2025-05-25T00:21:00+02:00,2025-05-25,08:21,0,1,1
8,2025-05-25T00:23:00+02:00,2025-05-25,08:23,0,1,1
28,2025-05-25T00:10:00+02:00,2025-05-25,08:10,1,1,2
28,2025-05-25T00:13:00+02:00,2025-05-25,08:13,4,0,4
28,2025-05-25T00:15:00+02:00,2025-05-25,08:15,0,1,1
29,2025-05-25T00:11:00+02:00,2025-05-25,08:11,2,1,3
29,2025-05-25T00:13:00+02:00,2025-05-25,08:13,0,5,5
29,2025-05-25T00:22:00+02:00,2025-05-25,08:22,0,2,2
29,2025-05-25T00:23:00+02:00,2025-05-25,08:23,1,0,1
29,2025-05-25T00:24:00+02:00,2025-05-25,08:24,0,2,2
31,2025-05-25T00:20:00+02:00,2025-05-25,08:20,1,1,2
36,2025-05-25T00:16:00+02:00,2025-05-25,08:16,1,0,1
37,2025-05-25T00:11:00+02:00,2025-05-25,08:11,1,0,1
37,2025-05-25T00:16:00+02:00,2025-05-25,08:16,1,0,1
39,2025-05-25T00:16:00+02:00,2025-05-25,08:16,0,1,1
40,2025-05-25T00:10:00+02:00,2025-05-25,08:10,0,2,2
40,2025-05-25T00:11:00+02:00,2025-05-25,08:11,0,2,2
40,2025-05-25T00:12:00+02:00,2025-05-25,08:12,0,1,1
40,2025-05-25T00:15:00+02:00,2025-05-25,08:15,0,2,2
40,2025-05-25T00:24:00+02:00,2025-05-25,08:24,1,2,3
41,2025-05-25T00:16:00+02:00,2025-05-25,08:16,1,0,1
41,2025-05-25T00:17:00+02:00,2025-05-25,08:17,1,6,7
41,2025-05-25T00:23:00+02:00,2025-05-25,08:23,3,2,5
41,2025-05-25T00:24:00+02:00,2025-05-25,08:24,0,2,2
43,2025-05-25T00:10:00+02:00,2025-05-25,08:10,1,1,2
45,2025-05-25T00:13:00+02:00,2025-05-25,08:13,0,1,1
45,2025-05-25T00:15:00+02:00,2025-05-25,08:15,2,1,3
45,2025-05-25T00:16:00+02:00,2025-05-25,08:16,1,0,1
45,2025-05-25T00:17:00+02:00,2025-05-25,08:17,1,0,1
45,2025-05-25T00:22:00+02:00,2025-05-25,08:22,2,2,4
45,2025-05-25T00:23:00+02:00,2025-05-25,08:23,0,1,1
47,2025-05-25T00:10:00+02:00,2025-05-25,08:10,2,1,3
47,2025-05-25T00:11:00+02:00,2025-05-25,08:11,6,4,10
47,2025-05-25T00:16:00+02:00,2025-05-25,08:16,3,4,7
47,2025-05-25T00:24:00+02:00,2025-05-25,08:24,1,0,1
50,2025-05-25T00:10:00+02:00,2025-05-25,08:10,1,1,2
50,2025-05-25T00:13:00+02:00,2025-05-25,08:13,0,1,1
50,2025-05-25T00:18:00+02:00,2025-05-25,08:18,0,1,1
54,2025-05-25T00:13:00+02:00,2025-05-25,08:13,0,2,2
54,2025-05-25T00:22:00+02:00,2025-05-25,08:22,0,1,1
61,2025-05-25T00:13:00+02:00,2025-05-25,08:13,1,2,3
66,2025-05-25T00:13:00+02:00,2025-05-25,08:13,2,1,3
66,2025-05-25T00:16:00+02:00,2025-05-25,08:16,1,3,4
66,2025-05-25T00:18:00+02:00,2025-05-25,08:18,1,3,4
66,2025-05-25T00:20:00+02:00,2025-05-25,08:20,2,3,5
66,2025-05-25T00:23:00+02:00,2025-05-25,08:23,2,1,3
69,2025-05-25T00:21:00+02:00,2025-05-25,08:21,1,0,1
70,2025-05-25T00:15:00+02:00,2025-05-25,08:15,3,0,3
70,2025-05-25T00:23:00+02:00,2025-05-25,08:23,2,1,3
71,2025-05-25T00:20:00+02:00,2025-05-25,08:20,0,1,1
78,2025-05-25T00:13:00+02:00,2025-05-25,08:13,3,0,3
78,2025-05-25T00:24:00+02:00,2025-05-25,08:24,1,0,1
84,2025-05-25T00:20:00+02:00,2025-05-25,08:20,12,11,23
87,2025-05-25T00:16:00+02:00,2025-05-25,08:16,1,0,1
108,2025-05-25T00:12:00+02:00,2025-05-25,08:12,2,3,5
108,2025-05-25T00:13:00+02:00,2025-05-25,08:13,2,0,2
132,2025-05-25T00:20:00+02:00,2025-05-25,08:20,7,5,12
133,2025-05-25T00:15:00+02:00,2025-05-25,08:15,12,21,33
133,2025-05-25T00:20:00+02:00,2025-05-25,08:20,12,11,23
135,2025-05-25T00:15:00+02:00,2025-05-25,08:15,6,9,15
140,2025-05-25T00:10:00+02:00,2025-05-25,08:10,6,3,9
140,2025-05-25T00:15:00+02:00,2025-05-25,08:15,5,0,5
165,2025-05-25T00:10:00+02:00,2025-05-25,08:10,0,3,3
165,2025-05-25T00:20:00+02:00,2025-05-25,08:20,1,1,2
166,2025-05-25T00:10:00+02:00,2025-05-25,08:10,3,0,3
167,2025-05-25T00:15:00+02:00,2025-05-25,08:15,0,1,1
167,2025-05-25T00:20:00+02:00,2025-05-25,08:20,2,2,4
1,2025-05-25T00:10:00+02:00,2025-05-25,08:10,0,1,1
1,2025-05-25T00:11:00+02:00,2025-05-25,08:11,3,0,3
1,2025-05-25T00:12:00+02:00,2025-05-25,08:12,0,1,1
1,2025-05-25T00:17:00+02:00,2025-05-25,08:17,2,3,5
1,2025-05-25T00:18:00+02:00,2025-05-25,08:18,2,0,2
1,2025-05-25T00:22:00+02:00,2025-05-25,08:22,0,1,1
2,2025-05-25T00:18:00+02:00,2025-05-25,08:18,0,5,5
2,2025-05-25T00:19:00+02:00,2025-05-25,08:19,0,2,2
9,2025-05-25T00:14:00+02:00,2025-05-25,08:14,2,4,6
9,2025-05-25T00:21:00+02:00,2025-05-25,08:21,1,0,1
9,2025-05-25T00:24:00+02:00,2025-05-25,08:24,1,0,1
10,2025-05-25T00:23:00+02:00,2025-05-25,08:23,0,1,1
11,2025-05-25T00:10:00+02:00,2025-05-25,08:10,3,2,5
11,2025-05-25T00:12:00+02:00,2025-05-25,08:12,1,1,2
11,2025-05-25T00:21:00+02:00,2025-05-25,08:21,0,3,3
12,2025-05-25T00:10:00+02:00,2025-05-25,08:10,1,2,3
12,2025-05-25T00:11:00+02:00,2025-05-25,08:11,1,1,2
12,2025-05-25T00:14:00+02:00,2025-05-25,08:14,2,0,2
12,2025-05-25T00:22:00+02:00,2025-05-25,08:22,2,0,2
12,2025-05-25T00:24:00+02:00,2025-05-25,08:24,1,1,2
17,2025-05-25T00:14:00+02:00,2025-05-25,08:14,1,0,1
18,2025-05-25T00:18:00+02:00,2025-05-25,08:18,1,0,1
18,2025-05-25T00:19:00+02:00,2025-05-25,08:19,1,0,1
19,2025-05-25T00:23:00+02:00,2025-05-25,08:23,3,2,5
23,2025-05-25T00:11:00+02:00,2025-05-25,08:11,2,3,5
23,2025-05-25T00:14:00+02:00,2025-05-25,08:14,3,0,3
23,2025-05-25T00:16:00+02:00,2025-05-25,08:16,1,5,6
23,2025-05-25T00:17:00+02:00,2025-05-25,08:17,0,1,1
23,2025-05-25T00:22:00+02:00,2025-05-25,08:22,1,1,2
24,2025-05-25T00:11:00+02:00,2025-05-25,08:11,0,2,2
24,2025-05-25T00:14:00+02:00,2025-05-25,08:14,7,0,7
24,2025-05-25T00:16:00+02:00,2025-05-25,08:16,3,2,5
24,2025-05-25T00:17:00+02:00,2025-05-25,08:17,0,3,3
24,2025-05-25T00:18:00+02:00,2025-05-25,08:18,0,7,7
24,2025-05-25T00:19:00+02:00,2025-05-25,08:19,6,4,10
24,2025-05-25T00:21:00+02:00,2025-05-25,08:21,5,2,7
25,2025-05-25T00:10:00+02:00,2025-05-25,08:10,9,18,27
25,2025-05-25T00:15:00+02:00,2025-05-25,08:15,13,15,28
27,2025-05-25T00:15:00+02:00,2025-05-25,08:15,0,1,1
27,2025-05-25T00:18:00+02:00,2025-05-25,08:18,0,3,3
30,2025-05-25T00:10:00+02:00,2025-05-25,08:10,3,3,6
30,2025-05-25T00:14:00+02:00,2025-05-25,08:14,0,1,1
30,2025-05-25T00:15:00+02:00,2025-05-25,08:15,0,2,2
30,2025-05-25T00:24:00+02:00,2025-05-25,08:24,1,0,1
35,2025-05-25T00:10:00+02:00,2025-05-25,08:10,4,4,8
35,2025-05-25T00:11:00+02:00,2025-05-25,08:11,6,2,8
35,2025-05-25T00:12:00+02:00,2025-05-25,08:12,4,5,9
35,2025-05-25T00:13:00+02:00,2025-05-25,08:13,7,6,13
35,2025-05-25T00:15:00+02:00,2025-05-25,08:15,11,6,17
35,2025-05-25T00:16:00+02:00,2025-05-25,08:16,3,6,9
35,2025-05-25T00:21:00+02:00,2025-05-25,08:21,5,10,15
35,2025-05-25T00:23:00+02:00,2025-05-25,08:23,6,28,34
48,2025-05-25T00:12:00+02:00,2025-05-25,08:12,3,1,4
48,2025-05-25T00:18:00+02:00,2025-05-25,08:18,0,3,3
49,2025-05-25T00:11:00+02:00,2025-05-25,08:11,0,1,1
49,2025-05-25T00:13:00+02:00,2025-05-25,08:13,3,0,3
49,2025-05-25T00:14:00+02:00,2025-05-25,08:14,3,1,4
49,2025-05-25T00:19:00+02:00,2025-05-25,08:19,3,1,4
49,2025-05-25T00:20:00+02:00,2025-05-25,08:20,1,0,1
49,2025-05-25T00:21:00+02:00,2025-05-25,08:21,4,0,4
51,2025-05-25T00:24:00+02:00,2025-05-25,08:24,1,1,2
52,2025-05-25T00:14:00+02:00,2025-05-25,08:14,0,1,1
53,2025-05-25T00:22:00+02:00,2025-05-25,08:22,1,0,1
56,2025-05-25T00:16:00+02:00,2025-05-25,08:16,1,3,4
56,2025-05-25T00:23:00+02:00,2025-05-25,08:23,2,0,2
58,2025-05-25T00:11:00+02:00,2025-05-25,08:11,1,0,1
58,2025-05-25T00:17:00+02:00,2025-05-25,08:17,0,3,3
58,2025-05-25T00:18:00+02:00,2025-05-25,08:18,1,0,1
58,2025-05-25T00:20:00+02:00,2025-05-25,08:20,1,1,2
58,2025-05-25T00:21:00+02:00,2025-05-25,08:21,0,1,1
58,2025-05-25T00:22:00+02:00,2025-05-25,08:22,1,0,1
58,2025-05-25T00:23:00+02:00,2025-05-25,08:23,1,1,2
62,2025-05-25T00:12:00+02:00,2025-05-25,08:12,0,2,2
62,2025-05-25T00:13:00+02:00,2025-05-25,08:13,1,0,1
62,2025-05-25T00:22:00+02:00,2025-05-25,08:22,0,2,2
62,2025-05-25T00:23:00+02:00,2025-05-25,08:23,3,0,3
63,2025-05-25T00:15:00+02:00,2025-05-25,08:15,1,1,2
63,2025-05-25T00:17:00+02:00,2025-05-25,08:17,2,1,3
63,2025-05-25T00:22:00+02:00,2025-05-25,08:22,0,1,1
67,2025-05-25T00:12:00+02:00,2025-05-25,08:12,1,0,1
67,2025-05-25T00:15:00+02:00,2025-05-25,08:15,3,0,3
67,2025-05-25T00:16:00+02:00,2025-05-25,08:16,2,2,4
67,2025-05-25T00:18:00+02:00,2025-05-25,08:18,1,0,1
67,2025-05-25T00:22:00+02:00,2025-05-25,08:22,1,1,2
67,2025-05-25T00:23:00+02:00,2025-05-25,08:23,1,1,2
68,2025-05-25T00:10:00+02:00,2025-05-25,08:10,1,0,1
68,2025-05-25T00:13:00+02:00,2025-05-25,08:13,0,1,1
68,2025-05-25T00:14:00+02:00,2025-05-25,08:14,2,1,3
68,2025-05-25T00:16:00+02:00,2025-05-25,08:16,0,1,1
68,2025-05-25T00:18:00+02:00,2025-05-25,08:18,1,0,1
72,2025-05-25T00:12:00+02:00,2025-05-25,08:12,3,1,4
72,2025-05-25T00:21:00+02:00,2025-05-25,08:21,1,1,2
72,2025-05-25T00:24:00+02:00,2025-05-25,08:24,0,3,3
76,2025-05-25T00:17:00+02:00,2025-05-25,08:17,0,1,1
76,2025-05-25T00:19:00+02:00,2025-05-25,08:19,1,0,1
79,2025-05-25T00:14:00+02:00,2025-05-25,08:14,0,2,2
79,2025-05-25T00:15:00+02:00,2025-05-25,08:15,0,1,1
85,2025-05-25T00:10:00+02:00,2025-05-25,08:10,0,1,1
85,2025-05-25T00:15:00+02:00,2025-05-25,08:15,0,2,2
86,2025-05-25T00:16:00+02:00,2025-05-25,08:16,0,2,2
109,2025-05-25T00:10:00+02:00,2025-05-25,08:10,2,1,3
123,2025-05-25T00:10:00+02:00,2025-05-25,08:10,0,1,1
123,2025-05-25T00:20:00+02:00,2025-05-25,08:20,0,3,3
137,2025-05-25T00:15:00+02:00,2025-05-25,08:15,0,1,1
139,2025-05-25T00:20:00+02:00,2025-05-25,08:20,5,3,8
142,2025-05-25T00:20:00+02:00,2025-05-25,08:20,25,83,108
3,2025-05-24T23:41:00+02:00,2025-05-25,07:41,1,0,1
3,2025-05-24T23:52:00+02:00,2025-05-25,07:52,0,1,1
3,2025-05-24T23:53:00+02:00,2025-05-25,07:53,1,0,1
4,2025-05-24T23:40:00+02:00,2025-05-25,07:40,1,0,1
4,2025-05-24T23:45:00+02:00,2025-05-25,07:45,0,3,3
4,2025-05-24T23:50:00+02:00,2025-05-25,07:50,1,0,1
4,2025-05-24T23:52:00+02:00,2025-05-25,07:52,3,1,4
5,2025-05-24T23:50:00+02:00,2025-05-25,07:50,6,7,13
6,2025-05-24T23:41:00+02:00,2025-05-25,07:41,1,1,2
6,2025-05-24T23:46:00+02:00,2025-05-25,07:46,1,0,1
6,2025-05-24T23:48:00+02:00,2025-05-25,07:48,1,1,2
6,2025-05-24T23:49:00+02:00,2025-05-25,07:49,2,0,2
6,2025-05-24T23:54:00+02:00,2025-05-25,07:54,9,4,13
8,2025-05-24T23:41:00+02:00,2025-05-25,07:41,0,4,4
8,2025-05-24T23:42:00+02:00,2025-05-25,07:42,1,1,2
8,2025-05-24T23:43:00+02:00,2025-05-25,07:43,1,3,4
8,2025-05-24T23:51:00+02:00,2025-05-25,07:51,2,1,3
8,2025-05-24T23:53:00+02:00,2025-05-25,07:53,0,1,1
28,2025-05-24T23:40:00+02:00,2025-05-25,07:40,0,1,1
28,2025-05-24T23:43:00+02:00,2025-05-25,07:43,1,1,2
28,2025-05-24T23:45:00+02:00,2025-05-25,07:45,0,1,1
28,2025-05-24T23:49:00+02:00,2025-05-25,07:49,0,2,2
28,2025-05-24T23:50:00+02:00,2025-05-25,07:50,0,2,2
28,2025-05-24T23:53:00+02:00,2025-05-25,07:53,0,3,3
29,2025-05-24T23:46:00+02:00,2025-05-25,07:46,0,3,3
29,2025-05-24T23:52:00+02:00,2025-05-25,07:52,2,4,6
29,2025-05-24T23:53:00+02:00,2025-05-25,07:53,0,1,1
31,2025-05-24T23:40:00+02:00,2025-05-25,07:40,0,1,1
31,2025-05-24T23:51:00+02:00,2025-05-25,07:51,0,2,2
36,2025-05-24T23:40:00+02:00,2025-05-25,07:40,3,0,3
36,2025-05-24T23:45:00+02:00,2025-05-25,07:45,2,0,2
36,2025-05-24T23:47:00+02:00,2025-05-25,07:47,7,1,8
36,2025-05-24T23:49:00+02:00,2025-05-25,07:49,0,4,4
36,2025-05-24T23:52:00+02:00,2025-05-25,07:52,0,2,2
37,2025-05-24T23:53:00+02:00,2025-05-25,07:53,1,0,1
40,2025-05-24T23:45:00+02:00,2025-05-25,07:45,3,0,3
40,2025-05-24T23:53:00+02:00,2025-05-25,07:53,1,2,3
40,2025-05-24T23:54:00+02:00,2025-05-25,07:54,4,0,4
41,2025-05-24T23:42:00+02:00,2025-05-25,07:42,1,0,1
41,2025-05-24T23:47:00+02:00,2025-05-25,07:47,1,0,1
41,2025-05-24T23:53:00+02:00,2025-05-25,07:53,0,1,1
44,2025-05-24T23:50:00+02:00,2025-05-25,07:50,0,1,1
45,2025-05-24T23:41:00+02:00,2025-05-25,07:41,5,5,10
45,2025-05-24T23:46:00+02:00,2025-05-25,07:46,0,3,3
45,2025-05-24T23:47:00+02:00,2025-05-25,07:47,1,0,1
47,2025-05-24T23:46:00+02:00,2025-05-25,07:46,1,1,2
47,2025-05-24T23:48:00+02:00,2025-05-25,07:48,2,1,3
47,2025-05-24T23:53:00+02:00,2025-05-25,07:53,0,4,4
59,2025-05-24T23:50:00+02:00,2025-05-25,07:50,1,2,3
61,2025-05-24T23:41:00+02:00,2025-05-25,07:41,0,2,2
61,2025-05-24T23:42:00+02:00,2025-05-25,07:42,0,2,2
61,2025-05-24T23:48:00+02:00,2025-05-25,07:48,0,4,4
61,2025-05-24T23:50:00+02:00,2025-05-25,07:50,4,4,8
61,2025-05-24T23:52:00+02:00,2025-05-25,07:52,0,2,2
66,2025-05-24T23:44:00+02:00,2025-05-25,07:44,0,2,2
66,2025-05-24T23:46:00+02:00,2025-05-25,07:46,4,5,9
66,2025-05-24T23:49:00+02:00,2025-05-25,07:49,0,1,1
69,2025-05-24T23:40:00+02:00,2025-05-25,07:40,0,1,1
69,2025-05-24T23:42:00+02:00,2025-05-25,07:42,1,0,1
70,2025-05-24T23:52:00+02:00,2025-05-25,07:52,1,0,1
75,2025-05-24T23:47:00+02:00,2025-05-25,07:47,0,1,1
77,2025-05-24T23:50:00+02:00,2025-05-25,07:50,2,5,7
78,2025-05-24T23:40:00+02:00,2025-05-25,07:40,1,2,3
78,2025-05-24T23:45:00+02:00,2025-05-25,07:45,0,2,2
78,2025-05-24T23:46:00+02:00,2025-05-25,07:46,0,1,1
78,2025-05-24T23:50:00+02:00,2025-05-25,07:50,2,1,3
84,2025-05-24T23:45:00+02:00,2025-05-25,07:45,11,12,23
87,2025-05-24T23:44:00+02:00,2025-05-25,07:44,0,1,1
107,2025-05-24T23:45:00+02:00,2025-05-25,07:45,2,3,5
108,2025-05-24T23:40:00+02:00,2025-05-25,07:40,0,2,2
108,2025-05-24T23:41:00+02:00,2025-05-25,07:41,2,0,2
108,2025-05-24T23:43:00+02:00,2025-05-25,07:43,0,1,1
108,2025-05-24T23:44:00+02:00,2025-05-25,07:44,1,0,1
108,2025-05-24T23:46:00+02:00,2025-05-25,07:46,3,0,3
108,2025-05-24T23:51:00+02:00,2025-05-25,07:51,1,0,1
108,2025-05-24T23:52:00+02:00,2025-05-25,07:52,0,1,1
118,2025-05-24T23:45:00+02:00,2025-05-25,07:45,0,1,1
134,2025-05-24T23:45:00+02:00,2025-05-25,07:45,5,8,13
134,2025-05-24T23:50:00+02:00,2025-05-25,07:50,14,20,34
140,2025-05-24T23:45:00+02:00,2025-05-25,07:45,6,2,8
162,2025-05-24T23:40:00+02:00,2025-05-25,07:40,8,2,10
162,2025-05-24T23:50:00+02:00,2025-05-25,07:50,12,3,15
165,2025-05-24T23:40:00+02:00,2025-05-25,07:40,5,0,5
165,2025-05-24T23:45:00+02:00,2025-05-25,07:45,0,2,2
166,2025-05-24T23:45:00+02:00,2025-05-25,07:45,0,1,1
179,2025-05-24T23:40:00+02:00,2025-05-25,07:40,5,1,6
179,2025-05-24T23:50:00+02:00,2025-05-25,07:50,3,0,3
1,2025-05-24T23:47:00+02:00,2025-05-25,07:47,1,1,2
1,2025-05-24T23:49:00+02:00,2025-05-25,07:49,0,2,2
1,2025-05-24T23:53:00+02:00,2025-05-25,07:53,1,0,1
2,2025-05-24T23:43:00+02:00,2025-05-25,07:43,2,1,3
2,2025-05-24T23:44:00+02:00,2025-05-25,07:44,0,1,1
2,2025-05-24T23:49:00+02:00,2025-05-25,07:49,1,0,1
2,2025-05-24T23:51:00+02:00,2025-05-25,07:51,1,1,2
9,2025-05-24T23:42:00+02:00,2025-05-25,07:42,1,1,2
9,2025-05-24T23:45:00+02:00,2025-05-25,07:45,3,0,3
9,2025-05-24T23:52:00+02:00,2025-05-25,07:52,2,1,3
11,2025-05-24T23:51:00+02:00,2025-05-25,07:51,1,0,1
12,2025-05-24T23:52:00+02:00,2025-05-25,07:52,1,0,1
12,2025-05-24T23:53:00+02:00,2025-05-25,07:53,0,1,1
18,2025-05-24T23:42:00+02:00,2025-05-25,07:42,2,0,2
18,2025-05-24T23:45:00+02:00,2025-05-25,07:45,0,2,2
18,2025-05-24T23:52:00+02:00,2025-05-25,07:52,0,1,1
20,2025-05-24T23:47:00+02:00,2025-05-25,07:47,1,0,1
20,2025-05-24T23:52:00+02:00,2025-05-25,07:52,1,0,1
23,2025-05-24T23:45:00+02:00,2025-05-25,07:45,3,0,3
23,2025-05-24T23:48:00+02:00,2025-05-25,07:48,2,0,2
23,2025-05-24T23:52:00+02:00,2025-05-25,07:52,0,3,3
23,2025-05-24T23:53:00+02:00,2025-05-25,07:53,0,2,2
24,2025-05-24T23:41:00+02:00,2025-05-25,07:41,3,0,3
24,2025-05-24T23:42:00+02:00,2025-05-25,07:42,1,2,3
24,2025-05-24T23:47:00+02:00,2025-05-25,07:47,1,6,7
25,2025-05-24T23:50:00+02:00,2025-05-25,07:50,14,20,34
27,2025-05-24T23:40:00+02:00,2025-05-25,07:40,2,0,2
27,2025-05-24T23:43:00+02:00,2025-05-25,07:43,1,0,1
27,2025-05-24T23:53:00+02:00,2025-05-25,07:53,0,1,1
30,2025-05-24T23:44:00+02:00,2025-05-25,07:44,2,0,2
30,2025-05-24T23:45:00+02:00,2025-05-25,07:45,0,1,1
30,2025-05-24T23:47:00+02:00,2025-05-25,07:47,0,2,2
30,2025-05-24T23:49:00+02:00,2025-05-25,07:49,0,1,1
30,2025-05-24T23:51:00+02:00,2025-05-25,07:51,0,2,2
30,2025-05-24T23:52:00+02:00,2025-05-25,07:52,0,1,1
30,2025-05-24T23:54:00+02:00,2025-05-25,07:54,3,0,3
35,2025-05-24T23:41:00+02:00,2025-05-25,07:41,6,3,9
35,2025-05-24T23:43:00+02:00,2025-05-25,07:43,12,4,16
35,2025-05-24T23:44:00+02:00,2025-05-25,07:44,3,2,5
35,2025-05-24T23:45:00+02:00,2025-05-25,07:45,2,4,6
35,2025-05-24T23:47:00+02:00,2025-05-25,07:47,8,2,10
35,2025-05-24T23:48:00+02:00,2025-05-25,07:48,10,2,12
35,2025-05-24T23:50:00+02:00,2025-05-25,07:50,5,1,6
35,2025-05-24T23:51:00+02:00,2025-05-25,07:51,6,1,7
35,2025-05-24T23:52:00+02:00,2025-05-25,07:52,5,8,13
35,2025-05-24T23:54:00+02:00,2025-05-25,07:54,3,2,5
46,2025-05-24T23:50:00+02:00,2025-05-25,07:50,5,1,6
48,2025-05-24T23:40:00+02:00,2025-05-25,07:40,3,0,3
48,2025-05-24T23:41:00+02:00,2025-05-25,07:41,1,2,3
48,2025-05-24T23:44:00+02:00,2025-05-25,07:44,1,1,2
48,2025-05-24T23:46:00+02:00,2025-05-25,07:46,2,0,2
48,2025-05-24T23:49:00+02:00,2025-05-25,07:49,0,2,2
49,2025-05-24T23:40:00+02:00,2025-05-25,07:40,4,0,4
49,2025-05-24T23:46:00+02:00,2025-05-25,07:46,1,2,3
49,2025-05-24T23:47:00+02:00,2025-05-25,07:47,3,2,5
49,2025-05-24T23:49:00+02:00,2025-05-25,07:49,3,0,3
49,2025-05-24T23:54:00+02:00,2025-05-25,07:54,0,3,3
51,2025-05-24T23:48:00+02:00,2025-05-25,07:48,1,1,2
51,2025-05-24T23:53:00+02:00,2025-05-25,07:53,2,0,2
51,2025-05-24T23:54:00+02:00,2025-05-25,07:54,0,1,1
52,2025-05-24T23:47:00+02:00,2025-05-25,07:47,2,0,2
53,2025-05-24T23:40:00+02:00,2025-05-25,07:40,0,1,1
53,2025-05-24T23:44:00+02:00,2025-05-25,07:44,2,0,2
53,2025-05-24T23:46:00+02:00,2025-05-25,07:46,1,0,1
53,2025-05-24T23:50:00+02:00,2025-05-25,07:50,3,3,6
53,2025-05-24T23:53:00+02:00,2025-05-25,07:53,4,0,4
53,2025-05-24T23:54:00+02:00,2025-05-25,07:54,1,0,1
56,2025-05-24T23:40:00+02:00,2025-05-25,07:40,2,0,2
56,2025-05-24T23:50:00+02:00,2025-05-25,07:50,1,0,1
56,2025-05-24T23:53:00+02:00,2025-05-25,07:53,1,0,1
58,2025-05-24T23:45:00+02:00,2025-05-25,07:45,3,1,4
58,2025-05-24T23:52:00+02:00,2025-05-25,07:52,1,0,1
62,2025-05-24T23:42:00+02:00,2025-05-25,07:42,0,1,1
62,2025-05-24T23:44:00+02:00,2025-05-25,07:44,2,0,2
62,2025-05-24T23:52:00+02:00,2025-05-25,07:52,0,2,2
63,2025-05-24T23:40:00+02:00,2025-05-25,07:40,0,1,1
63,2025-05-24T23:42:00+02:00,2025-05-25,07:42,2,0,2
63,2025-05-24T23:48:00+02:00,2025-05-25,07:48,0,1,1
67,2025-05-24T23:44:00+02:00,2025-05-25,07:44,4,0,4
67,2025-05-24T23:46:00+02:00,2025-05-25,07:46,0,3,3
67,2025-05-24T23:54:00+02:00,2025-05-25,07:54,2,5,7
68,2025-05-24T23:42:00+02:00,2025-05-25,07:42,1,0,1
68,2025-05-24T23:52:00+02:00,2025-05-25,07:52,1,0,1
68,2025-05-24T23:54:00+02:00,2025-05-25,07:54,1,0,1
72,2025-05-24T23:54:00+02:00,2025-05-25,07:54,1,0,1
76,2025-05-24T23:45:00+02:00,2025-05-25,07:45,2,0,2
79,2025-05-24T23:42:00+02:00,2025-05-25,07:42,1,0,1
79,2025-05-24T23:43:00+02:00,2025-05-25,07:43,2,1,3
79,2025-05-24T23:47:00+02:00,2025-05-25,07:47,0,3,3
79,2025-05-24T23:52:00+02:00,2025-05-25,07:52,2,0,2
86,2025-05-24T23:40:00+02:00,2025-05-25,07:40,0,2,2
86,2025-05-24T23:51:00+02:00,2025-05-25,07:51,1,0,1
86,2025-05-24T23:53:00+02:00,2025-05-25,07:53,1,0,1
109,2025-05-24T23:40:00+02:00,2025-05-25,07:40,1,0,1
117,2025-05-24T23:50:00+02:00,2025-05-25,07:50,1,4,5
123,2025-05-24T23:40:00+02:00,2025-05-25,07:40,0,2,2
123,2025-05-24T23:50:00+02:00,2025-05-25,07:50,1,0,1
130,2025-05-24T23:45:00+02:00,2025-05-25,07:45,1,5,6
136,2025-05-24T23:45:00+02:00,2025-05-25,07:45,4,13,17
161,2025-05-24T23:45:00+02:00,2025-05-25,07:45,4,15,19
161,2025-05-24T23:50:00+02:00,2025-05-25,07:50,7,29,36
164,2025-05-24T23:50:00+02:00,2025-05-25,07:50,5,0,5
181,2025-05-24T23:40:00+02:00,2025-05-25,07:40,0,1,1
181,2025-05-24T23:48:00+02:00,2025-05-25,07:48,1,2,3
181,2025-05-24T23:50:00+02:00,2025-05-25,07:50,1,2,3
181,2025-05-24T23:51:00+02:00,2025-05-25,07:51,3,5,8
181,2025-05-24T23:52:00+02:00,2025-05-25,07:52,0,9,9
181,2025-05-24T23:53:00+02:00,2025-05-25,07:53,0,6,6
181,2025-05-24T23:54:00+02:00,2025-05-25,07:54,1,2,3
180,2025-05-24T23:47:00+02:00,2025-05-25,07:47,1,0,1
180,2025-05-24T23:53:00+02:00,2025-05-25,07:53,0,1,1
3,2025-05-24T23:55:00+02:00,2025-05-25,07:55,4,2,6
3,2025-05-25T00:01:00+02:00,2025-05-25,08:01,2,1,3
3,2025-05-25T00:06:00+02:00,2025-05-25,08:06,1,0,1
4,2025-05-24T23:58:00+02:00,2025-05-25,07:58,3,3,6
4,2025-05-24T23:59:00+02:00,2025-05-25,07:59,3,3,6
4,2025-05-25T00:01:00+02:00,2025-05-25,08:01,0,5,5
4,2025-05-25T00:04:00+02:00,2025-05-25,08:04,1,0,1
4,2025-05-25T00:06:00+02:00,2025-05-25,08:06,0,1,1
4,2025-05-25T00:08:00+02:00,2025-05-25,08:08,0,1,1
4,2025-05-25T00:09:00+02:00,2025-05-25,08:09,0,3,3
6,2025-05-24T23:56:00+02:00,2025-05-25,07:56,1,0,1
6,2025-05-24T23:57:00+02:00,2025-05-25,07:57,2,5,7
6,2025-05-24T23:58:00+02:00,2025-05-25,07:58,1,14,15
6,2025-05-24T23:59:00+02:00,2025-05-25,07:59,3,1,4
6,2025-05-25T00:00:00+02:00,2025-05-25,08:00,5,1,6
6,2025-05-25T00:03:00+02:00,2025-05-25,08:03,0,1,1
6,2025-05-25T00:07:00+02:00,2025-05-25,08:07,3,4,7
8,2025-05-24T23:55:00+02:00,2025-05-25,07:55,2,1,3
8,2025-05-24T23:57:00+02:00,2025-05-25,07:57,1,3,4
8,2025-05-25T00:01:00+02:00,2025-05-25,08:01,3,0,3
28,2025-05-24T23:57:00+02:00,2025-05-25,07:57,0,2,2
28,2025-05-25T00:00:00+02:00,2025-05-25,08:00,1,1,2
28,2025-05-25T00:06:00+02:00,2025-05-25,08:06,0,2,2
29,2025-05-25T00:02:00+02:00,2025-05-25,08:02,0,4,4
29,2025-05-25T00:03:00+02:00,2025-05-25,08:03,5,1,6
29,2025-05-25T00:05:00+02:00,2025-05-25,08:05,5,0,5
31,2025-05-25T00:02:00+02:00,2025-05-25,08:02,1,1,2
36,2025-05-24T23:56:00+02:00,2025-05-25,07:56,1,0,1
36,2025-05-25T00:01:00+02:00,2025-05-25,08:01,0,1,1
36,2025-05-25T00:06:00+02:00,2025-05-25,08:06,0,1,1
36,2025-05-25T00:09:00+02:00,2025-05-25,08:09,1,1,2
37,2025-05-25T00:06:00+02:00,2025-05-25,08:06,1,0,1
39,2025-05-24T23:58:00+02:00,2025-05-25,07:58,0,1,1
39,2025-05-25T00:06:00+02:00,2025-05-25,08:06,1,0,1
39,2025-05-25T00:07:00+02:00,2025-05-25,08:07,1,1,2
39,2025-05-25T00:09:00+02:00,2025-05-25,08:09,3,0,3
40,2025-05-24T23:56:00+02:00,2025-05-25,07:56,0,3,3
40,2025-05-24T23:57:00+02:00,2025-05-25,07:57,3,0,3
41,2025-05-25T00:06:00+02:00,2025-05-25,08:06,2,0,2
43,2025-05-25T00:00:00+02:00,2025-05-25,08:00,1,3,4
43,2025-05-25T00:05:00+02:00,2025-05-25,08:05,1,0,1
47,2025-05-24T23:55:00+02:00,2025-05-25,07:55,1,3,4
47,2025-05-25T00:00:00+02:00,2025-05-25,08:00,0,2,2
47,2025-05-25T00:02:00+02:00,2025-05-25,08:02,1,0,1
47,2025-05-25T00:07:00+02:00,2025-05-25,08:07,1,2,3
50,2025-05-25T00:06:00+02:00,2025-05-25,08:06,0,2,2
50,2025-05-25T00:09:00+02:00,2025-05-25,08:09,1,1,2
54,2025-05-25T00:01:00+02:00,2025-05-25,08:01,0,1,1
54,2025-05-25T00:08:00+02:00,2025-05-25,08:08,0,4,4
54,2025-05-25T00:09:00+02:00,2025-05-25,08:09,0,2,2
59,2025-05-24T23:55:00+02:00,2025-05-25,07:55,0,1,1
61,2025-05-24T23:55:00+02:00,2025-05-25,07:55,2,4,6
61,2025-05-24T23:56:00+02:00,2025-05-25,07:56,1,0,1
61,2025-05-24T23:58:00+02:00,2025-05-25,07:58,1,1,2
61,2025-05-24T23:59:00+02:00,2025-05-25,07:59,1,1,2
61,2025-05-25T00:00:00+02:00,2025-05-25,08:00,3,2,5
61,2025-05-25T00:03:00+02:00,2025-05-25,08:03,1,1,2
66,2025-05-24T23:57:00+02:00,2025-05-25,07:57,1,0,1
66,2025-05-25T00:06:00+02:00,2025-05-25,08:06,0,1,1
66,2025-05-25T00:07:00+02:00,2025-05-25,08:07,0,2,2
69,2025-05-24T23:58:00+02:00,2025-05-25,07:58,0,1,1
70,2025-05-24T23:58:00+02:00,2025-05-25,07:58,0,2,2
70,2025-05-25T00:02:00+02:00,2025-05-25,08:02,1,0,1
71,2025-05-25T00:04:00+02:00,2025-05-25,08:04,0,1,1
75,2025-05-25T00:00:00+02:00,2025-05-25,08:00,4,1,5
75,2025-05-25T00:03:00+02:00,2025-05-25,08:03,1,0,1
75,2025-05-25T00:05:00+02:00,2025-05-25,08:05,0,2,2
75,2025-05-25T00:07:00+02:00,2025-05-25,08:07,0,1,1
77,2025-05-25T00:00:00+02:00,2025-05-25,08:00,5,4,9
78,2025-05-24T23:56:00+02:00,2025-05-25,07:56,0,1,1
78,2025-05-25T00:08:00+02:00,2025-05-25,08:08,1,4,5
78,2025-05-25T00:09:00+02:00,2025-05-25,08:09,0,2,2
87,2025-05-25T00:03:00+02:00,2025-05-25,08:03,0,1,1
108,2025-05-25T00:06:00+02:00,2025-05-25,08:06,1,1,2
131,2025-05-25T00:00:00+02:00,2025-05-25,08:00,2,1,3
132,2025-05-25T00:05:00+02:00,2025-05-25,08:05,2,2,4
134,2025-05-24T23:55:00+02:00,2025-05-25,07:55,14,20,34
135,2025-05-24T23:55:00+02:00,2025-05-25,07:55,10,15,25
135,2025-05-25T00:05:00+02:00,2025-05-25,08:05,9,6,15
162,2025-05-25T00:05:00+02:00,2025-05-25,08:05,8,5,13
167,2025-05-24T23:55:00+02:00,2025-05-25,07:55,1,1,2
1,2025-05-25T00:00:00+02:00,2025-05-25,08:00,1,0,1
1,2025-05-25T00:02:00+02:00,2025-05-25,08:02,1,4,5
1,2025-05-25T00:08:00+02:00,2025-05-25,08:08,1,0,1
2,2025-05-24T23:57:00+02:00,2025-05-25,07:57,1,0,1
2,2025-05-24T23:59:00+02:00,2025-05-25,07:59,0,1,1
2,2025-05-25T00:01:00+02:00,2025-05-25,08:01,1,2,3
2,2025-05-25T00:06:00+02:00,2025-05-25,08:06,0,2,2
9,2025-05-24T23:56:00+02:00,2025-05-25,07:56,1,0,1
9,2025-05-25T00:01:00+02:00,2025-05-25,08:01,1,2,3
11,2025-05-24T23:55:00+02:00,2025-05-25,07:55,4,1,5
11,2025-05-24T23:57:00+02:00,2025-05-25,07:57,2,0,2
11,2025-05-25T00:04:00+02:00,2025-05-25,08:04,2,0,2
12,2025-05-24T23:59:00+02:00,2025-05-25,07:59,2,0,2
12,2025-05-25T00:01:00+02:00,2025-05-25,08:01,2,0,2
12,2025-05-25T00:05:00+02:00,2025-05-25,08:05,2,2,4
12,2025-05-25T00:06:00+02:00,2025-05-25,08:06,0,1,1
12,2025-05-25T00:08:00+02:00,2025-05-25,08:08,1,1,2
12,2025-05-25T00:09:00+02:00,2025-05-25,08:09,1,0,1
17,2025-05-24T23:57:00+02:00,2025-05-25,07:57,1,0,1
17,2025-05-25T00:00:00+02:00,2025-05-25,08:00,1,0,1
17,2025-05-25T00:01:00+02:00,2025-05-25,08:01,0,1,1
17,2025-05-25T00:06:00+02:00,2025-05-25,08:06,1,1,2
18,2025-05-25T00:00:00+02:00,2025-05-25,08:00,0,2,2
19,2025-05-25T00:01:00+02:00,2025-05-25,08:01,1,1,2
20,2025-05-25T00:03:00+02:00,2025-05-25,08:03,0,1,1
20,2025-05-25T00:04:00+02:00,2025-05-25,08:04,0,1,1
23,2025-05-25T00:04:00+02:00,2025-05-25,08:04,0,4,4
24,2025-05-24T23:55:00+02:00,2025-05-25,07:55,5,0,5
24,2025-05-24T23:57:00+02:00,2025-05-25,07:57,3,7,10
24,2025-05-24T23:59:00+02:00,2025-05-25,07:59,5,1,6
24,2025-05-25T00:01:00+02:00,2025-05-25,08:01,6,1,7
24,2025-05-25T00:04:00+02:00,2025-05-25,08:04,3,3,6
24,2025-05-25T00:07:00+02:00,2025-05-25,08:07,3,2,5
25,2025-05-25T00:00:00+02:00,2025-05-25,08:00,15,19,34
27,2025-05-24T23:59:00+02:00,2025-05-25,07:59,1,0,1
27,2025-05-25T00:02:00+02:00,2025-05-25,08:02,0,1,1
27,2025-05-25T00:03:00+02:00,2025-05-25,08:03,0,1,1
27,2025-05-25T00:06:00+02:00,2025-05-25,08:06,2,0,2
30,2025-05-24T23:56:00+02:00,2025-05-25,07:56,2,1,3
30,2025-05-24T23:57:00+02:00,2025-05-25,07:57,4,1,5
30,2025-05-24T23:58:00+02:00,2025-05-25,07:58,0,1,1
30,2025-05-25T00:01:00+02:00,2025-05-25,08:01,1,4,5
30,2025-05-25T00:07:00+02:00,2025-05-25,08:07,0,1,1
35,2025-05-24T23:55:00+02:00,2025-05-25,07:55,8,6,14
35,2025-05-24T23:57:00+02:00,2025-05-25,07:57,6,2,8
35,2025-05-24T23:58:00+02:00,2025-05-25,07:58,6,4,10
35,2025-05-25T00:01:00+02:00,2025-05-25,08:01,5,5,10
35,2025-05-25T00:02:00+02:00,2025-05-25,08:02,4,6,10
35,2025-05-25T00:04:00+02:00,2025-05-25,08:04,10,6,16
35,2025-05-25T00:06:00+02:00,2025-05-25,08:06,5,6,11
35,2025-05-25T00:08:00+02:00,2025-05-25,08:08,13,7,20
46,2025-05-24T23:55:00+02:00,2025-05-25,07:55,3,0,3
48,2025-05-25T00:01:00+02:00,2025-05-25,08:01,0,2,2
48,2025-05-25T00:03:00+02:00,2025-05-25,08:03,0,3,3
48,2025-05-25T00:07:00+02:00,2025-05-25,08:07,1,0,1
49,2025-05-24T23:57:00+02:00,2025-05-25,07:57,3,0,3
49,2025-05-25T00:01:00+02:00,2025-05-25,08:01,2,0,2
51,2025-05-24T23:55:00+02:00,2025-05-25,07:55,1,0,1
51,2025-05-24T23:57:00+02:00,2025-05-25,07:57,3,0,3
51,2025-05-24T23:59:00+02:00,2025-05-25,07:59,0,1,1
56,2025-05-24T23:56:00+02:00,2025-05-25,07:56,0,2,2
56,2025-05-24T23:59:00+02:00,2025-05-25,07:59,1,1,2
56,2025-05-25T00:05:00+02:00,2025-05-25,08:05,1,1,2
56,2025-05-25T00:06:00+02:00,2025-05-25,08:06,2,0,2
56,2025-05-25T00:07:00+02:00,2025-05-25,08:07,1,1,2
56,2025-05-25T00:08:00+02:00,2025-05-25,08:08,0,1,1
58,2025-05-25T00:01:00+02:00,2025-05-25,08:01,2,0,2
58,2025-05-25T00:05:00+02:00,2025-05-25,08:05,1,6,7
58,2025-05-25T00:06:00+02:00,2025-05-25,08:06,3,3,6
58,2025-05-25T00:07:00+02:00,2025-05-25,08:07,1,4,5
63,2025-05-25T00:01:00+02:00,2025-05-25,08:01,0,1,1
63,2025-05-25T00:05:00+02:00,2025-05-25,08:05,0,2,2
63,2025-05-25T00:08:00+02:00,2025-05-25,08:08,1,1,2
67,2025-05-24T23:56:00+02:00,2025-05-25,07:56,2,3,5
67,2025-05-24T23:57:00+02:00,2025-05-25,07:57,11,2,13
67,2025-05-24T23:58:00+02:00,2025-05-25,07:58,1,0,1
67,2025-05-25T00:00:00+02:00,2025-05-25,08:00,2,3,5
67,2025-05-25T00:07:00+02:00,2025-05-25,08:07,1,0,1
67,2025-05-25T00:08:00+02:00,2025-05-25,08:08,1,0,1
68,2025-05-24T23:58:00+02:00,2025-05-25,07:58,0,4,4
68,2025-05-25T00:00:00+02:00,2025-05-25,08:00,1,0,1
68,2025-05-25T00:05:00+02:00,2025-05-25,08:05,0,1,1
68,2025-05-25T00:08:00+02:00,2025-05-25,08:08,3,0,3
72,2025-05-25T00:00:00+02:00,2025-05-25,08:00,1,0,1
72,2025-05-25T00:01:00+02:00,2025-05-25,08:01,0,1,1
72,2025-05-25T00:07:00+02:00,2025-05-25,08:07,0,1,1
72,2025-05-25T00:09:00+02:00,2025-05-25,08:09,2,3,5
76,2025-05-24T23:57:00+02:00,2025-05-25,07:57,0,1,1
79,2025-05-24T23:57:00+02:00,2025-05-25,07:57,7,0,7
79,2025-05-24T23:59:00+02:00,2025-05-25,07:59,1,2,3
79,2025-05-25T00:01:00+02:00,2025-05-25,08:01,2,2,4
79,2025-05-25T00:05:00+02:00,2025-05-25,08:05,1,7,8
79,2025-05-25T00:09:00+02:00,2025-05-25,08:09,4,3,7
85,2025-05-24T23:56:00+02:00,2025-05-25,07:56,1,2,3
85,2025-05-25T00:03:00+02:00,2025-05-25,08:03,2,0,2
85,2025-05-25T00:09:00+02:00,2025-05-25,08:09,1,0,1
109,2025-05-25T00:00:00+02:00,2025-05-25,08:00,0,1,1
117,2025-05-25T00:00:00+02:00,2025-05-25,08:00,0,2,2
123,2025-05-24T23:55:00+02:00,2025-05-25,07:55,1,9,10
130,2025-05-25T00:00:00+02:00,2025-05-25,08:00,1,0,1
136,2025-05-24T23:55:00+02:00,2025-05-25,07:55,3,11,14
136,2025-05-25T00:00:00+02:00,2025-05-25,08:00,8,6,14
139,2025-05-25T00:00:00+02:00,2025-05-25,08:00,0,1,1
139,2025-05-25T00:05:00+02:00,2025-05-25,08:05,0,1,1
141,2025-05-25T00:00:00+02:00,2025-05-25,08:00,4,1,5
142,2025-05-24T23:55:00+02:00,2025-05-25,07:55,14,17,31
161,2025-05-25T00:05:00+02:00,2025-05-25,08:05,5,16,21
164,2025-05-25T00:00:00+02:00,2025-05-25,08:00,1,1,2
181,2025-05-24T23:55:00+02:00,2025-05-25,07:55,1,6,7
181,2025-05-25T00:03:00+02:00,2025-05-25,08:03,1,2,3
181,2025-05-25T00:05:00+02:00,2025-05-25,08:05,3,2,5
181,2025-05-25T00:09:00+02:00,2025-05-25,08:09,0,1,1
182,2025-05-24T23:55:00+02:00,2025-05-25,07:55,4,5,9
182,2025-05-25T00:05:00+02:00,2025-05-25,08:05,3,7,10
180,2025-05-24T23:57:00+02:00,2025-05-25,07:57,1,0,1
181,2025-05-25T00:14:00+02:00,2025-05-25,08:14,0,5,5
181,2025-05-25T00:18:00+02:00,2025-05-25,08:18,1,3,4
181,2025-05-25T00:20:00+02:00,2025-05-25,08:20,2,6,8
182,2025-05-25T00:10:00+02:00,2025-05-25,08:10,1,1,2
180,2025-05-25T00:18:00+02:00,2025-05-25,08:18,1,0,1
180,2025-05-25T00:23:00+02:00,2025-05-25,08:23,1,0,1
180,2025-05-25T00:24:00+02:00,2025-05-25,08:24,1,0,1
3,2025-05-25T00:25:00+02:00,2025-05-25,08:25,2,0,2
3,2025-05-25T00:27:00+02:00,2025-05-25,08:27,1,0,1
3,2025-05-25T00:30:00+02:00,2025-05-25,08:30,1,3,4
3,2025-05-25T00:37:00+02:00,2025-05-25,08:37,0,5,5
3,2025-05-25T00:38:00+02:00,2025-05-25,08:38,3,0,3
4,2025-05-25T00:32:00+02:00,2025-05-25,08:32,3,0,3
4,2025-05-25T00:34:00+02:00,2025-05-25,08:34,3,2,5
4,2025-05-25T00:35:00+02:00,2025-05-25,08:35,1,0,1
4,2025-05-25T00:36:00+02:00,2025-05-25,08:36,2,5,7
4,2025-05-25T00:37:00+02:00,2025-05-25,08:37,3,5,8
4,2025-05-25T00:38:00+02:00,2025-05-25,08:38,3,0,3
5,2025-05-25T00:25:00+02:00,2025-05-25,08:25,11,16,27
5,2025-05-25T00:30:00+02:00,2025-05-25,08:30,11,7,18
5,2025-05-25T00:35:00+02:00,2025-05-25,08:35,13,25,38
6,2025-05-25T00:27:00+02:00,2025-05-25,08:27,2,4,6
6,2025-05-25T00:29:00+02:00,2025-05-25,08:29,4,3,7
6,2025-05-25T00:32:00+02:00,2025-05-25,08:32,5,1,6
8,2025-05-25T00:25:00+02:00,2025-05-25,08:25,1,0,1
8,2025-05-25T00:26:00+02:00,2025-05-25,08:26,1,2,3
8,2025-05-25T00:30:00+02:00,2025-05-25,08:30,1,0,1
8,2025-05-25T00:31:00+02:00,2025-05-25,08:31,7,2,9
8,2025-05-25T00:33:00+02:00,2025-05-25,08:33,22,0,22
8,2025-05-25T00:34:00+02:00,2025-05-25,08:34,40,1,41
8,2025-05-25T00:38:00+02:00,2025-05-25,08:38,1,1,2
28,2025-05-25T00:26:00+02:00,2025-05-25,08:26,1,4,5
28,2025-05-25T00:33:00+02:00,2025-05-25,08:33,2,2,4
28,2025-05-25T00:36:00+02:00,2025-05-25,08:36,0,2,2
28,2025-05-25T00:39:00+02:00,2025-05-25,08:39,1,3,4
29,2025-05-25T00:25:00+02:00,2025-05-25,08:25,0,3,3
29,2025-05-25T00:27:00+02:00,2025-05-25,08:27,2,2,4
29,2025-05-25T00:30:00+02:00,2025-05-25,08:30,2,2,4
31,2025-05-25T00:33:00+02:00,2025-05-25,08:33,1,0,1
31,2025-05-25T00:37:00+02:00,2025-05-25,08:37,1,0,1
36,2025-05-25T00:26:00+02:00,2025-05-25,08:26,0,1,1
36,2025-05-25T00:29:00+02:00,2025-05-25,08:29,1,0,1
36,2025-05-25T00:30:00+02:00,2025-05-25,08:30,1,0,1
37,2025-05-25T00:32:00+02:00,2025-05-25,08:32,0,1,1
37,2025-05-25T00:33:00+02:00,2025-05-25,08:33,1,2,3
39,2025-05-25T00:32:00+02:00,2025-05-25,08:32,2,1,3
40,2025-05-25T00:34:00+02:00,2025-05-25,08:34,0,1,1
40,2025-05-25T00:35:00+02:00,2025-05-25,08:35,1,1,2
41,2025-05-25T00:27:00+02:00,2025-05-25,08:27,0,2,2
41,2025-05-25T00:31:00+02:00,2025-05-25,08:31,1,1,2
41,2025-05-25T00:33:00+02:00,2025-05-25,08:33,0,1,1
45,2025-05-25T00:34:00+02:00,2025-05-25,08:34,6,5,11
45,2025-05-25T00:35:00+02:00,2025-05-25,08:35,2,1,3
45,2025-05-25T00:36:00+02:00,2025-05-25,08:36,0,3,3
45,2025-05-25T00:39:00+02:00,2025-05-25,08:39,1,3,4
47,2025-05-25T00:27:00+02:00,2025-05-25,08:27,1,11,12
47,2025-05-25T00:29:00+02:00,2025-05-25,08:29,3,4,7
47,2025-05-25T00:30:00+02:00,2025-05-25,08:30,1,3,4
47,2025-05-25T00:32:00+02:00,2025-05-25,08:32,3,4,7
47,2025-05-25T00:39:00+02:00,2025-05-25,08:39,0,3,3
50,2025-05-25T00:25:00+02:00,2025-05-25,08:25,0,1,1
50,2025-05-25T00:26:00+02:00,2025-05-25,08:26,3,3,6
50,2025-05-25T00:31:00+02:00,2025-05-25,08:31,0,1,1
50,2025-05-25T00:34:00+02:00,2025-05-25,08:34,1,0,1
50,2025-05-25T00:38:00+02:00,2025-05-25,08:38,0,1,1
54,2025-05-25T00:34:00+02:00,2025-05-25,08:34,1,3,4
59,2025-05-25T00:30:00+02:00,2025-05-25,08:30,2,4,6
59,2025-05-25T00:35:00+02:00,2025-05-25,08:35,4,6,10
61,2025-05-25T00:29:00+02:00,2025-05-25,08:29,1,0,1
61,2025-05-25T00:32:00+02:00,2025-05-25,08:32,2,1,3
61,2025-05-25T00:33:00+02:00,2025-05-25,08:33,0,1,1
61,2025-05-25T00:34:00+02:00,2025-05-25,08:34,0,2,2
61,2025-05-25T00:39:00+02:00,2025-05-25,08:39,1,3,4
66,2025-05-25T00:25:00+02:00,2025-05-25,08:25,0,3,3
66,2025-05-25T00:31:00+02:00,2025-05-25,08:31,3,2,5
66,2025-05-25T00:33:00+02:00,2025-05-25,08:33,1,0,1
66,2025-05-25T00:37:00+02:00,2025-05-25,08:37,0,3,3
66,2025-05-25T00:38:00+02:00,2025-05-25,08:38,1,4,5
69,2025-05-25T00:26:00+02:00,2025-05-25,08:26,0,1,1
69,2025-05-25T00:28:00+02:00,2025-05-25,08:28,0,1,1
69,2025-05-25T00:30:00+02:00,2025-05-25,08:30,2,0,2
69,2025-05-25T00:31:00+02:00,2025-05-25,08:31,1,0,1
69,2025-05-25T00:32:00+02:00,2025-05-25,08:32,1,0,1
70,2025-05-25T00:26:00+02:00,2025-05-25,08:26,1,3,4
75,2025-05-25T00:28:00+02:00,2025-05-25,08:28,1,0,1
77,2025-05-25T00:25:00+02:00,2025-05-25,08:25,7,4,11
77,2025-05-25T00:30:00+02:00,2025-05-25,08:30,5,6,11
78,2025-05-25T00:28:00+02:00,2025-05-25,08:28,3,2,5
78,2025-05-25T00:30:00+02:00,2025-05-25,08:30,0,3,3
78,2025-05-25T00:32:00+02:00,2025-05-25,08:32,0,3,3
87,2025-05-25T00:39:00+02:00,2025-05-25,08:39,2,0,2
108,2025-05-25T00:26:00+02:00,2025-05-25,08:26,1,0,1
108,2025-05-25T00:29:00+02:00,2025-05-25,08:29,1,0,1
108,2025-05-25T00:32:00+02:00,2025-05-25,08:32,1,2,3
108,2025-05-25T00:35:00+02:00,2025-05-25,08:35,4,1,5
108,2025-05-25T00:39:00+02:00,2025-05-25,08:39,1,7,8
118,2025-05-25T00:30:00+02:00,2025-05-25,08:30,1,0,1
131,2025-05-25T00:25:00+02:00,2025-05-25,08:25,0,2,2
131,2025-05-25T00:35:00+02:00,2025-05-25,08:35,3,1,4
132,2025-05-25T00:30:00+02:00,2025-05-25,08:30,4,6,10
132,2025-05-25T00:35:00+02:00,2025-05-25,08:35,9,3,12
133,2025-05-25T00:30:00+02:00,2025-05-25,08:30,24,16,40
133,2025-05-25T00:35:00+02:00,2025-05-25,08:35,19,33,52
134,2025-05-25T00:30:00+02:00,2025-05-25,08:30,12,19,31
134,2025-05-25T00:35:00+02:00,2025-05-25,08:35,20,13,33
135,2025-05-25T00:35:00+02:00,2025-05-25,08:35,5,20,25
140,2025-05-25T00:30:00+02:00,2025-05-25,08:30,8,5,13
140,2025-05-25T00:35:00+02:00,2025-05-25,08:35,7,0,7
162,2025-05-25T00:35:00+02:00,2025-05-25,08:35,13,9,22
167,2025-05-25T00:25:00+02:00,2025-05-25,08:25,3,5,8
1,2025-05-25T00:25:00+02:00,2025-05-25,08:25,2,0,2
1,2025-05-25T00:26:00+02:00,2025-05-25,08:26,1,1,2
1,2025-05-25T00:33:00+02:00,2025-05-25,08:33,3,1,4
1,2025-05-25T00:35:00+02:00,2025-05-25,08:35,3,0,3
1,2025-05-25T00:37:00+02:00,2025-05-25,08:37,1,1,2
1,2025-05-25T00:38:00+02:00,2025-05-25,08:38,0,3,3
2,2025-05-25T00:36:00+02:00,2025-05-25,08:36,1,2,3
9,2025-05-25T00:29:00+02:00,2025-05-25,08:29,1,0,1
9,2025-05-25T00:33:00+02:00,2025-05-25,08:33,1,2,3
9,2025-05-25T00:36:00+02:00,2025-05-25,08:36,1,0,1
9,2025-05-25T00:39:00+02:00,2025-05-25,08:39,1,1,2
10,2025-05-25T00:26:00+02:00,2025-05-25,08:26,2,0,2
11,2025-05-25T00:32:00+02:00,2025-05-25,08:32,1,0,1
11,2025-05-25T00:39:00+02:00,2025-05-25,08:39,0,1,1
12,2025-05-25T00:25:00+02:00,2025-05-25,08:25,0,1,1
12,2025-05-25T00:31:00+02:00,2025-05-25,08:31,4,2,6
12,2025-05-25T00:32:00+02:00,2025-05-25,08:32,1,3,4
12,2025-05-25T00:35:00+02:00,2025-05-25,08:35,2,0,2
17,2025-05-25T00:29:00+02:00,2025-05-25,08:29,1,1,2
17,2025-05-25T00:33:00+02:00,2025-05-25,08:33,0,1,1
17,2025-05-25T00:35:00+02:00,2025-05-25,08:35,1,0,1
17,2025-05-25T00:37:00+02:00,2025-05-25,08:37,1,1,2
17,2025-05-25T00:39:00+02:00,2025-05-25,08:39,0,2,2
18,2025-05-25T00:28:00+02:00,2025-05-25,08:28,4,0,4
18,2025-05-25T00:32:00+02:00,2025-05-25,08:32,0,2,2
18,2025-05-25T00:33:00+02:00,2025-05-25,08:33,0,1,1
18,2025-05-25T00:34:00+02:00,2025-05-25,08:34,1,0,1
18,2025-05-25T00:36:00+02:00,2025-05-25,08:36,1,0,1
18,2025-05-25T00:38:00+02:00,2025-05-25,08:38,2,1,3
19,2025-05-25T00:25:00+02:00,2025-05-25,08:25,1,0,1
19,2025-05-25T00:34:00+02:00,2025-05-25,08:34,1,0,1
19,2025-05-25T00:38:00+02:00,2025-05-25,08:38,0,1,1
20,2025-05-25T00:25:00+02:00,2025-05-25,08:25,1,2,3
20,2025-05-25T00:36:00+02:00,2025-05-25,08:36,2,1,3
23,2025-05-25T00:25:00+02:00,2025-05-25,08:25,7,1,8
23,2025-05-25T00:26:00+02:00,2025-05-25,08:26,5,0,5
23,2025-05-25T00:27:00+02:00,2025-05-25,08:27,4,4,8
23,2025-05-25T00:30:00+02:00,2025-05-25,08:30,0,1,1
23,2025-05-25T00:35:00+02:00,2025-05-25,08:35,0,3,3
23,2025-05-25T00:36:00+02:00,2025-05-25,08:36,5,2,7
23,2025-05-25T00:37:00+02:00,2025-05-25,08:37,0,4,4
23,2025-05-25T00:38:00+02:00,2025-05-25,08:38,2,5,7
23,2025-05-25T00:39:00+02:00,2025-05-25,08:39,1,0,1
24,2025-05-25T00:28:00+02:00,2025-05-25,08:28,4,8,12
24,2025-05-25T00:30:00+02:00,2025-05-25,08:30,0,4,4
24,2025-05-25T00:38:00+02:00,2025-05-25,08:38,9,5,14
25,2025-05-25T00:25:00+02:00,2025-05-25,08:25,8,107,115
27,2025-05-25T00:32:00+02:00,2025-05-25,08:32,1,0,1
27,2025-05-25T00:33:00+02:00,2025-05-25,08:33,1,2,3
30,2025-05-25T00:30:00+02:00,2025-05-25,08:30,0,1,1
35,2025-05-25T00:27:00+02:00,2025-05-25,08:27,10,9,19
35,2025-05-25T00:28:00+02:00,2025-05-25,08:28,11,0,11
35,2025-05-25T00:29:00+02:00,2025-05-25,08:29,6,9,15
35,2025-05-25T00:33:00+02:00,2025-05-25,08:33,6,23,29
46,2025-05-25T00:35:00+02:00,2025-05-25,08:35,1,0,1
48,2025-05-25T00:33:00+02:00,2025-05-25,08:33,1,3,4
48,2025-05-25T00:36:00+02:00,2025-05-25,08:36,3,2,5
48,2025-05-25T00:38:00+02:00,2025-05-25,08:38,0,1,1
49,2025-05-25T00:27:00+02:00,2025-05-25,08:27,1,7,8
49,2025-05-25T00:29:00+02:00,2025-05-25,08:29,3,1,4
49,2025-05-25T00:32:00+02:00,2025-05-25,08:32,1,1,2
49,2025-05-25T00:36:00+02:00,2025-05-25,08:36,1,4,5
49,2025-05-25T00:39:00+02:00,2025-05-25,08:39,3,1,4
51,2025-05-25T00:38:00+02:00,2025-05-25,08:38,1,1,2
52,2025-05-25T00:26:00+02:00,2025-05-25,08:26,1,0,1
52,2025-05-25T00:30:00+02:00,2025-05-25,08:30,0,1,1
52,2025-05-25T00:32:00+02:00,2025-05-25,08:32,0,3,3
52,2025-05-25T00:37:00+02:00,2025-05-25,08:37,2,0,2
53,2025-05-25T00:26:00+02:00,2025-05-25,08:26,1,1,2
53,2025-05-25T00:27:00+02:00,2025-05-25,08:27,3,0,3
53,2025-05-25T00:31:00+02:00,2025-05-25,08:31,1,0,1
53,2025-05-25T00:33:00+02:00,2025-05-25,08:33,3,1,4
53,2025-05-25T00:37:00+02:00,2025-05-25,08:37,0,1,1
56,2025-05-25T00:29:00+02:00,2025-05-25,08:29,2,1,3
56,2025-05-25T00:32:00+02:00,2025-05-25,08:32,3,0,3
56,2025-05-25T00:34:00+02:00,2025-05-25,08:34,1,0,1
56,2025-05-25T00:37:00+02:00,2025-05-25,08:37,2,0,2
58,2025-05-25T00:34:00+02:00,2025-05-25,08:34,3,0,3
58,2025-05-25T00:35:00+02:00,2025-05-25,08:35,2,4,6
58,2025-05-25T00:37:00+02:00,2025-05-25,08:37,1,5,6
62,2025-05-25T00:25:00+02:00,2025-05-25,08:25,1,1,2
62,2025-05-25T00:29:00+02:00,2025-05-25,08:29,0,1,1
62,2025-05-25T00:32:00+02:00,2025-05-25,08:32,2,1,3
62,2025-05-25T00:33:00+02:00,2025-05-25,08:33,1,0,1
62,2025-05-25T00:36:00+02:00,2025-05-25,08:36,1,0,1
62,2025-05-25T00:39:00+02:00,2025-05-25,08:39,1,2,3
63,2025-05-25T00:33:00+02:00,2025-05-25,08:33,0,1,1
67,2025-05-25T00:29:00+02:00,2025-05-25,08:29,3,0,3
67,2025-05-25T00:33:00+02:00,2025-05-25,08:33,2,8,10
68,2025-05-25T00:27:00+02:00,2025-05-25,08:27,0,1,1
68,2025-05-25T00:33:00+02:00,2025-05-25,08:33,1,1,2
68,2025-05-25T00:39:00+02:00,2025-05-25,08:39,0,2,2
72,2025-05-25T00:33:00+02:00,2025-05-25,08:33,0,1,1
72,2025-05-25T00:39:00+02:00,2025-05-25,08:39,0,3,3
76,2025-05-25T00:33:00+02:00,2025-05-25,08:33,1,1,2
76,2025-05-25T00:37:00+02:00,2025-05-25,08:37,1,0,1
79,2025-05-25T00:27:00+02:00,2025-05-25,08:27,4,1,5
79,2025-05-25T00:30:00+02:00,2025-05-25,08:30,0,1,1
79,2025-05-25T00:31:00+02:00,2025-05-25,08:31,2,2,4
79,2025-05-25T00:39:00+02:00,2025-05-25,08:39,0,3,3
85,2025-05-25T00:30:00+02:00,2025-05-25,08:30,1,0,1
85,2025-05-25T00:32:00+02:00,2025-05-25,08:32,1,1,2
85,2025-05-25T00:36:00+02:00,2025-05-25,08:36,1,3,4
85,2025-05-25T00:39:00+02:00,2025-05-25,08:39,0,1,1
86,2025-05-25T00:31:00+02:00,2025-05-25,08:31,0,3,3
123,2025-05-25T00:25:00+02:00,2025-05-25,08:25,3,0,3
123,2025-05-25T00:30:00+02:00,2025-05-25,08:30,2,1,3
123,2025-05-25T00:35:00+02:00,2025-05-25,08:35,0,4,4
136,2025-05-25T00:25:00+02:00,2025-05-25,08:25,4,5,9
139,2025-05-25T00:30:00+02:00,2025-05-25,08:30,2,3,5
141,2025-05-25T00:30:00+02:00,2025-05-25,08:30,5,5,10
142,2025-05-25T00:25:00+02:00,2025-05-25,08:25,35,17,52
142,2025-05-25T00:30:00+02:00,2025-05-25,08:30,21,61,82
142,2025-05-25T00:35:00+02:00,2025-05-25,08:35,17,14,31
164,2025-05-25T00:25:00+02:00,2025-05-25,08:25,1,3,4
164,2025-05-25T00:30:00+02:00,2025-05-25,08:30,4,2,6
181,2025-05-25T00:28:00+02:00,2025-05-25,08:28,2,3,5
181,2025-05-25T00:31:00+02:00,2025-05-25,08:31,1,3,4
181,2025-05-25T00:32:00+02:00,2025-05-25,08:32,1,5,6
181,2025-05-25T00:35:00+02:00,2025-05-25,08:35,3,5,8
181,2025-05-25T00:36:00+02:00,2025-05-25,08:36,2,7,9
181,2025-05-25T00:37:00+02:00,2025-05-25,08:37,2,8,10
3,2025-05-25T00:43:00+02:00,2025-05-25,08:43,4,2,6
3,2025-05-25T00:48:00+02:00,2025-05-25,08:48,2,2,4
3,2025-05-25T00:52:00+02:00,2025-05-25,08:52,2,6,8
3,2025-05-25T00:53:00+02:00,2025-05-25,08:53,1,1,2
3,2025-05-25T00:54:00+02:00,2025-05-25,08:54,2,0,2
4,2025-05-25T00:40:00+02:00,2025-05-25,08:40,2,5,7
4,2025-05-25T00:42:00+02:00,2025-05-25,08:42,3,1,4
4,2025-05-25T00:54:00+02:00,2025-05-25,08:54,3,2,5
5,2025-05-25T00:45:00+02:00,2025-05-25,08:45,17,22,39
6,2025-05-25T00:41:00+02:00,2025-05-25,08:41,5,3,8
6,2025-05-25T00:44:00+02:00,2025-05-25,08:44,5,4,9
6,2025-05-25T00:46:00+02:00,2025-05-25,08:46,0,3,3
6,2025-05-25T00:51:00+02:00,2025-05-25,08:51,3,2,5
8,2025-05-25T00:42:00+02:00,2025-05-25,08:42,7,2,9
8,2025-05-25T00:44:00+02:00,2025-05-25,08:44,3,6,9
8,2025-05-25T00:45:00+02:00,2025-05-25,08:45,0,1,1
8,2025-05-25T00:49:00+02:00,2025-05-25,08:49,2,8,10
8,2025-05-25T00:51:00+02:00,2025-05-25,08:51,1,0,1
8,2025-05-25T00:52:00+02:00,2025-05-25,08:52,1,6,7
28,2025-05-25T00:42:00+02:00,2025-05-25,08:42,3,0,3
28,2025-05-25T00:45:00+02:00,2025-05-25,08:45,0,2,2
28,2025-05-25T00:49:00+02:00,2025-05-25,08:49,2,2,4
28,2025-05-25T00:50:00+02:00,2025-05-25,08:50,3,4,7
29,2025-05-25T00:40:00+02:00,2025-05-25,08:40,4,7,11
29,2025-05-25T00:50:00+02:00,2025-05-25,08:50,2,4,6
29,2025-05-25T00:51:00+02:00,2025-05-25,08:51,0,3,3
29,2025-05-25T00:53:00+02:00,2025-05-25,08:53,0,1,1
31,2025-05-25T00:41:00+02:00,2025-05-25,08:41,0,2,2
31,2025-05-25T00:42:00+02:00,2025-05-25,08:42,0,1,1
31,2025-05-25T00:45:00+02:00,2025-05-25,08:45,0,3,3
31,2025-05-25T00:48:00+02:00,2025-05-25,08:48,4,1,5
31,2025-05-25T00:53:00+02:00,2025-05-25,08:53,0,2,2
31,2025-05-25T00:54:00+02:00,2025-05-25,08:54,1,0,1
36,2025-05-25T00:50:00+02:00,2025-05-25,08:50,1,0,1
37,2025-05-25T00:50:00+02:00,2025-05-25,08:50,1,0,1
39,2025-05-25T00:47:00+02:00,2025-05-25,08:47,0,4,4
39,2025-05-25T00:54:00+02:00,2025-05-25,08:54,1,0,1
40,2025-05-25T00:47:00+02:00,2025-05-25,08:47,1,1,2
41,2025-05-25T00:43:00+02:00,2025-05-25,08:43,2,0,2
41,2025-05-25T00:54:00+02:00,2025-05-25,08:54,5,0,5
43,2025-05-25T00:50:00+02:00,2025-05-25,08:50,3,1,4
44,2025-05-25T00:50:00+02:00,2025-05-25,08:50,2,1,3
45,2025-05-25T00:44:00+02:00,2025-05-25,08:44,1,4,5
47,2025-05-25T00:42:00+02:00,2025-05-25,08:42,4,5,9
47,2025-05-25T00:49:00+02:00,2025-05-25,08:49,7,4,11
47,2025-05-25T00:50:00+02:00,2025-05-25,08:50,1,1,2
47,2025-05-25T00:53:00+02:00,2025-05-25,08:53,3,11,14
50,2025-05-25T00:44:00+02:00,2025-05-25,08:44,2,0,2
50,2025-05-25T00:46:00+02:00,2025-05-25,08:46,1,0,1
50,2025-05-25T00:49:00+02:00,2025-05-25,08:49,1,0,1
50,2025-05-25T00:51:00+02:00,2025-05-25,08:51,1,1,2
54,2025-05-25T00:40:00+02:00,2025-05-25,08:40,2,0,2
54,2025-05-25T00:49:00+02:00,2025-05-25,08:49,0,3,3
59,2025-05-25T00:45:00+02:00,2025-05-25,08:45,4,9,13
59,2025-05-25T00:50:00+02:00,2025-05-25,08:50,1,5,6
61,2025-05-25T00:41:00+02:00,2025-05-25,08:41,1,2,3
61,2025-05-25T00:47:00+02:00,2025-05-25,08:47,7,3,10
61,2025-05-25T00:51:00+02:00,2025-05-25,08:51,1,2,3
66,2025-05-25T00:40:00+02:00,2025-05-25,08:40,1,3,4
66,2025-05-25T00:46:00+02:00,2025-05-25,08:46,3,0,3
66,2025-05-25T00:47:00+02:00,2025-05-25,08:47,0,3,3
66,2025-05-25T00:49:00+02:00,2025-05-25,08:49,2,1,3
66,2025-05-25T00:53:00+02:00,2025-05-25,08:53,0,4,4
69,2025-05-25T00:41:00+02:00,2025-05-25,08:41,1,0,1
69,2025-05-25T00:42:00+02:00,2025-05-25,08:42,3,0,3
69,2025-05-25T00:46:00+02:00,2025-05-25,08:46,2,0,2
69,2025-05-25T00:48:00+02:00,2025-05-25,08:48,1,0,1
69,2025-05-25T00:51:00+02:00,2025-05-25,08:51,1,1,2
69,2025-05-25T00:54:00+02:00,2025-05-25,08:54,2,0,2
70,2025-05-25T00:49:00+02:00,2025-05-25,08:49,1,0,1
70,2025-05-25T00:53:00+02:00,2025-05-25,08:53,3,0,3
70,2025-05-25T00:54:00+02:00,2025-05-25,08:54,0,2,2
75,2025-05-25T00:40:00+02:00,2025-05-25,08:40,0,1,1
75,2025-05-25T00:42:00+02:00,2025-05-25,08:42,0,1,1
75,2025-05-25T00:48:00+02:00,2025-05-25,08:48,0,1,1
77,2025-05-25T00:40:00+02:00,2025-05-25,08:40,80,6,86
78,2025-05-25T00:43:00+02:00,2025-05-25,08:43,3,0,3
78,2025-05-25T00:44:00+02:00,2025-05-25,08:44,0,3,3
78,2025-05-25T00:46:00+02:00,2025-05-25,08:46,2,1,3
78,2025-05-25T00:47:00+02:00,2025-05-25,08:47,0,5,5
78,2025-05-25T00:48:00+02:00,2025-05-25,08:48,1,4,5
78,2025-05-25T00:49:00+02:00,2025-05-25,08:49,0,1,1
78,2025-05-25T00:50:00+02:00,2025-05-25,08:50,0,6,6
87,2025-05-25T00:44:00+02:00,2025-05-25,08:44,0,1,1
107,2025-05-25T00:45:00+02:00,2025-05-25,08:45,7,3,10
107,2025-05-25T00:50:00+02:00,2025-05-25,08:50,0,2,2
108,2025-05-25T00:51:00+02:00,2025-05-25,08:51,2,0,2
118,2025-05-25T00:45:00+02:00,2025-05-25,08:45,1,0,1
131,2025-05-25T00:40:00+02:00,2025-05-25,08:40,3,5,8
132,2025-05-25T00:40:00+02:00,2025-05-25,08:40,6,2,8
132,2025-05-25T00:45:00+02:00,2025-05-25,08:45,5,8,13
133,2025-05-25T00:50:00+02:00,2025-05-25,08:50,26,29,55
134,2025-05-25T00:45:00+02:00,2025-05-25,08:45,15,14,29
135,2025-05-25T00:40:00+02:00,2025-05-25,08:40,10,23,33
162,2025-05-25T00:50:00+02:00,2025-05-25,08:50,9,8,17
165,2025-05-25T00:45:00+02:00,2025-05-25,08:45,3,2,5
165,2025-05-25T00:50:00+02:00,2025-05-25,08:50,1,3,4
166,2025-05-25T00:40:00+02:00,2025-05-25,08:40,1,1,2
167,2025-05-25T00:45:00+02:00,2025-05-25,08:45,0,3,3
179,2025-05-25T00:40:00+02:00,2025-05-25,08:40,1,3,4
179,2025-05-25T00:50:00+02:00,2025-05-25,08:50,1,1,2
1,2025-05-25T00:43:00+02:00,2025-05-25,08:43,0,3,3
1,2025-05-25T00:46:00+02:00,2025-05-25,08:46,0,3,3
1,2025-05-25T00:48:00+02:00,2025-05-25,08:48,0,2,2
1,2025-05-25T00:51:00+02:00,2025-05-25,08:51,3,0,3
1,2025-05-25T00:54:00+02:00,2025-05-25,08:54,2,0,2
2,2025-05-25T00:44:00+02:00,2025-05-25,08:44,1,0,1
2,2025-05-25T00:48:00+02:00,2025-05-25,08:48,1,0,1
2,2025-05-25T00:52:00+02:00,2025-05-25,08:52,3,1,4
9,2025-05-25T00:53:00+02:00,2025-05-25,08:53,1,0,1
10,2025-05-25T00:42:00+02:00,2025-05-25,08:42,0,1,1
10,2025-05-25T00:45:00+02:00,2025-05-25,08:45,3,0,3
10,2025-05-25T00:50:00+02:00,2025-05-25,08:50,0,1,1
11,2025-05-25T00:49:00+02:00,2025-05-25,08:49,0,3,3
11,2025-05-25T00:51:00+02:00,2025-05-25,08:51,3,1,4
12,2025-05-25T00:44:00+02:00,2025-05-25,08:44,1,5,6
12,2025-05-25T00:47:00+02:00,2025-05-25,08:47,2,0,2
12,2025-05-25T00:50:00+02:00,2025-05-25,08:50,1,1,2
12,2025-05-25T00:51:00+02:00,2025-05-25,08:51,1,0,1
12,2025-05-25T00:52:00+02:00,2025-05-25,08:52,0,1,1
12,2025-05-25T00:53:00+02:00,2025-05-25,08:53,3,6,9
17,2025-05-25T00:41:00+02:00,2025-05-25,08:41,0,3,3
17,2025-05-25T00:45:00+02:00,2025-05-25,08:45,1,2,3
17,2025-05-25T00:49:00+02:00,2025-05-25,08:49,0,1,1
17,2025-05-25T00:52:00+02:00,2025-05-25,08:52,5,1,6
17,2025-05-25T00:54:00+02:00,2025-05-25,08:54,0,1,1
18,2025-05-25T00:46:00+02:00,2025-05-25,08:46,1,1,2
19,2025-05-25T00:42:00+02:00,2025-05-25,08:42,2,2,4
19,2025-05-25T00:50:00+02:00,2025-05-25,08:50,1,0,1
20,2025-05-25T00:46:00+02:00,2025-05-25,08:46,0,2,2
20,2025-05-25T00:47:00+02:00,2025-05-25,08:47,0,1,1
23,2025-05-25T00:42:00+02:00,2025-05-25,08:42,0,3,3
23,2025-05-25T00:43:00+02:00,2025-05-25,08:43,4,1,5
23,2025-05-25T00:46:00+02:00,2025-05-25,08:46,0,5,5
23,2025-05-25T00:47:00+02:00,2025-05-25,08:47,4,2,6
24,2025-05-25T00:40:00+02:00,2025-05-25,08:40,4,0,4
24,2025-05-25T00:42:00+02:00,2025-05-25,08:42,1,1,2
24,2025-05-25T00:46:00+02:00,2025-05-25,08:46,7,10,17
24,2025-05-25T00:48:00+02:00,2025-05-25,08:48,4,4,8
25,2025-05-25T00:50:00+02:00,2025-05-25,08:50,21,29,50
27,2025-05-25T00:46:00+02:00,2025-05-25,08:46,0,4,4
27,2025-05-25T00:49:00+02:00,2025-05-25,08:49,1,7,8
30,2025-05-25T00:40:00+02:00,2025-05-25,08:40,0,1,1
30,2025-05-25T00:41:00+02:00,2025-05-25,08:41,1,0,1
30,2025-05-25T00:46:00+02:00,2025-05-25,08:46,0,1,1
30,2025-05-25T00:52:00+02:00,2025-05-25,08:52,1,0,1
35,2025-05-25T00:43:00+02:00,2025-05-25,08:43,9,4,13
35,2025-05-25T00:44:00+02:00,2025-05-25,08:44,8,9,17
35,2025-05-25T00:46:00+02:00,2025-05-25,08:46,7,4,11
35,2025-05-25T00:47:00+02:00,2025-05-25,08:47,10,4,14
35,2025-05-25T00:52:00+02:00,2025-05-25,08:52,7,3,10
35,2025-05-25T00:54:00+02:00,2025-05-25,08:54,11,9,20
48,2025-05-25T00:40:00+02:00,2025-05-25,08:40,1,2,3
48,2025-05-25T00:46:00+02:00,2025-05-25,08:46,0,2,2
48,2025-05-25T00:47:00+02:00,2025-05-25,08:47,1,6,7
48,2025-05-25T00:48:00+02:00,2025-05-25,08:48,4,1,5
48,2025-05-25T00:51:00+02:00,2025-05-25,08:51,3,2,5
49,2025-05-25T00:40:00+02:00,2025-05-25,08:40,2,3,5
49,2025-05-25T00:44:00+02:00,2025-05-25,08:44,6,4,10
49,2025-05-25T00:45:00+02:00,2025-05-25,08:45,2,0,2
49,2025-05-25T00:46:00+02:00,2025-05-25,08:46,6,0,6
49,2025-05-25T00:48:00+02:00,2025-05-25,08:48,4,5,9
49,2025-05-25T00:51:00+02:00,2025-05-25,08:51,6,3,9
49,2025-05-25T00:52:00+02:00,2025-05-25,08:52,4,2,6
49,2025-05-25T00:53:00+02:00,2025-05-25,08:53,4,2,6
51,2025-05-25T00:44:00+02:00,2025-05-25,08:44,1,2,3
51,2025-05-25T00:51:00+02:00,2025-05-25,08:51,0,1,1
52,2025-05-25T00:42:00+02:00,2025-05-25,08:42,0,3,3
52,2025-05-25T00:43:00+02:00,2025-05-25,08:43,3,0,3
52,2025-05-25T00:44:00+02:00,2025-05-25,08:44,0,1,1
52,2025-05-25T00:53:00+02:00,2025-05-25,08:53,1,0,1
53,2025-05-25T00:44:00+02:00,2025-05-25,08:44,3,1,4
53,2025-05-25T00:46:00+02:00,2025-05-25,08:46,2,0,2
53,2025-05-25T00:47:00+02:00,2025-05-25,08:47,2,0,2
53,2025-05-25T00:49:00+02:00,2025-05-25,08:49,1,0,1
53,2025-05-25T00:52:00+02:00,2025-05-25,08:52,1,0,1
56,2025-05-25T00:41:00+02:00,2025-05-25,08:41,2,0,2
56,2025-05-25T00:43:00+02:00,2025-05-25,08:43,1,0,1
56,2025-05-25T00:44:00+02:00,2025-05-25,08:44,2,0,2
56,2025-05-25T00:45:00+02:00,2025-05-25,08:45,2,0,2
56,2025-05-25T00:47:00+02:00,2025-05-25,08:47,0,1,1
56,2025-05-25T00:49:00+02:00,2025-05-25,08:49,3,1,4
56,2025-05-25T00:50:00+02:00,2025-05-25,08:50,3,1,4
58,2025-05-25T00:41:00+02:00,2025-05-25,08:41,2,0,2
58,2025-05-25T00:42:00+02:00,2025-05-25,08:42,3,1,4
58,2025-05-25T00:44:00+02:00,2025-05-25,08:44,1,3,4
58,2025-05-25T00:46:00+02:00,2025-05-25,08:46,7,9,16
58,2025-05-25T00:47:00+02:00,2025-05-25,08:47,5,6,11
58,2025-05-25T00:51:00+02:00,2025-05-25,08:51,1,3,4
58,2025-05-25T00:52:00+02:00,2025-05-25,08:52,4,2,6
62,2025-05-25T00:41:00+02:00,2025-05-25,08:41,0,1,1
62,2025-05-25T00:43:00+02:00,2025-05-25,08:43,0,1,1
62,2025-05-25T00:44:00+02:00,2025-05-25,08:44,1,0,1
62,2025-05-25T00:51:00+02:00,2025-05-25,08:51,3,0,3
62,2025-05-25T00:52:00+02:00,2025-05-25,08:52,2,1,3
62,2025-05-25T00:54:00+02:00,2025-05-25,08:54,1,0,1
63,2025-05-25T00:45:00+02:00,2025-05-25,08:45,2,0,2
63,2025-05-25T00:48:00+02:00,2025-05-25,08:48,0,1,1
63,2025-05-25T00:52:00+02:00,2025-05-25,08:52,3,5,8
67,2025-05-25T00:43:00+02:00,2025-05-25,08:43,3,0,3
67,2025-05-25T00:45:00+02:00,2025-05-25,08:45,1,6,7
67,2025-05-25T00:47:00+02:00,2025-05-25,08:47,1,2,3
67,2025-05-25T00:48:00+02:00,2025-05-25,08:48,3,5,8
67,2025-05-25T00:49:00+02:00,2025-05-25,08:49,2,2,4
67,2025-05-25T00:54:00+02:00,2025-05-25,08:54,2,3,5
68,2025-05-25T00:42:00+02:00,2025-05-25,08:42,0,4,4
68,2025-05-25T00:46:00+02:00,2025-05-25,08:46,3,0,3
68,2025-05-25T00:48:00+02:00,2025-05-25,08:48,0,1,1
68,2025-05-25T00:53:00+02:00,2025-05-25,08:53,1,2,3
68,2025-05-25T00:54:00+02:00,2025-05-25,08:54,4,0,4
72,2025-05-25T00:44:00+02:00,2025-05-25,08:44,1,0,1
72,2025-05-25T00:47:00+02:00,2025-05-25,08:47,1,0,1
72,2025-05-25T00:50:00+02:00,2025-05-25,08:50,3,0,3
72,2025-05-25T00:52:00+02:00,2025-05-25,08:52,3,1,4
76,2025-05-25T00:41:00+02:00,2025-05-25,08:41,3,0,3
76,2025-05-25T00:54:00+02:00,2025-05-25,08:54,1,0,1
79,2025-05-25T00:40:00+02:00,2025-05-25,08:40,2,4,6
79,2025-05-25T00:42:00+02:00,2025-05-25,08:42,1,2,3
79,2025-05-25T00:43:00+02:00,2025-05-25,08:43,0,2,2
85,2025-05-25T00:46:00+02:00,2025-05-25,08:46,1,1,2
85,2025-05-25T00:54:00+02:00,2025-05-25,08:54,3,0,3
86,2025-05-25T00:46:00+02:00,2025-05-25,08:46,1,0,1
86,2025-05-25T00:48:00+02:00,2025-05-25,08:48,0,2,2
86,2025-05-25T00:50:00+02:00,2025-05-25,08:50,5,0,5
109,2025-05-25T00:40:00+02:00,2025-05-25,08:40,1,0,1
109,2025-05-25T00:50:00+02:00,2025-05-25,08:50,2,1,3
117,2025-05-25T00:40:00+02:00,2025-05-25,08:40,1,6,7
117,2025-05-25T00:50:00+02:00,2025-05-25,08:50,4,4,8
123,2025-05-25T00:50:00+02:00,2025-05-25,08:50,5,10,15
136,2025-05-25T00:40:00+02:00,2025-05-25,08:40,4,9,13
136,2025-05-25T00:45:00+02:00,2025-05-25,08:45,4,3,7
139,2025-05-25T00:40:00+02:00,2025-05-25,08:40,0,1,1
141,2025-05-25T00:45:00+02:00,2025-05-25,08:45,6,6,12
142,2025-05-25T00:45:00+02:00,2025-05-25,08:45,25,14,39
161,2025-05-25T00:40:00+02:00,2025-05-25,08:40,5,13,18
161,2025-05-25T00:45:00+02:00,2025-05-25,08:45,8,8,16
161,2025-05-25T00:50:00+02:00,2025-05-25,08:50,5,15,20
164,2025-05-25T00:40:00+02:00,2025-05-25,08:40,6,5,11
164,2025-05-25T00:50:00+02:00,2025-05-25,08:50,9,4,13
181,2025-05-25T00:42:00+02:00,2025-05-25,08:42,0,6,6
181,2025-05-25T00:43:00+02:00,2025-05-25,08:43,2,5,7
181,2025-05-25T00:44:00+02:00,2025-05-25,08:44,2,3,5
181,2025-05-25T00:51:00+02:00,2025-05-25,08:51,0,4,4
181,2025-05-25T00:54:00+02:00,2025-05-25,08:54,0,10,10
180,2025-05-25T00:52:00+02:00,2025-05-25,08:52,0,1,1
3,2025-05-25T00:56:00+02:00,2025-05-25,08:56,0,3,3
3,2025-05-25T00:57:00+02:00,2025-05-25,08:57,3,2,5
3,2025-05-25T00:58:00+02:00,2025-05-25,08:58,2,0,2
3,2025-05-25T01:00:00+02:00,2025-05-25,09:00,4,0,4
3,2025-05-25T01:01:00+02:00,2025-05-25,09:01,3,1,4
3,2025-05-25T01:04:00+02:00,2025-05-25,09:04,3,2,5
3,2025-05-25T01:05:00+02:00,2025-05-25,09:05,0,3,3
3,2025-05-25T01:08:00+02:00,2025-05-25,09:08,2,3,5
4,2025-05-25T00:57:00+02:00,2025-05-25,08:57,8,2,10
4,2025-05-25T01:00:00+02:00,2025-05-25,09:00,6,5,11
4,2025-05-25T01:01:00+02:00,2025-05-25,09:01,4,4,8
4,2025-05-25T01:03:00+02:00,2025-05-25,09:03,3,0,3
4,2025-05-25T01:04:00+02:00,2025-05-25,09:04,6,0,6
4,2025-05-25T01:06:00+02:00,2025-05-25,09:06,2,1,3
4,2025-05-25T01:08:00+02:00,2025-05-25,09:08,2,0,2
4,2025-05-25T01:09:00+02:00,2025-05-25,09:09,1,7,8
6,2025-05-25T00:56:00+02:00,2025-05-25,08:56,4,5,9
6,2025-05-25T00:57:00+02:00,2025-05-25,08:57,4,0,4
6,2025-05-25T01:01:00+02:00,2025-05-25,09:01,4,18,22
6,2025-05-25T01:03:00+02:00,2025-05-25,09:03,7,5,12
6,2025-05-25T01:05:00+02:00,2025-05-25,09:05,4,6,10
6,2025-05-25T01:08:00+02:00,2025-05-25,09:08,4,4,8
8,2025-05-25T00:56:00+02:00,2025-05-25,08:56,1,3,4
8,2025-05-25T00:58:00+02:00,2025-05-25,08:58,1,2,3
8,2025-05-25T01:04:00+02:00,2025-05-25,09:04,1,3,4
8,2025-05-25T01:05:00+02:00,2025-05-25,09:05,5,2,7
8,2025-05-25T01:07:00+02:00,2025-05-25,09:07,3,1,4
8,2025-05-25T01:08:00+02:00,2025-05-25,09:08,0,5,5
28,2025-05-25T01:03:00+02:00,2025-05-25,09:03,4,1,5
28,2025-05-25T01:05:00+02:00,2025-05-25,09:05,2,2,4
28,2025-05-25T01:06:00+02:00,2025-05-25,09:06,1,3,4
28,2025-05-25T01:07:00+02:00,2025-05-25,09:07,0,4,4
28,2025-05-25T01:08:00+02:00,2025-05-25,09:08,4,2,6
29,2025-05-25T01:01:00+02:00,2025-05-25,09:01,6,7,13
29,2025-05-25T01:06:00+02:00,2025-05-25,09:06,1,2,3
29,2025-05-25T01:09:00+02:00,2025-05-25,09:09,2,5,7
31,2025-05-25T01:02:00+02:00,2025-05-25,09:02,3,0,3
31,2025-05-25T01:04:00+02:00,2025-05-25,09:04,1,0,1
31,2025-05-25T01:08:00+02:00,2025-05-25,09:08,0,1,1
36,2025-05-25T00:56:00+02:00,2025-05-25,08:56,0,1,1
36,2025-05-25T01:07:00+02:00,2025-05-25,09:07,1,0,1
37,2025-05-25T01:00:00+02:00,2025-05-25,09:00,0,1,1
37,2025-05-25T01:04:00+02:00,2025-05-25,09:04,2,1,3
39,2025-05-25T00:56:00+02:00,2025-05-25,08:56,0,4,4
39,2025-05-25T00:58:00+02:00,2025-05-25,08:58,0,3,3
40,2025-05-25T00:55:00+02:00,2025-05-25,08:55,1,0,1
40,2025-05-25T01:01:00+02:00,2025-05-25,09:01,3,1,4
40,2025-05-25T01:04:00+02:00,2025-05-25,09:04,1,0,1
40,2025-05-25T01:09:00+02:00,2025-05-25,09:09,2,0,2
41,2025-05-25T00:59:00+02:00,2025-05-25,08:59,0,3,3
41,2025-05-25T01:00:00+02:00,2025-05-25,09:00,4,1,5
41,2025-05-25T01:01:00+02:00,2025-05-25,09:01,1,0,1
41,2025-05-25T01:08:00+02:00,2025-05-25,09:08,2,6,8
41,2025-05-25T01:09:00+02:00,2025-05-25,09:09,10,4,14
43,2025-05-25T00:55:00+02:00,2025-05-25,08:55,5,1,6
44,2025-05-25T01:05:00+02:00,2025-05-25,09:05,0,1,1
45,2025-05-25T00:55:00+02:00,2025-05-25,08:55,0,3,3
45,2025-05-25T00:57:00+02:00,2025-05-25,08:57,1,1,2
45,2025-05-25T01:01:00+02:00,2025-05-25,09:01,1,4,5
45,2025-05-25T01:03:00+02:00,2025-05-25,09:03,7,1,8
47,2025-05-25T01:03:00+02:00,2025-05-25,09:03,2,3,5
47,2025-05-25T01:05:00+02:00,2025-05-25,09:05,5,7,12
47,2025-05-25T01:06:00+02:00,2025-05-25,09:06,3,4,7
47,2025-05-25T01:07:00+02:00,2025-05-25,09:07,3,3,6
50,2025-05-25T01:01:00+02:00,2025-05-25,09:01,3,0,3
50,2025-05-25T01:03:00+02:00,2025-05-25,09:03,0,1,1
50,2025-05-25T01:06:00+02:00,2025-05-25,09:06,2,0,2
50,2025-05-25T01:08:00+02:00,2025-05-25,09:08,4,1,5
54,2025-05-25T00:59:00+02:00,2025-05-25,08:59,1,0,1
54,2025-05-25T01:00:00+02:00,2025-05-25,09:00,1,0,1
54,2025-05-25T01:01:00+02:00,2025-05-25,09:01,1,0,1
54,2025-05-25T01:07:00+02:00,2025-05-25,09:07,1,1,2
54,2025-05-25T01:09:00+02:00,2025-05-25,09:09,1,0,1
59,2025-05-25T01:05:00+02:00,2025-05-25,09:05,4,7,11
61,2025-05-25T01:00:00+02:00,2025-05-25,09:00,0,3,3
61,2025-05-25T01:01:00+02:00,2025-05-25,09:01,0,1,1
61,2025-05-25T01:02:00+02:00,2025-05-25,09:02,2,2,4
61,2025-05-25T01:07:00+02:00,2025-05-25,09:07,0,2,2
61,2025-05-25T01:09:00+02:00,2025-05-25,09:09,2,1,3
66,2025-05-25T01:02:00+02:00,2025-05-25,09:02,1,3,4
66,2025-05-25T01:06:00+02:00,2025-05-25,09:06,0,4,4
66,2025-05-25T01:08:00+02:00,2025-05-25,09:08,1,3,4
69,2025-05-25T00:57:00+02:00,2025-05-25,08:57,4,1,5
69,2025-05-25T00:58:00+02:00,2025-05-25,08:58,2,3,5
69,2025-05-25T01:02:00+02:00,2025-05-25,09:02,2,2,4
69,2025-05-25T01:04:00+02:00,2025-05-25,09:04,3,2,5
70,2025-05-25T01:01:00+02:00,2025-05-25,09:01,0,2,2
75,2025-05-25T00:59:00+02:00,2025-05-25,08:59,0,2,2
75,2025-05-25T01:01:00+02:00,2025-05-25,09:01,1,0,1
78,2025-05-25T00:55:00+02:00,2025-05-25,08:55,1,1,2
78,2025-05-25T00:58:00+02:00,2025-05-25,08:58,0,3,3
78,2025-05-25T00:59:00+02:00,2025-05-25,08:59,0,2,2
78,2025-05-25T01:01:00+02:00,2025-05-25,09:01,0,1,1
78,2025-05-25T01:02:00+02:00,2025-05-25,09:02,1,2,3
78,2025-05-25T01:04:00+02:00,2025-05-25,09:04,7,3,10
78,2025-05-25T01:05:00+02:00,2025-05-25,09:05,0,1,1
78,2025-05-25T01:09:00+02:00,2025-05-25,09:09,2,3,5
84,2025-05-25T01:00:00+02:00,2025-05-25,09:00,26,20,46
87,2025-05-25T00:55:00+02:00,2025-05-25,08:55,0,1,1
87,2025-05-25T00:57:00+02:00,2025-05-25,08:57,0,1,1
87,2025-05-25T01:04:00+02:00,2025-05-25,09:04,0,1,1
87,2025-05-25T01:07:00+02:00,2025-05-25,09:07,1,0,1
107,2025-05-25T01:00:00+02:00,2025-05-25,09:00,1,4,5
108,2025-05-25T00:56:00+02:00,2025-05-25,08:56,0,3,3
108,2025-05-25T00:58:00+02:00,2025-05-25,08:58,1,5,6
108,2025-05-25T01:01:00+02:00,2025-05-25,09:01,1,0,1
108,2025-05-25T01:02:00+02:00,2025-05-25,09:02,0,2,2
108,2025-05-25T01:08:00+02:00,2025-05-25,09:08,0,3,3
108,2025-05-25T01:09:00+02:00,2025-05-25,09:09,1,0,1
118,2025-05-25T01:00:00+02:00,2025-05-25,09:00,1,2,3
131,2025-05-25T01:00:00+02:00,2025-05-25,09:00,0,2,2
133,2025-05-25T01:05:00+02:00,2025-05-25,09:05,8,18,26
135,2025-05-25T00:55:00+02:00,2025-05-25,08:55,16,8,24
135,2025-05-25T01:05:00+02:00,2025-05-25,09:05,12,14,26
162,2025-05-25T00:55:00+02:00,2025-05-25,08:55,17,16,33
165,2025-05-25T00:55:00+02:00,2025-05-25,08:55,1,1,2
165,2025-05-25T01:05:00+02:00,2025-05-25,09:05,2,6,8
166,2025-05-25T01:00:00+02:00,2025-05-25,09:00,1,1,2
166,2025-05-25T01:05:00+02:00,2025-05-25,09:05,0,3,3
179,2025-05-25T01:00:00+02:00,2025-05-25,09:00,3,2,5
179,2025-05-25T01:05:00+02:00,2025-05-25,09:05,3,1,4
1,2025-05-25T01:04:00+02:00,2025-05-25,09:04,2,1,3
2,2025-05-25T00:58:00+02:00,2025-05-25,08:58,0,1,1
2,2025-05-25T01:00:00+02:00,2025-05-25,09:00,0,6,6
2,2025-05-25T01:02:00+02:00,2025-05-25,09:02,2,0,2
2,2025-05-25T01:03:00+02:00,2025-05-25,09:03,2,3,5
2,2025-05-25T01:07:00+02:00,2025-05-25,09:07,2,7,9
2,2025-05-25T01:08:00+02:00,2025-05-25,09:08,2,4,6
9,2025-05-25T00:55:00+02:00,2025-05-25,08:55,1,0,1
9,2025-05-25T00:58:00+02:00,2025-05-25,08:58,2,0,2
9,2025-05-25T01:00:00+02:00,2025-05-25,09:00,0,1,1
9,2025-05-25T01:09:00+02:00,2025-05-25,09:09,1,1,2
10,2025-05-25T01:01:00+02:00,2025-05-25,09:01,2,0,2
10,2025-05-25T01:04:00+02:00,2025-05-25,09:04,1,1,2
10,2025-05-25T01:05:00+02:00,2025-05-25,09:05,3,0,3
10,2025-05-25T01:07:00+02:00,2025-05-25,09:07,0,3,3
11,2025-05-25T00:55:00+02:00,2025-05-25,08:55,1,3,4
11,2025-05-25T00:57:00+02:00,2025-05-25,08:57,0,1,1
11,2025-05-25T00:58:00+02:00,2025-05-25,08:58,1,0,1
11,2025-05-25T01:03:00+02:00,2025-05-25,09:03,0,1,1
11,2025-05-25T01:05:00+02:00,2025-05-25,09:05,4,1,5
11,2025-05-25T01:07:00+02:00,2025-05-25,09:07,2,3,5
12,2025-05-25T00:56:00+02:00,2025-05-25,08:56,3,2,5
12,2025-05-25T00:57:00+02:00,2025-05-25,08:57,1,4,5
12,2025-05-25T00:58:00+02:00,2025-05-25,08:58,2,1,3
12,2025-05-25T01:00:00+02:00,2025-05-25,09:00,1,2,3
12,2025-05-25T01:03:00+02:00,2025-05-25,09:03,0,2,2
17,2025-05-25T01:00:00+02:00,2025-05-25,09:00,3,1,4
17,2025-05-25T01:02:00+02:00,2025-05-25,09:02,4,2,6
17,2025-05-25T01:04:00+02:00,2025-05-25,09:04,0,4,4
17,2025-05-25T01:05:00+02:00,2025-05-25,09:05,1,1,2
18,2025-05-25T00:55:00+02:00,2025-05-25,08:55,0,1,1
18,2025-05-25T00:57:00+02:00,2025-05-25,08:57,2,0,2
18,2025-05-25T00:58:00+02:00,2025-05-25,08:58,0,2,2
19,2025-05-25T00:57:00+02:00,2025-05-25,08:57,1,0,1
19,2025-05-25T00:58:00+02:00,2025-05-25,08:58,1,2,3
19,2025-05-25T01:01:00+02:00,2025-05-25,09:01,3,5,8
19,2025-05-25T01:03:00+02:00,2025-05-25,09:03,0,1,1
20,2025-05-25T01:01:00+02:00,2025-05-25,09:01,1,0,1
20,2025-05-25T01:06:00+02:00,2025-05-25,09:06,5,0,5
23,2025-05-25T00:56:00+02:00,2025-05-25,08:56,2,1,3
23,2025-05-25T00:57:00+02:00,2025-05-25,08:57,0,2,2
23,2025-05-25T01:01:00+02:00,2025-05-25,09:01,1,0,1
23,2025-05-25T01:04:00+02:00,2025-05-25,09:04,6,0,6
24,2025-05-25T00:59:00+02:00,2025-05-25,08:59,6,0,6
24,2025-05-25T01:01:00+02:00,2025-05-25,09:01,2,1,3
24,2025-05-25T01:04:00+02:00,2025-05-25,09:04,5,1,6
24,2025-05-25T01:09:00+02:00,2025-05-25,09:09,6,5,11
25,2025-05-25T01:05:00+02:00,2025-05-25,09:05,8,33,41
27,2025-05-25T00:57:00+02:00,2025-05-25,08:57,3,1,4
27,2025-05-25T01:03:00+02:00,2025-05-25,09:03,0,8,8
30,2025-05-25T00:55:00+02:00,2025-05-25,08:55,1,0,1
30,2025-05-25T00:56:00+02:00,2025-05-25,08:56,3,0,3
30,2025-05-25T00:57:00+02:00,2025-05-25,08:57,1,0,1
30,2025-05-25T00:59:00+02:00,2025-05-25,08:59,0,2,2
35,2025-05-25T01:01:00+02:00,2025-05-25,09:01,8,9,17
35,2025-05-25T01:03:00+02:00,2025-05-25,09:03,6,18,24
35,2025-05-25T01:06:00+02:00,2025-05-25,09:06,3,4,7
46,2025-05-25T01:05:00+02:00,2025-05-25,09:05,1,1,2
48,2025-05-25T00:56:00+02:00,2025-05-25,08:56,1,0,1
48,2025-05-25T01:00:00+02:00,2025-05-25,09:00,2,4,6
48,2025-05-25T01:01:00+02:00,2025-05-25,09:01,1,3,4
48,2025-05-25T01:02:00+02:00,2025-05-25,09:02,2,3,5
48,2025-05-25T01:04:00+02:00,2025-05-25,09:04,2,4,6
48,2025-05-25T01:07:00+02:00,2025-05-25,09:07,1,0,1
48,2025-05-25T01:08:00+02:00,2025-05-25,09:08,3,2,5
49,2025-05-25T00:59:00+02:00,2025-05-25,08:59,4,1,5
49,2025-05-25T01:01:00+02:00,2025-05-25,09:01,0,1,1
49,2025-05-25T01:08:00+02:00,2025-05-25,09:08,3,3,6
51,2025-05-25T00:58:00+02:00,2025-05-25,08:58,0,1,1
51,2025-05-25T00:59:00+02:00,2025-05-25,08:59,2,1,3
51,2025-05-25T01:02:00+02:00,2025-05-25,09:02,0,1,1
52,2025-05-25T00:59:00+02:00,2025-05-25,08:59,2,1,3
52,2025-05-25T01:00:00+02:00,2025-05-25,09:00,1,4,5
52,2025-05-25T01:01:00+02:00,2025-05-25,09:01,4,2,6
52,2025-05-25T01:06:00+02:00,2025-05-25,09:06,1,0,1
53,2025-05-25T00:55:00+02:00,2025-05-25,08:55,6,1,7
53,2025-05-25T00:59:00+02:00,2025-05-25,08:59,7,4,11
53,2025-05-25T01:04:00+02:00,2025-05-25,09:04,6,1,7
53,2025-05-25T01:09:00+02:00,2025-05-25,09:09,2,8,10
56,2025-05-25T00:55:00+02:00,2025-05-25,08:55,0,7,7
56,2025-05-25T00:58:00+02:00,2025-05-25,08:58,1,2,3
56,2025-05-25T00:59:00+02:00,2025-05-25,08:59,2,0,2
56,2025-05-25T01:05:00+02:00,2025-05-25,09:05,1,1,2
56,2025-05-25T01:07:00+02:00,2025-05-25,09:07,2,2,4
56,2025-05-25T01:09:00+02:00,2025-05-25,09:09,8,0,8
58,2025-05-25T00:59:00+02:00,2025-05-25,08:59,5,0,5
58,2025-05-25T01:01:00+02:00,2025-05-25,09:01,5,1,6
58,2025-05-25T01:02:00+02:00,2025-05-25,09:02,8,1,9
58,2025-05-25T01:03:00+02:00,2025-05-25,09:03,10,3,13
58,2025-05-25T01:06:00+02:00,2025-05-25,09:06,3,0,3
58,2025-05-25T01:07:00+02:00,2025-05-25,09:07,8,0,8
62,2025-05-25T00:55:00+02:00,2025-05-25,08:55,1,1,2
62,2025-05-25T01:01:00+02:00,2025-05-25,09:01,0,1,1
62,2025-05-25T01:03:00+02:00,2025-05-25,09:03,1,0,1
63,2025-05-25T01:01:00+02:00,2025-05-25,09:01,0,3,3
63,2025-05-25T01:07:00+02:00,2025-05-25,09:07,0,2,2
67,2025-05-25T00:57:00+02:00,2025-05-25,08:57,1,2,3
67,2025-05-25T01:01:00+02:00,2025-05-25,09:01,1,3,4
67,2025-05-25T01:02:00+02:00,2025-05-25,09:02,2,2,4
67,2025-05-25T01:07:00+02:00,2025-05-25,09:07,7,1,8
67,2025-05-25T01:08:00+02:00,2025-05-25,09:08,4,0,4
68,2025-05-25T00:55:00+02:00,2025-05-25,08:55,3,9,12
68,2025-05-25T00:56:00+02:00,2025-05-25,08:56,8,4,12
68,2025-05-25T01:00:00+02:00,2025-05-25,09:00,4,0,4
68,2025-05-25T01:02:00+02:00,2025-05-25,09:02,2,3,5
68,2025-05-25T01:09:00+02:00,2025-05-25,09:09,1,0,1
72,2025-05-25T00:58:00+02:00,2025-05-25,08:58,0,1,1
72,2025-05-25T01:01:00+02:00,2025-05-25,09:01,0,2,2
72,2025-05-25T01:02:00+02:00,2025-05-25,09:02,0,4,4
72,2025-05-25T01:09:00+02:00,2025-05-25,09:09,1,0,1
76,2025-05-25T01:01:00+02:00,2025-05-25,09:01,1,0,1
79,2025-05-25T00:57:00+02:00,2025-05-25,08:57,1,0,1
79,2025-05-25T00:58:00+02:00,2025-05-25,08:58,2,3,5
79,2025-05-25T01:00:00+02:00,2025-05-25,09:00,2,2,4
79,2025-05-25T01:01:00+02:00,2025-05-25,09:01,2,0,2
79,2025-05-25T01:06:00+02:00,2025-05-25,09:06,4,1,5
85,2025-05-25T00:55:00+02:00,2025-05-25,08:55,1,1,2
85,2025-05-25T00:56:00+02:00,2025-05-25,08:56,3,0,3
85,2025-05-25T01:01:00+02:00,2025-05-25,09:01,2,0,2
85,2025-05-25T01:02:00+02:00,2025-05-25,09:02,2,1,3
85,2025-05-25T01:04:00+02:00,2025-05-25,09:04,1,2,3
85,2025-05-25T01:05:00+02:00,2025-05-25,09:05,1,0,1
85,2025-05-25T01:08:00+02:00,2025-05-25,09:08,2,2,4
86,2025-05-25T00:55:00+02:00,2025-05-25,08:55,2,0,2
86,2025-05-25T01:01:00+02:00,2025-05-25,09:01,3,2,5
86,2025-05-25T01:02:00+02:00,2025-05-25,09:02,1,1,2
117,2025-05-25T00:55:00+02:00,2025-05-25,08:55,5,4,9
130,2025-05-25T00:55:00+02:00,2025-05-25,08:55,1,6,7
136,2025-05-25T01:00:00+02:00,2025-05-25,09:00,23,7,30
141,2025-05-25T01:05:00+02:00,2025-05-25,09:05,10,5,15
142,2025-05-25T01:00:00+02:00,2025-05-25,09:00,18,15,33
142,2025-05-25T01:05:00+02:00,2025-05-25,09:05,34,21,55
161,2025-05-25T01:00:00+02:00,2025-05-25,09:00,27,15,42
161,2025-05-25T01:05:00+02:00,2025-05-25,09:05,9,6,15
164,2025-05-25T00:55:00+02:00,2025-05-25,08:55,8,1,9
164,2025-05-25T01:00:00+02:00,2025-05-25,09:00,5,2,7
181,2025-05-25T00:55:00+02:00,2025-05-25,08:55,2,6,8
181,2025-05-25T00:58:00+02:00,2025-05-25,08:58,4,3,7
181,2025-05-25T01:04:00+02:00,2025-05-25,09:04,4,9,13
181,2025-05-25T01:08:00+02:00,2025-05-25,09:08,0,3,3
180,2025-05-25T00:56:00+02:00,2025-05-25,08:56,1,0,1
3,2025-05-25T01:13:00+02:00,2025-05-25,09:13,2,3,5
3,2025-05-25T01:14:00+02:00,2025-05-25,09:14,4,0,4
3,2025-05-25T01:19:00+02:00,2025-05-25,09:19,4,0,4
3,2025-05-25T01:21:00+02:00,2025-05-25,09:21,15,3,18
3,2025-05-25T01:24:00+02:00,2025-05-25,09:24,3,0,3
4,2025-05-25T01:10:00+02:00,2025-05-25,09:10,1,1,2
4,2025-05-25T01:20:00+02:00,2025-05-25,09:20,10,4,14
4,2025-05-25T01:22:00+02:00,2025-05-25,09:22,7,6,13
4,2025-05-25T01:24:00+02:00,2025-05-25,09:24,4,2,6
5,2025-05-25T01:20:00+02:00,2025-05-25,09:20,21,18,39
6,2025-05-25T01:11:00+02:00,2025-05-25,09:11,8,2,10
6,2025-05-25T01:17:00+02:00,2025-05-25,09:17,6,4,10
6,2025-05-25T01:18:00+02:00,2025-05-25,09:18,6,5,11
8,2025-05-25T01:16:00+02:00,2025-05-25,09:16,0,3,3
8,2025-05-25T01:18:00+02:00,2025-05-25,09:18,0,2,2
28,2025-05-25T01:10:00+02:00,2025-05-25,09:10,1,4,5
28,2025-05-25T01:13:00+02:00,2025-05-25,09:13,2,1,3
28,2025-05-25T01:16:00+02:00,2025-05-25,09:16,2,1,3
28,2025-05-25T01:17:00+02:00,2025-05-25,09:17,3,0,3
28,2025-05-25T01:20:00+02:00,2025-05-25,09:20,0,4,4
28,2025-05-25T01:24:00+02:00,2025-05-25,09:24,1,3,4
29,2025-05-25T01:10:00+02:00,2025-05-25,09:10,2,5,7
29,2025-05-25T01:13:00+02:00,2025-05-25,09:13,0,3,3
29,2025-05-25T01:18:00+02:00,2025-05-25,09:18,3,1,4
29,2025-05-25T01:21:00+02:00,2025-05-25,09:21,6,7,13
31,2025-05-25T01:15:00+02:00,2025-05-25,09:15,1,2,3
31,2025-05-25T01:17:00+02:00,2025-05-25,09:17,2,1,3
31,2025-05-25T01:19:00+02:00,2025-05-25,09:19,1,1,2
31,2025-05-25T01:22:00+02:00,2025-05-25,09:22,0,5,5
31,2025-05-25T01:23:00+02:00,2025-05-25,09:23,0,1,1
36,2025-05-25T01:17:00+02:00,2025-05-25,09:17,3,1,4
37,2025-05-25T01:22:00+02:00,2025-05-25,09:22,0,2,2
37,2025-05-25T01:24:00+02:00,2025-05-25,09:24,0,1,1
39,2025-05-25T01:15:00+02:00,2025-05-25,09:15,0,1,1
39,2025-05-25T01:17:00+02:00,2025-05-25,09:17,1,0,1
39,2025-05-25T01:22:00+02:00,2025-05-25,09:22,1,0,1
40,2025-05-25T01:14:00+02:00,2025-05-25,09:14,2,1,3
40,2025-05-25T01:15:00+02:00,2025-05-25,09:15,1,1,2
40,2025-05-25T01:17:00+02:00,2025-05-25,09:17,1,0,1
40,2025-05-25T01:21:00+02:00,2025-05-25,09:21,2,4,6
40,2025-05-25T01:23:00+02:00,2025-05-25,09:23,1,0,1
40,2025-05-25T01:24:00+02:00,2025-05-25,09:24,0,5,5
41,2025-05-25T01:11:00+02:00,2025-05-25,09:11,7,0,7
41,2025-05-25T01:14:00+02:00,2025-05-25,09:14,1,1,2
41,2025-05-25T01:15:00+02:00,2025-05-25,09:15,0,1,1
41,2025-05-25T01:16:00+02:00,2025-05-25,09:16,3,0,3
41,2025-05-25T01:17:00+02:00,2025-05-25,09:17,2,0,2
41,2025-05-25T01:18:00+02:00,2025-05-25,09:18,2,3,5
43,2025-05-25T01:15:00+02:00,2025-05-25,09:15,4,2,6
43,2025-05-25T01:20:00+02:00,2025-05-25,09:20,9,3,12
45,2025-05-25T01:12:00+02:00,2025-05-25,09:12,2,3,5
45,2025-05-25T01:15:00+02:00,2025-05-25,09:15,2,2,4
45,2025-05-25T01:16:00+02:00,2025-05-25,09:16,5,1,6
45,2025-05-25T01:23:00+02:00,2025-05-25,09:23,1,0,1
47,2025-05-25T01:11:00+02:00,2025-05-25,09:11,3,2,5
47,2025-05-25T01:14:00+02:00,2025-05-25,09:14,2,5,7
47,2025-05-25T01:18:00+02:00,2025-05-25,09:18,11,9,20
47,2025-05-25T01:21:00+02:00,2025-05-25,09:21,8,4,12
47,2025-05-25T01:22:00+02:00,2025-05-25,09:22,10,5,15
47,2025-05-25T01:24:00+02:00,2025-05-25,09:24,3,1,4
50,2025-05-25T01:11:00+02:00,2025-05-25,09:11,0,1,1
50,2025-05-25T01:14:00+02:00,2025-05-25,09:14,2,2,4
50,2025-05-25T01:17:00+02:00,2025-05-25,09:17,1,1,2
50,2025-05-25T01:20:00+02:00,2025-05-25,09:20,1,0,1
54,2025-05-25T01:21:00+02:00,2025-05-25,09:21,2,0,2
54,2025-05-25T01:22:00+02:00,2025-05-25,09:22,2,2,4
59,2025-05-25T01:20:00+02:00,2025-05-25,09:20,2,3,5
61,2025-05-25T01:16:00+02:00,2025-05-25,09:16,0,3,3
61,2025-05-25T01:21:00+02:00,2025-05-25,09:21,3,1,4
61,2025-05-25T01:23:00+02:00,2025-05-25,09:23,0,3,3
61,2025-05-25T01:24:00+02:00,2025-05-25,09:24,2,1,3
66,2025-05-25T01:15:00+02:00,2025-05-25,09:15,6,1,7
66,2025-05-25T01:17:00+02:00,2025-05-25,09:17,0,1,1
66,2025-05-25T01:18:00+02:00,2025-05-25,09:18,5,1,6
66,2025-05-25T01:21:00+02:00,2025-05-25,09:21,4,1,5
69,2025-05-25T01:11:00+02:00,2025-05-25,09:11,3,0,3
69,2025-05-25T01:15:00+02:00,2025-05-25,09:15,1,0,1
69,2025-05-25T01:19:00+02:00,2025-05-25,09:19,4,2,6
70,2025-05-25T01:12:00+02:00,2025-05-25,09:12,1,0,1
70,2025-05-25T01:13:00+02:00,2025-05-25,09:13,2,1,3
70,2025-05-25T01:15:00+02:00,2025-05-25,09:15,0,2,2
70,2025-05-25T01:16:00+02:00,2025-05-25,09:16,1,3,4
75,2025-05-25T01:19:00+02:00,2025-05-25,09:19,1,0,1
77,2025-05-25T01:20:00+02:00,2025-05-25,09:20,15,16,31
78,2025-05-25T01:10:00+02:00,2025-05-25,09:10,0,3,3
78,2025-05-25T01:19:00+02:00,2025-05-25,09:19,0,1,1
84,2025-05-25T01:10:00+02:00,2025-05-25,09:10,27,21,48
84,2025-05-25T01:15:00+02:00,2025-05-25,09:15,35,21,56
87,2025-05-25T01:11:00+02:00,2025-05-25,09:11,0,1,1
87,2025-05-25T01:13:00+02:00,2025-05-25,09:13,1,0,1
87,2025-05-25T01:17:00+02:00,2025-05-25,09:17,3,0,3
107,2025-05-25T01:15:00+02:00,2025-05-25,09:15,1,3,4
107,2025-05-25T01:20:00+02:00,2025-05-25,09:20,6,6,12
108,2025-05-25T01:13:00+02:00,2025-05-25,09:13,0,1,1
108,2025-05-25T01:14:00+02:00,2025-05-25,09:14,4,0,4
118,2025-05-25T01:10:00+02:00,2025-05-25,09:10,0,1,1
124,2025-05-25T01:20:00+02:00,2025-05-25,09:20,0,1,1
131,2025-05-25T01:10:00+02:00,2025-05-25,09:10,8,2,10
131,2025-05-25T01:15:00+02:00,2025-05-25,09:15,6,11,17
131,2025-05-25T01:20:00+02:00,2025-05-25,09:20,1,5,6
132,2025-05-25T01:10:00+02:00,2025-05-25,09:10,14,4,18
133,2025-05-25T01:10:00+02:00,2025-05-25,09:10,26,25,51
134,2025-05-25T01:10:00+02:00,2025-05-25,09:10,18,31,49
135,2025-05-25T01:10:00+02:00,2025-05-25,09:10,18,19,37
140,2025-05-25T01:10:00+02:00,2025-05-25,09:10,6,8,14
140,2025-05-25T01:20:00+02:00,2025-05-25,09:20,10,2,12
162,2025-05-25T01:20:00+02:00,2025-05-25,09:20,21,16,37
165,2025-05-25T01:15:00+02:00,2025-05-25,09:15,4,2,6
165,2025-05-25T01:20:00+02:00,2025-05-25,09:20,0,6,6
166,2025-05-25T01:20:00+02:00,2025-05-25,09:20,10,3,13
167,2025-05-25T01:10:00+02:00,2025-05-25,09:10,0,5,5
167,2025-05-25T01:15:00+02:00,2025-05-25,09:15,1,4,5
1,2025-05-25T01:10:00+02:00,2025-05-25,09:10,3,0,3
1,2025-05-25T01:11:00+02:00,2025-05-25,09:11,4,1,5
1,2025-05-25T01:16:00+02:00,2025-05-25,09:16,5,5,10
1,2025-05-25T01:17:00+02:00,2025-05-25,09:17,8,0,8
2,2025-05-25T01:14:00+02:00,2025-05-25,09:14,2,2,4
2,2025-05-25T01:15:00+02:00,2025-05-25,09:15,3,2,5
2,2025-05-25T01:16:00+02:00,2025-05-25,09:16,3,0,3
9,2025-05-25T01:20:00+02:00,2025-05-25,09:20,1,1,2
10,2025-05-25T01:15:00+02:00,2025-05-25,09:15,0,4,4
10,2025-05-25T01:20:00+02:00,2025-05-25,09:20,4,0,4
11,2025-05-25T01:12:00+02:00,2025-05-25,09:12,0,4,4
11,2025-05-25T01:14:00+02:00,2025-05-25,09:14,1,0,1
11,2025-05-25T01:17:00+02:00,2025-05-25,09:17,3,2,5
11,2025-05-25T01:19:00+02:00,2025-05-25,09:19,1,4,5
11,2025-05-25T01:20:00+02:00,2025-05-25,09:20,1,2,3
11,2025-05-25T01:22:00+02:00,2025-05-25,09:22,4,3,7
11,2025-05-25T01:23:00+02:00,2025-05-25,09:23,2,1,3
12,2025-05-25T01:10:00+02:00,2025-05-25,09:10,2,0,2
12,2025-05-25T01:11:00+02:00,2025-05-25,09:11,3,0,3
12,2025-05-25T01:13:00+02:00,2025-05-25,09:13,1,4,5
12,2025-05-25T01:14:00+02:00,2025-05-25,09:14,1,1,2
12,2025-05-25T01:20:00+02:00,2025-05-25,09:20,5,4,9
12,2025-05-25T01:21:00+02:00,2025-05-25,09:21,0,7,7
12,2025-05-25T01:22:00+02:00,2025-05-25,09:22,0,1,1
17,2025-05-25T01:11:00+02:00,2025-05-25,09:11,0,1,1
17,2025-05-25T01:22:00+02:00,2025-05-25,09:22,1,0,1
18,2025-05-25T01:22:00+02:00,2025-05-25,09:22,0,3,3
18,2025-05-25T01:23:00+02:00,2025-05-25,09:23,1,3,4
19,2025-05-25T01:11:00+02:00,2025-05-25,09:11,3,0,3
19,2025-05-25T01:13:00+02:00,2025-05-25,09:13,0,1,1
19,2025-05-25T01:14:00+02:00,2025-05-25,09:14,0,2,2
19,2025-05-25T01:18:00+02:00,2025-05-25,09:18,0,3,3
19,2025-05-25T01:19:00+02:00,2025-05-25,09:19,1,1,2
19,2025-05-25T01:20:00+02:00,2025-05-25,09:20,0,1,1
19,2025-05-25T01:22:00+02:00,2025-05-25,09:22,0,1,1
19,2025-05-25T01:24:00+02:00,2025-05-25,09:24,0,4,4
20,2025-05-25T01:11:00+02:00,2025-05-25,09:11,0,3,3
20,2025-05-25T01:14:00+02:00,2025-05-25,09:14,1,5,6
20,2025-05-25T01:17:00+02:00,2025-05-25,09:17,3,2,5
20,2025-05-25T01:18:00+02:00,2025-05-25,09:18,4,0,4
20,2025-05-25T01:21:00+02:00,2025-05-25,09:21,0,2,2
20,2025-05-25T01:23:00+02:00,2025-05-25,09:23,1,6,7
23,2025-05-25T01:11:00+02:00,2025-05-25,09:11,2,1,3
23,2025-05-25T01:13:00+02:00,2025-05-25,09:13,4,1,5
23,2025-05-25T01:14:00+02:00,2025-05-25,09:14,3,5,8
23,2025-05-25T01:15:00+02:00,2025-05-25,09:15,3,0,3
23,2025-05-25T01:18:00+02:00,2025-05-25,09:18,0,2,2
23,2025-05-25T01:21:00+02:00,2025-05-25,09:21,5,6,11
23,2025-05-25T01:24:00+02:00,2025-05-25,09:24,9,2,11
24,2025-05-25T01:10:00+02:00,2025-05-25,09:10,1,25,26
24,2025-05-25T01:13:00+02:00,2025-05-25,09:13,7,1,8
24,2025-05-25T01:14:00+02:00,2025-05-25,09:14,7,0,7
24,2025-05-25T01:21:00+02:00,2025-05-25,09:21,4,23,27
24,2025-05-25T01:22:00+02:00,2025-05-25,09:22,4,7,11
25,2025-05-25T01:20:00+02:00,2025-05-25,09:20,23,32,55
27,2025-05-25T01:13:00+02:00,2025-05-25,09:13,5,0,5
27,2025-05-25T01:18:00+02:00,2025-05-25,09:18,0,3,3
27,2025-05-25T01:20:00+02:00,2025-05-25,09:20,0,7,7
27,2025-05-25T01:22:00+02:00,2025-05-25,09:22,4,9,13
30,2025-05-25T01:10:00+02:00,2025-05-25,09:10,0,2,2
30,2025-05-25T01:13:00+02:00,2025-05-25,09:13,1,8,9
30,2025-05-25T01:16:00+02:00,2025-05-25,09:16,6,3,9
30,2025-05-25T01:18:00+02:00,2025-05-25,09:18,2,2,4
30,2025-05-25T01:21:00+02:00,2025-05-25,09:21,0,2,2
30,2025-05-25T01:24:00+02:00,2025-05-25,09:24,2,0,2
35,2025-05-25T01:14:00+02:00,2025-05-25,09:14,13,7,20
35,2025-05-25T01:19:00+02:00,2025-05-25,09:19,8,5,13
35,2025-05-25T01:20:00+02:00,2025-05-25,09:20,16,5,21
35,2025-05-25T01:24:00+02:00,2025-05-25,09:24,21,4,25
46,2025-05-25T01:20:00+02:00,2025-05-25,09:20,3,0,3
48,2025-05-25T01:18:00+02:00,2025-05-25,09:18,5,1,6
48,2025-05-25T01:20:00+02:00,2025-05-25,09:20,2,2,4
48,2025-05-25T01:21:00+02:00,2025-05-25,09:21,4,2,6
48,2025-05-25T01:23:00+02:00,2025-05-25,09:23,3,12,15
49,2025-05-25T01:10:00+02:00,2025-05-25,09:10,6,9,15
49,2025-05-25T01:20:00+02:00,2025-05-25,09:20,5,2,7
49,2025-05-25T01:23:00+02:00,2025-05-25,09:23,3,8,11
51,2025-05-25T01:10:00+02:00,2025-05-25,09:10,3,1,4
51,2025-05-25T01:13:00+02:00,2025-05-25,09:13,2,3,5
51,2025-05-25T01:14:00+02:00,2025-05-25,09:14,2,2,4
51,2025-05-25T01:22:00+02:00,2025-05-25,09:22,1,1,2
52,2025-05-25T01:13:00+02:00,2025-05-25,09:13,3,0,3
52,2025-05-25T01:18:00+02:00,2025-05-25,09:18,0,2,2
52,2025-05-25T01:20:00+02:00,2025-05-25,09:20,2,1,3
52,2025-05-25T01:21:00+02:00,2025-05-25,09:21,1,2,3
52,2025-05-25T01:22:00+02:00,2025-05-25,09:22,4,1,5
52,2025-05-25T01:23:00+02:00,2025-05-25,09:23,2,2,4
53,2025-05-25T01:10:00+02:00,2025-05-25,09:10,1,3,4
53,2025-05-25T01:11:00+02:00,2025-05-25,09:11,7,2,9
53,2025-05-25T01:18:00+02:00,2025-05-25,09:18,4,0,4
53,2025-05-25T01:21:00+02:00,2025-05-25,09:21,2,3,5
56,2025-05-25T01:10:00+02:00,2025-05-25,09:10,7,0,7
56,2025-05-25T01:17:00+02:00,2025-05-25,09:17,2,0,2
56,2025-05-25T01:20:00+02:00,2025-05-25,09:20,6,2,8
56,2025-05-25T01:24:00+02:00,2025-05-25,09:24,9,6,15
58,2025-05-25T01:15:00+02:00,2025-05-25,09:15,22,1,23
58,2025-05-25T01:21:00+02:00,2025-05-25,09:21,7,7,14
62,2025-05-25T01:11:00+02:00,2025-05-25,09:11,0,1,1
62,2025-05-25T01:19:00+02:00,2025-05-25,09:19,1,0,1
62,2025-05-25T01:20:00+02:00,2025-05-25,09:20,3,0,3
62,2025-05-25T01:21:00+02:00,2025-05-25,09:21,2,1,3
62,2025-05-25T01:22:00+02:00,2025-05-25,09:22,0,1,1
63,2025-05-25T01:13:00+02:00,2025-05-25,09:13,0,1,1
63,2025-05-25T01:15:00+02:00,2025-05-25,09:15,3,2,5
63,2025-05-25T01:16:00+02:00,2025-05-25,09:16,0,2,2
63,2025-05-25T01:18:00+02:00,2025-05-25,09:18,1,0,1
63,2025-05-25T01:19:00+02:00,2025-05-25,09:19,0,1,1
63,2025-05-25T01:20:00+02:00,2025-05-25,09:20,18,4,22
63,2025-05-25T01:21:00+02:00,2025-05-25,09:21,1,1,2
67,2025-05-25T01:14:00+02:00,2025-05-25,09:14,2,1,3
67,2025-05-25T01:15:00+02:00,2025-05-25,09:15,3,2,5
67,2025-05-25T01:16:00+02:00,2025-05-25,09:16,3,4,7
67,2025-05-25T01:18:00+02:00,2025-05-25,09:18,3,5,8
68,2025-05-25T01:12:00+02:00,2025-05-25,09:12,2,0,2
68,2025-05-25T01:13:00+02:00,2025-05-25,09:13,1,1,2
68,2025-05-25T01:18:00+02:00,2025-05-25,09:18,1,3,4
68,2025-05-25T01:20:00+02:00,2025-05-25,09:20,2,4,6
72,2025-05-25T01:10:00+02:00,2025-05-25,09:10,2,0,2
72,2025-05-25T01:12:00+02:00,2025-05-25,09:12,1,1,2
72,2025-05-25T01:13:00+02:00,2025-05-25,09:13,1,1,2
72,2025-05-25T01:16:00+02:00,2025-05-25,09:16,0,2,2
72,2025-05-25T01:22:00+02:00,2025-05-25,09:22,2,5,7
72,2025-05-25T01:23:00+02:00,2025-05-25,09:23,1,0,1
76,2025-05-25T01:15:00+02:00,2025-05-25,09:15,1,0,1
76,2025-05-25T01:19:00+02:00,2025-05-25,09:19,0,2,2
76,2025-05-25T01:21:00+02:00,2025-05-25,09:21,1,1,2
79,2025-05-25T01:13:00+02:00,2025-05-25,09:13,3,3,6
79,2025-05-25T01:14:00+02:00,2025-05-25,09:14,1,0,1
79,2025-05-25T01:18:00+02:00,2025-05-25,09:18,4,3,7
79,2025-05-25T01:22:00+02:00,2025-05-25,09:22,7,1,8
85,2025-05-25T01:17:00+02:00,2025-05-25,09:17,2,0,2
86,2025-05-25T01:12:00+02:00,2025-05-25,09:12,1,1,2
86,2025-05-25T01:20:00+02:00,2025-05-25,09:20,0,1,1
86,2025-05-25T01:21:00+02:00,2025-05-25,09:21,1,2,3
109,2025-05-25T01:10:00+02:00,2025-05-25,09:10,13,2,15
117,2025-05-25T01:15:00+02:00,2025-05-25,09:15,3,6,9
123,2025-05-25T01:10:00+02:00,2025-05-25,09:10,0,2,2
123,2025-05-25T01:15:00+02:00,2025-05-25,09:15,4,3,7
137,2025-05-25T01:20:00+02:00,2025-05-25,09:20,2,1,3
142,2025-05-25T01:15:00+02:00,2025-05-25,09:15,24,13,37
161,2025-05-25T01:10:00+02:00,2025-05-25,09:10,14,14,28
161,2025-05-25T01:15:00+02:00,2025-05-25,09:15,4,43,47
164,2025-05-25T01:20:00+02:00,2025-05-25,09:20,2,1,3
181,2025-05-25T01:11:00+02:00,2025-05-25,09:11,1,4,5
181,2025-05-25T01:12:00+02:00,2025-05-25,09:12,2,6,8
181,2025-05-25T01:16:00+02:00,2025-05-25,09:16,3,11,14
181,2025-05-25T01:20:00+02:00,2025-05-25,09:20,3,7,10
181,2025-05-25T01:22:00+02:00,2025-05-25,09:22,3,6,9
182,2025-05-25T01:10:00+02:00,2025-05-25,09:10,7,8,15
182,2025-05-25T01:15:00+02:00,2025-05-25,09:15,9,7,16
180,2025-05-25T01:24:00+02:00,2025-05-25,09:24,0,1,1
3,2025-05-25T01:26:00+02:00,2025-05-25,09:26,0,3,3
3,2025-05-25T01:27:00+02:00,2025-05-25,09:27,5,1,6
3,2025-05-25T01:29:00+02:00,2025-05-25,09:29,4,5,9
3,2025-05-25T01:31:00+02:00,2025-05-25,09:31,9,0,9
3,2025-05-25T01:32:00+02:00,2025-05-25,09:32,2,1,3
3,2025-05-25T01:33:00+02:00,2025-05-25,09:33,2,5,7
3,2025-05-25T01:36:00+02:00,2025-05-25,09:36,6,5,11
3,2025-05-25T01:37:00+02:00,2025-05-25,09:37,2,5,7
4,2025-05-25T01:34:00+02:00,2025-05-25,09:34,5,6,11
4,2025-05-25T01:38:00+02:00,2025-05-25,09:38,10,4,14
6,2025-05-25T01:28:00+02:00,2025-05-25,09:28,9,9,18
6,2025-05-25T01:33:00+02:00,2025-05-25,09:33,3,8,11
6,2025-05-25T01:37:00+02:00,2025-05-25,09:37,8,14,22
6,2025-05-25T01:39:00+02:00,2025-05-25,09:39,1,2,3
8,2025-05-25T01:25:00+02:00,2025-05-25,09:25,1,3,4
8,2025-05-25T01:26:00+02:00,2025-05-25,09:26,0,5,5
8,2025-05-25T01:30:00+02:00,2025-05-25,09:30,2,0,2
8,2025-05-25T01:31:00+02:00,2025-05-25,09:31,3,4,7
8,2025-05-25T01:36:00+02:00,2025-05-25,09:36,3,7,10
8,2025-05-25T01:38:00+02:00,2025-05-25,09:38,1,5,6
28,2025-05-25T01:25:00+02:00,2025-05-25,09:25,1,7,8
28,2025-05-25T01:29:00+02:00,2025-05-25,09:29,3,5,8
28,2025-05-25T01:32:00+02:00,2025-05-25,09:32,2,2,4
28,2025-05-25T01:35:00+02:00,2025-05-25,09:35,2,4,6
28,2025-05-25T01:38:00+02:00,2025-05-25,09:38,1,0,1
28,2025-05-25T01:39:00+02:00,2025-05-25,09:39,6,0,6
29,2025-05-25T01:27:00+02:00,2025-05-25,09:27,2,1,3
29,2025-05-25T01:28:00+02:00,2025-05-25,09:28,2,9,11
29,2025-05-25T01:37:00+02:00,2025-05-25,09:37,3,5,8
31,2025-05-25T01:29:00+02:00,2025-05-25,09:29,0,1,1
31,2025-05-25T01:32:00+02:00,2025-05-25,09:32,1,0,1
31,2025-05-25T01:38:00+02:00,2025-05-25,09:38,0,1,1
31,2025-05-25T01:39:00+02:00,2025-05-25,09:39,0,1,1
36,2025-05-25T01:27:00+02:00,2025-05-25,09:27,2,0,2
36,2025-05-25T01:38:00+02:00,2025-05-25,09:38,1,0,1
37,2025-05-25T01:27:00+02:00,2025-05-25,09:27,2,0,2
37,2025-05-25T01:37:00+02:00,2025-05-25,09:37,0,1,1
39,2025-05-25T01:25:00+02:00,2025-05-25,09:25,1,0,1
39,2025-05-25T01:27:00+02:00,2025-05-25,09:27,1,0,1
39,2025-05-25T01:32:00+02:00,2025-05-25,09:32,1,0,1
39,2025-05-25T01:38:00+02:00,2025-05-25,09:38,1,2,3
40,2025-05-25T01:26:00+02:00,2025-05-25,09:26,5,4,9
40,2025-05-25T01:29:00+02:00,2025-05-25,09:29,0,1,1
40,2025-05-25T01:35:00+02:00,2025-05-25,09:35,2,2,4
40,2025-05-25T01:37:00+02:00,2025-05-25,09:37,0,2,2
40,2025-05-25T01:38:00+02:00,2025-05-25,09:38,1,5,6
41,2025-05-25T01:28:00+02:00,2025-05-25,09:28,0,1,1
41,2025-05-25T01:35:00+02:00,2025-05-25,09:35,2,1,3
41,2025-05-25T01:37:00+02:00,2025-05-25,09:37,2,4,6
41,2025-05-25T01:38:00+02:00,2025-05-25,09:38,3,3,6
41,2025-05-25T01:39:00+02:00,2025-05-25,09:39,0,2,2
43,2025-05-25T01:25:00+02:00,2025-05-25,09:25,1,3,4
44,2025-05-25T01:35:00+02:00,2025-05-25,09:35,0,1,1
45,2025-05-25T01:26:00+02:00,2025-05-25,09:26,5,2,7
45,2025-05-25T01:31:00+02:00,2025-05-25,09:31,5,5,10
45,2025-05-25T01:36:00+02:00,2025-05-25,09:36,4,1,5
45,2025-05-25T01:39:00+02:00,2025-05-25,09:39,9,0,9
47,2025-05-25T01:28:00+02:00,2025-05-25,09:28,7,2,9
47,2025-05-25T01:29:00+02:00,2025-05-25,09:29,8,4,12
47,2025-05-25T01:31:00+02:00,2025-05-25,09:31,7,7,14
47,2025-05-25T01:33:00+02:00,2025-05-25,09:33,0,1,1
47,2025-05-25T01:35:00+02:00,2025-05-25,09:35,2,14,16
47,2025-05-25T01:37:00+02:00,2025-05-25,09:37,4,6,10
50,2025-05-25T01:27:00+02:00,2025-05-25,09:27,3,2,5
50,2025-05-25T01:30:00+02:00,2025-05-25,09:30,1,1,2
50,2025-05-25T01:34:00+02:00,2025-05-25,09:34,1,1,2
50,2025-05-25T01:35:00+02:00,2025-05-25,09:35,2,3,5
50,2025-05-25T01:38:00+02:00,2025-05-25,09:38,0,2,2
54,2025-05-25T01:28:00+02:00,2025-05-25,09:28,4,0,4
61,2025-05-25T01:29:00+02:00,2025-05-25,09:29,4,4,8
61,2025-05-25T01:30:00+02:00,2025-05-25,09:30,1,3,4
61,2025-05-25T01:32:00+02:00,2025-05-25,09:32,2,4,6
61,2025-05-25T01:36:00+02:00,2025-05-25,09:36,2,4,6
66,2025-05-25T01:31:00+02:00,2025-05-25,09:31,2,2,4
66,2025-05-25T01:32:00+02:00,2025-05-25,09:32,3,2,5
66,2025-05-25T01:33:00+02:00,2025-05-25,09:33,6,3,9
66,2025-05-25T01:36:00+02:00,2025-05-25,09:36,2,4,6
66,2025-05-25T01:38:00+02:00,2025-05-25,09:38,3,4,7
69,2025-05-25T01:25:00+02:00,2025-05-25,09:25,3,1,4
69,2025-05-25T01:28:00+02:00,2025-05-25,09:28,2,3,5
69,2025-05-25T01:35:00+02:00,2025-05-25,09:35,1,3,4
69,2025-05-25T01:38:00+02:00,2025-05-25,09:38,7,0,7
70,2025-05-25T01:26:00+02:00,2025-05-25,09:26,1,2,3
70,2025-05-25T01:27:00+02:00,2025-05-25,09:27,4,1,5
70,2025-05-25T01:38:00+02:00,2025-05-25,09:38,1,4,5
70,2025-05-25T01:39:00+02:00,2025-05-25,09:39,2,3,5
71,2025-05-25T01:35:00+02:00,2025-05-25,09:35,0,1,1
75,2025-05-25T01:26:00+02:00,2025-05-25,09:26,1,0,1
75,2025-05-25T01:28:00+02:00,2025-05-25,09:28,2,0,2
77,2025-05-25T01:25:00+02:00,2025-05-25,09:25,16,36,52
77,2025-05-25T01:35:00+02:00,2025-05-25,09:35,15,9,24
78,2025-05-25T01:27:00+02:00,2025-05-25,09:27,2,1,3
78,2025-05-25T01:33:00+02:00,2025-05-25,09:33,1,0,1
78,2025-05-25T01:34:00+02:00,2025-05-25,09:34,0,3,3
78,2025-05-25T01:35:00+02:00,2025-05-25,09:35,1,4,5
78,2025-05-25T01:39:00+02:00,2025-05-25,09:39,0,4,4
87,2025-05-25T01:25:00+02:00,2025-05-25,09:25,4,3,7
87,2025-05-25T01:27:00+02:00,2025-05-25,09:27,2,1,3
107,2025-05-25T01:30:00+02:00,2025-05-25,09:30,8,3,11
107,2025-05-25T01:35:00+02:00,2025-05-25,09:35,4,8,12
108,2025-05-25T01:25:00+02:00,2025-05-25,09:25,1,0,1
108,2025-05-25T01:26:00+02:00,2025-05-25,09:26,3,1,4
108,2025-05-25T01:27:00+02:00,2025-05-25,09:27,4,1,5
108,2025-05-25T01:28:00+02:00,2025-05-25,09:28,2,1,3
108,2025-05-25T01:29:00+02:00,2025-05-25,09:29,6,1,7
108,2025-05-25T01:32:00+02:00,2025-05-25,09:32,0,2,2
108,2025-05-25T01:36:00+02:00,2025-05-25,09:36,2,1,3
108,2025-05-25T01:37:00+02:00,2025-05-25,09:37,0,5,5
118,2025-05-25T01:25:00+02:00,2025-05-25,09:25,0,3,3
131,2025-05-25T01:30:00+02:00,2025-05-25,09:30,1,3,4
134,2025-05-25T01:35:00+02:00,2025-05-25,09:35,27,18,45
135,2025-05-25T01:30:00+02:00,2025-05-25,09:30,19,13,32
162,2025-05-25T01:25:00+02:00,2025-05-25,09:25,25,16,41
162,2025-05-25T01:30:00+02:00,2025-05-25,09:30,17,21,38
165,2025-05-25T01:25:00+02:00,2025-05-25,09:25,0,5,5
166,2025-05-25T01:25:00+02:00,2025-05-25,09:25,0,4,4
167,2025-05-25T01:35:00+02:00,2025-05-25,09:35,2,7,9
179,2025-05-25T01:25:00+02:00,2025-05-25,09:25,9,4,13
179,2025-05-25T01:30:00+02:00,2025-05-25,09:30,4,11,15
179,2025-05-25T01:35:00+02:00,2025-05-25,09:35,6,1,7
1,2025-05-25T01:25:00+02:00,2025-05-25,09:25,0,11,11
1,2025-05-25T01:27:00+02:00,2025-05-25,09:27,1,2,3
1,2025-05-25T01:29:00+02:00,2025-05-25,09:29,1,2,3
1,2025-05-25T01:30:00+02:00,2025-05-25,09:30,4,1,5
1,2025-05-25T01:31:00+02:00,2025-05-25,09:31,6,6,12
2,2025-05-25T01:29:00+02:00,2025-05-25,09:29,1,4,5
2,2025-05-25T01:33:00+02:00,2025-05-25,09:33,4,4,8
2,2025-05-25T01:36:00+02:00,2025-05-25,09:36,5,1,6
2,2025-05-25T01:37:00+02:00,2025-05-25,09:37,4,8,12
9,2025-05-25T01:29:00+02:00,2025-05-25,09:29,4,0,4
9,2025-05-25T01:32:00+02:00,2025-05-25,09:32,1,0,1
9,2025-05-25T01:34:00+02:00,2025-05-25,09:34,1,1,2
9,2025-05-25T01:39:00+02:00,2025-05-25,09:39,0,1,1
10,2025-05-25T01:31:00+02:00,2025-05-25,09:31,2,0,2
10,2025-05-25T01:39:00+02:00,2025-05-25,09:39,2,0,2
11,2025-05-25T01:27:00+02:00,2025-05-25,09:27,17,4,21
11,2025-05-25T01:29:00+02:00,2025-05-25,09:29,2,1,3
11,2025-05-25T01:33:00+02:00,2025-05-25,09:33,2,0,2
11,2025-05-25T01:37:00+02:00,2025-05-25,09:37,4,1,5
12,2025-05-25T01:25:00+02:00,2025-05-25,09:25,4,6,10
12,2025-05-25T01:28:00+02:00,2025-05-25,09:28,15,3,18
12,2025-05-25T01:32:00+02:00,2025-05-25,09:32,0,4,4
12,2025-05-25T01:37:00+02:00,2025-05-25,09:37,3,1,4
17,2025-05-25T01:25:00+02:00,2025-05-25,09:25,1,3,4
17,2025-05-25T01:28:00+02:00,2025-05-25,09:28,2,1,3
17,2025-05-25T01:32:00+02:00,2025-05-25,09:32,0,1,1
17,2025-05-25T01:34:00+02:00,2025-05-25,09:34,1,0,1
18,2025-05-25T01:28:00+02:00,2025-05-25,09:28,1,2,3
18,2025-05-25T01:29:00+02:00,2025-05-25,09:29,1,0,1
18,2025-05-25T01:32:00+02:00,2025-05-25,09:32,1,2,3
18,2025-05-25T01:33:00+02:00,2025-05-25,09:33,4,1,5
18,2025-05-25T01:34:00+02:00,2025-05-25,09:34,3,2,5
18,2025-05-25T01:39:00+02:00,2025-05-25,09:39,0,4,4
19,2025-05-25T01:32:00+02:00,2025-05-25,09:32,0,1,1
19,2025-05-25T01:33:00+02:00,2025-05-25,09:33,2,0,2
20,2025-05-25T01:34:00+02:00,2025-05-25,09:34,1,0,1
20,2025-05-25T01:37:00+02:00,2025-05-25,09:37,0,1,1
20,2025-05-25T01:38:00+02:00,2025-05-25,09:38,0,1,1
20,2025-05-25T01:39:00+02:00,2025-05-25,09:39,1,3,4
23,2025-05-25T01:28:00+02:00,2025-05-25,09:28,3,1,4
23,2025-05-25T01:30:00+02:00,2025-05-25,09:30,2,7,9
23,2025-05-25T01:31:00+02:00,2025-05-25,09:31,6,0,6
23,2025-05-25T01:34:00+02:00,2025-05-25,09:34,6,12,18
23,2025-05-25T01:36:00+02:00,2025-05-25,09:36,7,2,9
23,2025-05-25T01:39:00+02:00,2025-05-25,09:39,1,2,3
24,2025-05-25T01:25:00+02:00,2025-05-25,09:25,1,6,7
24,2025-05-25T01:26:00+02:00,2025-05-25,09:26,4,3,7
24,2025-05-25T01:29:00+02:00,2025-05-25,09:29,3,1,4
24,2025-05-25T01:31:00+02:00,2025-05-25,09:31,2,8,10
24,2025-05-25T01:36:00+02:00,2025-05-25,09:36,15,1,16
24,2025-05-25T01:37:00+02:00,2025-05-25,09:37,7,1,8
25,2025-05-25T01:35:00+02:00,2025-05-25,09:35,23,37,60
27,2025-05-25T01:26:00+02:00,2025-05-25,09:26,8,5,13
27,2025-05-25T01:29:00+02:00,2025-05-25,09:29,5,3,8
27,2025-05-25T01:32:00+02:00,2025-05-25,09:32,3,3,6
27,2025-05-25T01:34:00+02:00,2025-05-25,09:34,1,2,3
27,2025-05-25T01:38:00+02:00,2025-05-25,09:38,2,1,3
27,2025-05-25T01:39:00+02:00,2025-05-25,09:39,4,7,11
30,2025-05-25T01:27:00+02:00,2025-05-25,09:27,3,0,3
30,2025-05-25T01:28:00+02:00,2025-05-25,09:28,2,2,4
30,2025-05-25T01:32:00+02:00,2025-05-25,09:32,1,2,3
30,2025-05-25T01:35:00+02:00,2025-05-25,09:35,0,9,9
35,2025-05-25T01:31:00+02:00,2025-05-25,09:31,6,7,13
35,2025-05-25T01:35:00+02:00,2025-05-25,09:35,13,12,25
35,2025-05-25T01:38:00+02:00,2025-05-25,09:38,10,8,18
35,2025-05-25T01:39:00+02:00,2025-05-25,09:39,24,25,49
48,2025-05-25T01:25:00+02:00,2025-05-25,09:25,2,4,6
48,2025-05-25T01:29:00+02:00,2025-05-25,09:29,6,1,7
48,2025-05-25T01:38:00+02:00,2025-05-25,09:38,0,2,2
49,2025-05-25T01:25:00+02:00,2025-05-25,09:25,2,6,8
49,2025-05-25T01:27:00+02:00,2025-05-25,09:27,5,0,5
51,2025-05-25T01:25:00+02:00,2025-05-25,09:25,1,6,7
51,2025-05-25T01:26:00+02:00,2025-05-25,09:26,0,8,8
51,2025-05-25T01:37:00+02:00,2025-05-25,09:37,2,2,4
52,2025-05-25T01:34:00+02:00,2025-05-25,09:34,2,0,2
52,2025-05-25T01:37:00+02:00,2025-05-25,09:37,3,0,3
52,2025-05-25T01:38:00+02:00,2025-05-25,09:38,0,1,1
53,2025-05-25T01:27:00+02:00,2025-05-25,09:27,1,3,4
53,2025-05-25T01:29:00+02:00,2025-05-25,09:29,3,2,5
53,2025-05-25T01:34:00+02:00,2025-05-25,09:34,3,0,3
53,2025-05-25T01:35:00+02:00,2025-05-25,09:35,5,1,6
56,2025-05-25T01:26:00+02:00,2025-05-25,09:26,2,1,3
56,2025-05-25T01:27:00+02:00,2025-05-25,09:27,2,2,4
56,2025-05-25T01:30:00+02:00,2025-05-25,09:30,4,0,4
56,2025-05-25T01:31:00+02:00,2025-05-25,09:31,3,4,7
58,2025-05-25T01:26:00+02:00,2025-05-25,09:26,3,2,5
58,2025-05-25T01:28:00+02:00,2025-05-25,09:28,0,4,4
58,2025-05-25T01:30:00+02:00,2025-05-25,09:30,3,3,6
58,2025-05-25T01:31:00+02:00,2025-05-25,09:31,4,0,4
58,2025-05-25T01:33:00+02:00,2025-05-25,09:33,5,0,5
58,2025-05-25T01:38:00+02:00,2025-05-25,09:38,11,4,15
62,2025-05-25T01:29:00+02:00,2025-05-25,09:29,2,1,3
62,2025-05-25T01:30:00+02:00,2025-05-25,09:30,1,1,2
62,2025-05-25T01:36:00+02:00,2025-05-25,09:36,2,2,4
63,2025-05-25T01:39:00+02:00,2025-05-25,09:39,5,2,7
67,2025-05-25T01:28:00+02:00,2025-05-25,09:28,1,5,6
67,2025-05-25T01:31:00+02:00,2025-05-25,09:31,2,4,6
67,2025-05-25T01:34:00+02:00,2025-05-25,09:34,10,7,17
68,2025-05-25T01:25:00+02:00,2025-05-25,09:25,3,1,4
68,2025-05-25T01:26:00+02:00,2025-05-25,09:26,4,6,10
68,2025-05-25T01:27:00+02:00,2025-05-25,09:27,2,3,5
68,2025-05-25T01:29:00+02:00,2025-05-25,09:29,0,3,3
68,2025-05-25T01:30:00+02:00,2025-05-25,09:30,0,5,5
68,2025-05-25T01:33:00+02:00,2025-05-25,09:33,2,2,4
68,2025-05-25T01:34:00+02:00,2025-05-25,09:34,2,1,3
72,2025-05-25T01:25:00+02:00,2025-05-25,09:25,0,1,1
72,2025-05-25T01:30:00+02:00,2025-05-25,09:30,0,3,3
72,2025-05-25T01:37:00+02:00,2025-05-25,09:37,0,1,1
76,2025-05-25T01:26:00+02:00,2025-05-25,09:26,1,1,2
76,2025-05-25T01:29:00+02:00,2025-05-25,09:29,3,0,3
76,2025-05-25T01:36:00+02:00,2025-05-25,09:36,3,0,3
79,2025-05-25T01:26:00+02:00,2025-05-25,09:26,1,0,1
79,2025-05-25T01:34:00+02:00,2025-05-25,09:34,3,7,10
79,2025-05-25T01:38:00+02:00,2025-05-25,09:38,1,1,2
85,2025-05-25T01:27:00+02:00,2025-05-25,09:27,1,1,2
85,2025-05-25T01:29:00+02:00,2025-05-25,09:29,3,1,4
85,2025-05-25T01:34:00+02:00,2025-05-25,09:34,2,0,2
85,2025-05-25T01:36:00+02:00,2025-05-25,09:36,1,1,2
86,2025-05-25T01:26:00+02:00,2025-05-25,09:26,1,0,1
86,2025-05-25T01:32:00+02:00,2025-05-25,09:32,0,1,1
86,2025-05-25T01:39:00+02:00,2025-05-25,09:39,1,0,1
109,2025-05-25T01:35:00+02:00,2025-05-25,09:35,9,3,12
117,2025-05-25T01:25:00+02:00,2025-05-25,09:25,6,4,10
136,2025-05-25T01:25:00+02:00,2025-05-25,09:25,17,8,25
138,2025-05-25T01:35:00+02:00,2025-05-25,09:35,0,2,2
139,2025-05-25T01:30:00+02:00,2025-05-25,09:30,3,7,10
164,2025-05-25T01:25:00+02:00,2025-05-25,09:25,5,0,5
181,2025-05-25T01:25:00+02:00,2025-05-25,09:25,4,17,21
181,2025-05-25T01:27:00+02:00,2025-05-25,09:27,7,5,12
181,2025-05-25T01:28:00+02:00,2025-05-25,09:28,3,9,12
181,2025-05-25T01:29:00+02:00,2025-05-25,09:29,5,9,14
181,2025-05-25T01:30:00+02:00,2025-05-25,09:30,1,7,8
181,2025-05-25T01:34:00+02:00,2025-05-25,09:34,1,12,13
181,2025-05-25T01:35:00+02:00,2025-05-25,09:35,2,17,19
181,2025-05-25T01:37:00+02:00,2025-05-25,09:37,1,3,4
181,2025-05-25T01:38:00+02:00,2025-05-25,09:38,5,12,17
182,2025-05-25T01:30:00+02:00,2025-05-25,09:30,11,9,20
182,2025-05-25T01:35:00+02:00,2025-05-25,09:35,11,7,18
180,2025-05-25T01:25:00+02:00,2025-05-25,09:25,0,2,2
180,2025-05-25T01:34:00+02:00,2025-05-25,09:34,1,0,1
180,2025-05-25T01:37:00+02:00,2025-05-25,09:37,3,0,3
181,2025-05-25T01:42:00+02:00,2025-05-25,09:42,11,7,18
181,2025-05-25T01:45:00+02:00,2025-05-25,09:45,6,11,17
181,2025-05-25T01:47:00+02:00,2025-05-25,09:47,1,9,10
181,2025-05-25T01:50:00+02:00,2025-05-25,09:50,2,16,18
181,2025-05-25T01:51:00+02:00,2025-05-25,09:51,5,13,18
181,2025-05-25T01:52:00+02:00,2025-05-25,09:52,5,5,10
181,2025-05-25T01:53:00+02:00,2025-05-25,09:53,2,18,20
182,2025-05-25T01:45:00+02:00,2025-05-25,09:45,13,10,23
3,2025-05-24T15:55:00+02:00,2025-05-24,23:55,21,13,34
3,2025-05-24T15:56:00+02:00,2025-05-24,23:56,6,11,17
3,2025-05-24T16:00:00+02:00,2025-05-25,00:00,11,12,23
3,2025-05-24T16:01:00+02:00,2025-05-25,00:01,3,12,15
3,2025-05-24T16:03:00+02:00,2025-05-25,00:03,3,9,12
3,2025-05-24T16:04:00+02:00,2025-05-25,00:04,8,6,14
3,2025-05-24T16:05:00+02:00,2025-05-25,00:05,20,3,23
3,2025-05-24T16:06:00+02:00,2025-05-25,00:06,6,4,10
4,2025-05-24T16:01:00+02:00,2025-05-25,00:01,10,4,14
4,2025-05-24T16:03:00+02:00,2025-05-25,00:03,5,4,9
4,2025-05-24T16:07:00+02:00,2025-05-25,00:07,4,5,9
5,2025-05-24T15:55:00+02:00,2025-05-24,23:55,44,25,69
6,2025-05-24T15:56:00+02:00,2025-05-24,23:56,9,0,9
6,2025-05-24T15:57:00+02:00,2025-05-24,23:57,6,3,9
6,2025-05-24T16:00:00+02:00,2025-05-25,00:00,9,4,13
6,2025-05-24T16:05:00+02:00,2025-05-25,00:05,2,0,2
6,2025-05-24T16:07:00+02:00,2025-05-25,00:07,6,2,8
6,2025-05-24T16:09:00+02:00,2025-05-25,00:09,5,10,15
28,2025-05-24T15:56:00+02:00,2025-05-24,23:56,2,1,3
28,2025-05-24T15:59:00+02:00,2025-05-24,23:59,3,2,5
28,2025-05-24T16:04:00+02:00,2025-05-25,00:04,1,0,1
28,2025-05-24T16:06:00+02:00,2025-05-25,00:06,3,1,4
28,2025-05-24T16:08:00+02:00,2025-05-25,00:08,2,0,2
29,2025-05-24T16:01:00+02:00,2025-05-25,00:01,0,6,6
29,2025-05-24T16:08:00+02:00,2025-05-25,00:08,0,5,5
29,2025-05-24T16:09:00+02:00,2025-05-25,00:09,1,1,2
31,2025-05-24T15:55:00+02:00,2025-05-24,23:55,0,3,3
31,2025-05-24T15:56:00+02:00,2025-05-24,23:56,2,2,4
31,2025-05-24T15:58:00+02:00,2025-05-24,23:58,1,3,4
31,2025-05-24T16:02:00+02:00,2025-05-25,00:02,1,2,3
31,2025-05-24T16:03:00+02:00,2025-05-25,00:03,0,6,6
31,2025-05-24T16:04:00+02:00,2025-05-25,00:04,1,0,1
31,2025-05-24T16:08:00+02:00,2025-05-25,00:08,1,6,7
36,2025-05-24T16:05:00+02:00,2025-05-25,00:05,2,1,3
36,2025-05-24T16:06:00+02:00,2025-05-25,00:06,0,5,5
36,2025-05-24T16:08:00+02:00,2025-05-25,00:08,4,0,4
36,2025-05-24T16:09:00+02:00,2025-05-25,00:09,4,0,4
37,2025-05-24T15:56:00+02:00,2025-05-24,23:56,0,2,2
37,2025-05-24T15:59:00+02:00,2025-05-24,23:59,5,3,8
37,2025-05-24T16:00:00+02:00,2025-05-25,00:00,2,1,3
37,2025-05-24T16:01:00+02:00,2025-05-25,00:01,0,3,3
37,2025-05-24T16:07:00+02:00,2025-05-25,00:07,0,2,2
37,2025-05-24T16:09:00+02:00,2025-05-25,00:09,0,6,6
39,2025-05-24T16:01:00+02:00,2025-05-25,00:01,2,0,2
40,2025-05-24T15:55:00+02:00,2025-05-24,23:55,3,0,3
40,2025-05-24T15:56:00+02:00,2025-05-24,23:56,1,0,1
40,2025-05-24T16:00:00+02:00,2025-05-25,00:00,3,0,3
40,2025-05-24T16:03:00+02:00,2025-05-25,00:03,1,0,1
41,2025-05-24T15:56:00+02:00,2025-05-24,23:56,3,1,4
41,2025-05-24T15:59:00+02:00,2025-05-24,23:59,0,1,1
41,2025-05-24T16:00:00+02:00,2025-05-25,00:00,1,2,3
41,2025-05-24T16:01:00+02:00,2025-05-25,00:01,0,2,2
41,2025-05-24T16:05:00+02:00,2025-05-25,00:05,2,9,11
41,2025-05-24T16:07:00+02:00,2025-05-25,00:07,2,1,3
41,2025-05-24T16:08:00+02:00,2025-05-25,00:08,0,3,3
44,2025-05-24T16:05:00+02:00,2025-05-25,00:05,1,0,1
45,2025-05-24T15:55:00+02:00,2025-05-24,23:55,5,6,11
45,2025-05-24T15:56:00+02:00,2025-05-24,23:56,2,6,8
45,2025-05-24T16:08:00+02:00,2025-05-25,00:08,4,2,6
45,2025-05-24T16:09:00+02:00,2025-05-25,00:09,6,3,9
47,2025-05-24T15:55:00+02:00,2025-05-24,23:55,2,2,4
47,2025-05-24T15:57:00+02:00,2025-05-24,23:57,2,4,6
47,2025-05-24T15:58:00+02:00,2025-05-24,23:58,2,5,7
47,2025-05-24T16:01:00+02:00,2025-05-25,00:01,14,2,16
47,2025-05-24T16:03:00+02:00,2025-05-25,00:03,2,6,8
47,2025-05-24T16:09:00+02:00,2025-05-25,00:09,5,4,9
50,2025-05-24T15:55:00+02:00,2025-05-24,23:55,12,0,12
50,2025-05-24T16:03:00+02:00,2025-05-25,00:03,1,0,1
50,2025-05-24T16:07:00+02:00,2025-05-25,00:07,1,0,1
50,2025-05-24T16:08:00+02:00,2025-05-25,00:08,2,0,2
54,2025-05-24T15:57:00+02:00,2025-05-24,23:57,1,0,1
54,2025-05-24T16:06:00+02:00,2025-05-25,00:06,1,0,1
54,2025-05-24T16:09:00+02:00,2025-05-25,00:09,0,1,1
59,2025-05-24T15:55:00+02:00,2025-05-24,23:55,11,18,29
59,2025-05-24T16:00:00+02:00,2025-05-25,00:00,10,12,22
61,2025-05-24T15:56:00+02:00,2025-05-24,23:56,0,3,3
61,2025-05-24T16:07:00+02:00,2025-05-25,00:07,2,1,3
61,2025-05-24T16:08:00+02:00,2025-05-25,00:08,1,0,1
66,2025-05-24T16:03:00+02:00,2025-05-25,00:03,4,8,12
66,2025-05-24T16:07:00+02:00,2025-05-25,00:07,9,3,12
70,2025-05-24T15:59:00+02:00,2025-05-24,23:59,0,1,1
75,2025-05-24T16:02:00+02:00,2025-05-25,00:02,0,1,1
75,2025-05-24T16:04:00+02:00,2025-05-25,00:04,3,0,3
75,2025-05-24T16:07:00+02:00,2025-05-25,00:07,2,2,4
77,2025-05-24T15:55:00+02:00,2025-05-24,23:55,3,0,3
78,2025-05-24T16:00:00+02:00,2025-05-25,00:00,0,2,2
84,2025-05-24T16:00:00+02:00,2025-05-25,00:00,24,26,50
84,2025-05-24T16:05:00+02:00,2025-05-25,00:05,16,34,50
87,2025-05-24T15:56:00+02:00,2025-05-24,23:56,0,1,1
107,2025-05-24T15:55:00+02:00,2025-05-24,23:55,3,2,5
108,2025-05-24T15:55:00+02:00,2025-05-24,23:55,0,1,1
108,2025-05-24T16:01:00+02:00,2025-05-25,00:01,6,1,7
132,2025-05-24T16:00:00+02:00,2025-05-25,00:00,6,2,8
133,2025-05-24T16:00:00+02:00,2025-05-25,00:00,8,11,19
134,2025-05-24T15:55:00+02:00,2025-05-24,23:55,12,7,19
134,2025-05-24T16:00:00+02:00,2025-05-25,00:00,11,12,23
162,2025-05-24T16:05:00+02:00,2025-05-25,00:05,3,4,7
165,2025-05-24T16:00:00+02:00,2025-05-25,00:00,0,1,1
166,2025-05-24T16:05:00+02:00,2025-05-25,00:05,1,3,4
167,2025-05-24T16:00:00+02:00,2025-05-25,00:00,0,1,1
179,2025-05-24T15:55:00+02:00,2025-05-24,23:55,3,0,3
1,2025-05-24T16:00:00+02:00,2025-05-25,00:00,6,4,10
1,2025-05-24T16:05:00+02:00,2025-05-25,00:05,1,0,1
2,2025-05-24T15:56:00+02:00,2025-05-24,23:56,0,4,4
2,2025-05-24T15:57:00+02:00,2025-05-24,23:57,3,0,3
2,2025-05-24T15:58:00+02:00,2025-05-24,23:58,0,1,1
2,2025-05-24T16:00:00+02:00,2025-05-25,00:00,0,2,2
2,2025-05-24T16:04:00+02:00,2025-05-25,00:04,0,1,1
2,2025-05-24T16:08:00+02:00,2025-05-25,00:08,2,0,2
9,2025-05-24T16:08:00+02:00,2025-05-25,00:08,1,0,1
9,2025-05-24T16:09:00+02:00,2025-05-25,00:09,0,1,1
10,2025-05-24T15:59:00+02:00,2025-05-24,23:59,0,2,2
10,2025-05-24T16:01:00+02:00,2025-05-25,00:01,2,0,2
10,2025-05-24T16:08:00+02:00,2025-05-25,00:08,0,1,1
11,2025-05-24T16:00:00+02:00,2025-05-25,00:00,6,2,8
12,2025-05-24T16:00:00+02:00,2025-05-25,00:00,6,0,6
12,2025-05-24T16:02:00+02:00,2025-05-25,00:02,7,0,7
12,2025-05-24T16:08:00+02:00,2025-05-25,00:08,3,7,10
18,2025-05-24T16:01:00+02:00,2025-05-25,00:01,2,0,2
19,2025-05-24T15:58:00+02:00,2025-05-24,23:58,0,4,4
19,2025-05-24T15:59:00+02:00,2025-05-24,23:59,10,5,15
19,2025-05-24T16:03:00+02:00,2025-05-25,00:03,4,2,6
19,2025-05-24T16:04:00+02:00,2025-05-25,00:04,14,0,14
19,2025-05-24T16:08:00+02:00,2025-05-25,00:08,4,1,5
20,2025-05-24T15:55:00+02:00,2025-05-24,23:55,10,2,12
20,2025-05-24T15:56:00+02:00,2025-05-24,23:56,1,8,9
20,2025-05-24T16:00:00+02:00,2025-05-25,00:00,9,4,13
20,2025-05-24T16:03:00+02:00,2025-05-25,00:03,9,9,18
20,2025-05-24T16:09:00+02:00,2025-05-25,00:09,5,9,14
23,2025-05-24T15:56:00+02:00,2025-05-24,23:56,0,2,2
23,2025-05-24T15:58:00+02:00,2025-05-24,23:58,1,5,6
23,2025-05-24T16:05:00+02:00,2025-05-25,00:05,1,3,4
23,2025-05-24T16:09:00+02:00,2025-05-25,00:09,0,1,1
24,2025-05-24T15:55:00+02:00,2025-05-24,23:55,3,5,8
24,2025-05-24T15:59:00+02:00,2025-05-24,23:59,3,6,9
24,2025-05-24T16:02:00+02:00,2025-05-25,00:02,5,2,7
24,2025-05-24T16:03:00+02:00,2025-05-25,00:03,0,13,13
24,2025-05-24T16:06:00+02:00,2025-05-25,00:06,0,4,4
24,2025-05-24T16:08:00+02:00,2025-05-25,00:08,2,5,7
24,2025-05-24T16:09:00+02:00,2025-05-25,00:09,2,2,4
27,2025-05-24T16:05:00+02:00,2025-05-25,00:05,2,0,2
27,2025-05-24T16:07:00+02:00,2025-05-25,00:07,2,0,2
30,2025-05-24T15:55:00+02:00,2025-05-24,23:55,8,9,17
30,2025-05-24T15:56:00+02:00,2025-05-24,23:56,11,9,20
30,2025-05-24T15:57:00+02:00,2025-05-24,23:57,2,13,15
30,2025-05-24T16:03:00+02:00,2025-05-25,00:03,2,2,4
30,2025-05-24T16:06:00+02:00,2025-05-25,00:06,10,12,22
30,2025-05-24T16:09:00+02:00,2025-05-25,00:09,10,20,30
35,2025-05-24T15:58:00+02:00,2025-05-24,23:58,7,5,12
35,2025-05-24T15:59:00+02:00,2025-05-24,23:59,11,3,14
35,2025-05-24T16:04:00+02:00,2025-05-25,00:04,1,6,7
35,2025-05-24T16:06:00+02:00,2025-05-25,00:06,11,7,18
49,2025-05-24T15:55:00+02:00,2025-05-24,23:55,2,2,4
49,2025-05-24T15:59:00+02:00,2025-05-24,23:59,0,2,2
49,2025-05-24T16:03:00+02:00,2025-05-25,00:03,0,2,2
49,2025-05-24T16:04:00+02:00,2025-05-25,00:04,1,0,1
49,2025-05-24T16:06:00+02:00,2025-05-25,00:06,6,1,7
49,2025-05-24T16:07:00+02:00,2025-05-25,00:07,3,0,3
49,2025-05-24T16:09:00+02:00,2025-05-25,00:09,0,5,5
51,2025-05-24T15:56:00+02:00,2025-05-24,23:56,2,2,4
51,2025-05-24T16:07:00+02:00,2025-05-25,00:07,3,0,3
52,2025-05-24T15:56:00+02:00,2025-05-24,23:56,9,3,12
52,2025-05-24T15:57:00+02:00,2025-05-24,23:57,2,0,2
52,2025-05-24T16:01:00+02:00,2025-05-25,00:01,7,2,9
52,2025-05-24T16:02:00+02:00,2025-05-25,00:02,8,6,14
52,2025-05-24T16:03:00+02:00,2025-05-25,00:03,5,5,10
53,2025-05-24T16:04:00+02:00,2025-05-25,00:04,1,1,2
56,2025-05-24T15:55:00+02:00,2025-05-24,23:55,1,1,2
56,2025-05-24T15:56:00+02:00,2025-05-24,23:56,2,4,6
56,2025-05-24T16:06:00+02:00,2025-05-25,00:06,1,3,4
58,2025-05-24T15:55:00+02:00,2025-05-24,23:55,17,17,34
58,2025-05-24T15:57:00+02:00,2025-05-24,23:57,6,8,14
58,2025-05-24T15:58:00+02:00,2025-05-24,23:58,1,8,9
58,2025-05-24T16:02:00+02:00,2025-05-25,00:02,2,2,4
58,2025-05-24T16:05:00+02:00,2025-05-25,00:05,3,5,8
58,2025-05-24T16:08:00+02:00,2025-05-25,00:08,3,5,8
62,2025-05-24T15:59:00+02:00,2025-05-24,23:59,1,0,1
62,2025-05-24T16:01:00+02:00,2025-05-25,00:01,3,4,7
62,2025-05-24T16:02:00+02:00,2025-05-25,00:02,5,0,5
62,2025-05-24T16:05:00+02:00,2025-05-25,00:05,0,1,1
63,2025-05-24T15:56:00+02:00,2025-05-24,23:56,0,3,3
63,2025-05-24T15:57:00+02:00,2025-05-24,23:57,2,5,7
63,2025-05-24T16:00:00+02:00,2025-05-25,00:00,1,3,4
63,2025-05-24T16:01:00+02:00,2025-05-25,00:01,0,4,4
63,2025-05-24T16:06:00+02:00,2025-05-25,00:06,4,0,4
63,2025-05-24T16:09:00+02:00,2025-05-25,00:09,0,3,3
67,2025-05-24T15:57:00+02:00,2025-05-24,23:57,0,9,9
67,2025-05-24T15:59:00+02:00,2025-05-24,23:59,2,1,3
67,2025-05-24T16:01:00+02:00,2025-05-25,00:01,2,8,10
67,2025-05-24T16:02:00+02:00,2025-05-25,00:02,3,0,3
67,2025-05-24T16:04:00+02:00,2025-05-25,00:04,1,0,1
67,2025-05-24T16:05:00+02:00,2025-05-25,00:05,1,3,4
67,2025-05-24T16:06:00+02:00,2025-05-25,00:06,0,3,3
67,2025-05-24T16:07:00+02:00,2025-05-25,00:07,3,5,8
72,2025-05-24T16:03:00+02:00,2025-05-25,00:03,2,6,8
72,2025-05-24T16:08:00+02:00,2025-05-25,00:08,0,1,1
79,2025-05-24T15:57:00+02:00,2025-05-24,23:57,3,1,4
79,2025-05-24T15:59:00+02:00,2025-05-24,23:59,1,4,5
79,2025-05-24T16:01:00+02:00,2025-05-25,00:01,2,1,3
79,2025-05-24T16:05:00+02:00,2025-05-25,00:05,0,5,5
79,2025-05-24T16:09:00+02:00,2025-05-25,00:09,2,4,6
85,2025-05-24T15:57:00+02:00,2025-05-24,23:57,1,0,1
85,2025-05-24T16:06:00+02:00,2025-05-25,00:06,1,0,1
109,2025-05-24T16:05:00+02:00,2025-05-25,00:05,2,7,9
117,2025-05-24T16:00:00+02:00,2025-05-25,00:00,15,4,19
141,2025-05-24T16:00:00+02:00,2025-05-25,00:00,8,10,18
142,2025-05-24T15:55:00+02:00,2025-05-24,23:55,1,1,2
142,2025-05-24T16:00:00+02:00,2025-05-25,00:00,1,3,4
181,2025-05-24T15:57:00+02:00,2025-05-24,23:57,2,6,8
181,2025-05-24T16:09:00+02:00,2025-05-25,00:09,8,3,11
182,2025-05-24T16:00:00+02:00,2025-05-25,00:00,17,10,27
3,2025-05-24T16:41:00+02:00,2025-05-25,00:41,7,13,20
3,2025-05-24T16:44:00+02:00,2025-05-25,00:44,1,7,8
3,2025-05-24T16:48:00+02:00,2025-05-25,00:48,3,3,6
3,2025-05-24T16:51:00+02:00,2025-05-25,00:51,0,9,9
3,2025-05-24T16:52:00+02:00,2025-05-25,00:52,1,4,5
3,2025-05-24T16:54:00+02:00,2025-05-25,00:54,6,12,18
4,2025-05-24T16:45:00+02:00,2025-05-25,00:45,0,1,1
4,2025-05-24T16:48:00+02:00,2025-05-25,00:48,6,5,11
4,2025-05-24T16:53:00+02:00,2025-05-25,00:53,11,13,24
6,2025-05-24T16:45:00+02:00,2025-05-25,00:45,1,7,8
6,2025-05-24T16:47:00+02:00,2025-05-25,00:47,5,7,12
6,2025-05-24T16:53:00+02:00,2025-05-25,00:53,4,1,5
29,2025-05-24T16:43:00+02:00,2025-05-25,00:43,1,0,1
31,2025-05-24T16:43:00+02:00,2025-05-25,00:43,1,8,9
31,2025-05-24T16:44:00+02:00,2025-05-25,00:44,3,7,10
31,2025-05-24T16:46:00+02:00,2025-05-25,00:46,0,11,11
36,2025-05-24T16:43:00+02:00,2025-05-25,00:43,1,7,8
36,2025-05-24T16:44:00+02:00,2025-05-25,00:44,2,1,3
36,2025-05-24T16:46:00+02:00,2025-05-25,00:46,6,1,7
36,2025-05-24T16:47:00+02:00,2025-05-25,00:47,3,2,5
36,2025-05-24T16:50:00+02:00,2025-05-25,00:50,6,1,7
36,2025-05-24T16:53:00+02:00,2025-05-25,00:53,0,2,2
39,2025-05-24T16:43:00+02:00,2025-05-25,00:43,0,1,1
40,2025-05-24T16:42:00+02:00,2025-05-25,00:42,2,0,2
40,2025-05-24T16:48:00+02:00,2025-05-25,00:48,1,0,1
40,2025-05-24T16:49:00+02:00,2025-05-25,00:49,0,2,2
40,2025-05-24T16:53:00+02:00,2025-05-25,00:53,0,2,2
41,2025-05-24T16:42:00+02:00,2025-05-25,00:42,1,0,1
41,2025-05-24T16:43:00+02:00,2025-05-25,00:43,2,0,2
41,2025-05-24T16:44:00+02:00,2025-05-25,00:44,0,7,7
41,2025-05-24T16:48:00+02:00,2025-05-25,00:48,6,0,6
45,2025-05-24T16:41:00+02:00,2025-05-25,00:41,2,3,5
45,2025-05-24T16:47:00+02:00,2025-05-25,00:47,3,14,17
45,2025-05-24T16:50:00+02:00,2025-05-25,00:50,1,1,2
45,2025-05-24T16:53:00+02:00,2025-05-25,00:53,4,8,12
47,2025-05-24T16:40:00+02:00,2025-05-25,00:40,1,1,2
47,2025-05-24T16:43:00+02:00,2025-05-25,00:43,0,9,9
47,2025-05-24T16:45:00+02:00,2025-05-25,00:45,2,2,4
47,2025-05-24T16:46:00+02:00,2025-05-25,00:46,0,4,4
47,2025-05-24T16:53:00+02:00,2025-05-25,00:53,4,3,7
47,2025-05-24T16:54:00+02:00,2025-05-25,00:54,2,0,2
54,2025-05-24T16:40:00+02:00,2025-05-25,00:40,1,0,1
54,2025-05-24T16:43:00+02:00,2025-05-25,00:43,0,2,2
54,2025-05-24T16:47:00+02:00,2025-05-25,00:47,0,1,1
54,2025-05-24T16:50:00+02:00,2025-05-25,00:50,0,1,1
54,2025-05-24T16:54:00+02:00,2025-05-25,00:54,2,0,2
59,2025-05-24T16:40:00+02:00,2025-05-25,00:40,2,5,7
59,2025-05-24T16:50:00+02:00,2025-05-25,00:50,2,1,3
61,2025-05-24T16:40:00+02:00,2025-05-25,00:40,1,1,2
61,2025-05-24T16:45:00+02:00,2025-05-25,00:45,1,0,1
61,2025-05-24T16:47:00+02:00,2025-05-25,00:47,1,0,1
61,2025-05-24T16:48:00+02:00,2025-05-25,00:48,1,0,1
66,2025-05-24T16:40:00+02:00,2025-05-25,00:40,8,7,15
66,2025-05-24T16:46:00+02:00,2025-05-25,00:46,1,0,1
66,2025-05-24T16:47:00+02:00,2025-05-25,00:47,0,4,4
66,2025-05-24T16:54:00+02:00,2025-05-25,00:54,6,2,8
77,2025-05-24T16:40:00+02:00,2025-05-25,00:40,0,3,3
87,2025-05-24T16:52:00+02:00,2025-05-25,00:52,0,4,4
107,2025-05-24T16:45:00+02:00,2025-05-25,00:45,3,1,4
107,2025-05-24T16:50:00+02:00,2025-05-25,00:50,3,2,5
108,2025-05-24T16:40:00+02:00,2025-05-25,00:40,2,0,2
108,2025-05-24T16:42:00+02:00,2025-05-25,00:42,6,1,7
108,2025-05-24T16:51:00+02:00,2025-05-25,00:51,2,0,2
132,2025-05-24T16:40:00+02:00,2025-05-25,00:40,3,2,5
132,2025-05-24T16:50:00+02:00,2025-05-25,00:50,3,2,5
133,2025-05-24T16:40:00+02:00,2025-05-25,00:40,5,3,8
162,2025-05-24T16:40:00+02:00,2025-05-25,00:40,2,0,2
162,2025-05-24T16:50:00+02:00,2025-05-25,00:50,5,2,7
167,2025-05-24T16:40:00+02:00,2025-05-25,00:40,1,0,1
179,2025-05-24T16:40:00+02:00,2025-05-25,00:40,2,0,2
179,2025-05-24T16:45:00+02:00,2025-05-25,00:45,5,0,5
1,2025-05-24T16:40:00+02:00,2025-05-25,00:40,4,1,5
1,2025-05-24T16:45:00+02:00,2025-05-25,00:45,0,1,1
1,2025-05-24T16:46:00+02:00,2025-05-25,00:46,0,2,2
1,2025-05-24T16:48:00+02:00,2025-05-25,00:48,2,3,5
1,2025-05-24T16:50:00+02:00,2025-05-25,00:50,0,5,5
1,2025-05-24T16:51:00+02:00,2025-05-25,00:51,2,1,3
1,2025-05-24T16:52:00+02:00,2025-05-25,00:52,0,11,11
1,2025-05-24T16:53:00+02:00,2025-05-25,00:53,2,0,2
2,2025-05-24T16:44:00+02:00,2025-05-25,00:44,0,2,2
2,2025-05-24T16:49:00+02:00,2025-05-25,00:49,1,2,3
2,2025-05-24T16:53:00+02:00,2025-05-25,00:53,7,4,11
9,2025-05-24T16:46:00+02:00,2025-05-25,00:46,1,0,1
17,2025-05-24T16:41:00+02:00,2025-05-25,00:41,1,0,1
17,2025-05-24T16:48:00+02:00,2025-05-25,00:48,2,0,2
17,2025-05-24T16:51:00+02:00,2025-05-25,00:51,4,1,5
17,2025-05-24T16:53:00+02:00,2025-05-25,00:53,2,8,10
18,2025-05-24T16:46:00+02:00,2025-05-25,00:46,2,0,2
19,2025-05-24T16:40:00+02:00,2025-05-25,00:40,6,9,15
19,2025-05-24T16:41:00+02:00,2025-05-25,00:41,2,0,2
19,2025-05-24T16:42:00+02:00,2025-05-25,00:42,2,0,2
19,2025-05-24T16:43:00+02:00,2025-05-25,00:43,1,7,8
19,2025-05-24T16:44:00+02:00,2025-05-25,00:44,0,5,5
19,2025-05-24T16:48:00+02:00,2025-05-25,00:48,1,5,6
19,2025-05-24T16:51:00+02:00,2025-05-25,00:51,7,6,13
19,2025-05-24T16:54:00+02:00,2025-05-25,00:54,1,10,11
20,2025-05-24T16:41:00+02:00,2025-05-25,00:41,1,3,4
20,2025-05-24T16:45:00+02:00,2025-05-25,00:45,4,1,5
20,2025-05-24T16:46:00+02:00,2025-05-25,00:46,1,4,5
20,2025-05-24T16:48:00+02:00,2025-05-25,00:48,0,10,10
20,2025-05-24T16:51:00+02:00,2025-05-25,00:51,4,5,9
20,2025-05-24T16:54:00+02:00,2025-05-25,00:54,1,8,9
23,2025-05-24T16:43:00+02:00,2025-05-25,00:43,0,1,1
23,2025-05-24T16:45:00+02:00,2025-05-25,00:45,0,1,1
23,2025-05-24T16:46:00+02:00,2025-05-25,00:46,0,1,1
23,2025-05-24T16:50:00+02:00,2025-05-25,00:50,0,4,4
24,2025-05-24T16:40:00+02:00,2025-05-25,00:40,1,5,6
24,2025-05-24T16:43:00+02:00,2025-05-25,00:43,2,0,2
24,2025-05-24T16:45:00+02:00,2025-05-25,00:45,1,5,6
24,2025-05-24T16:46:00+02:00,2025-05-25,00:46,1,5,6
24,2025-05-24T16:48:00+02:00,2025-05-25,00:48,1,6,7
24,2025-05-24T16:50:00+02:00,2025-05-25,00:50,0,3,3
24,2025-05-24T16:51:00+02:00,2025-05-25,00:51,1,4,5
24,2025-05-24T16:53:00+02:00,2025-05-25,00:53,0,1,1
25,2025-05-24T16:45:00+02:00,2025-05-25,00:45,11,3,14
25,2025-05-24T16:50:00+02:00,2025-05-25,00:50,0,15,15
30,2025-05-24T16:40:00+02:00,2025-05-25,00:40,4,14,18
30,2025-05-24T16:42:00+02:00,2025-05-25,00:42,3,5,8
30,2025-05-24T16:43:00+02:00,2025-05-25,00:43,1,10,11
30,2025-05-24T16:47:00+02:00,2025-05-25,00:47,3,5,8
30,2025-05-24T16:48:00+02:00,2025-05-25,00:48,6,1,7
30,2025-05-24T16:53:00+02:00,2025-05-25,00:53,3,5,8
35,2025-05-24T16:43:00+02:00,2025-05-25,00:43,0,1,1
35,2025-05-24T16:46:00+02:00,2025-05-25,00:46,0,5,5
35,2025-05-24T16:49:00+02:00,2025-05-25,00:49,1,2,3
35,2025-05-24T16:52:00+02:00,2025-05-25,00:52,0,1,1
49,2025-05-24T16:42:00+02:00,2025-05-25,00:42,1,3,4
49,2025-05-24T16:51:00+02:00,2025-05-25,00:51,1,2,3
51,2025-05-24T16:40:00+02:00,2025-05-25,00:40,0,1,1
51,2025-05-24T16:45:00+02:00,2025-05-25,00:45,2,0,2
51,2025-05-24T16:48:00+02:00,2025-05-25,00:48,0,2,2
51,2025-05-24T16:49:00+02:00,2025-05-25,00:49,0,3,3
52,2025-05-24T16:42:00+02:00,2025-05-25,00:42,7,0,7
52,2025-05-24T16:48:00+02:00,2025-05-25,00:48,6,1,7
53,2025-05-24T16:41:00+02:00,2025-05-25,00:41,0,2,2
53,2025-05-24T16:46:00+02:00,2025-05-25,00:46,2,1,3
53,2025-05-24T16:48:00+02:00,2025-05-25,00:48,0,1,1
53,2025-05-24T16:53:00+02:00,2025-05-25,00:53,2,3,5
56,2025-05-24T16:51:00+02:00,2025-05-25,00:51,3,0,3
56,2025-05-24T16:53:00+02:00,2025-05-25,00:53,1,0,1
58,2025-05-24T16:40:00+02:00,2025-05-25,00:40,6,1,7
58,2025-05-24T16:42:00+02:00,2025-05-25,00:42,1,2,3
58,2025-05-24T16:45:00+02:00,2025-05-25,00:45,13,6,19
58,2025-05-24T16:49:00+02:00,2025-05-25,00:49,3,10,13
58,2025-05-24T16:50:00+02:00,2025-05-25,00:50,0,4,4
58,2025-05-24T16:54:00+02:00,2025-05-25,00:54,0,6,6
62,2025-05-24T16:46:00+02:00,2025-05-25,00:46,2,0,2
62,2025-05-24T16:51:00+02:00,2025-05-25,00:51,1,2,3
62,2025-05-24T16:52:00+02:00,2025-05-25,00:52,1,0,1
63,2025-05-24T16:41:00+02:00,2025-05-25,00:41,1,1,2
63,2025-05-24T16:44:00+02:00,2025-05-25,00:44,1,0,1
63,2025-05-24T16:46:00+02:00,2025-05-25,00:46,1,4,5
63,2025-05-24T16:50:00+02:00,2025-05-25,00:50,0,2,2
63,2025-05-24T16:52:00+02:00,2025-05-25,00:52,0,1,1
63,2025-05-24T16:54:00+02:00,2025-05-25,00:54,0,1,1
67,2025-05-24T16:45:00+02:00,2025-05-25,00:45,0,1,1
67,2025-05-24T16:49:00+02:00,2025-05-25,00:49,3,3,6
67,2025-05-24T16:50:00+02:00,2025-05-25,00:50,0,2,2
67,2025-05-24T16:53:00+02:00,2025-05-25,00:53,1,0,1
68,2025-05-24T16:42:00+02:00,2025-05-25,00:42,0,1,1
68,2025-05-24T16:50:00+02:00,2025-05-25,00:50,0,1,1
68,2025-05-24T16:51:00+02:00,2025-05-25,00:51,2,0,2
72,2025-05-24T16:52:00+02:00,2025-05-25,00:52,0,1,1
79,2025-05-24T16:40:00+02:00,2025-05-25,00:40,2,0,2
79,2025-05-24T16:44:00+02:00,2025-05-25,00:44,2,0,2
79,2025-05-24T16:47:00+02:00,2025-05-25,00:47,0,3,3
79,2025-05-24T16:52:00+02:00,2025-05-25,00:52,1,0,1
139,2025-05-24T16:45:00+02:00,2025-05-25,00:45,1,2,3
139,2025-05-24T16:50:00+02:00,2025-05-25,00:50,1,0,1
141,2025-05-24T16:40:00+02:00,2025-05-25,00:40,21,6,27
141,2025-05-24T16:50:00+02:00,2025-05-25,00:50,1,3,4
142,2025-05-24T16:45:00+02:00,2025-05-25,00:45,0,1,1
164,2025-05-24T16:45:00+02:00,2025-05-25,00:45,2,0,2
181,2025-05-24T16:56:00+02:00,2025-05-25,00:56,0,1,1
181,2025-05-24T16:58:00+02:00,2025-05-25,00:58,2,3,5
181,2025-05-24T17:03:00+02:00,2025-05-25,01:03,3,6,9
181,2025-05-24T17:05:00+02:00,2025-05-25,01:05,4,5,9
181,2025-05-24T17:08:00+02:00,2025-05-25,01:08,11,1,12
181,2025-05-24T17:09:00+02:00,2025-05-25,01:09,4,1,5
3,2025-05-24T16:58:00+02:00,2025-05-25,00:58,3,2,5
3,2025-05-24T17:02:00+02:00,2025-05-25,01:02,1,10,11
3,2025-05-24T17:04:00+02:00,2025-05-25,01:04,7,1,8
3,2025-05-24T17:05:00+02:00,2025-05-25,01:05,8,2,10
3,2025-05-24T17:07:00+02:00,2025-05-25,01:07,1,2,3
4,2025-05-24T16:55:00+02:00,2025-05-25,00:55,8,4,12
4,2025-05-24T17:03:00+02:00,2025-05-25,01:03,4,15,19
4,2025-05-24T17:06:00+02:00,2025-05-25,01:06,1,16,17
4,2025-05-24T17:07:00+02:00,2025-05-25,01:07,0,4,4
6,2025-05-24T16:55:00+02:00,2025-05-25,00:55,1,0,1
6,2025-05-24T16:58:00+02:00,2025-05-25,00:58,8,1,9
6,2025-05-24T17:01:00+02:00,2025-05-25,01:01,3,2,5
6,2025-05-24T17:07:00+02:00,2025-05-25,01:07,5,3,8
28,2025-05-24T16:57:00+02:00,2025-05-25,00:57,2,0,2
28,2025-05-24T17:04:00+02:00,2025-05-25,01:04,0,1,1
28,2025-05-24T17:06:00+02:00,2025-05-25,01:06,1,0,1
29,2025-05-24T16:55:00+02:00,2025-05-25,00:55,0,1,1
29,2025-05-24T16:57:00+02:00,2025-05-25,00:57,1,0,1
29,2025-05-24T17:08:00+02:00,2025-05-25,01:08,0,1,1
31,2025-05-24T16:59:00+02:00,2025-05-25,00:59,0,2,2
31,2025-05-24T17:01:00+02:00,2025-05-25,01:01,0,1,1
31,2025-05-24T17:09:00+02:00,2025-05-25,01:09,1,0,1
36,2025-05-24T16:55:00+02:00,2025-05-25,00:55,1,3,4
36,2025-05-24T16:57:00+02:00,2025-05-25,00:57,3,1,4
36,2025-05-24T17:00:00+02:00,2025-05-25,01:00,6,2,8
36,2025-05-24T17:02:00+02:00,2025-05-25,01:02,5,2,7
36,2025-05-24T17:04:00+02:00,2025-05-25,01:04,4,3,7
36,2025-05-24T17:05:00+02:00,2025-05-25,01:05,0,5,5
36,2025-05-24T17:06:00+02:00,2025-05-25,01:06,10,3,13
36,2025-05-24T17:07:00+02:00,2025-05-25,01:07,6,1,7
37,2025-05-24T16:55:00+02:00,2025-05-25,00:55,2,0,2
37,2025-05-24T16:58:00+02:00,2025-05-25,00:58,1,0,1
39,2025-05-24T17:06:00+02:00,2025-05-25,01:06,1,0,1
39,2025-05-24T17:08:00+02:00,2025-05-25,01:08,3,1,4
40,2025-05-24T16:55:00+02:00,2025-05-25,00:55,0,3,3
40,2025-05-24T17:01:00+02:00,2025-05-25,01:01,3,0,3
40,2025-05-24T17:04:00+02:00,2025-05-25,01:04,1,0,1
40,2025-05-24T17:07:00+02:00,2025-05-25,01:07,1,0,1
40,2025-05-24T17:08:00+02:00,2025-05-25,01:08,3,1,4
41,2025-05-24T16:58:00+02:00,2025-05-25,00:58,0,3,3
41,2025-05-24T16:59:00+02:00,2025-05-25,00:59,0,2,2
41,2025-05-24T17:05:00+02:00,2025-05-25,01:05,0,7,7
44,2025-05-24T17:05:00+02:00,2025-05-25,01:05,3,0,3
45,2025-05-24T17:07:00+02:00,2025-05-25,01:07,0,4,4
45,2025-05-24T17:08:00+02:00,2025-05-25,01:08,0,6,6
47,2025-05-24T16:58:00+02:00,2025-05-25,00:58,0,7,7
47,2025-05-24T17:01:00+02:00,2025-05-25,01:01,0,6,6
47,2025-05-24T17:06:00+02:00,2025-05-25,01:06,2,0,2
47,2025-05-24T17:07:00+02:00,2025-05-25,01:07,2,1,3
47,2025-05-24T17:08:00+02:00,2025-05-25,01:08,0,3,3
50,2025-05-24T17:01:00+02:00,2025-05-25,01:01,1,0,1
54,2025-05-24T17:06:00+02:00,2025-05-25,01:06,1,0,1
54,2025-05-24T17:07:00+02:00,2025-05-25,01:07,1,0,1
54,2025-05-24T17:08:00+02:00,2025-05-25,01:08,2,0,2
59,2025-05-24T17:00:00+02:00,2025-05-25,01:00,3,6,9
59,2025-05-24T17:05:00+02:00,2025-05-25,01:05,7,5,12
61,2025-05-24T16:58:00+02:00,2025-05-25,00:58,4,0,4
61,2025-05-24T17:08:00+02:00,2025-05-25,01:08,2,2,4
66,2025-05-24T16:55:00+02:00,2025-05-25,00:55,1,7,8
66,2025-05-24T16:59:00+02:00,2025-05-25,00:59,1,4,5
66,2025-05-24T17:01:00+02:00,2025-05-25,01:01,3,2,5
66,2025-05-24T17:04:00+02:00,2025-05-25,01:04,1,4,5
70,2025-05-24T17:04:00+02:00,2025-05-25,01:04,1,0,1
70,2025-05-24T17:09:00+02:00,2025-05-25,01:09,0,1,1
77,2025-05-24T17:00:00+02:00,2025-05-25,01:00,2,1,3
84,2025-05-24T17:00:00+02:00,2025-05-25,01:00,8,6,14
87,2025-05-24T16:57:00+02:00,2025-05-25,00:57,1,2,3
107,2025-05-24T17:00:00+02:00,2025-05-25,01:00,2,0,2
108,2025-05-24T16:57:00+02:00,2025-05-25,00:57,0,2,2
108,2025-05-24T17:01:00+02:00,2025-05-25,01:01,1,0,1
108,2025-05-24T17:04:00+02:00,2025-05-25,01:04,2,0,2
108,2025-05-24T17:08:00+02:00,2025-05-25,01:08,1,9,10
131,2025-05-24T16:55:00+02:00,2025-05-25,00:55,7,13,20
132,2025-05-24T17:05:00+02:00,2025-05-25,01:05,4,4,8
133,2025-05-24T16:55:00+02:00,2025-05-25,00:55,2,2,4
133,2025-05-24T17:00:00+02:00,2025-05-25,01:00,1,1,2
162,2025-05-24T16:55:00+02:00,2025-05-25,00:55,3,1,4
167,2025-05-24T16:55:00+02:00,2025-05-25,00:55,2,0,2
1,2025-05-24T16:55:00+02:00,2025-05-25,00:55,3,6,9
1,2025-05-24T16:57:00+02:00,2025-05-25,00:57,0,4,4
1,2025-05-24T17:03:00+02:00,2025-05-25,01:03,0,1,1
12,2025-05-24T16:57:00+02:00,2025-05-25,00:57,1,0,1
12,2025-05-24T17:05:00+02:00,2025-05-25,01:05,0,1,1
17,2025-05-24T16:55:00+02:00,2025-05-25,00:55,1,0,1
17,2025-05-24T16:56:00+02:00,2025-05-25,00:56,0,1,1
18,2025-05-24T17:04:00+02:00,2025-05-25,01:04,1,0,1
19,2025-05-24T16:55:00+02:00,2025-05-25,00:55,4,0,4
20,2025-05-24T16:55:00+02:00,2025-05-25,00:55,4,4,8
20,2025-05-24T17:01:00+02:00,2025-05-25,01:01,4,6,10
20,2025-05-24T17:03:00+02:00,2025-05-25,01:03,3,1,4
20,2025-05-24T17:04:00+02:00,2025-05-25,01:04,0,2,2
20,2025-05-24T17:07:00+02:00,2025-05-25,01:07,3,12,15
23,2025-05-24T17:05:00+02:00,2025-05-25,01:05,0,2,2
24,2025-05-24T16:58:00+02:00,2025-05-25,00:58,1,3,4
24,2025-05-24T17:08:00+02:00,2025-05-25,01:08,1,0,1
24,2025-05-24T17:09:00+02:00,2025-05-25,01:09,0,2,2
25,2025-05-24T16:55:00+02:00,2025-05-25,00:55,1,9,10
25,2025-05-24T17:00:00+02:00,2025-05-25,01:00,8,7,15
27,2025-05-24T16:59:00+02:00,2025-05-25,00:59,1,0,1
30,2025-05-24T16:55:00+02:00,2025-05-25,00:55,4,4,8
30,2025-05-24T16:56:00+02:00,2025-05-25,00:56,12,2,14
30,2025-05-24T16:57:00+02:00,2025-05-25,00:57,7,9,16
30,2025-05-24T17:03:00+02:00,2025-05-25,01:03,1,0,1
30,2025-05-24T17:04:00+02:00,2025-05-25,01:04,1,13,14
30,2025-05-24T17:05:00+02:00,2025-05-25,01:05,13,1,14
30,2025-05-24T17:06:00+02:00,2025-05-25,01:06,5,4,9
35,2025-05-24T16:57:00+02:00,2025-05-25,00:57,0,6,6
35,2025-05-24T17:02:00+02:00,2025-05-25,01:02,0,7,7
35,2025-05-24T17:03:00+02:00,2025-05-25,01:03,1,1,2
35,2025-05-24T17:04:00+02:00,2025-05-25,01:04,5,2,7
35,2025-05-24T17:05:00+02:00,2025-05-25,01:05,3,1,4
35,2025-05-24T17:06:00+02:00,2025-05-25,01:06,1,1,2
35,2025-05-24T17:07:00+02:00,2025-05-25,01:07,1,8,9
49,2025-05-24T16:58:00+02:00,2025-05-25,00:58,1,0,1
49,2025-05-24T17:00:00+02:00,2025-05-25,01:00,0,3,3
51,2025-05-24T16:57:00+02:00,2025-05-25,00:57,1,0,1
51,2025-05-24T17:02:00+02:00,2025-05-25,01:02,1,0,1
52,2025-05-24T16:55:00+02:00,2025-05-25,00:55,2,4,6
52,2025-05-24T17:01:00+02:00,2025-05-25,01:01,0,1,1
52,2025-05-24T17:03:00+02:00,2025-05-25,01:03,14,1,15
52,2025-05-24T17:07:00+02:00,2025-05-25,01:07,4,0,4
53,2025-05-24T16:55:00+02:00,2025-05-25,00:55,5,1,6
53,2025-05-24T17:01:00+02:00,2025-05-25,01:01,0,2,2
53,2025-05-24T17:03:00+02:00,2025-05-25,01:03,0,1,1
56,2025-05-24T16:55:00+02:00,2025-05-25,00:55,0,1,1
56,2025-05-24T16:57:00+02:00,2025-05-25,00:57,0,1,1
56,2025-05-24T16:58:00+02:00,2025-05-25,00:58,1,1,2
56,2025-05-24T16:59:00+02:00,2025-05-25,00:59,1,2,3
58,2025-05-24T16:58:00+02:00,2025-05-25,00:58,0,14,14
58,2025-05-24T17:00:00+02:00,2025-05-25,01:00,2,5,7
62,2025-05-24T16:57:00+02:00,2025-05-25,00:57,3,4,7
62,2025-05-24T17:00:00+02:00,2025-05-25,01:00,2,0,2
62,2025-05-24T17:03:00+02:00,2025-05-25,01:03,4,1,5
62,2025-05-24T17:06:00+02:00,2025-05-25,01:06,2,0,2
62,2025-05-24T17:07:00+02:00,2025-05-25,01:07,2,0,2
63,2025-05-24T16:58:00+02:00,2025-05-25,00:58,0,1,1
63,2025-05-24T17:09:00+02:00,2025-05-25,01:09,0,3,3
67,2025-05-24T16:57:00+02:00,2025-05-25,00:57,1,0,1
67,2025-05-24T17:05:00+02:00,2025-05-25,01:05,1,4,5
67,2025-05-24T17:09:00+02:00,2025-05-25,01:09,2,1,3
72,2025-05-24T16:58:00+02:00,2025-05-25,00:58,0,2,2
72,2025-05-24T17:03:00+02:00,2025-05-25,01:03,0,3,3
72,2025-05-24T17:07:00+02:00,2025-05-25,01:07,1,0,1
76,2025-05-24T17:08:00+02:00,2025-05-25,01:08,0,1,1
79,2025-05-24T16:57:00+02:00,2025-05-25,00:57,5,1,6
79,2025-05-24T17:02:00+02:00,2025-05-25,01:02,1,4,5
79,2025-05-24T17:04:00+02:00,2025-05-25,01:04,1,0,1
109,2025-05-24T17:00:00+02:00,2025-05-25,01:00,0,1,1
117,2025-05-24T16:55:00+02:00,2025-05-25,00:55,5,4,9
117,2025-05-24T17:05:00+02:00,2025-05-25,01:05,6,1,7
164,2025-05-24T17:00:00+02:00,2025-05-25,01:00,1,0,1
181,2025-05-24T17:18:00+02:00,2025-05-25,01:18,3,0,3
181,2025-05-24T17:20:00+02:00,2025-05-25,01:20,1,0,1
181,2025-05-24T17:23:00+02:00,2025-05-25,01:23,4,2,6
182,2025-05-24T17:20:00+02:00,2025-05-25,01:20,9,3,12
3,2025-05-24T17:11:00+02:00,2025-05-25,01:11,2,5,7
3,2025-05-24T17:12:00+02:00,2025-05-25,01:12,4,12,16
3,2025-05-24T17:15:00+02:00,2025-05-25,01:15,0,9,9
3,2025-05-24T17:18:00+02:00,2025-05-25,01:18,4,4,8
3,2025-05-24T17:22:00+02:00,2025-05-25,01:22,0,3,3
4,2025-05-24T17:12:00+02:00,2025-05-25,01:12,1,2,3
4,2025-05-24T17:16:00+02:00,2025-05-25,01:16,5,2,7
4,2025-05-24T17:18:00+02:00,2025-05-25,01:18,5,6,11
4,2025-05-24T17:21:00+02:00,2025-05-25,01:21,4,5,9
4,2025-05-24T17:22:00+02:00,2025-05-25,01:22,6,2,8
4,2025-05-24T17:23:00+02:00,2025-05-25,01:23,3,6,9
6,2025-05-24T17:19:00+02:00,2025-05-25,01:19,4,3,7
6,2025-05-24T17:20:00+02:00,2025-05-25,01:20,5,0,5
6,2025-05-24T17:21:00+02:00,2025-05-25,01:21,4,4,8
6,2025-05-24T17:23:00+02:00,2025-05-25,01:23,2,2,4
6,2025-05-24T17:24:00+02:00,2025-05-25,01:24,3,0,3
28,2025-05-24T17:16:00+02:00,2025-05-25,01:16,2,0,2
28,2025-05-24T17:24:00+02:00,2025-05-25,01:24,1,0,1
29,2025-05-24T17:12:00+02:00,2025-05-25,01:12,0,1,1
29,2025-05-24T17:19:00+02:00,2025-05-25,01:19,0,1,1
29,2025-05-24T17:24:00+02:00,2025-05-25,01:24,1,1,2
31,2025-05-24T17:23:00+02:00,2025-05-25,01:23,1,0,1
36,2025-05-24T17:15:00+02:00,2025-05-25,01:15,5,6,11
36,2025-05-24T17:16:00+02:00,2025-05-25,01:16,3,2,5
36,2025-05-24T17:17:00+02:00,2025-05-25,01:17,5,2,7
36,2025-05-24T17:21:00+02:00,2025-05-25,01:21,0,5,5
36,2025-05-24T17:22:00+02:00,2025-05-25,01:22,8,2,10
36,2025-05-24T17:23:00+02:00,2025-05-25,01:23,0,1,1
37,2025-05-24T17:23:00+02:00,2025-05-25,01:23,0,2,2
39,2025-05-24T17:12:00+02:00,2025-05-25,01:12,0,1,1
40,2025-05-24T17:17:00+02:00,2025-05-25,01:17,2,0,2
41,2025-05-24T17:10:00+02:00,2025-05-25,01:10,1,4,5
41,2025-05-24T17:17:00+02:00,2025-05-25,01:17,4,9,13
41,2025-05-24T17:19:00+02:00,2025-05-25,01:19,3,0,3
41,2025-05-24T17:20:00+02:00,2025-05-25,01:20,0,1,1
45,2025-05-24T17:11:00+02:00,2025-05-25,01:11,2,4,6
45,2025-05-24T17:12:00+02:00,2025-05-25,01:12,2,8,10
45,2025-05-24T17:13:00+02:00,2025-05-25,01:13,1,10,11
45,2025-05-24T17:15:00+02:00,2025-05-25,01:15,0,2,2
45,2025-05-24T17:23:00+02:00,2025-05-25,01:23,1,2,3
47,2025-05-24T17:11:00+02:00,2025-05-25,01:11,0,1,1
47,2025-05-24T17:12:00+02:00,2025-05-25,01:12,0,1,1
47,2025-05-24T17:13:00+02:00,2025-05-25,01:13,0,3,3
47,2025-05-24T17:21:00+02:00,2025-05-25,01:21,1,1,2
47,2025-05-24T17:22:00+02:00,2025-05-25,01:22,1,0,1
50,2025-05-24T17:17:00+02:00,2025-05-25,01:17,3,0,3
59,2025-05-24T17:15:00+02:00,2025-05-25,01:15,4,0,4
61,2025-05-24T17:11:00+02:00,2025-05-25,01:11,1,0,1
61,2025-05-24T17:15:00+02:00,2025-05-25,01:15,1,0,1
61,2025-05-24T17:17:00+02:00,2025-05-25,01:17,0,1,1
61,2025-05-24T17:24:00+02:00,2025-05-25,01:24,2,1,3
66,2025-05-24T17:12:00+02:00,2025-05-25,01:12,0,1,1
66,2025-05-24T17:19:00+02:00,2025-05-25,01:19,0,1,1
66,2025-05-24T17:24:00+02:00,2025-05-25,01:24,7,5,12
69,2025-05-24T17:16:00+02:00,2025-05-25,01:16,0,3,3
69,2025-05-24T17:18:00+02:00,2025-05-25,01:18,1,0,1
70,2025-05-24T17:21:00+02:00,2025-05-25,01:21,6,0,6
71,2025-05-24T17:11:00+02:00,2025-05-25,01:11,2,0,2
75,2025-05-24T17:13:00+02:00,2025-05-25,01:13,0,3,3
108,2025-05-24T17:12:00+02:00,2025-05-25,01:12,0,1,1
108,2025-05-24T17:14:00+02:00,2025-05-25,01:14,2,0,2
108,2025-05-24T17:18:00+02:00,2025-05-25,01:18,6,1,7
108,2025-05-24T17:21:00+02:00,2025-05-25,01:21,3,1,4
131,2025-05-24T17:10:00+02:00,2025-05-25,01:10,3,17,20
132,2025-05-24T17:10:00+02:00,2025-05-25,01:10,1,1,2
133,2025-05-24T17:15:00+02:00,2025-05-25,01:15,3,6,9
134,2025-05-24T17:10:00+02:00,2025-05-25,01:10,6,1,7
134,2025-05-24T17:15:00+02:00,2025-05-25,01:15,4,4,8
134,2025-05-24T17:20:00+02:00,2025-05-25,01:20,5,1,6
135,2025-05-24T17:20:00+02:00,2025-05-25,01:20,8,4,12
165,2025-05-24T17:15:00+02:00,2025-05-25,01:15,1,0,1
179,2025-05-24T17:15:00+02:00,2025-05-25,01:15,2,3,5
1,2025-05-24T17:11:00+02:00,2025-05-25,01:11,4,1,5
1,2025-05-24T17:16:00+02:00,2025-05-25,01:16,0,7,7
1,2025-05-24T17:21:00+02:00,2025-05-25,01:21,1,0,1
2,2025-05-24T17:11:00+02:00,2025-05-25,01:11,2,0,2
2,2025-05-24T17:12:00+02:00,2025-05-25,01:12,3,0,3
2,2025-05-24T17:14:00+02:00,2025-05-25,01:14,0,2,2
2,2025-05-24T17:22:00+02:00,2025-05-25,01:22,0,1,1
11,2025-05-24T17:20:00+02:00,2025-05-25,01:20,1,0,1
18,2025-05-24T17:23:00+02:00,2025-05-25,01:23,1,0,1
19,2025-05-24T17:10:00+02:00,2025-05-25,01:10,2,8,10
19,2025-05-24T17:12:00+02:00,2025-05-25,01:12,1,0,1
19,2025-05-24T17:16:00+02:00,2025-05-25,01:16,0,6,6
19,2025-05-24T17:17:00+02:00,2025-05-25,01:17,2,0,2
19,2025-05-24T17:19:00+02:00,2025-05-25,01:19,7,5,12
19,2025-05-24T17:20:00+02:00,2025-05-25,01:20,2,4,6
19,2025-05-24T17:24:00+02:00,2025-05-25,01:24,2,5,7
20,2025-05-24T17:12:00+02:00,2025-05-25,01:12,0,6,6
20,2025-05-24T17:15:00+02:00,2025-05-25,01:15,2,3,5
20,2025-05-24T17:16:00+02:00,2025-05-25,01:16,7,6,13
20,2025-05-24T17:22:00+02:00,2025-05-25,01:22,2,1,3
20,2025-05-24T17:24:00+02:00,2025-05-25,01:24,0,5,5
23,2025-05-24T17:12:00+02:00,2025-05-25,01:12,0,1,1
24,2025-05-24T17:11:00+02:00,2025-05-25,01:11,1,2,3
24,2025-05-24T17:13:00+02:00,2025-05-25,01:13,1,2,3
24,2025-05-24T17:14:00+02:00,2025-05-25,01:14,4,0,4
24,2025-05-24T17:18:00+02:00,2025-05-25,01:18,0,4,4
24,2025-05-24T17:21:00+02:00,2025-05-25,01:21,1,1,2
24,2025-05-24T17:23:00+02:00,2025-05-25,01:23,0,16,16
24,2025-05-24T17:24:00+02:00,2025-05-25,01:24,1,2,3
25,2025-05-24T17:10:00+02:00,2025-05-25,01:10,2,0,2
25,2025-05-24T17:20:00+02:00,2025-05-25,01:20,2,3,5
27,2025-05-24T17:15:00+02:00,2025-05-25,01:15,0,2,2
27,2025-05-24T17:17:00+02:00,2025-05-25,01:17,1,0,1
30,2025-05-24T17:13:00+02:00,2025-05-25,01:13,11,5,16
30,2025-05-24T17:14:00+02:00,2025-05-25,01:14,14,6,20
30,2025-05-24T17:15:00+02:00,2025-05-25,01:15,6,6,12
30,2025-05-24T17:20:00+02:00,2025-05-25,01:20,3,1,4
30,2025-05-24T17:21:00+02:00,2025-05-25,01:21,1,2,3
30,2025-05-24T17:22:00+02:00,2025-05-25,01:22,4,2,6
35,2025-05-24T17:13:00+02:00,2025-05-25,01:13,2,1,3
35,2025-05-24T17:20:00+02:00,2025-05-25,01:20,0,3,3
49,2025-05-24T17:18:00+02:00,2025-05-25,01:18,2,0,2
49,2025-05-24T17:19:00+02:00,2025-05-25,01:19,2,0,2
49,2025-05-24T17:22:00+02:00,2025-05-25,01:22,0,3,3
52,2025-05-24T17:15:00+02:00,2025-05-25,01:15,11,7,18
52,2025-05-24T17:17:00+02:00,2025-05-25,01:17,5,19,24
52,2025-05-24T17:18:00+02:00,2025-05-25,01:18,3,1,4
52,2025-05-24T17:21:00+02:00,2025-05-25,01:21,0,4,4
53,2025-05-24T17:14:00+02:00,2025-05-25,01:14,6,0,6
53,2025-05-24T17:19:00+02:00,2025-05-25,01:19,1,1,2
53,2025-05-24T17:20:00+02:00,2025-05-25,01:20,2,0,2
53,2025-05-24T17:22:00+02:00,2025-05-25,01:22,2,0,2
56,2025-05-24T17:11:00+02:00,2025-05-25,01:11,2,0,2
56,2025-05-24T17:13:00+02:00,2025-05-25,01:13,7,0,7
56,2025-05-24T17:15:00+02:00,2025-05-25,01:15,0,3,3
56,2025-05-24T17:17:00+02:00,2025-05-25,01:17,0,3,3
56,2025-05-24T17:19:00+02:00,2025-05-25,01:19,0,2,2
58,2025-05-24T17:13:00+02:00,2025-05-25,01:13,0,1,1
58,2025-05-24T17:15:00+02:00,2025-05-25,01:15,9,3,12
58,2025-05-24T17:19:00+02:00,2025-05-25,01:19,0,1,1
58,2025-05-24T17:24:00+02:00,2025-05-25,01:24,1,0,1
62,2025-05-24T17:19:00+02:00,2025-05-25,01:19,0,2,2
67,2025-05-24T17:10:00+02:00,2025-05-25,01:10,2,2,4
67,2025-05-24T17:16:00+02:00,2025-05-25,01:16,1,0,1
67,2025-05-24T17:18:00+02:00,2025-05-25,01:18,1,0,1
68,2025-05-24T17:14:00+02:00,2025-05-25,01:14,1,2,3
68,2025-05-24T17:16:00+02:00,2025-05-25,01:16,0,1,1
72,2025-05-24T17:11:00+02:00,2025-05-25,01:11,0,1,1
72,2025-05-24T17:15:00+02:00,2025-05-25,01:15,0,1,1
79,2025-05-24T17:12:00+02:00,2025-05-25,01:12,0,1,1
79,2025-05-24T17:13:00+02:00,2025-05-25,01:13,1,2,3
79,2025-05-24T17:18:00+02:00,2025-05-25,01:18,1,2,3
79,2025-05-24T17:20:00+02:00,2025-05-25,01:20,6,1,7
79,2025-05-24T17:21:00+02:00,2025-05-25,01:21,1,1,2
136,2025-05-24T17:10:00+02:00,2025-05-25,01:10,0,1,1
139,2025-05-24T17:10:00+02:00,2025-05-25,01:10,0,2,2
139,2025-05-24T17:20:00+02:00,2025-05-25,01:20,1,0,1
141,2025-05-24T17:10:00+02:00,2025-05-25,01:10,0,5,5
181,2025-05-24T17:25:00+02:00,2025-05-25,01:25,2,3,5
181,2025-05-24T17:26:00+02:00,2025-05-25,01:26,1,1,2
181,2025-05-24T17:29:00+02:00,2025-05-25,01:29,1,2,3
181,2025-05-24T17:31:00+02:00,2025-05-25,01:31,0,1,1
181,2025-05-24T17:33:00+02:00,2025-05-25,01:33,6,1,7
181,2025-05-24T17:34:00+02:00,2025-05-25,01:34,8,1,9
181,2025-05-24T17:36:00+02:00,2025-05-25,01:36,1,6,7
181,2025-05-24T18:40:00+02:00,2025-05-25,02:40,2,1,3
181,2025-05-24T18:42:00+02:00,2025-05-25,02:42,2,0,2
181,2025-05-24T18:43:00+02:00,2025-05-25,02:43,0,1,1
181,2025-05-24T18:51:00+02:00,2025-05-25,02:51,2,0,2
181,2025-05-24T18:52:00+02:00,2025-05-25,02:52,1,0,1
182,2025-05-24T18:40:00+02:00,2025-05-25,02:40,16,15,31
3,2025-05-24T18:42:00+02:00,2025-05-25,02:42,1,3,4
3,2025-05-24T18:46:00+02:00,2025-05-25,02:46,2,1,3
3,2025-05-24T18:50:00+02:00,2025-05-25,02:50,0,6,6
4,2025-05-24T18:41:00+02:00,2025-05-25,02:41,1,1,2
5,2025-05-24T18:40:00+02:00,2025-05-25,02:40,2,14,16
6,2025-05-24T18:43:00+02:00,2025-05-25,02:43,2,3,5
6,2025-05-24T18:45:00+02:00,2025-05-25,02:45,1,0,1
6,2025-05-24T18:46:00+02:00,2025-05-25,02:46,2,7,9
28,2025-05-24T18:48:00+02:00,2025-05-25,02:48,2,0,2
29,2025-05-24T18:40:00+02:00,2025-05-25,02:40,0,2,2
31,2025-05-24T18:42:00+02:00,2025-05-25,02:42,1,0,1
36,2025-05-24T18:41:00+02:00,2025-05-25,02:41,1,1,2
36,2025-05-24T18:44:00+02:00,2025-05-25,02:44,1,0,1
36,2025-05-24T18:45:00+02:00,2025-05-25,02:45,5,5,10
36,2025-05-24T18:47:00+02:00,2025-05-25,02:47,3,0,3
36,2025-05-24T18:51:00+02:00,2025-05-25,02:51,0,9,9
36,2025-05-24T18:54:00+02:00,2025-05-25,02:54,0,4,4
40,2025-05-24T18:46:00+02:00,2025-05-25,02:46,1,0,1
41,2025-05-24T18:40:00+02:00,2025-05-25,02:40,1,1,2
41,2025-05-24T18:44:00+02:00,2025-05-25,02:44,4,0,4
41,2025-05-24T18:47:00+02:00,2025-05-25,02:47,0,1,1
41,2025-05-24T18:50:00+02:00,2025-05-25,02:50,0,4,4
41,2025-05-24T18:52:00+02:00,2025-05-25,02:52,0,4,4
41,2025-05-24T18:53:00+02:00,2025-05-25,02:53,0,2,2
43,2025-05-24T18:45:00+02:00,2025-05-25,02:45,1,0,1
44,2025-05-24T18:45:00+02:00,2025-05-25,02:45,1,0,1
45,2025-05-24T18:44:00+02:00,2025-05-25,02:44,0,4,4
45,2025-05-24T18:46:00+02:00,2025-05-25,02:46,0,2,2
45,2025-05-24T18:47:00+02:00,2025-05-25,02:47,0,1,1
45,2025-05-24T18:49:00+02:00,2025-05-25,02:49,0,7,7
45,2025-05-24T18:50:00+02:00,2025-05-25,02:50,1,0,1
45,2025-05-24T18:52:00+02:00,2025-05-25,02:52,0,1,1
45,2025-05-24T18:53:00+02:00,2025-05-25,02:53,0,6,6
47,2025-05-24T18:41:00+02:00,2025-05-25,02:41,1,0,1
47,2025-05-24T18:42:00+02:00,2025-05-25,02:42,0,2,2
47,2025-05-24T18:43:00+02:00,2025-05-25,02:43,0,2,2
47,2025-05-24T18:45:00+02:00,2025-05-25,02:45,0,1,1
47,2025-05-24T18:47:00+02:00,2025-05-25,02:47,0,5,5
47,2025-05-24T18:51:00+02:00,2025-05-25,02:51,1,0,1
47,2025-05-24T18:52:00+02:00,2025-05-25,02:52,0,1,1
54,2025-05-24T18:40:00+02:00,2025-05-25,02:40,0,2,2
59,2025-05-24T18:40:00+02:00,2025-05-25,02:40,12,4,16
61,2025-05-24T18:49:00+02:00,2025-05-25,02:49,0,1,1
61,2025-05-24T18:52:00+02:00,2025-05-25,02:52,0,1,1
61,2025-05-24T18:54:00+02:00,2025-05-25,02:54,1,0,1
66,2025-05-24T18:43:00+02:00,2025-05-25,02:43,8,2,10
66,2025-05-24T18:44:00+02:00,2025-05-25,02:44,7,0,7
66,2025-05-24T18:49:00+02:00,2025-05-25,02:49,4,0,4
66,2025-05-24T18:51:00+02:00,2025-05-25,02:51,0,1,1
69,2025-05-24T18:40:00+02:00,2025-05-25,02:40,0,1,1
69,2025-05-24T18:49:00+02:00,2025-05-25,02:49,0,1,1
70,2025-05-24T18:41:00+02:00,2025-05-25,02:41,2,0,2
108,2025-05-24T18:45:00+02:00,2025-05-25,02:45,0,1,1
108,2025-05-24T18:46:00+02:00,2025-05-25,02:46,5,2,7
108,2025-05-24T18:50:00+02:00,2025-05-25,02:50,1,0,1
132,2025-05-24T18:50:00+02:00,2025-05-25,02:50,4,0,4
1,2025-05-24T18:49:00+02:00,2025-05-25,02:49,6,0,6
2,2025-05-24T18:48:00+02:00,2025-05-25,02:48,1,0,1
2,2025-05-24T18:51:00+02:00,2025-05-25,02:51,0,1,1
9,2025-05-24T18:52:00+02:00,2025-05-25,02:52,0,2,2
10,2025-05-24T18:46:00+02:00,2025-05-25,02:46,0,2,2
10,2025-05-24T18:48:00+02:00,2025-05-25,02:48,0,2,2
10,2025-05-24T18:54:00+02:00,2025-05-25,02:54,1,0,1
11,2025-05-24T18:45:00+02:00,2025-05-25,02:45,0,2,2
12,2025-05-24T18:54:00+02:00,2025-05-25,02:54,0,1,1
17,2025-05-24T18:43:00+02:00,2025-05-25,02:43,0,2,2
19,2025-05-24T18:40:00+02:00,2025-05-25,02:40,1,2,3
19,2025-05-24T18:50:00+02:00,2025-05-25,02:50,2,4,6
19,2025-05-24T18:53:00+02:00,2025-05-25,02:53,1,1,2
19,2025-05-24T18:54:00+02:00,2025-05-25,02:54,0,2,2
20,2025-05-24T18:40:00+02:00,2025-05-25,02:40,4,1,5
20,2025-05-24T18:48:00+02:00,2025-05-25,02:48,1,0,1
20,2025-05-24T18:49:00+02:00,2025-05-25,02:49,0,4,4
20,2025-05-24T18:50:00+02:00,2025-05-25,02:50,0,4,4
20,2025-05-24T18:52:00+02:00,2025-05-25,02:52,2,2,4
20,2025-05-24T18:53:00+02:00,2025-05-25,02:53,0,7,7
20,2025-05-24T18:54:00+02:00,2025-05-25,02:54,3,5,8
24,2025-05-24T18:45:00+02:00,2025-05-25,02:45,0,1,1
24,2025-05-24T18:46:00+02:00,2025-05-25,02:46,0,1,1
24,2025-05-24T18:52:00+02:00,2025-05-25,02:52,2,0,2
25,2025-05-24T18:45:00+02:00,2025-05-25,02:45,4,0,4
30,2025-05-24T18:40:00+02:00,2025-05-25,02:40,4,3,7
30,2025-05-24T18:41:00+02:00,2025-05-25,02:41,3,0,3
30,2025-05-24T18:44:00+02:00,2025-05-25,02:44,8,8,16
30,2025-05-24T18:54:00+02:00,2025-05-25,02:54,4,0,4
35,2025-05-24T18:42:00+02:00,2025-05-25,02:42,2,0,2
35,2025-05-24T18:44:00+02:00,2025-05-25,02:44,1,0,1
35,2025-05-24T18:45:00+02:00,2025-05-25,02:45,0,1,1
49,2025-05-24T18:41:00+02:00,2025-05-25,02:41,0,4,4
49,2025-05-24T18:45:00+02:00,2025-05-25,02:45,3,1,4
49,2025-05-24T18:48:00+02:00,2025-05-25,02:48,1,0,1
49,2025-05-24T18:49:00+02:00,2025-05-25,02:49,0,4,4
49,2025-05-24T18:52:00+02:00,2025-05-25,02:52,4,3,7
51,2025-05-24T18:45:00+02:00,2025-05-25,02:45,1,1,2
52,2025-05-24T18:42:00+02:00,2025-05-25,02:42,8,0,8
52,2025-05-24T18:45:00+02:00,2025-05-25,02:45,1,10,11
52,2025-05-24T18:50:00+02:00,2025-05-25,02:50,0,2,2
52,2025-05-24T18:52:00+02:00,2025-05-25,02:52,0,1,1
52,2025-05-24T18:53:00+02:00,2025-05-25,02:53,1,0,1
53,2025-05-24T18:42:00+02:00,2025-05-25,02:42,1,0,1
53,2025-05-24T18:46:00+02:00,2025-05-25,02:46,1,0,1
53,2025-05-24T18:47:00+02:00,2025-05-25,02:47,3,0,3
56,2025-05-24T18:40:00+02:00,2025-05-25,02:40,1,0,1
56,2025-05-24T18:41:00+02:00,2025-05-25,02:41,2,1,3
56,2025-05-24T18:46:00+02:00,2025-05-25,02:46,1,1,2
56,2025-05-24T18:52:00+02:00,2025-05-25,02:52,0,2,2
56,2025-05-24T18:53:00+02:00,2025-05-25,02:53,0,3,3
58,2025-05-24T18:43:00+02:00,2025-05-25,02:43,3,0,3
58,2025-05-24T18:46:00+02:00,2025-05-25,02:46,0,1,1
58,2025-05-24T18:52:00+02:00,2025-05-25,02:52,3,1,4
62,2025-05-24T18:43:00+02:00,2025-05-25,02:43,3,0,3
62,2025-05-24T18:47:00+02:00,2025-05-25,02:47,0,2,2
63,2025-05-24T18:51:00+02:00,2025-05-25,02:51,0,2,2
67,2025-05-24T18:44:00+02:00,2025-05-25,02:44,0,3,3
67,2025-05-24T18:45:00+02:00,2025-05-25,02:45,1,0,1
67,2025-05-24T18:47:00+02:00,2025-05-25,02:47,1,0,1
72,2025-05-24T18:50:00+02:00,2025-05-25,02:50,0,1,1
79,2025-05-24T18:48:00+02:00,2025-05-25,02:48,1,0,1
79,2025-05-24T18:49:00+02:00,2025-05-25,02:49,1,0,1
79,2025-05-24T18:54:00+02:00,2025-05-25,02:54,0,3,3
109,2025-05-24T18:40:00+02:00,2025-05-25,02:40,3,5,8
109,2025-05-24T18:45:00+02:00,2025-05-25,02:45,0,2,2
141,2025-05-24T18:40:00+02:00,2025-05-25,02:40,5,2,7
142,2025-05-24T18:40:00+02:00,2025-05-25,02:40,1,0,1
164,2025-05-24T18:45:00+02:00,2025-05-25,02:45,0,2,2
3,2025-05-24T18:57:00+02:00,2025-05-25,02:57,3,1,4
3,2025-05-24T18:58:00+02:00,2025-05-25,02:58,1,0,1
4,2025-05-24T18:59:00+02:00,2025-05-25,02:59,0,2,2
4,2025-05-24T19:00:00+02:00,2025-05-25,03:00,2,9,11
4,2025-05-24T19:03:00+02:00,2025-05-25,03:03,4,8,12
4,2025-05-24T19:04:00+02:00,2025-05-25,03:04,3,6,9
5,2025-05-24T18:55:00+02:00,2025-05-25,02:55,3,3,6
5,2025-05-24T19:00:00+02:00,2025-05-25,03:00,6,2,8
6,2025-05-24T18:57:00+02:00,2025-05-25,02:57,0,3,3
6,2025-05-24T18:59:00+02:00,2025-05-25,02:59,1,1,2
6,2025-05-24T19:08:00+02:00,2025-05-25,03:08,3,1,4
6,2025-05-24T19:09:00+02:00,2025-05-25,03:09,2,2,4
28,2025-05-24T19:00:00+02:00,2025-05-25,03:00,0,1,1
29,2025-05-24T19:04:00+02:00,2025-05-25,03:04,0,1,1
29,2025-05-24T19:05:00+02:00,2025-05-25,03:05,0,4,4
36,2025-05-24T18:55:00+02:00,2025-05-25,02:55,2,4,6
36,2025-05-24T19:01:00+02:00,2025-05-25,03:01,4,7,11
36,2025-05-24T19:02:00+02:00,2025-05-25,03:02,4,5,9
36,2025-05-24T19:05:00+02:00,2025-05-25,03:05,5,8,13
36,2025-05-24T19:06:00+02:00,2025-05-25,03:06,2,8,10
40,2025-05-24T18:57:00+02:00,2025-05-25,02:57,2,0,2
40,2025-05-24T18:59:00+02:00,2025-05-25,02:59,2,0,2
41,2025-05-24T18:55:00+02:00,2025-05-25,02:55,1,5,6
41,2025-05-24T19:07:00+02:00,2025-05-25,03:07,0,4,4
41,2025-05-24T19:08:00+02:00,2025-05-25,03:08,0,3,3
41,2025-05-24T19:09:00+02:00,2025-05-25,03:09,0,2,2
44,2025-05-24T18:55:00+02:00,2025-05-25,02:55,0,1,1
44,2025-05-24T19:00:00+02:00,2025-05-25,03:00,1,0,1
45,2025-05-24T18:58:00+02:00,2025-05-25,02:58,1,0,1
45,2025-05-24T18:59:00+02:00,2025-05-25,02:59,0,3,3
45,2025-05-24T19:02:00+02:00,2025-05-25,03:02,0,7,7
45,2025-05-24T19:04:00+02:00,2025-05-25,03:04,1,0,1
45,2025-05-24T19:06:00+02:00,2025-05-25,03:06,0,6,6
47,2025-05-24T18:57:00+02:00,2025-05-25,02:57,2,0,2
47,2025-05-24T19:00:00+02:00,2025-05-25,03:00,0,1,1
47,2025-05-24T19:01:00+02:00,2025-05-25,03:01,0,8,8
47,2025-05-24T19:03:00+02:00,2025-05-25,03:03,3,0,3
47,2025-05-24T19:07:00+02:00,2025-05-25,03:07,2,1,3
47,2025-05-24T19:08:00+02:00,2025-05-25,03:08,2,2,4
50,2025-05-24T18:55:00+02:00,2025-05-25,02:55,0,2,2
61,2025-05-24T18:56:00+02:00,2025-05-25,02:56,2,0,2
61,2025-05-24T18:58:00+02:00,2025-05-25,02:58,1,0,1
61,2025-05-24T19:09:00+02:00,2025-05-25,03:09,0,1,1
66,2025-05-24T18:55:00+02:00,2025-05-25,02:55,1,2,3
66,2025-05-24T19:00:00+02:00,2025-05-25,03:00,0,3,3
66,2025-05-24T19:06:00+02:00,2025-05-25,03:06,4,2,6
66,2025-05-24T19:08:00+02:00,2025-05-25,03:08,1,6,7
66,2025-05-24T19:09:00+02:00,2025-05-25,03:09,0,1,1
69,2025-05-24T19:08:00+02:00,2025-05-25,03:08,1,0,1
70,2025-05-24T19:04:00+02:00,2025-05-25,03:04,0,2,2
107,2025-05-24T19:00:00+02:00,2025-05-25,03:00,1,2,3
131,2025-05-24T19:05:00+02:00,2025-05-25,03:05,1,5,6
133,2025-05-24T19:00:00+02:00,2025-05-25,03:00,0,1,1
1,2025-05-24T18:58:00+02:00,2025-05-25,02:58,1,0,1
2,2025-05-24T19:06:00+02:00,2025-05-25,03:06,1,0,1
9,2025-05-24T18:57:00+02:00,2025-05-25,02:57,1,0,1
9,2025-05-24T19:08:00+02:00,2025-05-25,03:08,1,0,1
10,2025-05-24T18:56:00+02:00,2025-05-25,02:56,0,1,1
10,2025-05-24T18:57:00+02:00,2025-05-25,02:57,0,1,1
10,2025-05-24T18:58:00+02:00,2025-05-25,02:58,0,1,1
17,2025-05-24T18:55:00+02:00,2025-05-25,02:55,1,0,1
17,2025-05-24T19:08:00+02:00,2025-05-25,03:08,0,1,1
19,2025-05-24T19:01:00+02:00,2025-05-25,03:01,1,6,7
19,2025-05-24T19:02:00+02:00,2025-05-25,03:02,2,7,9
19,2025-05-24T19:04:00+02:00,2025-05-25,03:04,0,5,5
19,2025-05-24T19:05:00+02:00,2025-05-25,03:05,0,8,8
20,2025-05-24T18:55:00+02:00,2025-05-25,02:55,0,6,6
20,2025-05-24T18:59:00+02:00,2025-05-25,02:59,9,1,10
20,2025-05-24T19:00:00+02:00,2025-05-25,03:00,3,6,9
20,2025-05-24T19:01:00+02:00,2025-05-25,03:01,0,1,1
20,2025-05-24T19:02:00+02:00,2025-05-25,03:02,6,0,6
20,2025-05-24T19:04:00+02:00,2025-05-25,03:04,6,8,14
20,2025-05-24T19:07:00+02:00,2025-05-25,03:07,1,5,6
23,2025-05-24T19:00:00+02:00,2025-05-25,03:00,0,2,2
24,2025-05-24T18:56:00+02:00,2025-05-25,02:56,1,0,1
24,2025-05-24T18:57:00+02:00,2025-05-25,02:57,0,2,2
24,2025-05-24T18:58:00+02:00,2025-05-25,02:58,1,0,1
24,2025-05-24T19:09:00+02:00,2025-05-25,03:09,2,1,3
25,2025-05-24T18:55:00+02:00,2025-05-25,02:55,2,3,5
25,2025-05-24T19:00:00+02:00,2025-05-25,03:00,0,1,1
27,2025-05-24T19:08:00+02:00,2025-05-25,03:08,3,0,3
30,2025-05-24T19:03:00+02:00,2025-05-25,03:03,3,4,7
35,2025-05-24T18:55:00+02:00,2025-05-25,02:55,1,0,1
35,2025-05-24T19:01:00+02:00,2025-05-25,03:01,3,0,3
49,2025-05-24T18:56:00+02:00,2025-05-25,02:56,4,0,4
49,2025-05-24T18:59:00+02:00,2025-05-25,02:59,1,0,1
49,2025-05-24T19:02:00+02:00,2025-05-25,03:02,0,1,1
49,2025-05-24T19:07:00+02:00,2025-05-25,03:07,3,2,5
49,2025-05-24T19:09:00+02:00,2025-05-25,03:09,1,0,1
51,2025-05-24T18:57:00+02:00,2025-05-25,02:57,3,0,3
52,2025-05-24T18:57:00+02:00,2025-05-25,02:57,1,0,1
52,2025-05-24T19:03:00+02:00,2025-05-25,03:03,2,3,5
52,2025-05-24T19:08:00+02:00,2025-05-25,03:08,0,1,1
53,2025-05-24T18:58:00+02:00,2025-05-25,02:58,2,0,2
53,2025-05-24T19:01:00+02:00,2025-05-25,03:01,1,0,1
53,2025-05-24T19:07:00+02:00,2025-05-25,03:07,0,1,1
56,2025-05-24T18:55:00+02:00,2025-05-25,02:55,0,1,1
56,2025-05-24T18:58:00+02:00,2025-05-25,02:58,1,0,1
56,2025-05-24T19:09:00+02:00,2025-05-25,03:09,3,3,6
58,2025-05-24T18:55:00+02:00,2025-05-25,02:55,2,1,3
58,2025-05-24T19:05:00+02:00,2025-05-25,03:05,2,1,3
58,2025-05-24T19:07:00+02:00,2025-05-25,03:07,0,1,1
63,2025-05-24T19:07:00+02:00,2025-05-25,03:07,0,2,2
67,2025-05-24T18:58:00+02:00,2025-05-25,02:58,3,3,6
67,2025-05-24T19:00:00+02:00,2025-05-25,03:00,2,1,3
67,2025-05-24T19:01:00+02:00,2025-05-25,03:01,1,0,1
68,2025-05-24T19:08:00+02:00,2025-05-25,03:08,1,0,1
79,2025-05-24T18:55:00+02:00,2025-05-25,02:55,1,1,2
79,2025-05-24T19:00:00+02:00,2025-05-25,03:00,1,0,1
79,2025-05-24T19:01:00+02:00,2025-05-25,03:01,1,2,3
85,2025-05-24T19:00:00+02:00,2025-05-25,03:00,0,1,1
109,2025-05-24T19:05:00+02:00,2025-05-25,03:05,5,0,5
139,2025-05-24T19:00:00+02:00,2025-05-25,03:00,1,0,1
141,2025-05-24T18:55:00+02:00,2025-05-25,02:55,10,2,12
141,2025-05-24T19:00:00+02:00,2025-05-25,03:00,4,1,5
3,2025-05-24T19:12:00+02:00,2025-05-25,03:12,3,1,4
3,2025-05-24T19:16:00+02:00,2025-05-25,03:16,1,1,2
3,2025-05-24T19:17:00+02:00,2025-05-25,03:17,8,2,10
3,2025-05-24T19:20:00+02:00,2025-05-25,03:20,4,6,10
3,2025-05-24T19:23:00+02:00,2025-05-25,03:23,4,0,4
4,2025-05-24T19:17:00+02:00,2025-05-25,03:17,4,0,4
4,2025-05-24T19:22:00+02:00,2025-05-25,03:22,1,0,1
4,2025-05-24T19:23:00+02:00,2025-05-25,03:23,6,2,8
6,2025-05-24T19:14:00+02:00,2025-05-25,03:14,0,2,2
6,2025-05-24T19:16:00+02:00,2025-05-25,03:16,1,0,1
6,2025-05-24T19:22:00+02:00,2025-05-25,03:22,2,0,2
8,2025-05-24T19:23:00+02:00,2025-05-25,03:23,1,0,1
29,2025-05-24T19:18:00+02:00,2025-05-25,03:18,0,2,2
36,2025-05-24T19:11:00+02:00,2025-05-25,03:11,4,2,6
36,2025-05-24T19:17:00+02:00,2025-05-25,03:17,4,1,5
36,2025-05-24T19:19:00+02:00,2025-05-25,03:19,5,1,6
36,2025-05-24T19:22:00+02:00,2025-05-25,03:22,0,9,9
36,2025-05-24T19:23:00+02:00,2025-05-25,03:23,3,7,10
36,2025-05-24T19:24:00+02:00,2025-05-25,03:24,6,3,9
39,2025-05-24T19:16:00+02:00,2025-05-25,03:16,0,1,1
40,2025-05-24T19:21:00+02:00,2025-05-25,03:21,2,0,2
41,2025-05-24T19:16:00+02:00,2025-05-25,03:16,0,3,3
41,2025-05-24T19:19:00+02:00,2025-05-25,03:19,0,1,1
41,2025-05-24T19:21:00+02:00,2025-05-25,03:21,0,1,1
41,2025-05-24T19:23:00+02:00,2025-05-25,03:23,3,4,7
45,2025-05-24T19:10:00+02:00,2025-05-25,03:10,0,1,1
45,2025-05-24T19:16:00+02:00,2025-05-25,03:16,1,0,1
45,2025-05-24T19:17:00+02:00,2025-05-25,03:17,2,5,7
45,2025-05-24T19:18:00+02:00,2025-05-25,03:18,2,5,7
45,2025-05-24T19:20:00+02:00,2025-05-25,03:20,0,2,2
47,2025-05-24T19:12:00+02:00,2025-05-25,03:12,1,1,2
47,2025-05-24T19:18:00+02:00,2025-05-25,03:18,2,2,4
47,2025-05-24T19:19:00+02:00,2025-05-25,03:19,1,1,2
47,2025-05-24T19:21:00+02:00,2025-05-25,03:21,2,0,2
47,2025-05-24T19:22:00+02:00,2025-05-25,03:22,0,2,2
54,2025-05-24T19:15:00+02:00,2025-05-25,03:15,1,0,1
59,2025-05-24T19:10:00+02:00,2025-05-25,03:10,11,12,23
66,2025-05-24T19:10:00+02:00,2025-05-25,03:10,2,0,2
66,2025-05-24T19:12:00+02:00,2025-05-25,03:12,0,5,5
66,2025-05-24T19:13:00+02:00,2025-05-25,03:13,0,2,2
66,2025-05-24T19:24:00+02:00,2025-05-25,03:24,3,0,3
69,2025-05-24T19:13:00+02:00,2025-05-25,03:13,0,1,1
107,2025-05-24T19:10:00+02:00,2025-05-25,03:10,0,1,1
107,2025-05-24T19:15:00+02:00,2025-05-25,03:15,1,0,1
108,2025-05-24T19:15:00+02:00,2025-05-25,03:15,1,0,1
131,2025-05-24T19:10:00+02:00,2025-05-25,03:10,2,5,7
131,2025-05-24T19:15:00+02:00,2025-05-25,03:15,0,5,5
134,2025-05-24T19:15:00+02:00,2025-05-25,03:15,1,0,1
162,2025-05-24T19:20:00+02:00,2025-05-25,03:20,5,2,7
1,2025-05-24T19:24:00+02:00,2025-05-25,03:24,0,5,5
2,2025-05-24T19:15:00+02:00,2025-05-25,03:15,0,2,2
9,2025-05-24T19:15:00+02:00,2025-05-25,03:15,0,2,2
12,2025-05-24T19:10:00+02:00,2025-05-25,03:10,0,1,1
17,2025-05-24T19:12:00+02:00,2025-05-25,03:12,0,1,1
17,2025-05-24T19:21:00+02:00,2025-05-25,03:21,0,1,1
19,2025-05-24T19:10:00+02:00,2025-05-25,03:10,0,2,2
19,2025-05-24T19:14:00+02:00,2025-05-25,03:14,0,1,1
19,2025-05-24T19:16:00+02:00,2025-05-25,03:16,2,2,4
19,2025-05-24T19:19:00+02:00,2025-05-25,03:19,1,0,1
19,2025-05-24T19:21:00+02:00,2025-05-25,03:21,4,0,4
19,2025-05-24T19:22:00+02:00,2025-05-25,03:22,4,7,11
20,2025-05-24T19:10:00+02:00,2025-05-25,03:10,0,6,6
20,2025-05-24T19:11:00+02:00,2025-05-25,03:11,1,3,4
20,2025-05-24T19:15:00+02:00,2025-05-25,03:15,1,6,7
23,2025-05-24T19:14:00+02:00,2025-05-25,03:14,0,1,1
23,2025-05-24T19:22:00+02:00,2025-05-25,03:22,3,0,3
24,2025-05-24T19:11:00+02:00,2025-05-25,03:11,0,2,2
24,2025-05-24T19:16:00+02:00,2025-05-25,03:16,3,0,3
24,2025-05-24T19:19:00+02:00,2025-05-25,03:19,2,0,2
24,2025-05-24T19:21:00+02:00,2025-05-25,03:21,0,2,2
27,2025-05-24T19:23:00+02:00,2025-05-25,03:23,2,0,2
30,2025-05-24T19:11:00+02:00,2025-05-25,03:11,6,3,9
30,2025-05-24T19:13:00+02:00,2025-05-25,03:13,8,0,8
30,2025-05-24T19:14:00+02:00,2025-05-25,03:14,5,3,8
30,2025-05-24T19:20:00+02:00,2025-05-25,03:20,0,10,10
35,2025-05-24T19:15:00+02:00,2025-05-25,03:15,1,0,1
35,2025-05-24T19:23:00+02:00,2025-05-25,03:23,1,2,3
49,2025-05-24T19:11:00+02:00,2025-05-25,03:11,1,1,2
49,2025-05-24T19:14:00+02:00,2025-05-25,03:14,2,1,3
49,2025-05-24T19:16:00+02:00,2025-05-25,03:16,0,2,2
51,2025-05-24T19:22:00+02:00,2025-05-25,03:22,2,0,2
52,2025-05-24T19:10:00+02:00,2025-05-25,03:10,3,2,5
52,2025-05-24T19:12:00+02:00,2025-05-25,03:12,2,1,3
52,2025-05-24T19:14:00+02:00,2025-05-25,03:14,0,2,2
52,2025-05-24T19:16:00+02:00,2025-05-25,03:16,3,0,3
53,2025-05-24T19:23:00+02:00,2025-05-25,03:23,0,2,2
56,2025-05-24T19:10:00+02:00,2025-05-25,03:10,0,3,3
56,2025-05-24T19:13:00+02:00,2025-05-25,03:13,2,0,2
56,2025-05-24T19:22:00+02:00,2025-05-25,03:22,2,0,2
56,2025-05-24T19:24:00+02:00,2025-05-25,03:24,3,1,4
58,2025-05-24T19:10:00+02:00,2025-05-25,03:10,3,0,3
58,2025-05-24T19:20:00+02:00,2025-05-25,03:20,1,1,2
62,2025-05-24T19:13:00+02:00,2025-05-25,03:13,0,1,1
62,2025-05-24T19:18:00+02:00,2025-05-25,03:18,1,1,2
62,2025-05-24T19:22:00+02:00,2025-05-25,03:22,0,1,1
63,2025-05-24T19:15:00+02:00,2025-05-25,03:15,0,2,2
67,2025-05-24T19:12:00+02:00,2025-05-25,03:12,1,0,1
67,2025-05-24T19:21:00+02:00,2025-05-25,03:21,0,2,2
67,2025-05-24T19:22:00+02:00,2025-05-25,03:22,0,1,1
68,2025-05-24T19:14:00+02:00,2025-05-25,03:14,1,1,2
79,2025-05-24T19:16:00+02:00,2025-05-25,03:16,1,0,1
79,2025-05-24T19:17:00+02:00,2025-05-25,03:17,1,0,1
79,2025-05-24T19:20:00+02:00,2025-05-25,03:20,3,1,4
109,2025-05-24T19:20:00+02:00,2025-05-25,03:20,1,0,1
137,2025-05-24T19:15:00+02:00,2025-05-25,03:15,1,0,1
181,2025-05-24T18:57:00+02:00,2025-05-25,02:57,0,4,4
181,2025-05-24T18:58:00+02:00,2025-05-25,02:58,4,0,4
181,2025-05-24T19:02:00+02:00,2025-05-25,03:02,6,1,7
181,2025-05-24T19:05:00+02:00,2025-05-25,03:05,1,1,2
181,2025-05-24T19:06:00+02:00,2025-05-25,03:06,3,1,4
181,2025-05-24T19:07:00+02:00,2025-05-25,03:07,0,4,4
182,2025-05-24T19:00:00+02:00,2025-05-25,03:00,5,5,10
181,2025-05-24T19:16:00+02:00,2025-05-25,03:16,1,0,1
181,2025-05-24T19:18:00+02:00,2025-05-25,03:18,4,5,9
181,2025-05-24T19:21:00+02:00,2025-05-25,03:21,7,2,9
182,2025-05-24T19:10:00+02:00,2025-05-25,03:10,6,7,13
182,2025-05-24T19:15:00+02:00,2025-05-25,03:15,13,5,18
3,2025-05-24T19:28:00+02:00,2025-05-25,03:28,2,5,7
3,2025-05-24T19:29:00+02:00,2025-05-25,03:29,5,3,8
3,2025-05-24T19:36:00+02:00,2025-05-25,03:36,5,0,5
3,2025-05-24T19:37:00+02:00,2025-05-25,03:37,5,1,6
4,2025-05-24T19:26:00+02:00,2025-05-25,03:26,0,4,4
4,2025-05-24T19:32:00+02:00,2025-05-25,03:32,2,2,4
4,2025-05-24T19:38:00+02:00,2025-05-25,03:38,0,2,2
5,2025-05-24T19:25:00+02:00,2025-05-25,03:25,4,7,11
6,2025-05-24T19:26:00+02:00,2025-05-25,03:26,2,0,2
6,2025-05-24T19:39:00+02:00,2025-05-25,03:39,0,1,1
28,2025-05-24T19:27:00+02:00,2025-05-25,03:27,1,0,1
31,2025-05-24T19:30:00+02:00,2025-05-25,03:30,2,3,5
31,2025-05-24T19:31:00+02:00,2025-05-25,03:31,3,1,4
31,2025-05-24T19:32:00+02:00,2025-05-25,03:32,2,4,6
36,2025-05-24T19:25:00+02:00,2025-05-25,03:25,3,5,8
36,2025-05-24T19:26:00+02:00,2025-05-25,03:26,2,2,4
36,2025-05-24T19:28:00+02:00,2025-05-25,03:28,1,2,3
36,2025-05-24T19:38:00+02:00,2025-05-25,03:38,3,1,4
37,2025-05-24T19:33:00+02:00,2025-05-25,03:33,0,1,1
37,2025-05-24T19:35:00+02:00,2025-05-25,03:35,0,4,4
41,2025-05-24T19:32:00+02:00,2025-05-25,03:32,1,0,1
43,2025-05-24T19:35:00+02:00,2025-05-25,03:35,2,0,2
44,2025-05-24T19:35:00+02:00,2025-05-25,03:35,2,0,2
45,2025-05-24T19:25:00+02:00,2025-05-25,03:25,0,3,3
45,2025-05-24T19:29:00+02:00,2025-05-25,03:29,1,0,1
47,2025-05-24T19:34:00+02:00,2025-05-25,03:34,0,1,1
61,2025-05-24T19:30:00+02:00,2025-05-25,03:30,3,0,3
61,2025-05-24T19:32:00+02:00,2025-05-25,03:32,3,0,3
61,2025-05-24T19:39:00+02:00,2025-05-25,03:39,1,0,1
66,2025-05-24T19:28:00+02:00,2025-05-25,03:28,2,0,2
66,2025-05-24T19:34:00+02:00,2025-05-25,03:34,0,2,2
66,2025-05-24T19:38:00+02:00,2025-05-25,03:38,0,2,2
84,2025-05-24T19:30:00+02:00,2025-05-25,03:30,6,5,11
107,2025-05-24T19:35:00+02:00,2025-05-25,03:35,0,1,1
108,2025-05-24T19:29:00+02:00,2025-05-25,03:29,1,0,1
108,2025-05-24T19:30:00+02:00,2025-05-25,03:30,2,0,2
131,2025-05-24T19:25:00+02:00,2025-05-25,03:25,0,9,9
131,2025-05-24T19:30:00+02:00,2025-05-25,03:30,2,0,2
131,2025-05-24T19:35:00+02:00,2025-05-25,03:35,4,6,10
133,2025-05-24T19:25:00+02:00,2025-05-25,03:25,0,5,5
133,2025-05-24T19:35:00+02:00,2025-05-25,03:35,5,6,11
134,2025-05-24T19:25:00+02:00,2025-05-25,03:25,2,6,8
135,2025-05-24T19:35:00+02:00,2025-05-25,03:35,6,0,6
1,2025-05-24T19:36:00+02:00,2025-05-25,03:36,2,0,2
18,2025-05-24T19:36:00+02:00,2025-05-25,03:36,1,0,1
19,2025-05-24T19:25:00+02:00,2025-05-25,03:25,0,1,1
19,2025-05-24T19:28:00+02:00,2025-05-25,03:28,0,7,7
19,2025-05-24T19:31:00+02:00,2025-05-25,03:31,2,2,4
19,2025-05-24T19:35:00+02:00,2025-05-25,03:35,2,8,10
19,2025-05-24T19:36:00+02:00,2025-05-25,03:36,1,0,1
20,2025-05-24T19:26:00+02:00,2025-05-25,03:26,3,1,4
20,2025-05-24T19:30:00+02:00,2025-05-25,03:30,1,1,2
20,2025-05-24T19:34:00+02:00,2025-05-25,03:34,0,1,1
20,2025-05-24T19:37:00+02:00,2025-05-25,03:37,1,3,4
24,2025-05-24T19:25:00+02:00,2025-05-25,03:25,2,4,6
24,2025-05-24T19:26:00+02:00,2025-05-25,03:26,0,1,1
24,2025-05-24T19:27:00+02:00,2025-05-25,03:27,1,0,1
24,2025-05-24T19:30:00+02:00,2025-05-25,03:30,0,1,1
24,2025-05-24T19:37:00+02:00,2025-05-25,03:37,0,1,1
25,2025-05-24T19:35:00+02:00,2025-05-25,03:35,0,2,2
27,2025-05-24T19:26:00+02:00,2025-05-25,03:26,0,1,1
30,2025-05-24T19:25:00+02:00,2025-05-25,03:25,4,1,5
30,2025-05-24T19:34:00+02:00,2025-05-25,03:34,0,3,3
35,2025-05-24T19:28:00+02:00,2025-05-25,03:28,1,0,1
35,2025-05-24T19:38:00+02:00,2025-05-25,03:38,0,1,1
49,2025-05-24T19:30:00+02:00,2025-05-25,03:30,0,1,1
49,2025-05-24T19:35:00+02:00,2025-05-25,03:35,2,0,2
51,2025-05-24T19:31:00+02:00,2025-05-25,03:31,0,1,1
52,2025-05-24T19:26:00+02:00,2025-05-25,03:26,1,1,2
52,2025-05-24T19:35:00+02:00,2025-05-25,03:35,0,3,3
52,2025-05-24T19:36:00+02:00,2025-05-25,03:36,8,0,8
52,2025-05-24T19:39:00+02:00,2025-05-25,03:39,2,0,2
53,2025-05-24T19:26:00+02:00,2025-05-25,03:26,1,0,1
53,2025-05-24T19:37:00+02:00,2025-05-25,03:37,1,0,1
56,2025-05-24T19:25:00+02:00,2025-05-25,03:25,0,1,1
58,2025-05-24T19:25:00+02:00,2025-05-25,03:25,2,2,4
58,2025-05-24T19:27:00+02:00,2025-05-25,03:27,0,3,3
58,2025-05-24T19:28:00+02:00,2025-05-25,03:28,0,1,1
58,2025-05-24T19:37:00+02:00,2025-05-25,03:37,1,1,2
58,2025-05-24T19:39:00+02:00,2025-05-25,03:39,1,0,1
62,2025-05-24T19:37:00+02:00,2025-05-25,03:37,1,0,1
67,2025-05-24T19:25:00+02:00,2025-05-25,03:25,1,0,1
67,2025-05-24T19:27:00+02:00,2025-05-25,03:27,0,3,3
67,2025-05-24T19:33:00+02:00,2025-05-25,03:33,0,1,1
67,2025-05-24T19:36:00+02:00,2025-05-25,03:36,0,1,1
67,2025-05-24T19:39:00+02:00,2025-05-25,03:39,1,0,1
72,2025-05-24T19:34:00+02:00,2025-05-25,03:34,0,2,2
72,2025-05-24T19:37:00+02:00,2025-05-25,03:37,0,1,1
76,2025-05-24T19:30:00+02:00,2025-05-25,03:30,1,0,1
79,2025-05-24T19:30:00+02:00,2025-05-25,03:30,0,1,1
79,2025-05-24T19:32:00+02:00,2025-05-25,03:32,1,0,1
109,2025-05-24T19:25:00+02:00,2025-05-25,03:25,2,3,5
117,2025-05-24T19:25:00+02:00,2025-05-25,03:25,1,0,1
117,2025-05-24T19:35:00+02:00,2025-05-25,03:35,0,2,2
141,2025-05-24T19:25:00+02:00,2025-05-25,03:25,10,3,13
141,2025-05-24T19:30:00+02:00,2025-05-25,03:30,2,4,6
141,2025-05-24T19:35:00+02:00,2025-05-25,03:35,1,3,4
164,2025-05-24T19:25:00+02:00,2025-05-25,03:25,1,0,1
181,2025-05-24T19:33:00+02:00,2025-05-25,03:33,1,0,1
181,2025-05-24T19:35:00+02:00,2025-05-25,03:35,4,0,4
181,2025-05-24T19:38:00+02:00,2025-05-25,03:38,2,3,5
182,2025-05-24T19:25:00+02:00,2025-05-25,03:25,19,15,34
180,2025-05-24T19:25:00+02:00,2025-05-25,03:25,0,1,1
3,2025-05-24T16:28:00+02:00,2025-05-25,00:28,8,2,10
3,2025-05-24T16:34:00+02:00,2025-05-25,00:34,6,13,19
3,2025-05-24T16:35:00+02:00,2025-05-25,00:35,6,4,10
4,2025-05-24T16:25:00+02:00,2025-05-25,00:25,2,2,4
4,2025-05-24T16:28:00+02:00,2025-05-25,00:28,2,6,8
4,2025-05-24T16:33:00+02:00,2025-05-25,00:33,2,7,9
4,2025-05-24T16:37:00+02:00,2025-05-25,00:37,1,5,6
4,2025-05-24T16:38:00+02:00,2025-05-25,00:38,3,2,5
5,2025-05-24T16:30:00+02:00,2025-05-25,00:30,8,13,21
5,2025-05-24T16:35:00+02:00,2025-05-25,00:35,6,7,13
6,2025-05-24T16:26:00+02:00,2025-05-25,00:26,8,1,9
6,2025-05-24T16:28:00+02:00,2025-05-25,00:28,5,1,6
6,2025-05-24T16:29:00+02:00,2025-05-25,00:29,3,4,7
6,2025-05-24T16:30:00+02:00,2025-05-25,00:30,6,3,9
6,2025-05-24T16:32:00+02:00,2025-05-25,00:32,3,0,3
6,2025-05-24T16:34:00+02:00,2025-05-25,00:34,5,7,12
6,2025-05-24T16:36:00+02:00,2025-05-25,00:36,12,14,26
6,2025-05-24T16:37:00+02:00,2025-05-25,00:37,1,5,6
6,2025-05-24T16:39:00+02:00,2025-05-25,00:39,4,3,7
8,2025-05-24T16:34:00+02:00,2025-05-25,00:34,0,2,2
28,2025-05-24T16:25:00+02:00,2025-05-25,00:25,3,0,3
28,2025-05-24T16:35:00+02:00,2025-05-25,00:35,1,0,1
29,2025-05-24T16:25:00+02:00,2025-05-25,00:25,0,2,2
29,2025-05-24T16:29:00+02:00,2025-05-25,00:29,2,0,2
29,2025-05-24T16:30:00+02:00,2025-05-25,00:30,4,2,6
29,2025-05-24T16:34:00+02:00,2025-05-25,00:34,0,3,3
29,2025-05-24T16:35:00+02:00,2025-05-25,00:35,0,2,2
29,2025-05-24T16:37:00+02:00,2025-05-25,00:37,2,0,2
31,2025-05-24T16:25:00+02:00,2025-05-25,00:25,1,0,1
31,2025-05-24T16:33:00+02:00,2025-05-25,00:33,0,5,5
31,2025-05-24T16:34:00+02:00,2025-05-25,00:34,1,0,1
36,2025-05-24T16:38:00+02:00,2025-05-25,00:38,1,3,4
37,2025-05-24T16:25:00+02:00,2025-05-25,00:25,12,6,18
37,2025-05-24T16:27:00+02:00,2025-05-25,00:27,4,1,5
39,2025-05-24T16:36:00+02:00,2025-05-25,00:36,1,0,1
40,2025-05-24T16:28:00+02:00,2025-05-25,00:28,3,0,3
40,2025-05-24T16:30:00+02:00,2025-05-25,00:30,0,2,2
41,2025-05-24T16:30:00+02:00,2025-05-25,00:30,0,2,2
44,2025-05-24T16:25:00+02:00,2025-05-25,00:25,1,0,1
45,2025-05-24T16:34:00+02:00,2025-05-25,00:34,4,0,4
45,2025-05-24T16:35:00+02:00,2025-05-25,00:35,2,1,3
45,2025-05-24T16:36:00+02:00,2025-05-25,00:36,3,6,9
45,2025-05-24T16:38:00+02:00,2025-05-25,00:38,5,0,5
47,2025-05-24T16:27:00+02:00,2025-05-25,00:27,0,2,2
47,2025-05-24T16:29:00+02:00,2025-05-25,00:29,3,2,5
47,2025-05-24T16:30:00+02:00,2025-05-25,00:30,3,4,7
47,2025-05-24T16:32:00+02:00,2025-05-25,00:32,0,6,6
47,2025-05-24T16:36:00+02:00,2025-05-25,00:36,3,3,6
47,2025-05-24T16:37:00+02:00,2025-05-25,00:37,7,0,7
47,2025-05-24T16:38:00+02:00,2025-05-25,00:38,1,1,2
47,2025-05-24T16:39:00+02:00,2025-05-25,00:39,0,3,3
50,2025-05-24T16:29:00+02:00,2025-05-25,00:29,2,0,2
50,2025-05-24T16:31:00+02:00,2025-05-25,00:31,0,2,2
54,2025-05-24T16:31:00+02:00,2025-05-25,00:31,3,2,5
54,2025-05-24T16:33:00+02:00,2025-05-25,00:33,1,0,1
59,2025-05-24T16:35:00+02:00,2025-05-25,00:35,4,7,11
61,2025-05-24T16:30:00+02:00,2025-05-25,00:30,1,0,1
61,2025-05-24T16:31:00+02:00,2025-05-25,00:31,4,0,4
61,2025-05-24T16:33:00+02:00,2025-05-25,00:33,2,2,4
61,2025-05-24T16:34:00+02:00,2025-05-25,00:34,2,0,2
61,2025-05-24T16:38:00+02:00,2025-05-25,00:38,1,0,1
61,2025-05-24T16:39:00+02:00,2025-05-25,00:39,0,1,1
66,2025-05-24T16:27:00+02:00,2025-05-25,00:27,6,1,7
66,2025-05-24T16:28:00+02:00,2025-05-25,00:28,4,0,4
66,2025-05-24T16:29:00+02:00,2025-05-25,00:29,6,6,12
66,2025-05-24T16:33:00+02:00,2025-05-25,00:33,3,17,20
66,2025-05-24T16:34:00+02:00,2025-05-25,00:34,6,10,16
66,2025-05-24T16:36:00+02:00,2025-05-25,00:36,10,0,10
66,2025-05-24T16:37:00+02:00,2025-05-25,00:37,0,4,4
70,2025-05-24T16:37:00+02:00,2025-05-25,00:37,0,1,1
75,2025-05-24T16:39:00+02:00,2025-05-25,00:39,2,0,2
78,2025-05-24T16:37:00+02:00,2025-05-25,00:37,0,1,1
84,2025-05-24T16:25:00+02:00,2025-05-25,00:25,7,19,26
87,2025-05-24T16:36:00+02:00,2025-05-25,00:36,2,0,2
107,2025-05-24T16:30:00+02:00,2025-05-25,00:30,4,0,4
108,2025-05-24T16:26:00+02:00,2025-05-25,00:26,0,1,1
108,2025-05-24T16:28:00+02:00,2025-05-25,00:28,1,1,2
108,2025-05-24T16:31:00+02:00,2025-05-25,00:31,4,0,4
108,2025-05-24T16:32:00+02:00,2025-05-25,00:32,0,2,2
108,2025-05-24T16:34:00+02:00,2025-05-25,00:34,1,0,1
108,2025-05-24T16:36:00+02:00,2025-05-25,00:36,1,2,3
118,2025-05-24T16:35:00+02:00,2025-05-25,00:35,1,0,1
133,2025-05-24T16:25:00+02:00,2025-05-25,00:25,8,3,11
135,2025-05-24T16:30:00+02:00,2025-05-25,00:30,1,4,5
135,2025-05-24T16:35:00+02:00,2025-05-25,00:35,4,4,8
162,2025-05-24T16:25:00+02:00,2025-05-25,00:25,9,1,10
1,2025-05-24T16:25:00+02:00,2025-05-25,00:25,1,0,1
1,2025-05-24T16:26:00+02:00,2025-05-25,00:26,1,0,1
1,2025-05-24T16:31:00+02:00,2025-05-25,00:31,1,0,1
1,2025-05-24T16:34:00+02:00,2025-05-25,00:34,4,0,4
1,2025-05-24T16:37:00+02:00,2025-05-25,00:37,0,3,3
2,2025-05-24T16:31:00+02:00,2025-05-25,00:31,0,1,1
9,2025-05-24T16:30:00+02:00,2025-05-25,00:30,1,0,1
10,2025-05-24T16:36:00+02:00,2025-05-25,00:36,0,2,2
11,2025-05-24T16:35:00+02:00,2025-05-25,00:35,3,1,4
12,2025-05-24T16:33:00+02:00,2025-05-25,00:33,1,1,2
17,2025-05-24T16:33:00+02:00,2025-05-25,00:33,0,1,1
19,2025-05-24T16:26:00+02:00,2025-05-25,00:26,5,5,10
19,2025-05-24T16:35:00+02:00,2025-05-25,00:35,1,0,1
19,2025-05-24T16:37:00+02:00,2025-05-25,00:37,0,7,7
19,2025-05-24T16:39:00+02:00,2025-05-25,00:39,6,3,9
20,2025-05-24T16:28:00+02:00,2025-05-25,00:28,4,7,11
20,2025-05-24T16:30:00+02:00,2025-05-25,00:30,4,1,5
20,2025-05-24T16:38:00+02:00,2025-05-25,00:38,9,5,14
23,2025-05-24T16:34:00+02:00,2025-05-25,00:34,0,1,1
24,2025-05-24T16:27:00+02:00,2025-05-25,00:27,3,0,3
24,2025-05-24T16:28:00+02:00,2025-05-25,00:28,6,2,8
24,2025-05-24T16:32:00+02:00,2025-05-25,00:32,0,2,2
24,2025-05-24T16:33:00+02:00,2025-05-25,00:33,0,9,9
24,2025-05-24T16:37:00+02:00,2025-05-25,00:37,1,6,7
25,2025-05-24T16:30:00+02:00,2025-05-25,00:30,13,3,16
27,2025-05-24T16:25:00+02:00,2025-05-25,00:25,1,0,1
27,2025-05-24T16:28:00+02:00,2025-05-25,00:28,0,2,2
27,2025-05-24T16:31:00+02:00,2025-05-25,00:31,4,0,4
30,2025-05-24T16:27:00+02:00,2025-05-25,00:27,7,13,20
30,2025-05-24T16:31:00+02:00,2025-05-25,00:31,2,1,3
30,2025-05-24T16:34:00+02:00,2025-05-25,00:34,5,3,8
30,2025-05-24T16:36:00+02:00,2025-05-25,00:36,2,10,12
30,2025-05-24T16:38:00+02:00,2025-05-25,00:38,3,7,10
35,2025-05-24T16:28:00+02:00,2025-05-25,00:28,3,1,4
35,2025-05-24T16:31:00+02:00,2025-05-25,00:31,4,5,9
35,2025-05-24T16:33:00+02:00,2025-05-25,00:33,2,6,8
35,2025-05-24T16:34:00+02:00,2025-05-25,00:34,4,4,8
35,2025-05-24T16:37:00+02:00,2025-05-25,00:37,3,4,7
49,2025-05-24T16:25:00+02:00,2025-05-25,00:25,2,0,2
49,2025-05-24T16:27:00+02:00,2025-05-25,00:27,1,1,2
49,2025-05-24T16:33:00+02:00,2025-05-25,00:33,3,0,3
49,2025-05-24T16:34:00+02:00,2025-05-25,00:34,2,0,2
51,2025-05-24T16:25:00+02:00,2025-05-25,00:25,2,2,4
51,2025-05-24T16:31:00+02:00,2025-05-25,00:31,0,4,4
51,2025-05-24T16:37:00+02:00,2025-05-25,00:37,0,1,1
52,2025-05-24T16:26:00+02:00,2025-05-25,00:26,4,3,7
52,2025-05-24T16:27:00+02:00,2025-05-25,00:27,11,1,12
52,2025-05-24T16:30:00+02:00,2025-05-25,00:30,5,12,17
52,2025-05-24T16:31:00+02:00,2025-05-25,00:31,2,6,8
52,2025-05-24T16:32:00+02:00,2025-05-25,00:32,2,11,13
52,2025-05-24T16:34:00+02:00,2025-05-25,00:34,0,4,4
52,2025-05-24T16:36:00+02:00,2025-05-25,00:36,4,6,10
52,2025-05-24T16:39:00+02:00,2025-05-25,00:39,4,1,5
53,2025-05-24T16:25:00+02:00,2025-05-25,00:25,4,0,4
53,2025-05-24T16:29:00+02:00,2025-05-25,00:29,0,3,3
53,2025-05-24T16:30:00+02:00,2025-05-25,00:30,2,0,2
53,2025-05-24T16:35:00+02:00,2025-05-25,00:35,0,4,4
56,2025-05-24T16:26:00+02:00,2025-05-25,00:26,3,0,3
56,2025-05-24T16:27:00+02:00,2025-05-25,00:27,0,1,1
56,2025-05-24T16:29:00+02:00,2025-05-25,00:29,1,0,1
56,2025-05-24T16:30:00+02:00,2025-05-25,00:30,2,0,2
56,2025-05-24T16:31:00+02:00,2025-05-25,00:31,2,4,6
56,2025-05-24T16:32:00+02:00,2025-05-25,00:32,1,0,1
56,2025-05-24T16:34:00+02:00,2025-05-25,00:34,0,4,4
56,2025-05-24T16:35:00+02:00,2025-05-25,00:35,2,1,3
56,2025-05-24T16:37:00+02:00,2025-05-25,00:37,0,3,3
58,2025-05-24T16:32:00+02:00,2025-05-25,00:32,1,2,3
58,2025-05-24T16:36:00+02:00,2025-05-25,00:36,3,6,9
58,2025-05-24T16:37:00+02:00,2025-05-25,00:37,0,4,4
58,2025-05-24T16:38:00+02:00,2025-05-25,00:38,4,6,10
62,2025-05-24T16:25:00+02:00,2025-05-25,00:25,1,1,2
62,2025-05-24T16:29:00+02:00,2025-05-25,00:29,2,0,2
62,2025-05-24T16:37:00+02:00,2025-05-25,00:37,5,2,7
63,2025-05-24T16:25:00+02:00,2025-05-25,00:25,0,7,7
63,2025-05-24T16:27:00+02:00,2025-05-25,00:27,2,2,4
63,2025-05-24T16:29:00+02:00,2025-05-25,00:29,0,1,1
63,2025-05-24T16:31:00+02:00,2025-05-25,00:31,0,1,1
63,2025-05-24T16:33:00+02:00,2025-05-25,00:33,0,4,4
63,2025-05-24T16:34:00+02:00,2025-05-25,00:34,0,1,1
67,2025-05-24T16:27:00+02:00,2025-05-25,00:27,1,2,3
67,2025-05-24T16:28:00+02:00,2025-05-25,00:28,0,3,3
67,2025-05-24T16:37:00+02:00,2025-05-25,00:37,1,3,4
68,2025-05-24T16:32:00+02:00,2025-05-25,00:32,1,0,1
72,2025-05-24T16:27:00+02:00,2025-05-25,00:27,0,1,1
72,2025-05-24T16:37:00+02:00,2025-05-25,00:37,0,2,2
79,2025-05-24T16:25:00+02:00,2025-05-25,00:25,5,5,10
79,2025-05-24T16:28:00+02:00,2025-05-25,00:28,17,0,17
79,2025-05-24T16:29:00+02:00,2025-05-25,00:29,0,7,7
79,2025-05-24T16:34:00+02:00,2025-05-25,00:34,2,2,4
109,2025-05-24T16:30:00+02:00,2025-05-25,00:30,6,5,11
109,2025-05-24T16:35:00+02:00,2025-05-25,00:35,2,10,12
117,2025-05-24T16:25:00+02:00,2025-05-25,00:25,6,4,10
139,2025-05-24T16:35:00+02:00,2025-05-25,00:35,1,0,1
141,2025-05-24T16:30:00+02:00,2025-05-25,00:30,3,3,6
164,2025-05-24T16:25:00+02:00,2025-05-25,00:25,1,4,5
181,2025-05-24T16:27:00+02:00,2025-05-25,00:27,2,2,4
181,2025-05-24T16:31:00+02:00,2025-05-25,00:31,7,5,12
181,2025-05-24T16:33:00+02:00,2025-05-25,00:33,4,1,5
182,2025-05-24T16:30:00+02:00,2025-05-25,00:30,13,6,19
181,2025-05-24T16:42:00+02:00,2025-05-25,00:42,0,6,6
181,2025-05-24T16:43:00+02:00,2025-05-25,00:43,1,2,3
181,2025-05-24T16:45:00+02:00,2025-05-25,00:45,5,4,9
181,2025-05-24T16:46:00+02:00,2025-05-25,00:46,4,4,8
181,2025-05-24T16:51:00+02:00,2025-05-25,00:51,11,5,16
181,2025-05-24T16:52:00+02:00,2025-05-25,00:52,1,5,6
182,2025-05-24T16:40:00+02:00,2025-05-25,00:40,16,11,27
3,2025-05-24T18:26:00+02:00,2025-05-25,02:26,1,0,1
3,2025-05-24T18:28:00+02:00,2025-05-25,02:28,2,2,4
3,2025-05-24T18:34:00+02:00,2025-05-25,02:34,2,3,5
4,2025-05-24T18:26:00+02:00,2025-05-25,02:26,2,0,2
4,2025-05-24T18:27:00+02:00,2025-05-25,02:27,9,7,16
4,2025-05-24T18:28:00+02:00,2025-05-25,02:28,1,3,4
4,2025-05-24T18:31:00+02:00,2025-05-25,02:31,1,5,6
4,2025-05-24T18:33:00+02:00,2025-05-25,02:33,3,0,3
5,2025-05-24T18:35:00+02:00,2025-05-25,02:35,5,5,10
6,2025-05-24T18:25:00+02:00,2025-05-25,02:25,2,2,4
6,2025-05-24T18:26:00+02:00,2025-05-25,02:26,5,1,6
6,2025-05-24T18:29:00+02:00,2025-05-25,02:29,2,1,3
6,2025-05-24T18:34:00+02:00,2025-05-25,02:34,4,0,4
6,2025-05-24T18:38:00+02:00,2025-05-25,02:38,2,4,6
28,2025-05-24T18:28:00+02:00,2025-05-25,02:28,1,0,1
28,2025-05-24T18:31:00+02:00,2025-05-25,02:31,1,0,1
28,2025-05-24T18:32:00+02:00,2025-05-25,02:32,2,0,2
36,2025-05-24T18:28:00+02:00,2025-05-25,02:28,0,1,1
36,2025-05-24T18:33:00+02:00,2025-05-25,02:33,2,0,2
36,2025-05-24T18:34:00+02:00,2025-05-25,02:34,1,0,1
36,2025-05-24T18:36:00+02:00,2025-05-25,02:36,3,8,11
36,2025-05-24T18:38:00+02:00,2025-05-25,02:38,0,3,3
37,2025-05-24T18:31:00+02:00,2025-05-25,02:31,0,1,1
41,2025-05-24T18:25:00+02:00,2025-05-25,02:25,0,2,2
41,2025-05-24T18:33:00+02:00,2025-05-25,02:33,0,5,5
41,2025-05-24T18:38:00+02:00,2025-05-25,02:38,0,3,3
45,2025-05-24T18:26:00+02:00,2025-05-25,02:26,2,0,2
45,2025-05-24T18:28:00+02:00,2025-05-25,02:28,2,1,3
45,2025-05-24T18:33:00+02:00,2025-05-25,02:33,0,1,1
45,2025-05-24T18:35:00+02:00,2025-05-25,02:35,0,2,2
45,2025-05-24T18:37:00+02:00,2025-05-25,02:37,0,6,6
47,2025-05-24T18:27:00+02:00,2025-05-25,02:27,1,0,1
47,2025-05-24T18:37:00+02:00,2025-05-25,02:37,0,6,6
50,2025-05-24T18:31:00+02:00,2025-05-25,02:31,0,1,1
54,2025-05-24T18:26:00+02:00,2025-05-25,02:26,2,0,2
54,2025-05-24T18:37:00+02:00,2025-05-25,02:37,2,0,2
61,2025-05-24T18:30:00+02:00,2025-05-25,02:30,1,0,1
61,2025-05-24T18:31:00+02:00,2025-05-25,02:31,2,0,2
61,2025-05-24T18:33:00+02:00,2025-05-25,02:33,0,1,1
61,2025-05-24T18:35:00+02:00,2025-05-25,02:35,3,0,3
66,2025-05-24T18:27:00+02:00,2025-05-25,02:27,0,6,6
77,2025-05-24T18:35:00+02:00,2025-05-25,02:35,0,1,1
78,2025-05-24T18:29:00+02:00,2025-05-25,02:29,0,1,1
108,2025-05-24T18:34:00+02:00,2025-05-25,02:34,1,0,1
108,2025-05-24T18:37:00+02:00,2025-05-25,02:37,1,0,1
131,2025-05-24T18:25:00+02:00,2025-05-25,02:25,4,2,6
131,2025-05-24T18:30:00+02:00,2025-05-25,02:30,4,17,21
131,2025-05-24T18:35:00+02:00,2025-05-25,02:35,7,1,8
134,2025-05-24T18:35:00+02:00,2025-05-25,02:35,4,0,4
162,2025-05-24T18:25:00+02:00,2025-05-25,02:25,1,1,2
162,2025-05-24T18:35:00+02:00,2025-05-25,02:35,3,3,6
167,2025-05-24T18:25:00+02:00,2025-05-25,02:25,0,1,1
167,2025-05-24T18:35:00+02:00,2025-05-25,02:35,0,1,1
1,2025-05-24T18:31:00+02:00,2025-05-25,02:31,1,1,2
1,2025-05-24T18:32:00+02:00,2025-05-25,02:32,1,0,1
1,2025-05-24T18:37:00+02:00,2025-05-25,02:37,1,0,1
2,2025-05-24T18:38:00+02:00,2025-05-25,02:38,0,4,4
17,2025-05-24T18:31:00+02:00,2025-05-25,02:31,3,0,3
19,2025-05-24T18:26:00+02:00,2025-05-25,02:26,0,3,3
19,2025-05-24T18:27:00+02:00,2025-05-25,02:27,1,2,3
19,2025-05-24T18:32:00+02:00,2025-05-25,02:32,0,2,2
19,2025-05-24T18:33:00+02:00,2025-05-25,02:33,0,9,9
19,2025-05-24T18:34:00+02:00,2025-05-25,02:34,4,7,11
19,2025-05-24T18:35:00+02:00,2025-05-25,02:35,1,3,4
19,2025-05-24T18:38:00+02:00,2025-05-25,02:38,0,3,3
20,2025-05-24T18:25:00+02:00,2025-05-25,02:25,4,1,5
20,2025-05-24T18:26:00+02:00,2025-05-25,02:26,0,7,7
20,2025-05-24T18:27:00+02:00,2025-05-25,02:27,2,5,7
20,2025-05-24T18:29:00+02:00,2025-05-25,02:29,5,4,9
20,2025-05-24T18:30:00+02:00,2025-05-25,02:30,2,6,8
20,2025-05-24T18:36:00+02:00,2025-05-25,02:36,5,2,7
23,2025-05-24T18:35:00+02:00,2025-05-25,02:35,1,0,1
23,2025-05-24T18:39:00+02:00,2025-05-25,02:39,0,2,2
24,2025-05-24T18:35:00+02:00,2025-05-25,02:35,0,1,1
25,2025-05-24T18:25:00+02:00,2025-05-25,02:25,3,2,5
27,2025-05-24T18:27:00+02:00,2025-05-25,02:27,1,0,1
27,2025-05-24T18:35:00+02:00,2025-05-25,02:35,1,0,1
30,2025-05-24T18:28:00+02:00,2025-05-25,02:28,0,6,6
30,2025-05-24T18:31:00+02:00,2025-05-25,02:31,0,3,3
30,2025-05-24T18:35:00+02:00,2025-05-25,02:35,4,10,14
30,2025-05-24T18:36:00+02:00,2025-05-25,02:36,4,5,9
35,2025-05-24T18:32:00+02:00,2025-05-25,02:32,1,3,4
35,2025-05-24T18:36:00+02:00,2025-05-25,02:36,1,0,1
35,2025-05-24T18:37:00+02:00,2025-05-25,02:37,0,2,2
49,2025-05-24T18:35:00+02:00,2025-05-25,02:35,0,1,1
49,2025-05-24T18:36:00+02:00,2025-05-25,02:36,0,4,4
51,2025-05-24T18:29:00+02:00,2025-05-25,02:29,1,0,1
51,2025-05-24T18:33:00+02:00,2025-05-25,02:33,0,1,1
51,2025-05-24T18:39:00+02:00,2025-05-25,02:39,0,2,2
52,2025-05-24T18:28:00+02:00,2025-05-25,02:28,0,4,4
52,2025-05-24T18:30:00+02:00,2025-05-25,02:30,2,0,2
52,2025-05-24T18:34:00+02:00,2025-05-25,02:34,4,4,8
52,2025-05-24T18:37:00+02:00,2025-05-25,02:37,0,1,1
53,2025-05-24T18:28:00+02:00,2025-05-25,02:28,0,1,1
56,2025-05-24T18:25:00+02:00,2025-05-25,02:25,3,0,3
56,2025-05-24T18:35:00+02:00,2025-05-25,02:35,1,0,1
56,2025-05-24T18:37:00+02:00,2025-05-25,02:37,2,0,2
58,2025-05-24T18:26:00+02:00,2025-05-25,02:26,3,4,7
58,2025-05-24T18:32:00+02:00,2025-05-25,02:32,0,4,4
58,2025-05-24T18:36:00+02:00,2025-05-25,02:36,0,5,5
62,2025-05-24T18:30:00+02:00,2025-05-25,02:30,1,0,1
62,2025-05-24T18:39:00+02:00,2025-05-25,02:39,1,4,5
63,2025-05-24T18:27:00+02:00,2025-05-25,02:27,0,4,4
63,2025-05-24T18:37:00+02:00,2025-05-25,02:37,0,2,2
67,2025-05-24T18:34:00+02:00,2025-05-25,02:34,0,1,1
67,2025-05-24T18:37:00+02:00,2025-05-25,02:37,0,3,3
67,2025-05-24T18:38:00+02:00,2025-05-25,02:38,0,2,2
72,2025-05-24T18:25:00+02:00,2025-05-25,02:25,0,4,4
72,2025-05-24T18:26:00+02:00,2025-05-25,02:26,0,6,6
72,2025-05-24T18:37:00+02:00,2025-05-25,02:37,1,0,1
72,2025-05-24T18:38:00+02:00,2025-05-25,02:38,0,1,1
76,2025-05-24T18:33:00+02:00,2025-05-25,02:33,0,1,1
79,2025-05-24T18:26:00+02:00,2025-05-25,02:26,1,2,3
79,2025-05-24T18:28:00+02:00,2025-05-25,02:28,3,0,3
79,2025-05-24T18:32:00+02:00,2025-05-25,02:32,2,2,4
79,2025-05-24T18:35:00+02:00,2025-05-25,02:35,3,2,5
86,2025-05-24T18:37:00+02:00,2025-05-25,02:37,0,1,1
141,2025-05-24T18:25:00+02:00,2025-05-25,02:25,0,2,2
141,2025-05-24T18:35:00+02:00,2025-05-25,02:35,2,5,7
142,2025-05-24T18:35:00+02:00,2025-05-25,02:35,0,2,2
3,2025-05-24T18:10:00+02:00,2025-05-25,02:10,0,2,2
3,2025-05-24T18:16:00+02:00,2025-05-25,02:16,3,1,4
3,2025-05-24T18:18:00+02:00,2025-05-25,02:18,2,4,6
3,2025-05-24T18:21:00+02:00,2025-05-25,02:21,0,3,3
3,2025-05-24T18:22:00+02:00,2025-05-25,02:22,0,1,1
3,2025-05-24T18:24:00+02:00,2025-05-25,02:24,1,4,5
4,2025-05-24T18:10:00+02:00,2025-05-25,02:10,0,1,1
4,2025-05-24T18:12:00+02:00,2025-05-25,02:12,2,4,6
4,2025-05-24T18:14:00+02:00,2025-05-25,02:14,0,1,1
4,2025-05-24T18:17:00+02:00,2025-05-25,02:17,1,1,2
4,2025-05-24T18:20:00+02:00,2025-05-25,02:20,3,1,4
4,2025-05-24T18:22:00+02:00,2025-05-25,02:22,0,3,3
4,2025-05-24T18:24:00+02:00,2025-05-25,02:24,0,2,2
5,2025-05-24T18:10:00+02:00,2025-05-25,02:10,4,5,9
6,2025-05-24T18:16:00+02:00,2025-05-25,02:16,1,0,1
6,2025-05-24T18:19:00+02:00,2025-05-25,02:19,2,0,2
6,2025-05-24T18:20:00+02:00,2025-05-25,02:20,1,1,2
28,2025-05-24T18:13:00+02:00,2025-05-25,02:13,0,1,1
28,2025-05-24T18:20:00+02:00,2025-05-25,02:20,0,2,2
28,2025-05-24T18:22:00+02:00,2025-05-25,02:22,1,1,2
36,2025-05-24T18:12:00+02:00,2025-05-25,02:12,2,5,7
36,2025-05-24T18:21:00+02:00,2025-05-25,02:21,2,2,4
41,2025-05-24T18:15:00+02:00,2025-05-25,02:15,0,4,4
41,2025-05-24T18:19:00+02:00,2025-05-25,02:19,0,5,5
41,2025-05-24T18:24:00+02:00,2025-05-25,02:24,0,1,1
45,2025-05-24T18:17:00+02:00,2025-05-25,02:17,0,5,5
45,2025-05-24T18:20:00+02:00,2025-05-25,02:20,1,0,1
45,2025-05-24T18:21:00+02:00,2025-05-25,02:21,3,3,6
47,2025-05-24T18:11:00+02:00,2025-05-25,02:11,4,1,5
50,2025-05-24T18:22:00+02:00,2025-05-25,02:22,1,0,1
54,2025-05-24T18:23:00+02:00,2025-05-25,02:23,0,1,1
59,2025-05-24T18:20:00+02:00,2025-05-25,02:20,8,2,10
61,2025-05-24T18:18:00+02:00,2025-05-25,02:18,2,0,2
61,2025-05-24T18:21:00+02:00,2025-05-25,02:21,5,0,5
61,2025-05-24T18:24:00+02:00,2025-05-25,02:24,2,0,2
66,2025-05-24T18:11:00+02:00,2025-05-25,02:11,1,1,2
66,2025-05-24T18:19:00+02:00,2025-05-25,02:19,0,1,1
66,2025-05-24T18:20:00+02:00,2025-05-25,02:20,3,0,3
66,2025-05-24T18:24:00+02:00,2025-05-25,02:24,1,1,2
69,2025-05-24T18:19:00+02:00,2025-05-25,02:19,1,0,1
70,2025-05-24T18:11:00+02:00,2025-05-25,02:11,1,0,1
78,2025-05-24T18:13:00+02:00,2025-05-25,02:13,0,1,1
107,2025-05-24T18:10:00+02:00,2025-05-25,02:10,1,2,3
107,2025-05-24T18:20:00+02:00,2025-05-25,02:20,6,0,6
108,2025-05-24T18:15:00+02:00,2025-05-25,02:15,2,0,2
131,2025-05-24T18:15:00+02:00,2025-05-25,02:15,3,14,17
131,2025-05-24T18:20:00+02:00,2025-05-25,02:20,3,9,12
133,2025-05-24T18:15:00+02:00,2025-05-25,02:15,1,1,2
133,2025-05-24T18:20:00+02:00,2025-05-25,02:20,0,2,2
135,2025-05-24T18:10:00+02:00,2025-05-25,02:10,1,3,4
135,2025-05-24T18:15:00+02:00,2025-05-25,02:15,1,1,2
135,2025-05-24T18:20:00+02:00,2025-05-25,02:20,1,2,3
167,2025-05-24T18:15:00+02:00,2025-05-25,02:15,1,1,2
179,2025-05-24T18:15:00+02:00,2025-05-25,02:15,1,0,1
179,2025-05-24T18:20:00+02:00,2025-05-25,02:20,2,1,3
1,2025-05-24T18:10:00+02:00,2025-05-25,02:10,0,1,1
1,2025-05-24T18:11:00+02:00,2025-05-25,02:11,0,1,1
1,2025-05-24T18:16:00+02:00,2025-05-25,02:16,0,4,4
1,2025-05-24T18:19:00+02:00,2025-05-25,02:19,2,2,4
2,2025-05-24T18:17:00+02:00,2025-05-25,02:17,1,0,1
2,2025-05-24T18:18:00+02:00,2025-05-25,02:18,0,2,2
2,2025-05-24T18:19:00+02:00,2025-05-25,02:19,0,1,1
9,2025-05-24T18:16:00+02:00,2025-05-25,02:16,1,0,1
11,2025-05-24T18:20:00+02:00,2025-05-25,02:20,0,1,1
12,2025-05-24T18:18:00+02:00,2025-05-25,02:18,0,2,2
17,2025-05-24T18:24:00+02:00,2025-05-25,02:24,1,0,1
19,2025-05-24T18:14:00+02:00,2025-05-25,02:14,0,2,2
19,2025-05-24T18:19:00+02:00,2025-05-25,02:19,0,3,3
19,2025-05-24T18:21:00+02:00,2025-05-25,02:21,6,2,8
20,2025-05-24T18:12:00+02:00,2025-05-25,02:12,0,5,5
20,2025-05-24T18:16:00+02:00,2025-05-25,02:16,1,2,3
23,2025-05-24T18:21:00+02:00,2025-05-25,02:21,0,2,2
24,2025-05-24T18:11:00+02:00,2025-05-25,02:11,0,6,6
24,2025-05-24T18:17:00+02:00,2025-05-25,02:17,0,4,4
24,2025-05-24T18:19:00+02:00,2025-05-25,02:19,2,2,4
27,2025-05-24T18:14:00+02:00,2025-05-25,02:14,2,0,2
30,2025-05-24T18:14:00+02:00,2025-05-25,02:14,1,2,3
30,2025-05-24T18:16:00+02:00,2025-05-25,02:16,3,4,7
30,2025-05-24T18:18:00+02:00,2025-05-25,02:18,8,0,8
30,2025-05-24T18:19:00+02:00,2025-05-25,02:19,1,2,3
30,2025-05-24T18:21:00+02:00,2025-05-25,02:21,5,1,6
49,2025-05-24T18:15:00+02:00,2025-05-25,02:15,2,3,5
49,2025-05-24T18:16:00+02:00,2025-05-25,02:16,2,2,4
49,2025-05-24T18:22:00+02:00,2025-05-25,02:22,0,2,2
51,2025-05-24T18:13:00+02:00,2025-05-25,02:13,1,0,1
52,2025-05-24T18:12:00+02:00,2025-05-25,02:12,2,0,2
52,2025-05-24T18:14:00+02:00,2025-05-25,02:14,10,0,10
52,2025-05-24T18:16:00+02:00,2025-05-25,02:16,0,1,1
52,2025-05-24T18:20:00+02:00,2025-05-25,02:20,1,1,2
53,2025-05-24T18:20:00+02:00,2025-05-25,02:20,0,1,1
56,2025-05-24T18:16:00+02:00,2025-05-25,02:16,0,1,1
56,2025-05-24T18:22:00+02:00,2025-05-25,02:22,2,0,2
56,2025-05-24T18:23:00+02:00,2025-05-25,02:23,2,4,6
58,2025-05-24T18:13:00+02:00,2025-05-25,02:13,0,1,1
58,2025-05-24T18:15:00+02:00,2025-05-25,02:15,2,0,2
58,2025-05-24T18:20:00+02:00,2025-05-25,02:20,0,4,4
63,2025-05-24T18:12:00+02:00,2025-05-25,02:12,0,1,1
63,2025-05-24T18:16:00+02:00,2025-05-25,02:16,1,1,2
67,2025-05-24T18:12:00+02:00,2025-05-25,02:12,0,1,1
67,2025-05-24T18:14:00+02:00,2025-05-25,02:14,0,3,3
67,2025-05-24T18:22:00+02:00,2025-05-25,02:22,2,0,2
67,2025-05-24T18:24:00+02:00,2025-05-25,02:24,1,2,3
79,2025-05-24T18:10:00+02:00,2025-05-25,02:10,4,0,4
79,2025-05-24T18:11:00+02:00,2025-05-25,02:11,0,3,3
79,2025-05-24T18:14:00+02:00,2025-05-25,02:14,1,0,1
79,2025-05-24T18:17:00+02:00,2025-05-25,02:17,0,6,6
79,2025-05-24T18:18:00+02:00,2025-05-25,02:18,1,3,4
79,2025-05-24T18:19:00+02:00,2025-05-25,02:19,0,2,2
86,2025-05-24T18:18:00+02:00,2025-05-25,02:18,0,1,1
109,2025-05-24T18:10:00+02:00,2025-05-25,02:10,1,3,4
117,2025-05-24T18:15:00+02:00,2025-05-25,02:15,0,1,1
142,2025-05-24T18:15:00+02:00,2025-05-25,02:15,0,1,1
3,2025-05-24T18:02:00+02:00,2025-05-25,02:02,3,2,5
3,2025-05-24T18:04:00+02:00,2025-05-25,02:04,6,0,6
3,2025-05-24T18:05:00+02:00,2025-05-25,02:05,0,2,2
3,2025-05-24T18:06:00+02:00,2025-05-25,02:06,2,4,6
4,2025-05-24T17:55:00+02:00,2025-05-25,01:55,0,2,2
4,2025-05-24T18:02:00+02:00,2025-05-25,02:02,4,13,17
4,2025-05-24T18:04:00+02:00,2025-05-25,02:04,1,5,6
4,2025-05-24T18:09:00+02:00,2025-05-25,02:09,0,4,4
6,2025-05-24T17:56:00+02:00,2025-05-25,01:56,1,1,2
6,2025-05-24T17:57:00+02:00,2025-05-25,01:57,3,3,6
6,2025-05-24T17:59:00+02:00,2025-05-25,01:59,2,2,4
6,2025-05-24T18:01:00+02:00,2025-05-25,02:01,2,0,2
6,2025-05-24T18:02:00+02:00,2025-05-25,02:02,6,0,6
28,2025-05-24T18:03:00+02:00,2025-05-25,02:03,1,4,5
28,2025-05-24T18:06:00+02:00,2025-05-25,02:06,1,0,1
29,2025-05-24T17:55:00+02:00,2025-05-25,01:55,0,2,2
29,2025-05-24T18:07:00+02:00,2025-05-25,02:07,0,2,2
31,2025-05-24T18:01:00+02:00,2025-05-25,02:01,0,3,3
31,2025-05-24T18:07:00+02:00,2025-05-25,02:07,1,0,1
36,2025-05-24T17:55:00+02:00,2025-05-25,01:55,1,1,2
36,2025-05-24T18:00:00+02:00,2025-05-25,02:00,3,2,5
36,2025-05-24T18:03:00+02:00,2025-05-25,02:03,4,1,5
40,2025-05-24T17:57:00+02:00,2025-05-25,01:57,2,0,2
40,2025-05-24T18:07:00+02:00,2025-05-25,02:07,2,0,2
41,2025-05-24T17:56:00+02:00,2025-05-25,01:56,1,2,3
41,2025-05-24T18:06:00+02:00,2025-05-25,02:06,0,3,3
41,2025-05-24T18:08:00+02:00,2025-05-25,02:08,0,1,1
43,2025-05-24T18:00:00+02:00,2025-05-25,02:00,0,3,3
44,2025-05-24T18:05:00+02:00,2025-05-25,02:05,2,0,2
45,2025-05-24T17:55:00+02:00,2025-05-25,01:55,2,7,9
45,2025-05-24T18:00:00+02:00,2025-05-25,02:00,2,7,9
45,2025-05-24T18:01:00+02:00,2025-05-25,02:01,1,0,1
45,2025-05-24T18:08:00+02:00,2025-05-25,02:08,0,2,2
47,2025-05-24T17:56:00+02:00,2025-05-25,01:56,1,5,6
47,2025-05-24T17:58:00+02:00,2025-05-25,01:58,0,4,4
47,2025-05-24T18:02:00+02:00,2025-05-25,02:02,3,1,4
47,2025-05-24T18:04:00+02:00,2025-05-25,02:04,1,1,2
47,2025-05-24T18:05:00+02:00,2025-05-25,02:05,0,1,1
50,2025-05-24T18:04:00+02:00,2025-05-25,02:04,3,0,3
61,2025-05-24T18:01:00+02:00,2025-05-25,02:01,0,2,2
61,2025-05-24T18:06:00+02:00,2025-05-25,02:06,0,1,1
66,2025-05-24T17:55:00+02:00,2025-05-25,01:55,0,7,7
66,2025-05-24T17:59:00+02:00,2025-05-25,01:59,1,0,1
66,2025-05-24T18:00:00+02:00,2025-05-25,02:00,2,1,3
66,2025-05-24T18:01:00+02:00,2025-05-25,02:01,1,1,2
66,2025-05-24T18:02:00+02:00,2025-05-25,02:02,2,5,7
66,2025-05-24T18:08:00+02:00,2025-05-25,02:08,6,0,6
66,2025-05-24T18:09:00+02:00,2025-05-25,02:09,0,2,2
107,2025-05-24T17:55:00+02:00,2025-05-25,01:55,2,2,4
108,2025-05-24T17:56:00+02:00,2025-05-25,01:56,1,0,1
108,2025-05-24T18:08:00+02:00,2025-05-25,02:08,2,0,2
118,2025-05-24T18:05:00+02:00,2025-05-25,02:05,0,1,1
132,2025-05-24T17:55:00+02:00,2025-05-25,01:55,2,6,8
133,2025-05-24T17:55:00+02:00,2025-05-25,01:55,0,4,4
166,2025-05-24T18:00:00+02:00,2025-05-25,02:00,0,1,1
179,2025-05-24T18:05:00+02:00,2025-05-25,02:05,0,2,2
1,2025-05-24T17:55:00+02:00,2025-05-25,01:55,0,2,2
1,2025-05-24T17:56:00+02:00,2025-05-25,01:56,3,0,3
1,2025-05-24T18:00:00+02:00,2025-05-25,02:00,0,2,2
1,2025-05-24T18:02:00+02:00,2025-05-25,02:02,1,0,1
2,2025-05-24T17:59:00+02:00,2025-05-25,01:59,0,3,3
2,2025-05-24T18:07:00+02:00,2025-05-25,02:07,0,6,6
2,2025-05-24T18:08:00+02:00,2025-05-25,02:08,0,1,1
11,2025-05-24T17:56:00+02:00,2025-05-25,01:56,2,0,2
12,2025-05-24T17:58:00+02:00,2025-05-25,01:58,2,0,2
18,2025-05-24T17:56:00+02:00,2025-05-25,01:56,1,0,1
19,2025-05-24T17:55:00+02:00,2025-05-25,01:55,6,2,8
19,2025-05-24T17:58:00+02:00,2025-05-25,01:58,0,2,2
19,2025-05-24T18:01:00+02:00,2025-05-25,02:01,1,5,6
19,2025-05-24T18:02:00+02:00,2025-05-25,02:02,1,2,3
19,2025-05-24T18:07:00+02:00,2025-05-25,02:07,0,1,1
20,2025-05-24T17:56:00+02:00,2025-05-25,01:56,1,8,9
20,2025-05-24T17:58:00+02:00,2025-05-25,01:58,0,6,6
20,2025-05-24T17:59:00+02:00,2025-05-25,01:59,2,10,12
20,2025-05-24T18:05:00+02:00,2025-05-25,02:05,1,2,3
20,2025-05-24T18:06:00+02:00,2025-05-25,02:06,4,4,8
23,2025-05-24T17:59:00+02:00,2025-05-25,01:59,0,2,2
23,2025-05-24T18:03:00+02:00,2025-05-25,02:03,0,2,2
23,2025-05-24T18:09:00+02:00,2025-05-25,02:09,0,1,1
24,2025-05-24T18:00:00+02:00,2025-05-25,02:00,2,1,3
24,2025-05-24T18:06:00+02:00,2025-05-25,02:06,1,2,3
25,2025-05-24T18:00:00+02:00,2025-05-25,02:00,7,3,10
25,2025-05-24T18:05:00+02:00,2025-05-25,02:05,5,6,11
30,2025-05-24T17:55:00+02:00,2025-05-25,01:55,4,7,11
30,2025-05-24T17:57:00+02:00,2025-05-25,01:57,1,5,6
30,2025-05-24T18:01:00+02:00,2025-05-25,02:01,4,1,5
30,2025-05-24T18:03:00+02:00,2025-05-25,02:03,5,3,8
30,2025-05-24T18:04:00+02:00,2025-05-25,02:04,2,4,6
30,2025-05-24T18:06:00+02:00,2025-05-25,02:06,0,7,7
30,2025-05-24T18:08:00+02:00,2025-05-25,02:08,0,4,4
35,2025-05-24T17:55:00+02:00,2025-05-25,01:55,1,0,1
35,2025-05-24T17:56:00+02:00,2025-05-25,01:56,0,1,1
35,2025-05-24T18:03:00+02:00,2025-05-25,02:03,3,0,3
35,2025-05-24T18:09:00+02:00,2025-05-25,02:09,0,2,2
49,2025-05-24T17:55:00+02:00,2025-05-25,01:55,2,2,4
49,2025-05-24T17:59:00+02:00,2025-05-25,01:59,0,2,2
49,2025-05-24T18:04:00+02:00,2025-05-25,02:04,3,2,5
49,2025-05-24T18:05:00+02:00,2025-05-25,02:05,2,0,2
51,2025-05-24T18:03:00+02:00,2025-05-25,02:03,0,1,1
51,2025-05-24T18:04:00+02:00,2025-05-25,02:04,1,1,2
52,2025-05-24T17:55:00+02:00,2025-05-25,01:55,2,0,2
52,2025-05-24T17:56:00+02:00,2025-05-25,01:56,2,3,5
52,2025-05-24T18:04:00+02:00,2025-05-25,02:04,1,0,1
53,2025-05-24T18:01:00+02:00,2025-05-25,02:01,2,0,2
53,2025-05-24T18:03:00+02:00,2025-05-25,02:03,3,0,3
53,2025-05-24T18:07:00+02:00,2025-05-25,02:07,0,2,2
53,2025-05-24T18:08:00+02:00,2025-05-25,02:08,3,1,4
56,2025-05-24T17:57:00+02:00,2025-05-25,01:57,0,1,1
56,2025-05-24T18:06:00+02:00,2025-05-25,02:06,1,0,1
58,2025-05-24T17:59:00+02:00,2025-05-25,01:59,0,10,10
58,2025-05-24T18:04:00+02:00,2025-05-25,02:04,1,1,2
62,2025-05-24T18:03:00+02:00,2025-05-25,02:03,1,0,1
62,2025-05-24T18:06:00+02:00,2025-05-25,02:06,5,0,5
62,2025-05-24T18:09:00+02:00,2025-05-25,02:09,2,0,2
63,2025-05-24T17:57:00+02:00,2025-05-25,01:57,0,2,2
63,2025-05-24T18:02:00+02:00,2025-05-25,02:02,1,2,3
63,2025-05-24T18:04:00+02:00,2025-05-25,02:04,0,1,1
63,2025-05-24T18:05:00+02:00,2025-05-25,02:05,0,4,4
63,2025-05-24T18:09:00+02:00,2025-05-25,02:09,0,3,3
67,2025-05-24T17:57:00+02:00,2025-05-25,01:57,0,1,1
67,2025-05-24T18:03:00+02:00,2025-05-25,02:03,1,0,1
67,2025-05-24T18:09:00+02:00,2025-05-25,02:09,0,1,1
68,2025-05-24T18:04:00+02:00,2025-05-25,02:04,2,0,2
72,2025-05-24T17:55:00+02:00,2025-05-25,01:55,0,1,1
76,2025-05-24T17:57:00+02:00,2025-05-25,01:57,0,1,1
79,2025-05-24T17:55:00+02:00,2025-05-25,01:55,1,3,4
79,2025-05-24T17:58:00+02:00,2025-05-25,01:58,1,4,5
141,2025-05-24T18:00:00+02:00,2025-05-25,02:00,8,2,10
142,2025-05-24T18:00:00+02:00,2025-05-25,02:00,1,0,1
164,2025-05-24T18:00:00+02:00,2025-05-25,02:00,3,0,3
181,2025-05-24T18:11:00+02:00,2025-05-25,02:11,0,4,4
181,2025-05-24T18:18:00+02:00,2025-05-25,02:18,6,0,6
181,2025-05-24T18:23:00+02:00,2025-05-25,02:23,0,3,3
181,2025-05-24T18:24:00+02:00,2025-05-25,02:24,4,0,4
182,2025-05-24T18:10:00+02:00,2025-05-25,02:10,12,11,23
182,2025-05-24T18:20:00+02:00,2025-05-25,02:20,13,9,22
181,2025-05-24T18:29:00+02:00,2025-05-25,02:29,0,2,2
181,2025-05-24T18:37:00+02:00,2025-05-25,02:37,3,2,5
182,2025-05-24T18:30:00+02:00,2025-05-25,02:30,7,5,12
3,2025-05-24T17:43:00+02:00,2025-05-25,01:43,1,0,1
3,2025-05-24T17:45:00+02:00,2025-05-25,01:45,9,3,12
4,2025-05-24T17:41:00+02:00,2025-05-25,01:41,3,1,4
4,2025-05-24T17:45:00+02:00,2025-05-25,01:45,6,3,9
4,2025-05-24T17:53:00+02:00,2025-05-25,01:53,0,6,6
4,2025-05-24T17:54:00+02:00,2025-05-25,01:54,2,3,5
6,2025-05-24T17:41:00+02:00,2025-05-25,01:41,1,3,4
6,2025-05-24T17:42:00+02:00,2025-05-25,01:42,0,3,3
6,2025-05-24T17:44:00+02:00,2025-05-25,01:44,3,1,4
6,2025-05-24T17:46:00+02:00,2025-05-25,01:46,5,0,5
6,2025-05-24T17:48:00+02:00,2025-05-25,01:48,2,0,2
28,2025-05-24T17:52:00+02:00,2025-05-25,01:52,2,0,2
28,2025-05-24T17:54:00+02:00,2025-05-25,01:54,5,0,5
36,2025-05-24T17:41:00+02:00,2025-05-25,01:41,4,1,5
36,2025-05-24T17:43:00+02:00,2025-05-25,01:43,4,5,9
36,2025-05-24T17:44:00+02:00,2025-05-25,01:44,2,2,4
36,2025-05-24T17:51:00+02:00,2025-05-25,01:51,3,3,6
36,2025-05-24T17:53:00+02:00,2025-05-25,01:53,8,1,9
36,2025-05-24T17:54:00+02:00,2025-05-25,01:54,0,1,1
39,2025-05-24T17:47:00+02:00,2025-05-25,01:47,1,0,1
40,2025-05-24T17:45:00+02:00,2025-05-25,01:45,1,0,1
40,2025-05-24T17:48:00+02:00,2025-05-25,01:48,1,2,3
40,2025-05-24T17:51:00+02:00,2025-05-25,01:51,0,4,4
40,2025-05-24T17:52:00+02:00,2025-05-25,01:52,2,0,2
41,2025-05-24T17:42:00+02:00,2025-05-25,01:42,1,0,1
41,2025-05-24T17:44:00+02:00,2025-05-25,01:44,0,4,4
41,2025-05-24T17:45:00+02:00,2025-05-25,01:45,1,3,4
41,2025-05-24T17:46:00+02:00,2025-05-25,01:46,0,3,3
41,2025-05-24T17:48:00+02:00,2025-05-25,01:48,1,1,2
41,2025-05-24T17:54:00+02:00,2025-05-25,01:54,2,6,8
45,2025-05-24T17:42:00+02:00,2025-05-25,01:42,1,0,1
45,2025-05-24T17:50:00+02:00,2025-05-25,01:50,0,8,8
45,2025-05-24T17:51:00+02:00,2025-05-25,01:51,0,2,2
45,2025-05-24T17:52:00+02:00,2025-05-25,01:52,7,1,8
47,2025-05-24T17:40:00+02:00,2025-05-25,01:40,1,3,4
47,2025-05-24T17:43:00+02:00,2025-05-25,01:43,1,4,5
47,2025-05-24T17:47:00+02:00,2025-05-25,01:47,4,1,5
54,2025-05-24T17:46:00+02:00,2025-05-25,01:46,2,1,3
59,2025-05-24T17:45:00+02:00,2025-05-25,01:45,1,2,3
59,2025-05-24T17:50:00+02:00,2025-05-25,01:50,8,1,9
61,2025-05-24T17:48:00+02:00,2025-05-25,01:48,0,2,2
66,2025-05-24T17:40:00+02:00,2025-05-25,01:40,7,0,7
66,2025-05-24T17:41:00+02:00,2025-05-25,01:41,6,2,8
66,2025-05-24T17:45:00+02:00,2025-05-25,01:45,0,2,2
66,2025-05-24T17:48:00+02:00,2025-05-25,01:48,2,2,4
66,2025-05-24T17:53:00+02:00,2025-05-25,01:53,3,1,4
70,2025-05-24T17:49:00+02:00,2025-05-25,01:49,0,1,1
77,2025-05-24T17:40:00+02:00,2025-05-25,01:40,3,0,3
78,2025-05-24T17:42:00+02:00,2025-05-25,01:42,0,1,1
78,2025-05-24T17:54:00+02:00,2025-05-25,01:54,0,1,1
84,2025-05-24T17:45:00+02:00,2025-05-25,01:45,8,11,19
108,2025-05-24T17:41:00+02:00,2025-05-25,01:41,4,1,5
108,2025-05-24T17:50:00+02:00,2025-05-25,01:50,2,0,2
131,2025-05-24T17:50:00+02:00,2025-05-25,01:50,5,16,21
132,2025-05-24T17:40:00+02:00,2025-05-25,01:40,1,2,3
135,2025-05-24T17:40:00+02:00,2025-05-25,01:40,5,4,9
135,2025-05-24T17:45:00+02:00,2025-05-25,01:45,11,9,20
162,2025-05-24T17:45:00+02:00,2025-05-25,01:45,4,3,7
1,2025-05-24T17:41:00+02:00,2025-05-25,01:41,2,0,2
1,2025-05-24T17:45:00+02:00,2025-05-25,01:45,4,0,4
1,2025-05-24T17:46:00+02:00,2025-05-25,01:46,0,2,2
1,2025-05-24T17:52:00+02:00,2025-05-25,01:52,5,6,11
2,2025-05-24T17:43:00+02:00,2025-05-25,01:43,0,2,2
2,2025-05-24T17:44:00+02:00,2025-05-25,01:44,0,3,3
9,2025-05-24T17:42:00+02:00,2025-05-25,01:42,0,1,1
9,2025-05-24T17:47:00+02:00,2025-05-25,01:47,0,1,1
11,2025-05-24T17:40:00+02:00,2025-05-25,01:40,1,1,2
11,2025-05-24T17:41:00+02:00,2025-05-25,01:41,0,1,1
17,2025-05-24T17:44:00+02:00,2025-05-25,01:44,1,0,1
17,2025-05-24T17:50:00+02:00,2025-05-25,01:50,0,1,1
17,2025-05-24T17:53:00+02:00,2025-05-25,01:53,3,0,3
19,2025-05-24T17:40:00+02:00,2025-05-25,01:40,2,3,5
19,2025-05-24T17:45:00+02:00,2025-05-25,01:45,1,3,4
19,2025-05-24T17:50:00+02:00,2025-05-25,01:50,1,0,1
19,2025-05-24T17:54:00+02:00,2025-05-25,01:54,0,11,11
20,2025-05-24T17:41:00+02:00,2025-05-25,01:41,4,4,8
20,2025-05-24T17:42:00+02:00,2025-05-25,01:42,6,3,9
20,2025-05-24T17:48:00+02:00,2025-05-25,01:48,7,1,8
20,2025-05-24T17:50:00+02:00,2025-05-25,01:50,6,0,6
20,2025-05-24T17:51:00+02:00,2025-05-25,01:51,6,1,7
20,2025-05-24T17:54:00+02:00,2025-05-25,01:54,3,1,4
23,2025-05-24T17:40:00+02:00,2025-05-25,01:40,0,4,4
24,2025-05-24T17:52:00+02:00,2025-05-25,01:52,0,1,1
24,2025-05-24T17:54:00+02:00,2025-05-25,01:54,4,1,5
25,2025-05-24T17:50:00+02:00,2025-05-25,01:50,0,1,1
27,2025-05-24T17:52:00+02:00,2025-05-25,01:52,0,2,2
27,2025-05-24T17:54:00+02:00,2025-05-25,01:54,2,0,2
30,2025-05-24T17:40:00+02:00,2025-05-25,01:40,9,2,11
30,2025-05-24T17:42:00+02:00,2025-05-25,01:42,1,2,3
30,2025-05-24T17:45:00+02:00,2025-05-25,01:45,0,3,3
30,2025-05-24T17:47:00+02:00,2025-05-25,01:47,1,4,5
30,2025-05-24T17:48:00+02:00,2025-05-25,01:48,2,2,4
30,2025-05-24T17:49:00+02:00,2025-05-25,01:49,0,1,1
30,2025-05-24T17:50:00+02:00,2025-05-25,01:50,1,4,5
30,2025-05-24T17:54:00+02:00,2025-05-25,01:54,1,1,2
35,2025-05-24T17:47:00+02:00,2025-05-25,01:47,1,1,2
35,2025-05-24T17:49:00+02:00,2025-05-25,01:49,2,4,6
35,2025-05-24T17:50:00+02:00,2025-05-25,01:50,2,3,5
35,2025-05-24T17:53:00+02:00,2025-05-25,01:53,1,2,3
49,2025-05-24T17:41:00+02:00,2025-05-25,01:41,8,1,9
49,2025-05-24T17:44:00+02:00,2025-05-25,01:44,5,0,5
49,2025-05-24T17:47:00+02:00,2025-05-25,01:47,4,0,4
49,2025-05-24T17:50:00+02:00,2025-05-25,01:50,2,4,6
49,2025-05-24T17:53:00+02:00,2025-05-25,01:53,0,3,3
52,2025-05-24T17:45:00+02:00,2025-05-25,01:45,2,0,2
52,2025-05-24T17:49:00+02:00,2025-05-25,01:49,0,9,9
52,2025-05-24T17:50:00+02:00,2025-05-25,01:50,6,3,9
52,2025-05-24T17:53:00+02:00,2025-05-25,01:53,3,2,5
53,2025-05-24T17:41:00+02:00,2025-05-25,01:41,3,0,3
53,2025-05-24T17:42:00+02:00,2025-05-25,01:42,0,4,4
53,2025-05-24T17:47:00+02:00,2025-05-25,01:47,4,0,4
53,2025-05-24T17:53:00+02:00,2025-05-25,01:53,0,9,9
56,2025-05-24T17:43:00+02:00,2025-05-25,01:43,0,2,2
56,2025-05-24T17:51:00+02:00,2025-05-25,01:51,0,4,4
58,2025-05-24T17:42:00+02:00,2025-05-25,01:42,2,2,4
58,2025-05-24T17:45:00+02:00,2025-05-25,01:45,0,2,2
58,2025-05-24T17:47:00+02:00,2025-05-25,01:47,0,1,1
58,2025-05-24T17:50:00+02:00,2025-05-25,01:50,2,1,3
58,2025-05-24T17:51:00+02:00,2025-05-25,01:51,4,1,5
58,2025-05-24T17:54:00+02:00,2025-05-25,01:54,1,0,1
62,2025-05-24T17:43:00+02:00,2025-05-25,01:43,1,0,1
62,2025-05-24T17:45:00+02:00,2025-05-25,01:45,1,0,1
62,2025-05-24T17:51:00+02:00,2025-05-25,01:51,2,0,2
62,2025-05-24T17:53:00+02:00,2025-05-25,01:53,0,2,2
62,2025-05-24T17:54:00+02:00,2025-05-25,01:54,3,0,3
63,2025-05-24T17:41:00+02:00,2025-05-25,01:41,0,1,1
63,2025-05-24T17:44:00+02:00,2025-05-25,01:44,0,1,1
63,2025-05-24T17:45:00+02:00,2025-05-25,01:45,0,3,3
63,2025-05-24T17:47:00+02:00,2025-05-25,01:47,0,1,1
63,2025-05-24T17:48:00+02:00,2025-05-25,01:48,1,0,1
63,2025-05-24T17:51:00+02:00,2025-05-25,01:51,0,1,1
67,2025-05-24T17:45:00+02:00,2025-05-25,01:45,1,0,1
67,2025-05-24T17:46:00+02:00,2025-05-25,01:46,2,0,2
67,2025-05-24T17:48:00+02:00,2025-05-25,01:48,0,1,1
67,2025-05-24T17:50:00+02:00,2025-05-25,01:50,0,2,2
72,2025-05-24T17:53:00+02:00,2025-05-25,01:53,0,4,4
79,2025-05-24T17:42:00+02:00,2025-05-25,01:42,2,6,8
79,2025-05-24T17:46:00+02:00,2025-05-25,01:46,1,1,2
109,2025-05-24T17:50:00+02:00,2025-05-25,01:50,0,3,3
164,2025-05-24T17:40:00+02:00,2025-05-25,01:40,2,1,3
164,2025-05-24T17:45:00+02:00,2025-05-25,01:45,2,2,4
3,2025-05-24T17:26:00+02:00,2025-05-25,01:26,1,5,6
3,2025-05-24T17:27:00+02:00,2025-05-25,01:27,3,4,7
3,2025-05-24T17:31:00+02:00,2025-05-25,01:31,2,3,5
3,2025-05-24T17:33:00+02:00,2025-05-25,01:33,1,9,10
4,2025-05-24T17:31:00+02:00,2025-05-25,01:31,2,1,3
4,2025-05-24T17:38:00+02:00,2025-05-25,01:38,0,3,3
5,2025-05-24T17:30:00+02:00,2025-05-25,01:30,4,2,6
5,2025-05-24T17:35:00+02:00,2025-05-25,01:35,6,2,8
6,2025-05-24T17:26:00+02:00,2025-05-25,01:26,1,5,6
6,2025-05-24T17:33:00+02:00,2025-05-25,01:33,5,0,5
28,2025-05-24T17:29:00+02:00,2025-05-25,01:29,4,0,4
29,2025-05-24T17:30:00+02:00,2025-05-25,01:30,0,2,2
29,2025-05-24T17:36:00+02:00,2025-05-25,01:36,0,1,1
31,2025-05-24T17:28:00+02:00,2025-05-25,01:28,2,0,2
36,2025-05-24T17:25:00+02:00,2025-05-25,01:25,1,5,6
36,2025-05-24T17:28:00+02:00,2025-05-25,01:28,1,1,2
36,2025-05-24T17:33:00+02:00,2025-05-25,01:33,2,1,3
36,2025-05-24T17:38:00+02:00,2025-05-25,01:38,2,7,9
36,2025-05-24T17:39:00+02:00,2025-05-25,01:39,11,4,15
37,2025-05-24T17:33:00+02:00,2025-05-25,01:33,1,0,1
37,2025-05-24T17:34:00+02:00,2025-05-25,01:34,0,5,5
40,2025-05-24T17:27:00+02:00,2025-05-25,01:27,1,0,1
40,2025-05-24T17:32:00+02:00,2025-05-25,01:32,6,0,6
40,2025-05-24T17:38:00+02:00,2025-05-25,01:38,2,0,2
41,2025-05-24T17:30:00+02:00,2025-05-25,01:30,1,0,1
41,2025-05-24T17:32:00+02:00,2025-05-25,01:32,2,11,13
41,2025-05-24T17:33:00+02:00,2025-05-25,01:33,0,4,4
41,2025-05-24T17:35:00+02:00,2025-05-25,01:35,1,1,2
41,2025-05-24T17:37:00+02:00,2025-05-25,01:37,4,0,4
43,2025-05-24T17:30:00+02:00,2025-05-25,01:30,1,0,1
45,2025-05-24T17:27:00+02:00,2025-05-25,01:27,1,0,1
45,2025-05-24T17:28:00+02:00,2025-05-25,01:28,1,10,11
45,2025-05-24T17:33:00+02:00,2025-05-25,01:33,0,4,4
45,2025-05-24T17:36:00+02:00,2025-05-25,01:36,2,2,4
45,2025-05-24T17:38:00+02:00,2025-05-25,01:38,10,3,13
45,2025-05-24T17:39:00+02:00,2025-05-25,01:39,0,4,4
47,2025-05-24T17:31:00+02:00,2025-05-25,01:31,2,5,7
50,2025-05-24T17:35:00+02:00,2025-05-25,01:35,0,2,2
54,2025-05-24T17:25:00+02:00,2025-05-25,01:25,0,1,1
54,2025-05-24T17:33:00+02:00,2025-05-25,01:33,1,0,1
54,2025-05-24T17:37:00+02:00,2025-05-25,01:37,0,1,1
54,2025-05-24T17:38:00+02:00,2025-05-25,01:38,1,0,1
59,2025-05-24T17:25:00+02:00,2025-05-25,01:25,5,3,8
59,2025-05-24T17:30:00+02:00,2025-05-25,01:30,9,0,9
59,2025-05-24T17:35:00+02:00,2025-05-25,01:35,11,0,11
61,2025-05-24T17:28:00+02:00,2025-05-25,01:28,2,0,2
61,2025-05-24T17:34:00+02:00,2025-05-25,01:34,1,0,1
61,2025-05-24T17:38:00+02:00,2025-05-25,01:38,2,2,4
66,2025-05-24T17:25:00+02:00,2025-05-25,01:25,4,12,16
66,2025-05-24T17:31:00+02:00,2025-05-25,01:31,5,1,6
66,2025-05-24T17:34:00+02:00,2025-05-25,01:34,3,0,3
66,2025-05-24T17:37:00+02:00,2025-05-25,01:37,8,0,8
66,2025-05-24T17:38:00+02:00,2025-05-25,01:38,2,0,2
66,2025-05-24T17:39:00+02:00,2025-05-25,01:39,3,7,10
69,2025-05-24T17:35:00+02:00,2025-05-25,01:35,1,0,1
77,2025-05-24T17:30:00+02:00,2025-05-25,01:30,5,1,6
84,2025-05-24T17:25:00+02:00,2025-05-25,01:25,3,14,17
107,2025-05-24T17:35:00+02:00,2025-05-25,01:35,0,4,4
132,2025-05-24T17:25:00+02:00,2025-05-25,01:25,1,1,2
132,2025-05-24T17:35:00+02:00,2025-05-25,01:35,2,0,2
133,2025-05-24T17:25:00+02:00,2025-05-25,01:25,2,0,2
133,2025-05-24T17:30:00+02:00,2025-05-25,01:30,1,3,4
162,2025-05-24T17:30:00+02:00,2025-05-25,01:30,1,2,3
167,2025-05-24T17:25:00+02:00,2025-05-25,01:25,1,0,1
179,2025-05-24T17:30:00+02:00,2025-05-25,01:30,0,1,1
1,2025-05-24T17:25:00+02:00,2025-05-25,01:25,1,0,1
1,2025-05-24T17:29:00+02:00,2025-05-25,01:29,2,0,2
1,2025-05-24T17:31:00+02:00,2025-05-25,01:31,4,1,5
1,2025-05-24T17:32:00+02:00,2025-05-25,01:32,0,1,1
1,2025-05-24T17:34:00+02:00,2025-05-25,01:34,6,0,6
1,2025-05-24T17:36:00+02:00,2025-05-25,01:36,0,1,1
2,2025-05-24T17:27:00+02:00,2025-05-25,01:27,0,4,4
2,2025-05-24T17:28:00+02:00,2025-05-25,01:28,1,0,1
2,2025-05-24T17:29:00+02:00,2025-05-25,01:29,2,1,3
2,2025-05-24T17:30:00+02:00,2025-05-25,01:30,1,0,1
2,2025-05-24T17:35:00+02:00,2025-05-25,01:35,0,1,1
9,2025-05-24T17:30:00+02:00,2025-05-25,01:30,1,0,1
9,2025-05-24T17:37:00+02:00,2025-05-25,01:37,0,1,1
11,2025-05-24T17:35:00+02:00,2025-05-25,01:35,0,1,1
12,2025-05-24T17:33:00+02:00,2025-05-25,01:33,4,1,5
12,2025-05-24T17:34:00+02:00,2025-05-25,01:34,0,2,2
19,2025-05-24T17:27:00+02:00,2025-05-25,01:27,0,5,5
19,2025-05-24T17:32:00+02:00,2025-05-25,01:32,2,5,7
20,2025-05-24T17:28:00+02:00,2025-05-25,01:28,0,2,2
20,2025-05-24T17:32:00+02:00,2025-05-25,01:32,0,2,2
20,2025-05-24T17:34:00+02:00,2025-05-25,01:34,2,3,5
20,2025-05-24T17:35:00+02:00,2025-05-25,01:35,5,0,5
20,2025-05-24T17:37:00+02:00,2025-05-25,01:37,1,2,3
24,2025-05-24T17:29:00+02:00,2025-05-25,01:29,2,2,4
24,2025-05-24T17:32:00+02:00,2025-05-25,01:32,0,2,2
24,2025-05-24T17:34:00+02:00,2025-05-25,01:34,2,10,12
24,2025-05-24T17:35:00+02:00,2025-05-25,01:35,0,1,1
25,2025-05-24T17:35:00+02:00,2025-05-25,01:35,1,4,5
27,2025-05-24T17:34:00+02:00,2025-05-25,01:34,1,0,1
30,2025-05-24T17:25:00+02:00,2025-05-25,01:25,1,7,8
30,2025-05-24T17:27:00+02:00,2025-05-25,01:27,4,4,8
30,2025-05-24T17:28:00+02:00,2025-05-25,01:28,1,0,1
30,2025-05-24T17:29:00+02:00,2025-05-25,01:29,8,3,11
30,2025-05-24T17:35:00+02:00,2025-05-25,01:35,0,4,4
30,2025-05-24T17:39:00+02:00,2025-05-25,01:39,5,1,6
35,2025-05-24T17:27:00+02:00,2025-05-25,01:27,1,3,4
35,2025-05-24T17:28:00+02:00,2025-05-25,01:28,1,0,1
35,2025-05-24T17:29:00+02:00,2025-05-25,01:29,3,3,6
35,2025-05-24T17:30:00+02:00,2025-05-25,01:30,3,0,3
35,2025-05-24T17:32:00+02:00,2025-05-25,01:32,6,1,7
35,2025-05-24T17:35:00+02:00,2025-05-25,01:35,0,2,2
35,2025-05-24T17:38:00+02:00,2025-05-25,01:38,0,1,1
35,2025-05-24T17:39:00+02:00,2025-05-25,01:39,5,0,5
49,2025-05-24T17:37:00+02:00,2025-05-25,01:37,3,0,3
49,2025-05-24T17:38:00+02:00,2025-05-25,01:38,0,2,2
51,2025-05-24T17:38:00+02:00,2025-05-25,01:38,2,0,2
52,2025-05-24T17:27:00+02:00,2025-05-25,01:27,5,1,6
52,2025-05-24T17:28:00+02:00,2025-05-25,01:28,1,2,3
52,2025-05-24T17:36:00+02:00,2025-05-25,01:36,1,0,1
53,2025-05-24T17:27:00+02:00,2025-05-25,01:27,1,0,1
53,2025-05-24T17:32:00+02:00,2025-05-25,01:32,0,3,3
56,2025-05-24T17:25:00+02:00,2025-05-25,01:25,0,1,1
56,2025-05-24T17:30:00+02:00,2025-05-25,01:30,1,2,3
56,2025-05-24T17:31:00+02:00,2025-05-25,01:31,1,0,1
56,2025-05-24T17:37:00+02:00,2025-05-25,01:37,2,0,2
56,2025-05-24T17:39:00+02:00,2025-05-25,01:39,1,3,4
58,2025-05-24T17:25:00+02:00,2025-05-25,01:25,1,7,8
58,2025-05-24T17:26:00+02:00,2025-05-25,01:26,0,7,7
58,2025-05-24T17:27:00+02:00,2025-05-25,01:27,2,0,2
58,2025-05-24T17:28:00+02:00,2025-05-25,01:28,1,3,4
58,2025-05-24T17:31:00+02:00,2025-05-25,01:31,4,1,5
62,2025-05-24T17:26:00+02:00,2025-05-25,01:26,0,1,1
62,2025-05-24T17:28:00+02:00,2025-05-25,01:28,3,0,3
63,2025-05-24T17:28:00+02:00,2025-05-25,01:28,0,2,2
63,2025-05-24T17:31:00+02:00,2025-05-25,01:31,0,11,11
63,2025-05-24T17:33:00+02:00,2025-05-25,01:33,1,2,3
67,2025-05-24T17:26:00+02:00,2025-05-25,01:26,0,1,1
67,2025-05-24T17:31:00+02:00,2025-05-25,01:31,0,1,1
67,2025-05-24T17:33:00+02:00,2025-05-25,01:33,0,2,2
72,2025-05-24T17:32:00+02:00,2025-05-25,01:32,2,0,2
72,2025-05-24T17:39:00+02:00,2025-05-25,01:39,0,2,2
79,2025-05-24T17:30:00+02:00,2025-05-25,01:30,2,5,7
79,2025-05-24T17:36:00+02:00,2025-05-25,01:36,2,3,5
79,2025-05-24T17:39:00+02:00,2025-05-25,01:39,0,3,3
109,2025-05-24T17:25:00+02:00,2025-05-25,01:25,8,5,13
139,2025-05-24T17:30:00+02:00,2025-05-25,01:30,1,0,1
139,2025-05-24T17:35:00+02:00,2025-05-25,01:35,1,0,1
141,2025-05-24T17:30:00+02:00,2025-05-25,01:30,12,1,13
142,2025-05-24T17:30:00+02:00,2025-05-25,01:30,2,0,2
181,2025-05-24T17:40:00+02:00,2025-05-25,01:40,4,2,6
181,2025-05-24T17:41:00+02:00,2025-05-25,01:41,6,4,10
181,2025-05-24T17:47:00+02:00,2025-05-25,01:47,1,1,2
181,2025-05-24T17:55:00+02:00,2025-05-25,01:55,0,1,1
181,2025-05-24T17:56:00+02:00,2025-05-25,01:56,1,0,1
181,2025-05-24T17:57:00+02:00,2025-05-25,01:57,0,7,7
181,2025-05-24T17:58:00+02:00,2025-05-25,01:58,3,4,7
181,2025-05-24T18:02:00+02:00,2025-05-25,02:02,1,3,4
181,2025-05-24T18:03:00+02:00,2025-05-25,02:03,0,2,2
181,2025-05-24T18:04:00+02:00,2025-05-25,02:04,8,0,8
181,2025-05-24T18:05:00+02:00,2025-05-25,02:05,1,4,5
181,2025-05-24T18:06:00+02:00,2025-05-25,02:06,2,0,2
181,2025-05-24T18:07:00+02:00,2025-05-25,02:07,5,2,7
181,2025-05-24T18:08:00+02:00,2025-05-25,02:08,1,1,2
182,2025-05-24T18:05:00+02:00,2025-05-25,02:05,2,7,9
181,2025-05-24T19:41:00+02:00,2025-05-25,03:41,0,4,4
181,2025-05-24T19:42:00+02:00,2025-05-25,03:42,3,0,3
181,2025-05-24T19:44:00+02:00,2025-05-25,03:44,0,5,5
181,2025-05-24T19:51:00+02:00,2025-05-25,03:51,2,0,2
181,2025-05-24T19:53:00+02:00,2025-05-25,03:53,2,0,2
181,2025-05-24T19:54:00+02:00,2025-05-25,03:54,4,0,4
3,2025-05-24T15:58:00+02:00,2025-05-24,23:58,7,15,22
3,2025-05-24T16:07:00+02:00,2025-05-25,00:07,10,6,16
3,2025-05-24T16:08:00+02:00,2025-05-25,00:08,2,2,4
3,2025-05-24T16:09:00+02:00,2025-05-25,00:09,1,8,9
4,2025-05-24T15:55:00+02:00,2025-05-24,23:55,3,7,10
4,2025-05-24T15:56:00+02:00,2025-05-24,23:56,9,4,13
4,2025-05-24T15:57:00+02:00,2025-05-24,23:57,1,11,12
4,2025-05-24T15:59:00+02:00,2025-05-24,23:59,7,6,13
4,2025-05-24T16:02:00+02:00,2025-05-25,00:02,9,3,12
4,2025-05-24T16:04:00+02:00,2025-05-25,00:04,5,2,7
4,2025-05-24T16:05:00+02:00,2025-05-25,00:05,7,6,13
4,2025-05-24T16:06:00+02:00,2025-05-25,00:06,9,14,23
5,2025-05-24T16:00:00+02:00,2025-05-25,00:00,5,22,27
6,2025-05-24T15:55:00+02:00,2025-05-24,23:55,3,4,7
6,2025-05-24T15:59:00+02:00,2025-05-24,23:59,5,4,9
6,2025-05-24T16:01:00+02:00,2025-05-25,00:01,17,1,18
6,2025-05-24T16:03:00+02:00,2025-05-25,00:03,14,5,19
6,2025-05-24T16:04:00+02:00,2025-05-25,00:04,3,2,5
28,2025-05-24T15:55:00+02:00,2025-05-24,23:55,0,2,2
28,2025-05-24T15:58:00+02:00,2025-05-24,23:58,1,0,1
28,2025-05-24T16:00:00+02:00,2025-05-25,00:00,0,2,2
28,2025-05-24T16:01:00+02:00,2025-05-25,00:01,0,3,3
28,2025-05-24T16:02:00+02:00,2025-05-25,00:02,3,1,4
28,2025-05-24T16:03:00+02:00,2025-05-25,00:03,1,0,1
28,2025-05-24T16:07:00+02:00,2025-05-25,00:07,0,1,1
28,2025-05-24T16:09:00+02:00,2025-05-25,00:09,0,1,1
29,2025-05-24T15:57:00+02:00,2025-05-24,23:57,0,3,3
29,2025-05-24T16:04:00+02:00,2025-05-25,00:04,0,5,5
31,2025-05-24T15:59:00+02:00,2025-05-24,23:59,10,2,12
31,2025-05-24T16:05:00+02:00,2025-05-25,00:05,0,5,5
31,2025-05-24T16:06:00+02:00,2025-05-25,00:06,0,2,2
31,2025-05-24T16:09:00+02:00,2025-05-25,00:09,0,7,7
36,2025-05-24T15:55:00+02:00,2025-05-24,23:55,5,5,10
36,2025-05-24T15:56:00+02:00,2025-05-24,23:56,2,3,5
36,2025-05-24T15:58:00+02:00,2025-05-24,23:58,0,7,7
36,2025-05-24T16:00:00+02:00,2025-05-25,00:00,6,2,8
36,2025-05-24T16:01:00+02:00,2025-05-25,00:01,7,7,14
36,2025-05-24T16:02:00+02:00,2025-05-25,00:02,3,5,8
36,2025-05-24T16:03:00+02:00,2025-05-25,00:03,6,4,10
36,2025-05-24T16:07:00+02:00,2025-05-25,00:07,1,5,6
37,2025-05-24T15:55:00+02:00,2025-05-24,23:55,1,0,1
37,2025-05-24T15:58:00+02:00,2025-05-24,23:58,1,1,2
37,2025-05-24T16:05:00+02:00,2025-05-25,00:05,0,5,5
39,2025-05-24T15:55:00+02:00,2025-05-24,23:55,0,1,1
39,2025-05-24T16:07:00+02:00,2025-05-25,00:07,1,0,1
39,2025-05-24T16:08:00+02:00,2025-05-25,00:08,0,1,1
40,2025-05-24T15:58:00+02:00,2025-05-24,23:58,0,2,2
40,2025-05-24T16:02:00+02:00,2025-05-25,00:02,1,0,1
40,2025-05-24T16:05:00+02:00,2025-05-25,00:05,1,2,3
40,2025-05-24T16:07:00+02:00,2025-05-25,00:07,2,0,2
41,2025-05-24T15:57:00+02:00,2025-05-24,23:57,2,0,2
41,2025-05-24T15:58:00+02:00,2025-05-24,23:58,0,14,14
43,2025-05-24T16:05:00+02:00,2025-05-25,00:05,1,0,1
44,2025-05-24T15:55:00+02:00,2025-05-24,23:55,0,2,2
45,2025-05-24T15:57:00+02:00,2025-05-24,23:57,0,4,4
45,2025-05-24T16:03:00+02:00,2025-05-25,00:03,7,2,9
45,2025-05-24T16:04:00+02:00,2025-05-25,00:04,2,7,9
47,2025-05-24T16:00:00+02:00,2025-05-25,00:00,8,3,11
47,2025-05-24T16:04:00+02:00,2025-05-25,00:04,4,4,8
47,2025-05-24T16:05:00+02:00,2025-05-25,00:05,2,3,5
47,2025-05-24T16:07:00+02:00,2025-05-25,00:07,3,6,9
47,2025-05-24T16:08:00+02:00,2025-05-25,00:08,1,6,7
54,2025-05-24T15:55:00+02:00,2025-05-24,23:55,0,11,11
54,2025-05-24T15:56:00+02:00,2025-05-24,23:56,3,1,4
54,2025-05-24T16:01:00+02:00,2025-05-25,00:01,2,2,4
54,2025-05-24T16:02:00+02:00,2025-05-25,00:02,0,1,1
54,2025-05-24T16:04:00+02:00,2025-05-25,00:04,5,0,5
54,2025-05-24T16:08:00+02:00,2025-05-25,00:08,1,0,1
59,2025-05-24T16:05:00+02:00,2025-05-25,00:05,7,13,20
61,2025-05-24T16:00:00+02:00,2025-05-25,00:00,0,2,2
61,2025-05-24T16:01:00+02:00,2025-05-25,00:01,1,0,1
61,2025-05-24T16:09:00+02:00,2025-05-25,00:09,2,0,2
66,2025-05-24T15:55:00+02:00,2025-05-24,23:55,4,3,7
66,2025-05-24T15:56:00+02:00,2025-05-24,23:56,20,3,23
66,2025-05-24T15:57:00+02:00,2025-05-24,23:57,17,1,18
66,2025-05-24T15:58:00+02:00,2025-05-24,23:58,5,8,13
66,2025-05-24T16:00:00+02:00,2025-05-25,00:00,14,7,21
66,2025-05-24T16:02:00+02:00,2025-05-25,00:02,2,10,12
66,2025-05-24T16:05:00+02:00,2025-05-25,00:05,3,7,10
66,2025-05-24T16:06:00+02:00,2025-05-25,00:06,3,6,9
66,2025-05-24T16:08:00+02:00,2025-05-25,00:08,5,0,5
69,2025-05-24T15:59:00+02:00,2025-05-24,23:59,0,1,1
69,2025-05-24T16:03:00+02:00,2025-05-25,00:03,1,0,1
70,2025-05-24T16:08:00+02:00,2025-05-25,00:08,0,2,2
78,2025-05-24T16:01:00+02:00,2025-05-25,00:01,0,1,1
107,2025-05-24T16:00:00+02:00,2025-05-25,00:00,1,3,4
108,2025-05-24T15:59:00+02:00,2025-05-24,23:59,0,2,2
108,2025-05-24T16:05:00+02:00,2025-05-25,00:05,9,4,13
108,2025-05-24T16:08:00+02:00,2025-05-25,00:08,3,0,3
132,2025-05-24T15:55:00+02:00,2025-05-24,23:55,10,2,12
132,2025-05-24T16:05:00+02:00,2025-05-25,00:05,6,5,11
135,2025-05-24T15:55:00+02:00,2025-05-24,23:55,3,4,7
135,2025-05-24T16:00:00+02:00,2025-05-25,00:00,8,2,10
162,2025-05-24T15:55:00+02:00,2025-05-24,23:55,6,3,9
165,2025-05-24T15:55:00+02:00,2025-05-24,23:55,0,1,1
165,2025-05-24T16:05:00+02:00,2025-05-25,00:05,3,1,4
1,2025-05-24T15:55:00+02:00,2025-05-24,23:55,2,4,6
1,2025-05-24T15:57:00+02:00,2025-05-24,23:57,2,0,2
1,2025-05-24T16:02:00+02:00,2025-05-25,00:02,0,3,3
1,2025-05-24T16:03:00+02:00,2025-05-25,00:03,1,5,6
1,2025-05-24T16:06:00+02:00,2025-05-25,00:06,4,2,6
1,2025-05-24T16:08:00+02:00,2025-05-25,00:08,4,1,5
1,2025-05-24T16:09:00+02:00,2025-05-25,00:09,1,2,3
2,2025-05-24T15:59:00+02:00,2025-05-24,23:59,0,4,4
2,2025-05-24T16:05:00+02:00,2025-05-25,00:05,2,2,4
2,2025-05-24T16:07:00+02:00,2025-05-25,00:07,0,2,2
2,2025-05-24T16:09:00+02:00,2025-05-25,00:09,2,0,2
9,2025-05-24T15:57:00+02:00,2025-05-24,23:57,2,0,2
10,2025-05-24T16:03:00+02:00,2025-05-25,00:03,0,1,1
12,2025-05-24T15:58:00+02:00,2025-05-24,23:58,0,2,2
17,2025-05-24T15:58:00+02:00,2025-05-24,23:58,2,0,2
17,2025-05-24T16:01:00+02:00,2025-05-25,00:01,2,2,4
17,2025-05-24T16:03:00+02:00,2025-05-25,00:03,2,0,2
17,2025-05-24T16:08:00+02:00,2025-05-25,00:08,1,2,3
17,2025-05-24T16:09:00+02:00,2025-05-25,00:09,0,4,4
18,2025-05-24T15:59:00+02:00,2025-05-24,23:59,1,0,1
19,2025-05-24T15:57:00+02:00,2025-05-24,23:57,2,5,7
19,2025-05-24T16:01:00+02:00,2025-05-25,00:01,7,8,15
19,2025-05-24T16:02:00+02:00,2025-05-25,00:02,4,1,5
19,2025-05-24T16:05:00+02:00,2025-05-25,00:05,3,6,9
20,2025-05-24T15:57:00+02:00,2025-05-24,23:57,11,3,14
20,2025-05-24T15:59:00+02:00,2025-05-24,23:59,5,4,9
20,2025-05-24T16:01:00+02:00,2025-05-25,00:01,8,8,16
20,2025-05-24T16:05:00+02:00,2025-05-25,00:05,8,0,8
20,2025-05-24T16:06:00+02:00,2025-05-25,00:06,2,10,12
20,2025-05-24T16:07:00+02:00,2025-05-25,00:07,3,9,12
23,2025-05-24T15:55:00+02:00,2025-05-24,23:55,3,0,3
23,2025-05-24T15:57:00+02:00,2025-05-24,23:57,0,3,3
23,2025-05-24T16:02:00+02:00,2025-05-25,00:02,0,1,1
23,2025-05-24T16:06:00+02:00,2025-05-25,00:06,2,3,5
23,2025-05-24T16:08:00+02:00,2025-05-25,00:08,10,1,11
24,2025-05-24T15:56:00+02:00,2025-05-24,23:56,1,4,5
25,2025-05-24T15:55:00+02:00,2025-05-24,23:55,1,3,4
27,2025-05-24T15:57:00+02:00,2025-05-24,23:57,3,0,3
27,2025-05-24T15:58:00+02:00,2025-05-24,23:58,0,2,2
27,2025-05-24T16:00:00+02:00,2025-05-25,00:00,0,2,2
27,2025-05-24T16:02:00+02:00,2025-05-25,00:02,1,0,1
27,2025-05-24T16:03:00+02:00,2025-05-25,00:03,1,0,1
27,2025-05-24T16:04:00+02:00,2025-05-25,00:04,0,1,1
27,2025-05-24T16:09:00+02:00,2025-05-25,00:09,4,0,4
30,2025-05-24T15:59:00+02:00,2025-05-24,23:59,10,3,13
30,2025-05-24T16:00:00+02:00,2025-05-25,00:00,12,6,18
30,2025-05-24T16:01:00+02:00,2025-05-25,00:01,3,11,14
30,2025-05-24T16:02:00+02:00,2025-05-25,00:02,8,8,16
30,2025-05-24T16:04:00+02:00,2025-05-25,00:04,10,7,17
30,2025-05-24T16:05:00+02:00,2025-05-25,00:05,5,3,8
35,2025-05-24T15:57:00+02:00,2025-05-24,23:57,2,4,6
35,2025-05-24T16:00:00+02:00,2025-05-25,00:00,5,6,11
35,2025-05-24T16:01:00+02:00,2025-05-25,00:01,11,4,15
35,2025-05-24T16:08:00+02:00,2025-05-25,00:08,2,3,5
46,2025-05-24T15:55:00+02:00,2025-05-24,23:55,0,1,1
49,2025-05-24T15:56:00+02:00,2025-05-24,23:56,4,0,4
49,2025-05-24T16:08:00+02:00,2025-05-25,00:08,4,1,5
52,2025-05-24T15:55:00+02:00,2025-05-24,23:55,4,10,14
52,2025-05-24T15:58:00+02:00,2025-05-24,23:58,2,7,9
52,2025-05-24T16:00:00+02:00,2025-05-25,00:00,6,2,8
52,2025-05-24T16:08:00+02:00,2025-05-25,00:08,0,2,2
52,2025-05-24T16:09:00+02:00,2025-05-25,00:09,1,8,9
53,2025-05-24T15:55:00+02:00,2025-05-24,23:55,2,0,2
53,2025-05-24T15:56:00+02:00,2025-05-24,23:56,3,2,5
53,2025-05-24T15:59:00+02:00,2025-05-24,23:59,4,0,4
53,2025-05-24T16:00:00+02:00,2025-05-25,00:00,1,1,2
53,2025-05-24T16:05:00+02:00,2025-05-25,00:05,2,0,2
53,2025-05-24T16:06:00+02:00,2025-05-25,00:06,1,3,4
53,2025-05-24T16:07:00+02:00,2025-05-25,00:07,9,0,9
56,2025-05-24T16:07:00+02:00,2025-05-25,00:07,3,0,3
58,2025-05-24T15:56:00+02:00,2025-05-24,23:56,2,5,7
58,2025-05-24T15:59:00+02:00,2025-05-24,23:59,1,1,2
58,2025-05-24T16:00:00+02:00,2025-05-25,00:00,0,14,14
58,2025-05-24T16:01:00+02:00,2025-05-25,00:01,3,5,8
58,2025-05-24T16:04:00+02:00,2025-05-25,00:04,1,12,13
58,2025-05-24T16:06:00+02:00,2025-05-25,00:06,10,3,13
58,2025-05-24T16:07:00+02:00,2025-05-25,00:07,4,15,19
62,2025-05-24T15:55:00+02:00,2025-05-24,23:55,7,0,7
62,2025-05-24T15:56:00+02:00,2025-05-24,23:56,2,0,2
62,2025-05-24T16:00:00+02:00,2025-05-25,00:00,2,0,2
62,2025-05-24T16:04:00+02:00,2025-05-25,00:04,0,3,3
62,2025-05-24T16:07:00+02:00,2025-05-25,00:07,2,0,2
62,2025-05-24T16:08:00+02:00,2025-05-25,00:08,3,5,8
63,2025-05-24T15:58:00+02:00,2025-05-24,23:58,1,2,3
63,2025-05-24T15:59:00+02:00,2025-05-24,23:59,0,3,3
63,2025-05-24T16:04:00+02:00,2025-05-25,00:04,0,3,3
63,2025-05-24T16:08:00+02:00,2025-05-25,00:08,2,0,2
67,2025-05-24T16:00:00+02:00,2025-05-25,00:00,0,5,5
67,2025-05-24T16:08:00+02:00,2025-05-25,00:08,1,2,3
72,2025-05-24T15:55:00+02:00,2025-05-24,23:55,1,8,9
72,2025-05-24T15:57:00+02:00,2025-05-24,23:57,2,4,6
72,2025-05-24T15:58:00+02:00,2025-05-24,23:58,0,2,2
72,2025-05-24T15:59:00+02:00,2025-05-24,23:59,1,6,7
72,2025-05-24T16:00:00+02:00,2025-05-25,00:00,0,10,10
72,2025-05-24T16:01:00+02:00,2025-05-25,00:01,3,14,17
72,2025-05-24T16:02:00+02:00,2025-05-25,00:02,2,10,12
72,2025-05-24T16:07:00+02:00,2025-05-25,00:07,0,6,6
76,2025-05-24T16:02:00+02:00,2025-05-25,00:02,2,0,2
79,2025-05-24T15:56:00+02:00,2025-05-24,23:56,5,2,7
79,2025-05-24T15:58:00+02:00,2025-05-24,23:58,2,2,4
79,2025-05-24T16:02:00+02:00,2025-05-25,00:02,1,5,6
79,2025-05-24T16:03:00+02:00,2025-05-25,00:03,3,8,11
79,2025-05-24T16:04:00+02:00,2025-05-25,00:04,6,3,9
79,2025-05-24T16:06:00+02:00,2025-05-25,00:06,3,2,5
79,2025-05-24T16:07:00+02:00,2025-05-25,00:07,3,2,5
86,2025-05-24T15:57:00+02:00,2025-05-24,23:57,0,1,1
86,2025-05-24T16:08:00+02:00,2025-05-25,00:08,0,1,1
109,2025-05-24T15:55:00+02:00,2025-05-24,23:55,2,1,3
117,2025-05-24T16:05:00+02:00,2025-05-25,00:05,8,3,11
130,2025-05-24T16:00:00+02:00,2025-05-25,00:00,1,0,1
142,2025-05-24T16:05:00+02:00,2025-05-25,00:05,0,1,1
181,2025-05-24T15:55:00+02:00,2025-05-24,23:55,6,5,11
181,2025-05-24T15:56:00+02:00,2025-05-24,23:56,2,3,5
181,2025-05-24T15:58:00+02:00,2025-05-24,23:58,6,6,12
181,2025-05-24T15:59:00+02:00,2025-05-24,23:59,0,6,6
181,2025-05-24T16:00:00+02:00,2025-05-25,00:00,4,12,16
181,2025-05-24T16:01:00+02:00,2025-05-25,00:01,13,1,14
181,2025-05-24T16:04:00+02:00,2025-05-25,00:04,4,3,7
181,2025-05-24T16:08:00+02:00,2025-05-25,00:08,11,2,13
182,2025-05-24T16:05:00+02:00,2025-05-25,00:05,10,34,44
70,2025-05-24T15:56:00+02:00,2025-05-24,23:56,0,1,1
70,2025-05-24T16:04:00+02:00,2025-05-25,00:04,1,0,1
71,2025-05-24T16:04:00+02:00,2025-05-25,00:04,1,0,1
77,2025-05-24T16:00:00+02:00,2025-05-25,00:00,3,0,3
108,2025-05-24T15:56:00+02:00,2025-05-24,23:56,2,2,4
108,2025-05-24T15:57:00+02:00,2025-05-24,23:57,4,1,5
108,2025-05-24T16:04:00+02:00,2025-05-25,00:04,5,5,10
108,2025-05-24T16:06:00+02:00,2025-05-25,00:06,0,2,2
118,2025-05-24T15:55:00+02:00,2025-05-24,23:55,0,1,1
118,2025-05-24T16:00:00+02:00,2025-05-25,00:00,1,1,2
133,2025-05-24T15:55:00+02:00,2025-05-24,23:55,13,7,20
134,2025-05-24T16:05:00+02:00,2025-05-25,00:05,15,5,20
45,2025-05-24T16:23:00+02:00,2025-05-25,00:23,1,12,13
45,2025-05-24T16:24:00+02:00,2025-05-25,00:24,1,15,16
47,2025-05-24T16:16:00+02:00,2025-05-25,00:16,2,4,6
47,2025-05-24T16:21:00+02:00,2025-05-25,00:21,3,0,3
50,2025-05-24T16:11:00+02:00,2025-05-25,00:11,1,0,1
50,2025-05-24T16:23:00+02:00,2025-05-25,00:23,2,0,2
54,2025-05-24T16:24:00+02:00,2025-05-25,00:24,0,2,2
59,2025-05-24T16:15:00+02:00,2025-05-25,00:15,5,7,12
61,2025-05-24T16:11:00+02:00,2025-05-25,00:11,2,1,3
61,2025-05-24T16:14:00+02:00,2025-05-25,00:14,2,0,2
61,2025-05-24T16:17:00+02:00,2025-05-25,00:17,0,2,2
61,2025-05-24T16:18:00+02:00,2025-05-25,00:18,1,0,1
61,2025-05-24T16:19:00+02:00,2025-05-25,00:19,3,0,3
66,2025-05-24T16:11:00+02:00,2025-05-25,00:11,1,5,6
66,2025-05-24T16:18:00+02:00,2025-05-25,00:18,2,4,6
66,2025-05-24T16:20:00+02:00,2025-05-25,00:20,1,1,2
69,2025-05-24T16:10:00+02:00,2025-05-25,00:10,0,2,2
69,2025-05-24T16:16:00+02:00,2025-05-25,00:16,0,2,2
71,2025-05-24T16:12:00+02:00,2025-05-25,00:12,2,0,2
77,2025-05-24T16:10:00+02:00,2025-05-25,00:10,4,0,4
77,2025-05-24T16:15:00+02:00,2025-05-25,00:15,0,3,3
78,2025-05-24T16:20:00+02:00,2025-05-25,00:20,0,1,1
84,2025-05-24T16:10:00+02:00,2025-05-25,00:10,13,25,38
84,2025-05-24T16:15:00+02:00,2025-05-25,00:15,21,14,35
108,2025-05-24T16:11:00+02:00,2025-05-25,00:11,2,0,2
108,2025-05-24T16:19:00+02:00,2025-05-25,00:19,0,1,1
108,2025-05-24T16:24:00+02:00,2025-05-25,00:24,1,0,1
132,2025-05-24T16:20:00+02:00,2025-05-25,00:20,6,4,10
133,2025-05-24T16:15:00+02:00,2025-05-25,00:15,11,11,22
133,2025-05-24T16:20:00+02:00,2025-05-25,00:20,5,6,11
134,2025-05-24T16:10:00+02:00,2025-05-25,00:10,8,10,18
134,2025-05-24T16:15:00+02:00,2025-05-25,00:15,10,10,20
135,2025-05-24T16:10:00+02:00,2025-05-25,00:10,4,3,7
135,2025-05-24T16:20:00+02:00,2025-05-25,00:20,8,8,16
162,2025-05-24T16:20:00+02:00,2025-05-25,00:20,7,4,11
165,2025-05-24T16:10:00+02:00,2025-05-25,00:10,2,0,2
167,2025-05-24T16:10:00+02:00,2025-05-25,00:10,0,2,2
167,2025-05-24T16:15:00+02:00,2025-05-25,00:15,1,0,1
179,2025-05-24T16:20:00+02:00,2025-05-25,00:20,1,0,1
1,2025-05-24T16:10:00+02:00,2025-05-25,00:10,4,1,5
1,2025-05-24T16:12:00+02:00,2025-05-25,00:12,2,0,2
1,2025-05-24T16:13:00+02:00,2025-05-25,00:13,4,1,5
1,2025-05-24T16:16:00+02:00,2025-05-25,00:16,1,5,6
1,2025-05-24T16:17:00+02:00,2025-05-25,00:17,3,6,9
1,2025-05-24T16:23:00+02:00,2025-05-25,00:23,1,0,1
1,2025-05-24T16:24:00+02:00,2025-05-25,00:24,1,0,1
2,2025-05-24T16:14:00+02:00,2025-05-25,00:14,0,1,1
9,2025-05-24T16:11:00+02:00,2025-05-25,00:11,2,0,2
9,2025-05-24T16:18:00+02:00,2025-05-25,00:18,0,5,5
11,2025-05-24T16:15:00+02:00,2025-05-25,00:15,0,1,1
11,2025-05-24T16:24:00+02:00,2025-05-25,00:24,1,0,1
12,2025-05-24T16:12:00+02:00,2025-05-25,00:12,2,0,2
12,2025-05-24T16:13:00+02:00,2025-05-25,00:13,2,1,3
12,2025-05-24T16:14:00+02:00,2025-05-25,00:14,2,2,4
17,2025-05-24T16:21:00+02:00,2025-05-25,00:21,0,6,6
17,2025-05-24T16:24:00+02:00,2025-05-25,00:24,1,0,1
18,2025-05-24T16:12:00+02:00,2025-05-25,00:12,0,1,1
19,2025-05-24T16:11:00+02:00,2025-05-25,00:11,7,4,11
19,2025-05-24T16:17:00+02:00,2025-05-25,00:17,4,0,4
19,2025-05-24T16:19:00+02:00,2025-05-25,00:19,3,9,12
19,2025-05-24T16:22:00+02:00,2025-05-25,00:22,0,1,1
19,2025-05-24T16:23:00+02:00,2025-05-25,00:23,0,1,1
20,2025-05-24T16:12:00+02:00,2025-05-25,00:12,9,7,16
20,2025-05-24T16:14:00+02:00,2025-05-25,00:14,12,2,14
20,2025-05-24T16:18:00+02:00,2025-05-25,00:18,2,3,5
20,2025-05-24T16:19:00+02:00,2025-05-25,00:19,0,8,8
20,2025-05-24T16:20:00+02:00,2025-05-25,00:20,1,0,1
20,2025-05-24T16:21:00+02:00,2025-05-25,00:21,4,7,11
20,2025-05-24T16:24:00+02:00,2025-05-25,00:24,7,0,7
23,2025-05-24T16:10:00+02:00,2025-05-25,00:10,3,0,3
23,2025-05-24T16:12:00+02:00,2025-05-25,00:12,1,1,2
23,2025-05-24T16:22:00+02:00,2025-05-25,00:22,3,4,7
23,2025-05-24T16:23:00+02:00,2025-05-25,00:23,2,6,8
24,2025-05-24T16:10:00+02:00,2025-05-25,00:10,5,4,9
24,2025-05-24T16:13:00+02:00,2025-05-25,00:13,1,1,2
24,2025-05-24T16:15:00+02:00,2025-05-25,00:15,0,2,2
24,2025-05-24T16:16:00+02:00,2025-05-25,00:16,5,2,7
24,2025-05-24T16:20:00+02:00,2025-05-25,00:20,2,4,6
24,2025-05-24T16:24:00+02:00,2025-05-25,00:24,1,2,3
27,2025-05-24T16:23:00+02:00,2025-05-25,00:23,3,0,3
30,2025-05-24T16:11:00+02:00,2025-05-25,00:11,1,6,7
30,2025-05-24T16:15:00+02:00,2025-05-25,00:15,4,2,6
30,2025-05-24T16:18:00+02:00,2025-05-25,00:18,3,0,3
35,2025-05-24T16:10:00+02:00,2025-05-25,00:10,1,4,5
35,2025-05-24T16:20:00+02:00,2025-05-25,00:20,2,8,10
35,2025-05-24T16:22:00+02:00,2025-05-25,00:22,6,5,11
35,2025-05-24T16:23:00+02:00,2025-05-25,00:23,2,7,9
49,2025-05-24T16:11:00+02:00,2025-05-25,00:11,0,2,2
49,2025-05-24T16:12:00+02:00,2025-05-25,00:12,6,3,9
49,2025-05-24T16:13:00+02:00,2025-05-25,00:13,3,0,3
49,2025-05-24T16:19:00+02:00,2025-05-25,00:19,4,5,9
49,2025-05-24T16:20:00+02:00,2025-05-25,00:20,0,2,2
49,2025-05-24T16:24:00+02:00,2025-05-25,00:24,4,4,8
51,2025-05-24T16:11:00+02:00,2025-05-25,00:11,0,1,1
51,2025-05-24T16:13:00+02:00,2025-05-25,00:13,0,1,1
51,2025-05-24T16:17:00+02:00,2025-05-25,00:17,2,0,2
51,2025-05-24T16:18:00+02:00,2025-05-25,00:18,1,1,2
51,2025-05-24T16:22:00+02:00,2025-05-25,00:22,2,1,3
51,2025-05-24T16:24:00+02:00,2025-05-25,00:24,1,1,2
52,2025-05-24T16:17:00+02:00,2025-05-25,00:17,6,1,7
52,2025-05-24T16:19:00+02:00,2025-05-25,00:19,2,1,3
52,2025-05-24T16:22:00+02:00,2025-05-25,00:22,2,0,2
53,2025-05-24T16:13:00+02:00,2025-05-25,00:13,0,1,1
53,2025-05-24T16:16:00+02:00,2025-05-25,00:16,0,1,1
53,2025-05-24T16:19:00+02:00,2025-05-25,00:19,4,0,4
53,2025-05-24T16:21:00+02:00,2025-05-25,00:21,2,12,14
53,2025-05-24T16:24:00+02:00,2025-05-25,00:24,1,1,2
56,2025-05-24T16:12:00+02:00,2025-05-25,00:12,0,4,4
56,2025-05-24T16:13:00+02:00,2025-05-25,00:13,4,3,7
56,2025-05-24T16:14:00+02:00,2025-05-25,00:14,2,7,9
56,2025-05-24T16:17:00+02:00,2025-05-25,00:17,3,7,10
56,2025-05-24T16:18:00+02:00,2025-05-25,00:18,3,3,6
56,2025-05-24T16:23:00+02:00,2025-05-25,00:23,3,9,12
58,2025-05-24T16:10:00+02:00,2025-05-25,00:10,3,3,6
58,2025-05-24T16:13:00+02:00,2025-05-25,00:13,2,10,12
58,2025-05-24T16:19:00+02:00,2025-05-25,00:19,7,1,8
58,2025-05-24T16:21:00+02:00,2025-05-25,00:21,2,2,4
62,2025-05-24T16:13:00+02:00,2025-05-25,00:13,1,2,3
62,2025-05-24T16:17:00+02:00,2025-05-25,00:17,5,0,5
62,2025-05-24T16:18:00+02:00,2025-05-25,00:18,3,2,5
62,2025-05-24T16:19:00+02:00,2025-05-25,00:19,0,5,5
62,2025-05-24T16:21:00+02:00,2025-05-25,00:21,4,0,4
63,2025-05-24T16:10:00+02:00,2025-05-25,00:10,0,3,3
63,2025-05-24T16:15:00+02:00,2025-05-25,00:15,0,2,2
63,2025-05-24T16:22:00+02:00,2025-05-25,00:22,1,4,5
63,2025-05-24T16:24:00+02:00,2025-05-25,00:24,0,1,1
67,2025-05-24T16:19:00+02:00,2025-05-25,00:19,3,2,5
67,2025-05-24T16:22:00+02:00,2025-05-25,00:22,0,3,3
72,2025-05-24T16:12:00+02:00,2025-05-25,00:12,2,12,14
72,2025-05-24T16:15:00+02:00,2025-05-25,00:15,0,6,6
76,2025-05-24T16:18:00+02:00,2025-05-25,00:18,0,1,1
79,2025-05-24T16:12:00+02:00,2025-05-25,00:12,1,4,5
79,2025-05-24T16:14:00+02:00,2025-05-25,00:14,0,1,1
79,2025-05-24T16:18:00+02:00,2025-05-25,00:18,6,4,10
79,2025-05-24T16:19:00+02:00,2025-05-25,00:19,2,2,4
79,2025-05-24T16:20:00+02:00,2025-05-25,00:20,4,1,5
79,2025-05-24T16:23:00+02:00,2025-05-25,00:23,0,2,2
79,2025-05-24T16:24:00+02:00,2025-05-25,00:24,4,0,4
109,2025-05-24T16:15:00+02:00,2025-05-25,00:15,3,1,4
109,2025-05-24T16:20:00+02:00,2025-05-25,00:20,1,2,3
117,2025-05-24T16:15:00+02:00,2025-05-25,00:15,11,5,16
117,2025-05-24T16:20:00+02:00,2025-05-25,00:20,1,3,4
139,2025-05-24T16:15:00+02:00,2025-05-25,00:15,2,4,6
141,2025-05-24T16:20:00+02:00,2025-05-25,00:20,6,0,6
164,2025-05-24T16:10:00+02:00,2025-05-25,00:10,1,6,7
164,2025-05-24T16:15:00+02:00,2025-05-25,00:15,9,2,11
47,2025-05-24T16:10:00+02:00,2025-05-25,00:10,7,1,8
47,2025-05-24T16:12:00+02:00,2025-05-25,00:12,5,2,7
47,2025-05-24T16:14:00+02:00,2025-05-25,00:14,3,6,9
47,2025-05-24T16:19:00+02:00,2025-05-25,00:19,3,0,3
47,2025-05-24T16:22:00+02:00,2025-05-25,00:22,3,6,9
47,2025-05-24T16:23:00+02:00,2025-05-25,00:23,1,10,11
47,2025-05-24T16:24:00+02:00,2025-05-25,00:24,1,17,18
50,2025-05-24T16:13:00+02:00,2025-05-25,00:13,1,1,2
50,2025-05-24T16:18:00+02:00,2025-05-25,00:18,0,5,5
50,2025-05-24T16:24:00+02:00,2025-05-25,00:24,1,0,1
54,2025-05-24T16:10:00+02:00,2025-05-25,00:10,0,3,3
54,2025-05-24T16:20:00+02:00,2025-05-25,00:20,1,3,4
54,2025-05-24T16:23:00+02:00,2025-05-25,00:23,0,1,1
59,2025-05-24T16:10:00+02:00,2025-05-25,00:10,9,7,16
59,2025-05-24T16:20:00+02:00,2025-05-25,00:20,10,1,11
61,2025-05-24T16:10:00+02:00,2025-05-25,00:10,5,0,5
61,2025-05-24T16:16:00+02:00,2025-05-25,00:16,3,1,4
61,2025-05-24T16:20:00+02:00,2025-05-25,00:20,1,0,1
66,2025-05-24T16:13:00+02:00,2025-05-25,00:13,1,1,2
66,2025-05-24T16:15:00+02:00,2025-05-25,00:15,9,3,12
66,2025-05-24T16:16:00+02:00,2025-05-25,00:16,6,2,8
66,2025-05-24T16:17:00+02:00,2025-05-25,00:17,4,20,24
66,2025-05-24T16:21:00+02:00,2025-05-25,00:21,10,9,19
66,2025-05-24T16:22:00+02:00,2025-05-25,00:22,3,8,11
66,2025-05-24T16:23:00+02:00,2025-05-25,00:23,4,5,9
66,2025-05-24T16:24:00+02:00,2025-05-25,00:24,7,13,20
77,2025-05-24T16:20:00+02:00,2025-05-25,00:20,1,0,1
78,2025-05-24T16:11:00+02:00,2025-05-25,00:11,1,0,1
84,2025-05-24T16:20:00+02:00,2025-05-25,00:20,24,27,51
87,2025-05-24T16:11:00+02:00,2025-05-25,00:11,0,3,3
87,2025-05-24T16:15:00+02:00,2025-05-25,00:15,1,0,1
107,2025-05-24T16:20:00+02:00,2025-05-25,00:20,0,1,1
108,2025-05-24T16:10:00+02:00,2025-05-25,00:10,6,3,9
108,2025-05-24T16:13:00+02:00,2025-05-25,00:13,8,0,8
108,2025-05-24T16:14:00+02:00,2025-05-25,00:14,0,2,2
108,2025-05-24T16:21:00+02:00,2025-05-25,00:21,0,1,1
118,2025-05-24T16:15:00+02:00,2025-05-25,00:15,0,1,1
131,2025-05-24T16:10:00+02:00,2025-05-25,00:10,10,17,27
131,2025-05-24T16:20:00+02:00,2025-05-25,00:20,12,8,20
132,2025-05-24T16:10:00+02:00,2025-05-25,00:10,4,6,10
133,2025-05-24T16:10:00+02:00,2025-05-25,00:10,11,5,16
134,2025-05-24T16:20:00+02:00,2025-05-25,00:20,7,5,12
162,2025-05-24T16:15:00+02:00,2025-05-25,00:15,2,16,18
165,2025-05-24T16:20:00+02:00,2025-05-25,00:20,3,0,3
179,2025-05-24T16:15:00+02:00,2025-05-25,00:15,0,3,3
1,2025-05-24T16:15:00+02:00,2025-05-25,00:15,1,0,1
1,2025-05-24T16:21:00+02:00,2025-05-25,00:21,1,2,3
2,2025-05-24T16:10:00+02:00,2025-05-25,00:10,0,1,1
2,2025-05-24T16:16:00+02:00,2025-05-25,00:16,0,1,1
2,2025-05-24T16:18:00+02:00,2025-05-25,00:18,1,1,2
2,2025-05-24T16:24:00+02:00,2025-05-25,00:24,0,1,1
9,2025-05-24T16:15:00+02:00,2025-05-25,00:15,1,0,1
10,2025-05-24T16:24:00+02:00,2025-05-25,00:24,0,1,1
11,2025-05-24T16:10:00+02:00,2025-05-25,00:10,0,2,2
12,2025-05-24T16:18:00+02:00,2025-05-25,00:18,1,0,1
12,2025-05-24T16:21:00+02:00,2025-05-25,00:21,1,0,1
17,2025-05-24T16:10:00+02:00,2025-05-25,00:10,2,1,3
17,2025-05-24T16:11:00+02:00,2025-05-25,00:11,0,2,2
17,2025-05-24T16:12:00+02:00,2025-05-25,00:12,1,0,1
17,2025-05-24T16:13:00+02:00,2025-05-25,00:13,0,1,1
17,2025-05-24T16:14:00+02:00,2025-05-25,00:14,1,0,1
17,2025-05-24T16:17:00+02:00,2025-05-25,00:17,0,1,1
19,2025-05-24T16:10:00+02:00,2025-05-25,00:10,0,3,3
19,2025-05-24T16:14:00+02:00,2025-05-25,00:14,2,0,2
19,2025-05-24T16:18:00+02:00,2025-05-25,00:18,4,16,20
19,2025-05-24T16:20:00+02:00,2025-05-25,00:20,2,15,17
19,2025-05-24T16:21:00+02:00,2025-05-25,00:21,2,11,13
20,2025-05-24T16:13:00+02:00,2025-05-25,00:13,6,6,12
20,2025-05-24T16:17:00+02:00,2025-05-25,00:17,3,6,9
23,2025-05-24T16:11:00+02:00,2025-05-25,00:11,2,1,3
23,2025-05-24T16:15:00+02:00,2025-05-25,00:15,0,1,1
23,2025-05-24T16:20:00+02:00,2025-05-25,00:20,0,2,2
24,2025-05-24T16:14:00+02:00,2025-05-25,00:14,4,0,4
24,2025-05-24T16:19:00+02:00,2025-05-25,00:19,2,6,8
24,2025-05-24T16:21:00+02:00,2025-05-25,00:21,7,0,7
24,2025-05-24T16:22:00+02:00,2025-05-25,00:22,5,3,8
25,2025-05-24T16:10:00+02:00,2025-05-25,00:10,4,6,10
25,2025-05-24T16:15:00+02:00,2025-05-25,00:15,14,6,20
27,2025-05-24T16:10:00+02:00,2025-05-25,00:10,1,0,1
27,2025-05-24T16:14:00+02:00,2025-05-25,00:14,2,0,2
27,2025-05-24T16:18:00+02:00,2025-05-25,00:18,1,0,1
30,2025-05-24T16:10:00+02:00,2025-05-25,00:10,14,5,19
30,2025-05-24T16:12:00+02:00,2025-05-25,00:12,16,0,16
30,2025-05-24T16:19:00+02:00,2025-05-25,00:19,0,22,22
35,2025-05-24T16:14:00+02:00,2025-05-25,00:14,6,2,8
35,2025-05-24T16:15:00+02:00,2025-05-25,00:15,4,8,12
35,2025-05-24T16:16:00+02:00,2025-05-25,00:16,0,1,1
35,2025-05-24T16:17:00+02:00,2025-05-25,00:17,4,6,10
35,2025-05-24T16:19:00+02:00,2025-05-25,00:19,2,5,7
35,2025-05-24T16:21:00+02:00,2025-05-25,00:21,5,3,8
49,2025-05-24T16:10:00+02:00,2025-05-25,00:10,1,2,3
49,2025-05-24T16:15:00+02:00,2025-05-25,00:15,4,0,4
49,2025-05-24T16:18:00+02:00,2025-05-25,00:18,2,0,2
49,2025-05-24T16:22:00+02:00,2025-05-25,00:22,2,2,4
49,2025-05-24T16:23:00+02:00,2025-05-25,00:23,0,1,1
51,2025-05-24T16:15:00+02:00,2025-05-25,00:15,0,2,2
51,2025-05-24T16:19:00+02:00,2025-05-25,00:19,1,0,1
52,2025-05-24T16:11:00+02:00,2025-05-25,00:11,4,1,5
52,2025-05-24T16:13:00+02:00,2025-05-25,00:13,0,1,1
52,2025-05-24T16:18:00+02:00,2025-05-25,00:18,7,12,19
52,2025-05-24T16:21:00+02:00,2025-05-25,00:21,0,5,5
53,2025-05-24T16:12:00+02:00,2025-05-25,00:12,0,1,1
53,2025-05-24T16:18:00+02:00,2025-05-25,00:18,0,3,3
53,2025-05-24T16:20:00+02:00,2025-05-25,00:20,0,1,1
56,2025-05-24T16:15:00+02:00,2025-05-25,00:15,2,0,2
58,2025-05-24T16:11:00+02:00,2025-05-25,00:11,3,5,8
58,2025-05-24T16:17:00+02:00,2025-05-25,00:17,1,0,1
58,2025-05-24T16:20:00+02:00,2025-05-25,00:20,5,3,8
58,2025-05-24T16:24:00+02:00,2025-05-25,00:24,5,4,9
62,2025-05-24T16:10:00+02:00,2025-05-25,00:10,0,1,1
62,2025-05-24T16:15:00+02:00,2025-05-25,00:15,3,0,3
62,2025-05-24T16:22:00+02:00,2025-05-25,00:22,1,3,4
63,2025-05-24T16:12:00+02:00,2025-05-25,00:12,0,1,1
63,2025-05-24T16:13:00+02:00,2025-05-25,00:13,0,1,1
63,2025-05-24T16:16:00+02:00,2025-05-25,00:16,0,1,1
63,2025-05-24T16:18:00+02:00,2025-05-25,00:18,2,10,12
63,2025-05-24T16:21:00+02:00,2025-05-25,00:21,0,1,1
63,2025-05-24T16:23:00+02:00,2025-05-25,00:23,2,1,3
67,2025-05-24T16:10:00+02:00,2025-05-25,00:10,3,4,7
67,2025-05-24T16:11:00+02:00,2025-05-25,00:11,5,0,5
67,2025-05-24T16:12:00+02:00,2025-05-25,00:12,1,0,1
67,2025-05-24T16:16:00+02:00,2025-05-25,00:16,0,5,5
67,2025-05-24T16:17:00+02:00,2025-05-25,00:17,1,0,1
68,2025-05-24T16:18:00+02:00,2025-05-25,00:18,1,0,1
68,2025-05-24T16:22:00+02:00,2025-05-25,00:22,0,2,2
72,2025-05-24T16:19:00+02:00,2025-05-25,00:19,1,0,1
79,2025-05-24T16:13:00+02:00,2025-05-25,00:13,4,0,4
79,2025-05-24T16:15:00+02:00,2025-05-25,00:15,0,9,9
79,2025-05-24T16:22:00+02:00,2025-05-25,00:22,2,10,12
86,2025-05-24T16:21:00+02:00,2025-05-25,00:21,1,0,1
86,2025-05-24T16:23:00+02:00,2025-05-25,00:23,0,1,1
109,2025-05-24T16:10:00+02:00,2025-05-25,00:10,4,6,10
141,2025-05-24T16:15:00+02:00,2025-05-25,00:15,9,2,11
142,2025-05-24T16:10:00+02:00,2025-05-25,00:10,1,0,1
142,2025-05-24T16:15:00+02:00,2025-05-25,00:15,1,1,2
164,2025-05-24T16:20:00+02:00,2025-05-25,00:20,0,2,2
3,2025-05-24T15:57:00+02:00,2025-05-24,23:57,7,10,17
3,2025-05-24T15:59:00+02:00,2025-05-24,23:59,11,9,20
3,2025-05-24T16:02:00+02:00,2025-05-25,00:02,5,8,13
4,2025-05-24T15:58:00+02:00,2025-05-24,23:58,2,3,5
4,2025-05-24T16:00:00+02:00,2025-05-25,00:00,2,2,4
4,2025-05-24T16:08:00+02:00,2025-05-25,00:08,5,17,22
4,2025-05-24T16:09:00+02:00,2025-05-25,00:09,2,5,7
5,2025-05-24T16:05:00+02:00,2025-05-25,00:05,8,16,24
6,2025-05-24T15:58:00+02:00,2025-05-24,23:58,2,6,8
6,2025-05-24T16:02:00+02:00,2025-05-25,00:02,9,3,12
6,2025-05-24T16:06:00+02:00,2025-05-25,00:06,8,4,12
6,2025-05-24T16:08:00+02:00,2025-05-25,00:08,11,4,15
8,2025-05-24T16:06:00+02:00,2025-05-25,00:06,0,2,2
28,2025-05-24T15:57:00+02:00,2025-05-24,23:57,4,0,4
29,2025-05-24T15:55:00+02:00,2025-05-24,23:55,0,6,6
29,2025-05-24T16:05:00+02:00,2025-05-25,00:05,2,0,2
29,2025-05-24T16:06:00+02:00,2025-05-25,00:06,0,2,2
31,2025-05-24T15:57:00+02:00,2025-05-24,23:57,2,0,2
31,2025-05-24T16:07:00+02:00,2025-05-25,00:07,0,1,1
36,2025-05-24T15:57:00+02:00,2025-05-24,23:57,3,5,8
36,2025-05-24T15:59:00+02:00,2025-05-24,23:59,4,1,5
36,2025-05-24T16:04:00+02:00,2025-05-25,00:04,0,3,3
37,2025-05-24T15:57:00+02:00,2025-05-24,23:57,0,3,3
37,2025-05-24T16:03:00+02:00,2025-05-25,00:03,1,0,1
37,2025-05-24T16:04:00+02:00,2025-05-25,00:04,1,3,4
40,2025-05-24T16:04:00+02:00,2025-05-25,00:04,0,2,2
40,2025-05-24T16:09:00+02:00,2025-05-25,00:09,5,0,5
41,2025-05-24T15:55:00+02:00,2025-05-24,23:55,1,11,12
41,2025-05-24T16:03:00+02:00,2025-05-25,00:03,7,3,10
41,2025-05-24T16:04:00+02:00,2025-05-25,00:04,14,4,18
43,2025-05-24T16:00:00+02:00,2025-05-25,00:00,0,2,2
44,2025-05-24T16:00:00+02:00,2025-05-25,00:00,0,2,2
45,2025-05-24T15:58:00+02:00,2025-05-24,23:58,8,0,8
45,2025-05-24T15:59:00+02:00,2025-05-24,23:59,7,3,10
45,2025-05-24T16:00:00+02:00,2025-05-25,00:00,4,4,8
45,2025-05-24T16:02:00+02:00,2025-05-25,00:02,5,1,6
45,2025-05-24T16:05:00+02:00,2025-05-25,00:05,1,4,5
45,2025-05-24T16:06:00+02:00,2025-05-25,00:06,5,13,18
45,2025-05-24T16:07:00+02:00,2025-05-25,00:07,3,11,14
47,2025-05-24T15:56:00+02:00,2025-05-24,23:56,4,3,7
47,2025-05-24T15:59:00+02:00,2025-05-24,23:59,4,2,6
47,2025-05-24T16:02:00+02:00,2025-05-25,00:02,0,1,1
47,2025-05-24T16:06:00+02:00,2025-05-25,00:06,5,7,12
50,2025-05-24T16:04:00+02:00,2025-05-25,00:04,0,2,2
50,2025-05-24T16:06:00+02:00,2025-05-25,00:06,1,0,1
54,2025-05-24T15:58:00+02:00,2025-05-24,23:58,2,0,2
61,2025-05-24T15:58:00+02:00,2025-05-24,23:58,2,2,4
61,2025-05-24T15:59:00+02:00,2025-05-24,23:59,2,0,2
61,2025-05-24T16:04:00+02:00,2025-05-25,00:04,3,1,4
61,2025-05-24T16:06:00+02:00,2025-05-25,00:06,2,0,2
66,2025-05-24T15:59:00+02:00,2025-05-24,23:59,5,4,9
66,2025-05-24T16:01:00+02:00,2025-05-25,00:01,2,9,11
66,2025-05-24T16:04:00+02:00,2025-05-25,00:04,3,4,7
66,2025-05-24T16:09:00+02:00,2025-05-25,00:09,6,1,7
69,2025-05-24T16:04:00+02:00,2025-05-25,00:04,1,0,1
69,2025-05-24T16:08:00+02:00,2025-05-25,00:08,0,3,3
70,2025-05-24T16:00:00+02:00,2025-05-25,00:00,0,1,1
71,2025-05-24T15:58:00+02:00,2025-05-24,23:58,1,0,1
75,2025-05-24T16:08:00+02:00,2025-05-25,00:08,0,1,1
77,2025-05-24T16:05:00+02:00,2025-05-25,00:05,2,2,4
78,2025-05-24T16:07:00+02:00,2025-05-25,00:07,0,1,1
84,2025-05-24T15:55:00+02:00,2025-05-24,23:55,15,19,34
107,2025-05-24T16:05:00+02:00,2025-05-25,00:05,0,2,2
108,2025-05-24T16:00:00+02:00,2025-05-25,00:00,1,2,3
108,2025-05-24T16:02:00+02:00,2025-05-25,00:02,2,2,4
108,2025-05-24T16:03:00+02:00,2025-05-25,00:03,4,2,6
108,2025-05-24T16:07:00+02:00,2025-05-25,00:07,0,2,2
131,2025-05-24T16:00:00+02:00,2025-05-25,00:00,11,11,22
131,2025-05-24T16:05:00+02:00,2025-05-25,00:05,15,24,39
133,2025-05-24T16:05:00+02:00,2025-05-25,00:05,9,7,16
135,2025-05-24T16:05:00+02:00,2025-05-25,00:05,7,3,10
162,2025-05-24T16:00:00+02:00,2025-05-25,00:00,7,5,12
167,2025-05-24T15:55:00+02:00,2025-05-24,23:55,0,4,4
167,2025-05-24T16:05:00+02:00,2025-05-25,00:05,0,3,3
179,2025-05-24T16:00:00+02:00,2025-05-25,00:00,2,3,5
179,2025-05-24T16:05:00+02:00,2025-05-25,00:05,1,8,9
1,2025-05-24T15:56:00+02:00,2025-05-24,23:56,1,1,2
1,2025-05-24T15:58:00+02:00,2025-05-24,23:58,1,3,4
1,2025-05-24T15:59:00+02:00,2025-05-24,23:59,0,4,4
1,2025-05-24T16:01:00+02:00,2025-05-25,00:01,5,0,5
1,2025-05-24T16:04:00+02:00,2025-05-25,00:04,0,2,2
1,2025-05-24T16:07:00+02:00,2025-05-25,00:07,3,0,3
2,2025-05-24T16:03:00+02:00,2025-05-25,00:03,0,1,1
2,2025-05-24T16:06:00+02:00,2025-05-25,00:06,0,2,2
10,2025-05-24T15:55:00+02:00,2025-05-24,23:55,2,0,2
10,2025-05-24T15:56:00+02:00,2025-05-24,23:56,2,0,2
10,2025-05-24T16:00:00+02:00,2025-05-25,00:00,1,0,1
11,2025-05-24T15:55:00+02:00,2025-05-24,23:55,4,2,6
12,2025-05-24T16:01:00+02:00,2025-05-25,00:01,0,1,1
12,2025-05-24T16:05:00+02:00,2025-05-25,00:05,7,1,8
12,2025-05-24T16:09:00+02:00,2025-05-25,00:09,0,2,2
17,2025-05-24T15:55:00+02:00,2025-05-24,23:55,0,2,2
17,2025-05-24T15:59:00+02:00,2025-05-24,23:59,0,2,2
17,2025-05-24T16:05:00+02:00,2025-05-25,00:05,0,3,3
17,2025-05-24T16:06:00+02:00,2025-05-25,00:06,0,1,1
19,2025-05-24T15:55:00+02:00,2025-05-24,23:55,0,6,6
19,2025-05-24T15:56:00+02:00,2025-05-24,23:56,6,5,11
19,2025-05-24T16:00:00+02:00,2025-05-25,00:00,0,3,3
19,2025-05-24T16:06:00+02:00,2025-05-25,00:06,1,2,3
19,2025-05-24T16:09:00+02:00,2025-05-25,00:09,3,4,7
20,2025-05-24T15:58:00+02:00,2025-05-24,23:58,7,5,12
20,2025-05-24T16:02:00+02:00,2025-05-25,00:02,1,2,3
20,2025-05-24T16:04:00+02:00,2025-05-25,00:04,14,8,22
20,2025-05-24T16:08:00+02:00,2025-05-25,00:08,6,2,8
23,2025-05-24T16:01:00+02:00,2025-05-25,00:01,1,3,4
23,2025-05-24T16:07:00+02:00,2025-05-25,00:07,1,2,3
24,2025-05-24T15:57:00+02:00,2025-05-24,23:57,1,8,9
24,2025-05-24T15:58:00+02:00,2025-05-24,23:58,3,0,3
24,2025-05-24T16:01:00+02:00,2025-05-25,00:01,3,6,9
24,2025-05-24T16:04:00+02:00,2025-05-25,00:04,5,11,16
24,2025-05-24T16:05:00+02:00,2025-05-25,00:05,7,8,15
24,2025-05-24T16:07:00+02:00,2025-05-25,00:07,2,2,4
25,2025-05-24T16:00:00+02:00,2025-05-25,00:00,10,9,19
25,2025-05-24T16:05:00+02:00,2025-05-25,00:05,2,9,11
27,2025-05-24T15:55:00+02:00,2025-05-24,23:55,4,0,4
27,2025-05-24T16:08:00+02:00,2025-05-25,00:08,0,1,1
30,2025-05-24T15:58:00+02:00,2025-05-24,23:58,5,1,6
30,2025-05-24T16:07:00+02:00,2025-05-25,00:07,14,2,16
30,2025-05-24T16:08:00+02:00,2025-05-25,00:08,5,6,11
35,2025-05-24T15:55:00+02:00,2025-05-24,23:55,10,7,17
35,2025-05-24T15:56:00+02:00,2025-05-24,23:56,7,3,10
35,2025-05-24T16:02:00+02:00,2025-05-25,00:02,3,6,9
35,2025-05-24T16:03:00+02:00,2025-05-25,00:03,1,10,11
35,2025-05-24T16:05:00+02:00,2025-05-25,00:05,2,9,11
35,2025-05-24T16:07:00+02:00,2025-05-25,00:07,2,10,12
35,2025-05-24T16:09:00+02:00,2025-05-25,00:09,0,10,10
49,2025-05-24T15:57:00+02:00,2025-05-24,23:57,0,2,2
49,2025-05-24T15:58:00+02:00,2025-05-24,23:58,2,5,7
49,2025-05-24T16:00:00+02:00,2025-05-25,00:00,0,1,1
49,2025-05-24T16:02:00+02:00,2025-05-25,00:02,5,1,6
51,2025-05-24T15:55:00+02:00,2025-05-24,23:55,1,2,3
51,2025-05-24T15:58:00+02:00,2025-05-24,23:58,2,3,5
51,2025-05-24T16:06:00+02:00,2025-05-25,00:06,1,0,1
52,2025-05-24T15:59:00+02:00,2025-05-24,23:59,3,6,9
52,2025-05-24T16:04:00+02:00,2025-05-25,00:04,1,0,1
52,2025-05-24T16:05:00+02:00,2025-05-25,00:05,3,3,6
52,2025-05-24T16:06:00+02:00,2025-05-25,00:06,2,2,4
52,2025-05-24T16:07:00+02:00,2025-05-25,00:07,1,1,2
53,2025-05-24T15:57:00+02:00,2025-05-24,23:57,0,1,1
53,2025-05-24T15:58:00+02:00,2025-05-24,23:58,1,0,1
53,2025-05-24T16:01:00+02:00,2025-05-25,00:01,1,0,1
53,2025-05-24T16:02:00+02:00,2025-05-25,00:02,6,0,6
53,2025-05-24T16:09:00+02:00,2025-05-25,00:09,0,1,1
56,2025-05-24T15:57:00+02:00,2025-05-24,23:57,0,2,2
56,2025-05-24T15:58:00+02:00,2025-05-24,23:58,0,3,3
56,2025-05-24T16:05:00+02:00,2025-05-25,00:05,1,4,5
56,2025-05-24T16:08:00+02:00,2025-05-25,00:08,0,4,4
56,2025-05-24T16:09:00+02:00,2025-05-25,00:09,6,5,11
58,2025-05-24T16:03:00+02:00,2025-05-25,00:03,2,5,7
58,2025-05-24T16:09:00+02:00,2025-05-25,00:09,2,3,5
62,2025-05-24T15:57:00+02:00,2025-05-24,23:57,2,4,6
62,2025-05-24T16:03:00+02:00,2025-05-25,00:03,1,1,2
63,2025-05-24T15:55:00+02:00,2025-05-24,23:55,0,10,10
63,2025-05-24T16:02:00+02:00,2025-05-25,00:02,1,1,2
63,2025-05-24T16:05:00+02:00,2025-05-25,00:05,0,2,2
67,2025-05-24T15:55:00+02:00,2025-05-24,23:55,0,1,1
67,2025-05-24T16:03:00+02:00,2025-05-25,00:03,5,5,10
67,2025-05-24T16:09:00+02:00,2025-05-25,00:09,2,5,7
68,2025-05-24T15:55:00+02:00,2025-05-24,23:55,0,1,1
68,2025-05-24T16:07:00+02:00,2025-05-25,00:07,1,0,1
68,2025-05-24T16:08:00+02:00,2025-05-25,00:08,0,1,1
72,2025-05-24T15:56:00+02:00,2025-05-24,23:56,0,12,12
72,2025-05-24T16:04:00+02:00,2025-05-25,00:04,0,1,1
72,2025-05-24T16:05:00+02:00,2025-05-25,00:05,0,18,18
72,2025-05-24T16:06:00+02:00,2025-05-25,00:06,0,10,10
72,2025-05-24T16:09:00+02:00,2025-05-25,00:09,0,5,5
79,2025-05-24T15:55:00+02:00,2025-05-24,23:55,1,7,8
79,2025-05-24T16:00:00+02:00,2025-05-25,00:00,1,3,4
79,2025-05-24T16:08:00+02:00,2025-05-25,00:08,5,5,10
109,2025-05-24T16:00:00+02:00,2025-05-25,00:00,3,3,6
117,2025-05-24T15:55:00+02:00,2025-05-24,23:55,13,11,24
136,2025-05-24T16:00:00+02:00,2025-05-25,00:00,1,0,1
139,2025-05-24T16:00:00+02:00,2025-05-25,00:00,2,0,2
139,2025-05-24T16:05:00+02:00,2025-05-25,00:05,0,1,1
141,2025-05-24T15:55:00+02:00,2025-05-24,23:55,5,7,12
141,2025-05-24T16:05:00+02:00,2025-05-25,00:05,3,14,17
164,2025-05-24T16:00:00+02:00,2025-05-25,00:00,2,0,2
164,2025-05-24T16:05:00+02:00,2025-05-25,00:05,0,1,1
181,2025-05-24T16:02:00+02:00,2025-05-25,00:02,5,6,11
181,2025-05-24T16:03:00+02:00,2025-05-25,00:03,4,0,4
181,2025-05-24T16:05:00+02:00,2025-05-25,00:05,12,7,19
181,2025-05-24T16:06:00+02:00,2025-05-25,00:06,8,2,10
181,2025-05-24T16:07:00+02:00,2025-05-25,00:07,6,1,7
182,2025-05-24T15:55:00+02:00,2025-05-24,23:55,25,20,45
181,2025-05-24T16:12:00+02:00,2025-05-25,00:12,9,2,11
181,2025-05-24T16:22:00+02:00,2025-05-25,00:22,13,4,17
181,2025-05-24T16:23:00+02:00,2025-05-25,00:23,4,5,9
182,2025-05-24T16:15:00+02:00,2025-05-25,00:15,12,8,20
181,2025-05-24T16:13:00+02:00,2025-05-25,00:13,1,5,6
181,2025-05-24T16:14:00+02:00,2025-05-25,00:14,2,11,13
181,2025-05-24T16:15:00+02:00,2025-05-25,00:15,2,4,6
181,2025-05-24T16:16:00+02:00,2025-05-25,00:16,18,1,19
181,2025-05-24T16:21:00+02:00,2025-05-25,00:21,2,3,5
182,2025-05-24T16:10:00+02:00,2025-05-25,00:10,11,12,23
3,2025-05-24T16:12:00+02:00,2025-05-25,00:12,2,4,6
3,2025-05-24T16:16:00+02:00,2025-05-25,00:16,2,0,2
3,2025-05-24T16:18:00+02:00,2025-05-25,00:18,0,3,3
3,2025-05-24T16:19:00+02:00,2025-05-25,00:19,9,9,18
3,2025-05-24T16:21:00+02:00,2025-05-25,00:21,6,5,11
4,2025-05-24T16:12:00+02:00,2025-05-25,00:12,0,6,6
4,2025-05-24T16:16:00+02:00,2025-05-25,00:16,9,8,17
4,2025-05-24T16:21:00+02:00,2025-05-25,00:21,5,4,9
4,2025-05-24T16:22:00+02:00,2025-05-25,00:22,5,6,11
5,2025-05-24T16:10:00+02:00,2025-05-25,00:10,17,21,38
5,2025-05-24T16:20:00+02:00,2025-05-25,00:20,11,28,39
6,2025-05-24T16:12:00+02:00,2025-05-25,00:12,4,4,8
6,2025-05-24T16:14:00+02:00,2025-05-25,00:14,5,3,8
6,2025-05-24T16:15:00+02:00,2025-05-25,00:15,7,1,8
6,2025-05-24T16:17:00+02:00,2025-05-25,00:17,2,7,9
6,2025-05-24T16:18:00+02:00,2025-05-25,00:18,5,0,5
6,2025-05-24T16:22:00+02:00,2025-05-25,00:22,10,3,13
6,2025-05-24T16:24:00+02:00,2025-05-25,00:24,9,3,12
28,2025-05-24T16:18:00+02:00,2025-05-25,00:18,0,2,2
31,2025-05-24T16:12:00+02:00,2025-05-25,00:12,0,1,1
31,2025-05-24T16:13:00+02:00,2025-05-25,00:13,3,1,4
31,2025-05-24T16:16:00+02:00,2025-05-25,00:16,1,1,2
36,2025-05-24T16:10:00+02:00,2025-05-25,00:10,1,6,7
36,2025-05-24T16:11:00+02:00,2025-05-25,00:11,6,3,9
36,2025-05-24T16:14:00+02:00,2025-05-25,00:14,3,17,20
36,2025-05-24T16:15:00+02:00,2025-05-25,00:15,2,15,17
36,2025-05-24T16:16:00+02:00,2025-05-25,00:16,0,12,12
36,2025-05-24T16:17:00+02:00,2025-05-25,00:17,0,5,5
36,2025-05-24T16:18:00+02:00,2025-05-25,00:18,3,5,8
36,2025-05-24T16:19:00+02:00,2025-05-25,00:19,4,9,13
36,2025-05-24T16:20:00+02:00,2025-05-25,00:20,10,9,19
36,2025-05-24T16:21:00+02:00,2025-05-25,00:21,3,3,6
36,2025-05-24T16:22:00+02:00,2025-05-25,00:22,4,1,5
37,2025-05-24T16:15:00+02:00,2025-05-25,00:15,4,0,4
37,2025-05-24T16:19:00+02:00,2025-05-25,00:19,5,0,5
37,2025-05-24T16:23:00+02:00,2025-05-25,00:23,1,3,4
37,2025-05-24T16:24:00+02:00,2025-05-25,00:24,3,0,3
40,2025-05-24T16:16:00+02:00,2025-05-25,00:16,3,0,3
40,2025-05-24T16:19:00+02:00,2025-05-25,00:19,3,0,3
40,2025-05-24T16:21:00+02:00,2025-05-25,00:21,1,0,1
41,2025-05-24T16:11:00+02:00,2025-05-25,00:11,2,8,10
41,2025-05-24T16:13:00+02:00,2025-05-25,00:13,1,8,9
41,2025-05-24T16:14:00+02:00,2025-05-25,00:14,6,7,13
41,2025-05-24T16:16:00+02:00,2025-05-25,00:16,3,11,14
41,2025-05-24T16:17:00+02:00,2025-05-25,00:17,0,2,2
41,2025-05-24T16:20:00+02:00,2025-05-25,00:20,0,5,5
41,2025-05-24T16:21:00+02:00,2025-05-25,00:21,0,1,1
44,2025-05-24T16:10:00+02:00,2025-05-25,00:10,2,0,2
45,2025-05-24T16:10:00+02:00,2025-05-25,00:10,8,13,21
45,2025-05-24T16:11:00+02:00,2025-05-25,00:11,3,1,4
45,2025-05-24T16:13:00+02:00,2025-05-25,00:13,1,1,2
45,2025-05-24T16:19:00+02:00,2025-05-25,00:19,3,8,11
45,2025-05-24T16:20:00+02:00,2025-05-25,00:20,0,12,12
3,2025-05-24T16:13:00+02:00,2025-05-25,00:13,5,5,10
3,2025-05-24T16:22:00+02:00,2025-05-25,00:22,5,7,12
3,2025-05-24T16:24:00+02:00,2025-05-25,00:24,2,5,7
4,2025-05-24T16:14:00+02:00,2025-05-25,00:14,2,8,10
4,2025-05-24T16:19:00+02:00,2025-05-25,00:19,1,16,17
4,2025-05-24T16:20:00+02:00,2025-05-25,00:20,6,8,14
4,2025-05-24T16:23:00+02:00,2025-05-25,00:23,2,9,11
4,2025-05-24T16:24:00+02:00,2025-05-25,00:24,0,3,3
6,2025-05-24T16:10:00+02:00,2025-05-25,00:10,10,19,29
6,2025-05-24T16:13:00+02:00,2025-05-25,00:13,9,0,9
6,2025-05-24T16:19:00+02:00,2025-05-25,00:19,4,4,8
6,2025-05-24T16:20:00+02:00,2025-05-25,00:20,5,3,8
6,2025-05-24T16:21:00+02:00,2025-05-25,00:21,9,8,17
28,2025-05-24T16:11:00+02:00,2025-05-25,00:11,0,9,9
28,2025-05-24T16:12:00+02:00,2025-05-25,00:12,1,0,1
28,2025-05-24T16:19:00+02:00,2025-05-25,00:19,3,1,4
29,2025-05-24T16:15:00+02:00,2025-05-25,00:15,0,1,1
29,2025-05-24T16:17:00+02:00,2025-05-25,00:17,0,1,1
29,2025-05-24T16:18:00+02:00,2025-05-25,00:18,0,1,1
29,2025-05-24T16:24:00+02:00,2025-05-25,00:24,0,1,1
31,2025-05-24T16:10:00+02:00,2025-05-25,00:10,1,0,1
31,2025-05-24T16:14:00+02:00,2025-05-25,00:14,0,1,1
31,2025-05-24T16:17:00+02:00,2025-05-25,00:17,1,2,3
31,2025-05-24T16:22:00+02:00,2025-05-25,00:22,0,5,5
31,2025-05-24T16:23:00+02:00,2025-05-25,00:23,2,1,3
36,2025-05-24T16:13:00+02:00,2025-05-25,00:13,1,12,13
36,2025-05-24T16:23:00+02:00,2025-05-25,00:23,7,3,10
37,2025-05-24T16:16:00+02:00,2025-05-25,00:16,1,0,1
39,2025-05-24T16:10:00+02:00,2025-05-25,00:10,1,0,1
39,2025-05-24T16:12:00+02:00,2025-05-25,00:12,0,1,1
40,2025-05-24T16:14:00+02:00,2025-05-25,00:14,0,2,2
40,2025-05-24T16:18:00+02:00,2025-05-25,00:18,3,0,3
40,2025-05-24T16:20:00+02:00,2025-05-25,00:20,1,0,1
41,2025-05-24T16:12:00+02:00,2025-05-25,00:12,0,4,4
41,2025-05-24T16:15:00+02:00,2025-05-25,00:15,2,7,9
43,2025-05-24T16:20:00+02:00,2025-05-25,00:20,1,1,2
45,2025-05-24T16:12:00+02:00,2025-05-25,00:12,7,2,9
45,2025-05-24T16:14:00+02:00,2025-05-25,00:14,6,9,15
45,2025-05-24T16:15:00+02:00,2025-05-25,00:15,21,3,24
45,2025-05-24T16:17:00+02:00,2025-05-25,00:17,0,4,4
45,2025-05-24T16:22:00+02:00,2025-05-25,00:22,3,3,6
3,2025-05-24T16:25:00+02:00,2025-05-25,00:25,6,3,9
3,2025-05-24T16:26:00+02:00,2025-05-25,00:26,7,1,8
3,2025-05-24T16:32:00+02:00,2025-05-25,00:32,5,5,10
3,2025-05-24T16:37:00+02:00,2025-05-25,00:37,7,4,11
3,2025-05-24T16:39:00+02:00,2025-05-25,00:39,2,2,4
4,2025-05-24T16:26:00+02:00,2025-05-25,00:26,6,6,12
4,2025-05-24T16:29:00+02:00,2025-05-25,00:29,2,5,7
4,2025-05-24T16:30:00+02:00,2025-05-25,00:30,8,12,20
4,2025-05-24T16:31:00+02:00,2025-05-25,00:31,4,1,5
4,2025-05-24T16:32:00+02:00,2025-05-25,00:32,2,4,6
4,2025-05-24T16:39:00+02:00,2025-05-25,00:39,5,0,5
5,2025-05-24T16:25:00+02:00,2025-05-25,00:25,8,13,21
6,2025-05-24T16:33:00+02:00,2025-05-25,00:33,4,6,10
6,2025-05-24T16:38:00+02:00,2025-05-25,00:38,4,4,8
28,2025-05-24T16:27:00+02:00,2025-05-25,00:27,2,0,2
28,2025-05-24T16:34:00+02:00,2025-05-25,00:34,1,0,1
29,2025-05-24T16:27:00+02:00,2025-05-25,00:27,1,0,1
29,2025-05-24T16:39:00+02:00,2025-05-25,00:39,0,3,3
31,2025-05-24T16:29:00+02:00,2025-05-25,00:29,0,1,1
31,2025-05-24T16:32:00+02:00,2025-05-25,00:32,3,0,3
31,2025-05-24T16:36:00+02:00,2025-05-25,00:36,0,6,6
31,2025-05-24T16:39:00+02:00,2025-05-25,00:39,4,1,5
36,2025-05-24T16:26:00+02:00,2025-05-25,00:26,6,1,7
36,2025-05-24T16:30:00+02:00,2025-05-25,00:30,2,1,3
36,2025-05-24T16:34:00+02:00,2025-05-25,00:34,8,2,10
36,2025-05-24T16:35:00+02:00,2025-05-25,00:35,4,6,10
36,2025-05-24T16:37:00+02:00,2025-05-25,00:37,1,4,5
36,2025-05-24T16:39:00+02:00,2025-05-25,00:39,2,2,4
37,2025-05-24T16:30:00+02:00,2025-05-25,00:30,2,0,2
37,2025-05-24T16:32:00+02:00,2025-05-25,00:32,0,1,1
37,2025-05-24T16:36:00+02:00,2025-05-25,00:36,1,1,2
39,2025-05-24T16:25:00+02:00,2025-05-25,00:25,1,0,1
39,2025-05-24T16:27:00+02:00,2025-05-25,00:27,1,0,1
39,2025-05-24T16:29:00+02:00,2025-05-25,00:29,1,0,1
40,2025-05-24T16:32:00+02:00,2025-05-25,00:32,1,0,1
40,2025-05-24T16:39:00+02:00,2025-05-25,00:39,1,0,1
41,2025-05-24T16:25:00+02:00,2025-05-25,00:25,0,11,11
41,2025-05-24T16:27:00+02:00,2025-05-25,00:27,3,0,3
41,2025-05-24T16:31:00+02:00,2025-05-25,00:31,1,0,1
41,2025-05-24T16:33:00+02:00,2025-05-25,00:33,0,11,11
41,2025-05-24T16:34:00+02:00,2025-05-25,00:34,1,1,2
41,2025-05-24T16:35:00+02:00,2025-05-25,00:35,0,1,1
43,2025-05-24T16:25:00+02:00,2025-05-25,00:25,0,1,1
45,2025-05-24T16:27:00+02:00,2025-05-25,00:27,7,5,12
45,2025-05-24T16:28:00+02:00,2025-05-25,00:28,2,6,8
45,2025-05-24T16:29:00+02:00,2025-05-25,00:29,0,9,9
45,2025-05-24T16:31:00+02:00,2025-05-25,00:31,5,4,9
45,2025-05-24T16:39:00+02:00,2025-05-25,00:39,0,9,9
47,2025-05-24T16:25:00+02:00,2025-05-25,00:25,5,5,10
47,2025-05-24T16:28:00+02:00,2025-05-25,00:28,6,4,10
47,2025-05-24T16:34:00+02:00,2025-05-25,00:34,0,1,1
47,2025-05-24T16:35:00+02:00,2025-05-25,00:35,15,1,16
54,2025-05-24T16:25:00+02:00,2025-05-25,00:25,0,3,3
54,2025-05-24T16:26:00+02:00,2025-05-25,00:26,0,1,1
54,2025-05-24T16:28:00+02:00,2025-05-25,00:28,0,2,2
59,2025-05-24T16:25:00+02:00,2025-05-25,00:25,8,5,13
61,2025-05-24T16:28:00+02:00,2025-05-25,00:28,1,0,1
61,2025-05-24T16:35:00+02:00,2025-05-25,00:35,2,0,2
61,2025-05-24T16:36:00+02:00,2025-05-25,00:36,0,4,4
66,2025-05-24T16:25:00+02:00,2025-05-25,00:25,3,3,6
66,2025-05-24T16:26:00+02:00,2025-05-25,00:26,5,12,17
66,2025-05-24T16:30:00+02:00,2025-05-25,00:30,3,13,16
66,2025-05-24T16:31:00+02:00,2025-05-25,00:31,5,3,8
66,2025-05-24T16:39:00+02:00,2025-05-25,00:39,20,11,31
69,2025-05-24T16:27:00+02:00,2025-05-25,00:27,3,0,3
71,2025-05-24T16:25:00+02:00,2025-05-25,00:25,0,2,2
75,2025-05-24T16:25:00+02:00,2025-05-25,00:25,0,1,1
77,2025-05-24T16:30:00+02:00,2025-05-25,00:30,2,0,2
77,2025-05-24T16:35:00+02:00,2025-05-25,00:35,4,0,4
78,2025-05-24T16:31:00+02:00,2025-05-25,00:31,0,1,1
87,2025-05-24T16:26:00+02:00,2025-05-25,00:26,0,2,2
107,2025-05-24T16:25:00+02:00,2025-05-25,00:25,0,4,4
108,2025-05-24T16:33:00+02:00,2025-05-25,00:33,0,2,2
131,2025-05-24T16:30:00+02:00,2025-05-25,00:30,7,7,14
131,2025-05-24T16:35:00+02:00,2025-05-25,00:35,16,0,16
132,2025-05-24T16:30:00+02:00,2025-05-25,00:30,2,8,10
162,2025-05-24T16:30:00+02:00,2025-05-25,00:30,0,5,5
162,2025-05-24T16:35:00+02:00,2025-05-25,00:35,4,3,7
165,2025-05-24T16:30:00+02:00,2025-05-25,00:30,1,0,1
165,2025-05-24T16:35:00+02:00,2025-05-25,00:35,1,0,1
166,2025-05-24T16:30:00+02:00,2025-05-25,00:30,1,0,1
179,2025-05-24T16:25:00+02:00,2025-05-25,00:25,1,6,7
1,2025-05-24T16:33:00+02:00,2025-05-25,00:33,9,5,14
2,2025-05-24T16:25:00+02:00,2025-05-25,00:25,5,0,5
2,2025-05-24T16:32:00+02:00,2025-05-25,00:32,0,1,1
2,2025-05-24T16:36:00+02:00,2025-05-25,00:36,0,2,2
2,2025-05-24T16:38:00+02:00,2025-05-25,00:38,0,1,1
9,2025-05-24T16:31:00+02:00,2025-05-25,00:31,1,0,1
12,2025-05-24T16:38:00+02:00,2025-05-25,00:38,6,0,6
12,2025-05-24T16:39:00+02:00,2025-05-25,00:39,0,3,3
17,2025-05-24T16:30:00+02:00,2025-05-25,00:30,0,1,1
17,2025-05-24T16:34:00+02:00,2025-05-25,00:34,2,2,4
17,2025-05-24T16:37:00+02:00,2025-05-25,00:37,0,1,1
19,2025-05-24T16:28:00+02:00,2025-05-25,00:28,6,7,13
19,2025-05-24T16:31:00+02:00,2025-05-25,00:31,4,2,6
19,2025-05-24T16:32:00+02:00,2025-05-25,00:32,0,3,3
19,2025-05-24T16:33:00+02:00,2025-05-25,00:33,2,2,4
19,2025-05-24T16:34:00+02:00,2025-05-25,00:34,0,2,2
20,2025-05-24T16:26:00+02:00,2025-05-25,00:26,1,1,2
20,2025-05-24T16:31:00+02:00,2025-05-25,00:31,0,6,6
20,2025-05-24T16:34:00+02:00,2025-05-25,00:34,2,9,11
20,2025-05-24T16:39:00+02:00,2025-05-25,00:39,0,8,8
23,2025-05-24T16:26:00+02:00,2025-05-25,00:26,0,2,2
23,2025-05-24T16:28:00+02:00,2025-05-25,00:28,0,2,2
23,2025-05-24T16:33:00+02:00,2025-05-25,00:33,1,2,3
24,2025-05-24T16:25:00+02:00,2025-05-25,00:25,0,7,7
24,2025-05-24T16:26:00+02:00,2025-05-25,00:26,1,6,7
24,2025-05-24T16:29:00+02:00,2025-05-25,00:29,5,0,5
24,2025-05-24T16:30:00+02:00,2025-05-25,00:30,5,0,5
24,2025-05-24T16:34:00+02:00,2025-05-25,00:34,2,3,5
24,2025-05-24T16:35:00+02:00,2025-05-25,00:35,5,0,5
24,2025-05-24T16:39:00+02:00,2025-05-25,00:39,0,7,7
25,2025-05-24T16:35:00+02:00,2025-05-25,00:35,5,6,11
27,2025-05-24T16:29:00+02:00,2025-05-25,00:29,1,0,1
27,2025-05-24T16:30:00+02:00,2025-05-25,00:30,2,0,2
27,2025-05-24T16:39:00+02:00,2025-05-25,00:39,0,11,11
30,2025-05-24T16:26:00+02:00,2025-05-25,00:26,0,3,3
30,2025-05-24T16:29:00+02:00,2025-05-25,00:29,10,9,19
30,2025-05-24T16:30:00+02:00,2025-05-25,00:30,7,2,9
30,2025-05-24T16:32:00+02:00,2025-05-25,00:32,2,6,8
30,2025-05-24T16:33:00+02:00,2025-05-25,00:33,2,2,4
30,2025-05-24T16:37:00+02:00,2025-05-25,00:37,5,13,18
30,2025-05-24T16:39:00+02:00,2025-05-25,00:39,3,3,6
35,2025-05-24T16:29:00+02:00,2025-05-25,00:29,3,1,4
35,2025-05-24T16:32:00+02:00,2025-05-25,00:32,4,5,9
35,2025-05-24T16:35:00+02:00,2025-05-25,00:35,1,5,6
35,2025-05-24T16:36:00+02:00,2025-05-25,00:36,3,3,6
49,2025-05-24T16:38:00+02:00,2025-05-25,00:38,4,0,4
51,2025-05-24T16:35:00+02:00,2025-05-25,00:35,1,0,1
52,2025-05-24T16:29:00+02:00,2025-05-25,00:29,3,2,5
52,2025-05-24T16:38:00+02:00,2025-05-25,00:38,0,4,4
53,2025-05-24T16:31:00+02:00,2025-05-25,00:31,1,0,1
53,2025-05-24T16:32:00+02:00,2025-05-25,00:32,0,5,5
53,2025-05-24T16:37:00+02:00,2025-05-25,00:37,4,0,4
53,2025-05-24T16:39:00+02:00,2025-05-25,00:39,2,0,2
56,2025-05-24T16:38:00+02:00,2025-05-25,00:38,1,0,1
56,2025-05-24T16:39:00+02:00,2025-05-25,00:39,3,0,3
58,2025-05-24T16:25:00+02:00,2025-05-25,00:25,5,10,15
58,2025-05-24T16:28:00+02:00,2025-05-25,00:28,5,1,6
58,2025-05-24T16:29:00+02:00,2025-05-25,00:29,0,2,2
58,2025-05-24T16:34:00+02:00,2025-05-25,00:34,4,0,4
62,2025-05-24T16:26:00+02:00,2025-05-25,00:26,1,7,8
62,2025-05-24T16:31:00+02:00,2025-05-25,00:31,3,0,3
62,2025-05-24T16:33:00+02:00,2025-05-25,00:33,0,5,5
62,2025-05-24T16:39:00+02:00,2025-05-25,00:39,2,0,2
63,2025-05-24T16:30:00+02:00,2025-05-25,00:30,1,2,3
63,2025-05-24T16:32:00+02:00,2025-05-25,00:32,0,3,3
63,2025-05-24T16:36:00+02:00,2025-05-25,00:36,0,1,1
63,2025-05-24T16:37:00+02:00,2025-05-25,00:37,1,1,2
63,2025-05-24T16:39:00+02:00,2025-05-25,00:39,0,5,5
67,2025-05-24T16:26:00+02:00,2025-05-25,00:26,1,1,2
67,2025-05-24T16:31:00+02:00,2025-05-25,00:31,0,3,3
67,2025-05-24T16:32:00+02:00,2025-05-25,00:32,0,2,2
67,2025-05-24T16:33:00+02:00,2025-05-25,00:33,0,4,4
67,2025-05-24T16:34:00+02:00,2025-05-25,00:34,0,2,2
67,2025-05-24T16:38:00+02:00,2025-05-25,00:38,2,0,2
67,2025-05-24T16:39:00+02:00,2025-05-25,00:39,0,1,1
68,2025-05-24T16:39:00+02:00,2025-05-25,00:39,1,0,1
72,2025-05-24T16:28:00+02:00,2025-05-25,00:28,0,1,1
72,2025-05-24T16:31:00+02:00,2025-05-25,00:31,1,0,1
72,2025-05-24T16:36:00+02:00,2025-05-25,00:36,2,1,3
72,2025-05-24T16:38:00+02:00,2025-05-25,00:38,5,0,5
79,2025-05-24T16:30:00+02:00,2025-05-25,00:30,0,2,2
79,2025-05-24T16:31:00+02:00,2025-05-25,00:31,0,3,3
79,2025-05-24T16:32:00+02:00,2025-05-25,00:32,2,5,7
79,2025-05-24T16:33:00+02:00,2025-05-25,00:33,1,5,6
79,2025-05-24T16:38:00+02:00,2025-05-25,00:38,0,1,1
79,2025-05-24T16:39:00+02:00,2025-05-25,00:39,4,2,6
86,2025-05-24T16:26:00+02:00,2025-05-25,00:26,0,2,2
109,2025-05-24T16:25:00+02:00,2025-05-25,00:25,1,5,6
139,2025-05-24T16:25:00+02:00,2025-05-25,00:25,3,0,3
141,2025-05-24T16:35:00+02:00,2025-05-25,00:35,3,3,6
181,2025-05-24T16:28:00+02:00,2025-05-25,00:28,1,4,5
181,2025-05-24T16:32:00+02:00,2025-05-25,00:32,4,0,4
181,2025-05-24T16:34:00+02:00,2025-05-25,00:34,6,2,8
181,2025-05-24T16:36:00+02:00,2025-05-25,00:36,2,2,4
181,2025-05-24T16:37:00+02:00,2025-05-25,00:37,4,12,16
181,2025-05-24T16:38:00+02:00,2025-05-25,00:38,1,8,9
182,2025-05-24T16:25:00+02:00,2025-05-25,00:25,6,13,19
3,2025-05-24T16:27:00+02:00,2025-05-25,00:27,11,14,25
3,2025-05-24T16:29:00+02:00,2025-05-25,00:29,3,10,13
3,2025-05-24T16:30:00+02:00,2025-05-25,00:30,2,3,5
3,2025-05-24T16:31:00+02:00,2025-05-25,00:31,5,10,15
3,2025-05-24T16:33:00+02:00,2025-05-25,00:33,11,2,13
3,2025-05-24T16:36:00+02:00,2025-05-25,00:36,0,2,2
3,2025-05-24T16:38:00+02:00,2025-05-25,00:38,1,6,7
4,2025-05-24T16:27:00+02:00,2025-05-25,00:27,0,5,5
4,2025-05-24T16:34:00+02:00,2025-05-25,00:34,2,1,3
4,2025-05-24T16:35:00+02:00,2025-05-25,00:35,1,1,2
4,2025-05-24T16:36:00+02:00,2025-05-25,00:36,1,5,6
6,2025-05-24T16:25:00+02:00,2025-05-25,00:25,2,3,5
6,2025-05-24T16:27:00+02:00,2025-05-25,00:27,17,4,21
6,2025-05-24T16:31:00+02:00,2025-05-25,00:31,12,3,15
6,2025-05-24T16:35:00+02:00,2025-05-25,00:35,5,0,5
8,2025-05-24T16:30:00+02:00,2025-05-25,00:30,3,0,3
8,2025-05-24T16:33:00+02:00,2025-05-25,00:33,1,1,2
8,2025-05-24T16:37:00+02:00,2025-05-25,00:37,2,0,2
28,2025-05-24T16:31:00+02:00,2025-05-25,00:31,1,7,8
28,2025-05-24T16:32:00+02:00,2025-05-25,00:32,1,0,1
28,2025-05-24T16:37:00+02:00,2025-05-25,00:37,0,1,1
28,2025-05-24T16:38:00+02:00,2025-05-25,00:38,2,0,2
28,2025-05-24T16:39:00+02:00,2025-05-25,00:39,0,1,1
29,2025-05-24T16:33:00+02:00,2025-05-25,00:33,0,2,2
31,2025-05-24T16:28:00+02:00,2025-05-25,00:28,0,1,1
31,2025-05-24T16:31:00+02:00,2025-05-25,00:31,2,1,3
31,2025-05-24T16:37:00+02:00,2025-05-25,00:37,0,2,2
31,2025-05-24T16:38:00+02:00,2025-05-25,00:38,0,6,6
36,2025-05-24T16:25:00+02:00,2025-05-25,00:25,0,3,3
36,2025-05-24T16:27:00+02:00,2025-05-25,00:27,4,0,4
36,2025-05-24T16:28:00+02:00,2025-05-25,00:28,9,3,12
36,2025-05-24T16:31:00+02:00,2025-05-25,00:31,2,0,2
36,2025-05-24T16:32:00+02:00,2025-05-25,00:32,5,10,15
36,2025-05-24T16:33:00+02:00,2025-05-25,00:33,7,3,10
36,2025-05-24T16:36:00+02:00,2025-05-25,00:36,10,1,11
37,2025-05-24T16:26:00+02:00,2025-05-25,00:26,2,0,2
37,2025-05-24T16:38:00+02:00,2025-05-25,00:38,0,3,3
39,2025-05-24T16:31:00+02:00,2025-05-25,00:31,2,0,2
40,2025-05-24T16:26:00+02:00,2025-05-25,00:26,4,0,4
41,2025-05-24T16:26:00+02:00,2025-05-25,00:26,0,9,9
41,2025-05-24T16:28:00+02:00,2025-05-25,00:28,1,2,3
41,2025-05-24T16:32:00+02:00,2025-05-25,00:32,0,2,2
41,2025-05-24T16:36:00+02:00,2025-05-25,00:36,0,3,3
41,2025-05-24T16:39:00+02:00,2025-05-25,00:39,4,1,5
43,2025-05-24T16:35:00+02:00,2025-05-25,00:35,0,1,1
45,2025-05-24T16:25:00+02:00,2025-05-25,00:25,3,4,7
45,2025-05-24T16:26:00+02:00,2025-05-25,00:26,4,5,9
45,2025-05-24T16:30:00+02:00,2025-05-25,00:30,0,6,6
45,2025-05-24T16:32:00+02:00,2025-05-25,00:32,1,4,5
45,2025-05-24T16:33:00+02:00,2025-05-25,00:33,2,4,6
45,2025-05-24T16:37:00+02:00,2025-05-25,00:37,5,3,8
47,2025-05-24T16:26:00+02:00,2025-05-25,00:26,0,1,1
47,2025-05-24T16:31:00+02:00,2025-05-25,00:31,5,6,11
47,2025-05-24T16:33:00+02:00,2025-05-25,00:33,5,0,5
50,2025-05-24T16:25:00+02:00,2025-05-25,00:25,0,1,1
50,2025-05-24T16:38:00+02:00,2025-05-25,00:38,2,0,2
54,2025-05-24T16:29:00+02:00,2025-05-25,00:29,0,4,4
54,2025-05-24T16:35:00+02:00,2025-05-25,00:35,2,0,2
54,2025-05-24T16:36:00+02:00,2025-05-25,00:36,2,1,3
54,2025-05-24T16:37:00+02:00,2025-05-25,00:37,3,0,3
54,2025-05-24T16:39:00+02:00,2025-05-25,00:39,0,1,1
59,2025-05-24T16:30:00+02:00,2025-05-25,00:30,12,4,16
61,2025-05-24T16:26:00+02:00,2025-05-25,00:26,0,1,1
61,2025-05-24T16:27:00+02:00,2025-05-25,00:27,1,0,1
61,2025-05-24T16:32:00+02:00,2025-05-25,00:32,1,2,3
61,2025-05-24T16:37:00+02:00,2025-05-25,00:37,0,2,2
66,2025-05-24T16:32:00+02:00,2025-05-25,00:32,5,16,21
66,2025-05-24T16:35:00+02:00,2025-05-25,00:35,6,9,15
66,2025-05-24T16:38:00+02:00,2025-05-25,00:38,2,4,6
69,2025-05-24T16:30:00+02:00,2025-05-25,00:30,0,1,1
69,2025-05-24T16:39:00+02:00,2025-05-25,00:39,1,0,1
77,2025-05-24T16:25:00+02:00,2025-05-25,00:25,2,0,2
78,2025-05-24T16:35:00+02:00,2025-05-25,00:35,0,1,1
84,2025-05-24T16:30:00+02:00,2025-05-25,00:30,18,24,42
84,2025-05-24T16:35:00+02:00,2025-05-25,00:35,8,26,34
108,2025-05-24T16:27:00+02:00,2025-05-25,00:27,3,0,3
108,2025-05-24T16:35:00+02:00,2025-05-25,00:35,0,2,2
108,2025-05-24T16:39:00+02:00,2025-05-25,00:39,0,3,3
131,2025-05-24T16:25:00+02:00,2025-05-25,00:25,22,2,24
132,2025-05-24T16:25:00+02:00,2025-05-25,00:25,7,2,9
132,2025-05-24T16:35:00+02:00,2025-05-25,00:35,9,9,18
133,2025-05-24T16:30:00+02:00,2025-05-25,00:30,4,1,5
133,2025-05-24T16:35:00+02:00,2025-05-25,00:35,12,0,12
134,2025-05-24T16:25:00+02:00,2025-05-25,00:25,14,4,18
134,2025-05-24T16:30:00+02:00,2025-05-25,00:30,13,5,18
134,2025-05-24T16:35:00+02:00,2025-05-25,00:35,11,8,19
135,2025-05-24T16:25:00+02:00,2025-05-25,00:25,3,5,8
167,2025-05-24T16:25:00+02:00,2025-05-25,00:25,0,2,2
179,2025-05-24T16:30:00+02:00,2025-05-25,00:30,1,0,1
179,2025-05-24T16:35:00+02:00,2025-05-25,00:35,2,5,7
1,2025-05-24T16:27:00+02:00,2025-05-25,00:27,1,4,5
1,2025-05-24T16:28:00+02:00,2025-05-25,00:28,0,4,4
1,2025-05-24T16:32:00+02:00,2025-05-25,00:32,2,0,2
2,2025-05-24T16:27:00+02:00,2025-05-25,00:27,1,0,1
9,2025-05-24T16:26:00+02:00,2025-05-25,00:26,0,1,1
9,2025-05-24T16:27:00+02:00,2025-05-25,00:27,1,1,2
9,2025-05-24T16:39:00+02:00,2025-05-25,00:39,0,1,1
10,2025-05-24T16:27:00+02:00,2025-05-25,00:27,1,0,1
10,2025-05-24T16:30:00+02:00,2025-05-25,00:30,0,1,1
11,2025-05-24T16:29:00+02:00,2025-05-25,00:29,2,0,2
11,2025-05-24T16:30:00+02:00,2025-05-25,00:30,1,0,1
12,2025-05-24T16:31:00+02:00,2025-05-25,00:31,2,0,2
12,2025-05-24T16:32:00+02:00,2025-05-25,00:32,0,2,2
17,2025-05-24T16:35:00+02:00,2025-05-25,00:35,0,2,2
17,2025-05-24T16:36:00+02:00,2025-05-25,00:36,0,1,1
19,2025-05-24T16:25:00+02:00,2025-05-25,00:25,1,3,4
19,2025-05-24T16:27:00+02:00,2025-05-25,00:27,1,7,8
19,2025-05-24T16:29:00+02:00,2025-05-25,00:29,6,3,9
19,2025-05-24T16:30:00+02:00,2025-05-25,00:30,7,4,11
19,2025-05-24T16:36:00+02:00,2025-05-25,00:36,10,3,13
19,2025-05-24T16:38:00+02:00,2025-05-25,00:38,7,2,9
20,2025-05-24T16:27:00+02:00,2025-05-25,00:27,1,4,5
20,2025-05-24T16:29:00+02:00,2025-05-25,00:29,5,7,12
20,2025-05-24T16:32:00+02:00,2025-05-25,00:32,5,14,19
20,2025-05-24T16:33:00+02:00,2025-05-25,00:33,13,11,24
20,2025-05-24T16:35:00+02:00,2025-05-25,00:35,0,3,3
20,2025-05-24T16:36:00+02:00,2025-05-25,00:36,2,4,6
20,2025-05-24T16:37:00+02:00,2025-05-25,00:37,0,6,6
23,2025-05-24T16:25:00+02:00,2025-05-25,00:25,2,0,2
23,2025-05-24T16:31:00+02:00,2025-05-25,00:31,2,1,3
23,2025-05-24T16:32:00+02:00,2025-05-25,00:32,2,2,4
23,2025-05-24T16:39:00+02:00,2025-05-25,00:39,2,0,2
24,2025-05-24T16:36:00+02:00,2025-05-25,00:36,0,5,5
24,2025-05-24T16:38:00+02:00,2025-05-25,00:38,8,2,10
25,2025-05-24T16:25:00+02:00,2025-05-25,00:25,5,1,6
30,2025-05-24T16:25:00+02:00,2025-05-25,00:25,0,5,5
30,2025-05-24T16:28:00+02:00,2025-05-25,00:28,0,4,4
30,2025-05-24T16:35:00+02:00,2025-05-25,00:35,3,8,11
35,2025-05-24T16:25:00+02:00,2025-05-25,00:25,3,3,6
35,2025-05-24T16:26:00+02:00,2025-05-25,00:26,2,6,8
35,2025-05-24T16:27:00+02:00,2025-05-25,00:27,4,7,11
35,2025-05-24T16:30:00+02:00,2025-05-25,00:30,2,3,5
35,2025-05-24T16:38:00+02:00,2025-05-25,00:38,2,8,10
35,2025-05-24T16:39:00+02:00,2025-05-25,00:39,5,8,13
49,2025-05-24T16:26:00+02:00,2025-05-25,00:26,2,9,11
49,2025-05-24T16:28:00+02:00,2025-05-25,00:28,1,0,1
49,2025-05-24T16:30:00+02:00,2025-05-25,00:30,0,3,3
49,2025-05-24T16:31:00+02:00,2025-05-25,00:31,0,1,1
51,2025-05-24T16:29:00+02:00,2025-05-25,00:29,0,2,2
52,2025-05-24T16:28:00+02:00,2025-05-25,00:28,5,1,6
52,2025-05-24T16:33:00+02:00,2025-05-25,00:33,3,6,9
52,2025-05-24T16:35:00+02:00,2025-05-25,00:35,1,0,1
52,2025-05-24T16:37:00+02:00,2025-05-25,00:37,4,0,4
53,2025-05-24T16:26:00+02:00,2025-05-25,00:26,4,0,4
53,2025-05-24T16:28:00+02:00,2025-05-25,00:28,2,1,3
53,2025-05-24T16:33:00+02:00,2025-05-25,00:33,1,0,1
56,2025-05-24T16:25:00+02:00,2025-05-25,00:25,3,0,3
56,2025-05-24T16:28:00+02:00,2025-05-25,00:28,0,1,1
56,2025-05-24T16:33:00+02:00,2025-05-25,00:33,2,0,2
56,2025-05-24T16:36:00+02:00,2025-05-25,00:36,1,0,1
58,2025-05-24T16:26:00+02:00,2025-05-25,00:26,4,0,4
58,2025-05-24T16:27:00+02:00,2025-05-25,00:27,9,5,14
58,2025-05-24T16:30:00+02:00,2025-05-25,00:30,6,1,7
58,2025-05-24T16:31:00+02:00,2025-05-25,00:31,5,4,9
58,2025-05-24T16:33:00+02:00,2025-05-25,00:33,1,0,1
58,2025-05-24T16:35:00+02:00,2025-05-25,00:35,2,4,6
58,2025-05-24T16:39:00+02:00,2025-05-25,00:39,3,13,16
62,2025-05-24T16:30:00+02:00,2025-05-25,00:30,3,1,4
62,2025-05-24T16:35:00+02:00,2025-05-25,00:35,0,2,2
62,2025-05-24T16:38:00+02:00,2025-05-25,00:38,0,2,2
63,2025-05-24T16:26:00+02:00,2025-05-25,00:26,0,1,1
63,2025-05-24T16:38:00+02:00,2025-05-25,00:38,0,1,1
67,2025-05-24T16:25:00+02:00,2025-05-25,00:25,0,1,1
67,2025-05-24T16:30:00+02:00,2025-05-25,00:30,2,1,3
67,2025-05-24T16:35:00+02:00,2025-05-25,00:35,0,1,1
68,2025-05-24T16:37:00+02:00,2025-05-25,00:37,1,0,1
72,2025-05-24T16:30:00+02:00,2025-05-25,00:30,1,1,2
72,2025-05-24T16:35:00+02:00,2025-05-25,00:35,0,1,1
79,2025-05-24T16:26:00+02:00,2025-05-25,00:26,1,0,1
79,2025-05-24T16:27:00+02:00,2025-05-25,00:27,3,0,3
79,2025-05-24T16:35:00+02:00,2025-05-25,00:35,2,4,6
79,2025-05-24T16:36:00+02:00,2025-05-25,00:36,0,5,5
79,2025-05-24T16:37:00+02:00,2025-05-25,00:37,0,2,2
117,2025-05-24T16:30:00+02:00,2025-05-25,00:30,11,7,18
117,2025-05-24T16:35:00+02:00,2025-05-25,00:35,5,1,6
130,2025-05-24T16:35:00+02:00,2025-05-25,00:35,2,0,2
136,2025-05-24T16:30:00+02:00,2025-05-25,00:30,1,0,1
141,2025-05-24T16:25:00+02:00,2025-05-25,00:25,1,8,9
142,2025-05-24T16:25:00+02:00,2025-05-25,00:25,2,1,3
181,2025-05-24T16:25:00+02:00,2025-05-25,00:25,3,7,10
181,2025-05-24T16:26:00+02:00,2025-05-25,00:26,3,6,9
181,2025-05-24T16:29:00+02:00,2025-05-25,00:29,5,3,8
181,2025-05-24T16:30:00+02:00,2025-05-25,00:30,3,4,7
181,2025-05-24T16:35:00+02:00,2025-05-25,00:35,10,0,10
181,2025-05-24T16:39:00+02:00,2025-05-25,00:39,5,2,7
182,2025-05-24T16:35:00+02:00,2025-05-25,00:35,27,28,55
3,2025-05-25T07:41:00+02:00,2025-05-25,15:41,12,20,32
3,2025-05-25T07:44:00+02:00,2025-05-25,15:44,27,27,54
3,2025-05-25T07:48:00+02:00,2025-05-25,15:48,31,20,51
3,2025-05-25T07:49:00+02:00,2025-05-25,15:49,16,19,35
3,2025-05-25T07:54:00+02:00,2025-05-25,15:54,19,10,29
4,2025-05-25T07:40:00+02:00,2025-05-25,15:40,43,26,69
4,2025-05-25T07:45:00+02:00,2025-05-25,15:45,25,30,55
4,2025-05-25T07:48:00+02:00,2025-05-25,15:48,25,28,53
4,2025-05-25T07:49:00+02:00,2025-05-25,15:49,41,14,55
4,2025-05-25T07:50:00+02:00,2025-05-25,15:50,33,33,66
4,2025-05-25T07:52:00+02:00,2025-05-25,15:52,26,32,58
4,2025-05-25T07:54:00+02:00,2025-05-25,15:54,17,20,37
5,2025-05-25T07:40:00+02:00,2025-05-25,15:40,76,107,183
5,2025-05-25T07:50:00+02:00,2025-05-25,15:50,76,132,208
6,2025-05-25T07:43:00+02:00,2025-05-25,15:43,19,19,38
6,2025-05-25T07:45:00+02:00,2025-05-25,15:45,10,35,45
6,2025-05-25T07:48:00+02:00,2025-05-25,15:48,12,16,28
8,2025-05-25T07:41:00+02:00,2025-05-25,15:41,3,12,15
8,2025-05-25T07:44:00+02:00,2025-05-25,15:44,6,1,7
8,2025-05-25T07:46:00+02:00,2025-05-25,15:46,4,4,8
8,2025-05-25T07:53:00+02:00,2025-05-25,15:53,4,6,10
28,2025-05-25T07:41:00+02:00,2025-05-25,15:41,23,5,28
28,2025-05-25T07:43:00+02:00,2025-05-25,15:43,17,9,26
28,2025-05-25T07:52:00+02:00,2025-05-25,15:52,8,4,12
28,2025-05-25T07:53:00+02:00,2025-05-25,15:53,19,11,30
29,2025-05-25T07:41:00+02:00,2025-05-25,15:41,7,26,33
29,2025-05-25T07:42:00+02:00,2025-05-25,15:42,17,20,37
29,2025-05-25T07:43:00+02:00,2025-05-25,15:43,4,20,24
29,2025-05-25T07:54:00+02:00,2025-05-25,15:54,14,19,33
31,2025-05-25T07:41:00+02:00,2025-05-25,15:41,13,9,22
31,2025-05-25T07:45:00+02:00,2025-05-25,15:45,2,2,4
31,2025-05-25T07:46:00+02:00,2025-05-25,15:46,4,2,6
31,2025-05-25T07:49:00+02:00,2025-05-25,15:49,5,0,5
31,2025-05-25T07:51:00+02:00,2025-05-25,15:51,4,7,11
31,2025-05-25T07:52:00+02:00,2025-05-25,15:52,1,6,7
31,2025-05-25T07:53:00+02:00,2025-05-25,15:53,5,2,7
36,2025-05-25T07:44:00+02:00,2025-05-25,15:44,4,3,7
36,2025-05-25T07:46:00+02:00,2025-05-25,15:46,1,2,3
36,2025-05-25T07:47:00+02:00,2025-05-25,15:47,6,0,6
36,2025-05-25T07:48:00+02:00,2025-05-25,15:48,2,4,6
36,2025-05-25T07:49:00+02:00,2025-05-25,15:49,3,0,3
36,2025-05-25T07:50:00+02:00,2025-05-25,15:50,1,1,2
36,2025-05-25T07:53:00+02:00,2025-05-25,15:53,3,0,3
39,2025-05-25T07:43:00+02:00,2025-05-25,15:43,2,0,2
39,2025-05-25T07:53:00+02:00,2025-05-25,15:53,2,0,2
39,2025-05-25T07:54:00+02:00,2025-05-25,15:54,1,0,1
40,2025-05-25T07:40:00+02:00,2025-05-25,15:40,7,6,13
40,2025-05-25T07:41:00+02:00,2025-05-25,15:41,3,2,5
40,2025-05-25T07:42:00+02:00,2025-05-25,15:42,2,1,3
40,2025-05-25T07:49:00+02:00,2025-05-25,15:49,2,1,3
41,2025-05-25T07:44:00+02:00,2025-05-25,15:44,8,8,16
41,2025-05-25T07:45:00+02:00,2025-05-25,15:45,23,14,37
41,2025-05-25T07:47:00+02:00,2025-05-25,15:47,12,14,26
41,2025-05-25T07:48:00+02:00,2025-05-25,15:48,14,9,23
41,2025-05-25T07:50:00+02:00,2025-05-25,15:50,11,27,38
41,2025-05-25T07:53:00+02:00,2025-05-25,15:53,11,14,25
43,2025-05-25T07:50:00+02:00,2025-05-25,15:50,8,3,11
44,2025-05-25T07:40:00+02:00,2025-05-25,15:40,5,1,6
44,2025-05-25T07:45:00+02:00,2025-05-25,15:45,5,1,6
44,2025-05-25T07:50:00+02:00,2025-05-25,15:50,2,1,3
45,2025-05-25T07:40:00+02:00,2025-05-25,15:40,25,17,42
45,2025-05-25T07:45:00+02:00,2025-05-25,15:45,13,14,27
45,2025-05-25T07:46:00+02:00,2025-05-25,15:46,33,26,59
45,2025-05-25T07:50:00+02:00,2025-05-25,15:50,25,13,38
45,2025-05-25T07:51:00+02:00,2025-05-25,15:51,17,12,29
45,2025-05-25T07:54:00+02:00,2025-05-25,15:54,12,31,43
47,2025-05-25T07:40:00+02:00,2025-05-25,15:40,20,15,35
47,2025-05-25T07:42:00+02:00,2025-05-25,15:42,6,57,63
47,2025-05-25T07:44:00+02:00,2025-05-25,15:44,32,33,65
47,2025-05-25T07:45:00+02:00,2025-05-25,15:45,16,30,46
47,2025-05-25T07:50:00+02:00,2025-05-25,15:50,12,5,17
47,2025-05-25T07:52:00+02:00,2025-05-25,15:52,22,28,50
50,2025-05-25T07:45:00+02:00,2025-05-25,15:45,13,3,16
50,2025-05-25T07:51:00+02:00,2025-05-25,15:51,2,1,3
50,2025-05-25T07:52:00+02:00,2025-05-25,15:52,4,0,4
50,2025-05-25T07:54:00+02:00,2025-05-25,15:54,4,7,11
54,2025-05-25T07:41:00+02:00,2025-05-25,15:41,5,9,14
54,2025-05-25T07:44:00+02:00,2025-05-25,15:44,4,4,8
54,2025-05-25T07:46:00+02:00,2025-05-25,15:46,2,1,3
54,2025-05-25T07:48:00+02:00,2025-05-25,15:48,0,8,8
54,2025-05-25T07:49:00+02:00,2025-05-25,15:49,4,3,7
54,2025-05-25T07:52:00+02:00,2025-05-25,15:52,5,0,5
54,2025-05-25T07:53:00+02:00,2025-05-25,15:53,2,1,3
59,2025-05-25T07:40:00+02:00,2025-05-25,15:40,17,16,33
61,2025-05-25T07:40:00+02:00,2025-05-25,15:40,7,8,15
61,2025-05-25T07:42:00+02:00,2025-05-25,15:42,7,5,12
61,2025-05-25T07:45:00+02:00,2025-05-25,15:45,4,3,7
61,2025-05-25T07:46:00+02:00,2025-05-25,15:46,2,12,14
61,2025-05-25T07:49:00+02:00,2025-05-25,15:49,2,11,13
61,2025-05-25T07:52:00+02:00,2025-05-25,15:52,11,8,19
61,2025-05-25T07:53:00+02:00,2025-05-25,15:53,9,3,12
66,2025-05-25T07:45:00+02:00,2025-05-25,15:45,29,29,58
66,2025-05-25T07:48:00+02:00,2025-05-25,15:48,24,24,48
69,2025-05-25T07:40:00+02:00,2025-05-25,15:40,5,4,9
69,2025-05-25T07:45:00+02:00,2025-05-25,15:45,2,2,4
69,2025-05-25T07:46:00+02:00,2025-05-25,15:46,0,4,4
69,2025-05-25T07:47:00+02:00,2025-05-25,15:47,6,4,10
69,2025-05-25T07:48:00+02:00,2025-05-25,15:48,4,4,8
70,2025-05-25T07:41:00+02:00,2025-05-25,15:41,3,1,4
70,2025-05-25T07:42:00+02:00,2025-05-25,15:42,4,4,8
70,2025-05-25T07:43:00+02:00,2025-05-25,15:43,4,3,7
70,2025-05-25T07:44:00+02:00,2025-05-25,15:44,1,3,4
70,2025-05-25T07:45:00+02:00,2025-05-25,15:45,1,3,4
70,2025-05-25T07:47:00+02:00,2025-05-25,15:47,4,5,9
70,2025-05-25T07:50:00+02:00,2025-05-25,15:50,4,2,6
70,2025-05-25T07:51:00+02:00,2025-05-25,15:51,7,1,8
70,2025-05-25T07:52:00+02:00,2025-05-25,15:52,3,3,6
71,2025-05-25T07:50:00+02:00,2025-05-25,15:50,0,1,1
75,2025-05-25T07:43:00+02:00,2025-05-25,15:43,2,5,7
75,2025-05-25T07:44:00+02:00,2025-05-25,15:44,1,1,2
75,2025-05-25T07:48:00+02:00,2025-05-25,15:48,0,2,2
77,2025-05-25T07:50:00+02:00,2025-05-25,15:50,27,23,50
78,2025-05-25T07:42:00+02:00,2025-05-25,15:42,3,2,5
78,2025-05-25T07:47:00+02:00,2025-05-25,15:47,0,2,2
78,2025-05-25T07:48:00+02:00,2025-05-25,15:48,0,2,2
78,2025-05-25T07:51:00+02:00,2025-05-25,15:51,0,1,1
78,2025-05-25T07:53:00+02:00,2025-05-25,15:53,0,1,1
84,2025-05-25T07:40:00+02:00,2025-05-25,15:40,102,115,217
84,2025-05-25T07:45:00+02:00,2025-05-25,15:45,75,123,198
87,2025-05-25T07:40:00+02:00,2025-05-25,15:40,3,0,3
87,2025-05-25T07:42:00+02:00,2025-05-25,15:42,4,2,6
87,2025-05-25T07:45:00+02:00,2025-05-25,15:45,2,1,3
87,2025-05-25T07:46:00+02:00,2025-05-25,15:46,0,2,2
87,2025-05-25T07:47:00+02:00,2025-05-25,15:47,0,3,3
87,2025-05-25T07:49:00+02:00,2025-05-25,15:49,3,0,3
87,2025-05-25T07:51:00+02:00,2025-05-25,15:51,0,2,2
87,2025-05-25T07:53:00+02:00,2025-05-25,15:53,3,5,8
87,2025-05-25T07:54:00+02:00,2025-05-25,15:54,4,0,4
107,2025-05-25T07:45:00+02:00,2025-05-25,15:45,6,15,21
108,2025-05-25T07:42:00+02:00,2025-05-25,15:42,5,3,8
124,2025-05-25T07:50:00+02:00,2025-05-25,15:50,1,1,2
131,2025-05-25T07:40:00+02:00,2025-05-25,15:40,14,12,26
131,2025-05-25T07:45:00+02:00,2025-05-25,15:45,1,2,3
132,2025-05-25T07:40:00+02:00,2025-05-25,15:40,3,6,9
132,2025-05-25T07:45:00+02:00,2025-05-25,15:45,22,4,26
135,2025-05-25T07:50:00+02:00,2025-05-25,15:50,55,33,88
162,2025-05-25T07:40:00+02:00,2025-05-25,15:40,35,61,96
165,2025-05-25T07:40:00+02:00,2025-05-25,15:40,3,3,6
165,2025-05-25T07:45:00+02:00,2025-05-25,15:45,4,4,8
166,2025-05-25T07:50:00+02:00,2025-05-25,15:50,2,5,7
167,2025-05-25T07:40:00+02:00,2025-05-25,15:40,5,8,13
179,2025-05-25T07:45:00+02:00,2025-05-25,15:45,4,7,11
179,2025-05-25T07:50:00+02:00,2025-05-25,15:50,4,7,11
1,2025-05-25T07:41:00+02:00,2025-05-25,15:41,18,20,38
1,2025-05-25T07:44:00+02:00,2025-05-25,15:44,19,26,45
1,2025-05-25T07:49:00+02:00,2025-05-25,15:49,27,34,61
1,2025-05-25T07:50:00+02:00,2025-05-25,15:50,30,20,50
1,2025-05-25T07:54:00+02:00,2025-05-25,15:54,28,28,56
2,2025-05-25T07:47:00+02:00,2025-05-25,15:47,11,8,19
2,2025-05-25T07:50:00+02:00,2025-05-25,15:50,9,10,19
2,2025-05-25T07:52:00+02:00,2025-05-25,15:52,16,15,31
2,2025-05-25T07:54:00+02:00,2025-05-25,15:54,4,12,16
9,2025-05-25T07:54:00+02:00,2025-05-25,15:54,3,4,7
10,2025-05-25T07:42:00+02:00,2025-05-25,15:42,0,1,1
10,2025-05-25T07:49:00+02:00,2025-05-25,15:49,2,0,2
10,2025-05-25T07:51:00+02:00,2025-05-25,15:51,0,1,1
10,2025-05-25T07:52:00+02:00,2025-05-25,15:52,2,1,3
10,2025-05-25T07:54:00+02:00,2025-05-25,15:54,0,2,2
11,2025-05-25T07:42:00+02:00,2025-05-25,15:42,1,0,1
11,2025-05-25T07:44:00+02:00,2025-05-25,15:44,4,0,4
11,2025-05-25T07:48:00+02:00,2025-05-25,15:48,0,1,1
11,2025-05-25T07:50:00+02:00,2025-05-25,15:50,6,5,11
11,2025-05-25T07:52:00+02:00,2025-05-25,15:52,1,1,2
12,2025-05-25T07:40:00+02:00,2025-05-25,15:40,12,0,12
12,2025-05-25T07:43:00+02:00,2025-05-25,15:43,10,1,11
12,2025-05-25T07:47:00+02:00,2025-05-25,15:47,18,2,20
12,2025-05-25T07:48:00+02:00,2025-05-25,15:48,5,2,7
12,2025-05-25T07:53:00+02:00,2025-05-25,15:53,9,6,15
12,2025-05-25T07:54:00+02:00,2025-05-25,15:54,4,8,12
17,2025-05-25T07:46:00+02:00,2025-05-25,15:46,4,19,23
17,2025-05-25T07:48:00+02:00,2025-05-25,15:48,0,6,6
17,2025-05-25T07:50:00+02:00,2025-05-25,15:50,2,14,16
17,2025-05-25T07:53:00+02:00,2025-05-25,15:53,0,3,3
18,2025-05-25T07:42:00+02:00,2025-05-25,15:42,3,1,4
18,2025-05-25T07:45:00+02:00,2025-05-25,15:45,5,0,5
18,2025-05-25T07:49:00+02:00,2025-05-25,15:49,4,0,4
18,2025-05-25T07:51:00+02:00,2025-05-25,15:51,2,1,3
18,2025-05-25T07:52:00+02:00,2025-05-25,15:52,4,0,4
19,2025-05-25T07:41:00+02:00,2025-05-25,15:41,6,14,20
19,2025-05-25T07:47:00+02:00,2025-05-25,15:47,21,5,26
19,2025-05-25T07:49:00+02:00,2025-05-25,15:49,19,5,24
19,2025-05-25T07:50:00+02:00,2025-05-25,15:50,12,7,19
20,2025-05-25T07:41:00+02:00,2025-05-25,15:41,5,4,9
20,2025-05-25T07:49:00+02:00,2025-05-25,15:49,1,1,2
23,2025-05-25T07:40:00+02:00,2025-05-25,15:40,0,6,6
23,2025-05-25T07:43:00+02:00,2025-05-25,15:43,3,3,6
23,2025-05-25T07:44:00+02:00,2025-05-25,15:44,0,4,4
23,2025-05-25T07:45:00+02:00,2025-05-25,15:45,3,11,14
23,2025-05-25T07:49:00+02:00,2025-05-25,15:49,1,3,4
23,2025-05-25T07:50:00+02:00,2025-05-25,15:50,1,1,2
23,2025-05-25T07:51:00+02:00,2025-05-25,15:51,1,4,5
24,2025-05-25T07:45:00+02:00,2025-05-25,15:45,7,15,22
24,2025-05-25T07:48:00+02:00,2025-05-25,15:48,9,46,55
24,2025-05-25T07:50:00+02:00,2025-05-25,15:50,1,14,15
24,2025-05-25T07:52:00+02:00,2025-05-25,15:52,4,22,26
24,2025-05-25T07:53:00+02:00,2025-05-25,15:53,12,13,25
27,2025-05-25T07:44:00+02:00,2025-05-25,15:44,5,0,5
27,2025-05-25T07:45:00+02:00,2025-05-25,15:45,7,6,13
27,2025-05-25T07:48:00+02:00,2025-05-25,15:48,3,1,4
27,2025-05-25T07:49:00+02:00,2025-05-25,15:49,1,0,1
30,2025-05-25T07:43:00+02:00,2025-05-25,15:43,1,3,4
30,2025-05-25T07:45:00+02:00,2025-05-25,15:45,3,1,4
30,2025-05-25T07:48:00+02:00,2025-05-25,15:48,6,1,7
30,2025-05-25T07:54:00+02:00,2025-05-25,15:54,1,2,3
35,2025-05-25T07:40:00+02:00,2025-05-25,15:40,20,22,42
35,2025-05-25T07:41:00+02:00,2025-05-25,15:41,22,40,62
35,2025-05-25T07:47:00+02:00,2025-05-25,15:47,19,19,38
35,2025-05-25T07:52:00+02:00,2025-05-25,15:52,21,26,47
46,2025-05-25T07:40:00+02:00,2025-05-25,15:40,7,4,11
48,2025-05-25T07:43:00+02:00,2025-05-25,15:43,11,4,15
48,2025-05-25T07:45:00+02:00,2025-05-25,15:45,12,2,14
48,2025-05-25T07:47:00+02:00,2025-05-25,15:47,4,5,9
48,2025-05-25T07:49:00+02:00,2025-05-25,15:49,6,9,15
48,2025-05-25T07:52:00+02:00,2025-05-25,15:52,6,5,11
48,2025-05-25T07:53:00+02:00,2025-05-25,15:53,12,2,14
48,2025-05-25T07:54:00+02:00,2025-05-25,15:54,12,0,12
49,2025-05-25T07:42:00+02:00,2025-05-25,15:42,3,11,14
49,2025-05-25T07:43:00+02:00,2025-05-25,15:43,7,12,19
49,2025-05-25T07:48:00+02:00,2025-05-25,15:48,4,12,16
49,2025-05-25T07:49:00+02:00,2025-05-25,15:49,2,12,14
49,2025-05-25T07:53:00+02:00,2025-05-25,15:53,0,13,13
51,2025-05-25T07:43:00+02:00,2025-05-25,15:43,0,3,3
51,2025-05-25T07:50:00+02:00,2025-05-25,15:50,1,3,4
51,2025-05-25T07:51:00+02:00,2025-05-25,15:51,2,0,2
51,2025-05-25T07:53:00+02:00,2025-05-25,15:53,6,2,8
52,2025-05-25T07:45:00+02:00,2025-05-25,15:45,2,3,5
52,2025-05-25T07:46:00+02:00,2025-05-25,15:46,7,6,13
52,2025-05-25T07:53:00+02:00,2025-05-25,15:53,3,5,8
53,2025-05-25T07:40:00+02:00,2025-05-25,15:40,12,4,16
53,2025-05-25T07:48:00+02:00,2025-05-25,15:48,10,10,20
53,2025-05-25T07:52:00+02:00,2025-05-25,15:52,17,16,33
56,2025-05-25T07:40:00+02:00,2025-05-25,15:40,4,7,11
56,2025-05-25T07:42:00+02:00,2025-05-25,15:42,8,14,22
56,2025-05-25T07:43:00+02:00,2025-05-25,15:43,12,4,16
56,2025-05-25T07:44:00+02:00,2025-05-25,15:44,4,1,5
56,2025-05-25T07:46:00+02:00,2025-05-25,15:46,15,5,20
56,2025-05-25T07:52:00+02:00,2025-05-25,15:52,7,2,9
56,2025-05-25T07:54:00+02:00,2025-05-25,15:54,1,0,1
58,2025-05-25T07:42:00+02:00,2025-05-25,15:42,8,15,23
58,2025-05-25T07:45:00+02:00,2025-05-25,15:45,6,3,9
58,2025-05-25T07:48:00+02:00,2025-05-25,15:48,13,10,23
58,2025-05-25T07:54:00+02:00,2025-05-25,15:54,14,11,25
62,2025-05-25T07:40:00+02:00,2025-05-25,15:40,6,3,9
62,2025-05-25T07:47:00+02:00,2025-05-25,15:47,2,3,5
62,2025-05-25T07:48:00+02:00,2025-05-25,15:48,7,3,10
62,2025-05-25T07:50:00+02:00,2025-05-25,15:50,0,1,1
62,2025-05-25T07:51:00+02:00,2025-05-25,15:51,6,5,11
62,2025-05-25T07:52:00+02:00,2025-05-25,15:52,2,10,12
62,2025-05-25T07:53:00+02:00,2025-05-25,15:53,3,0,3
63,2025-05-25T07:47:00+02:00,2025-05-25,15:47,5,5,10
63,2025-05-25T07:50:00+02:00,2025-05-25,15:50,9,9,18
63,2025-05-25T07:52:00+02:00,2025-05-25,15:52,9,8,17
67,2025-05-25T07:40:00+02:00,2025-05-25,15:40,3,20,23
67,2025-05-25T07:42:00+02:00,2025-05-25,15:42,8,8,16
67,2025-05-25T07:43:00+02:00,2025-05-25,15:43,0,7,7
67,2025-05-25T07:49:00+02:00,2025-05-25,15:49,5,7,12
67,2025-05-25T07:50:00+02:00,2025-05-25,15:50,10,15,25
67,2025-05-25T07:54:00+02:00,2025-05-25,15:54,9,4,13
68,2025-05-25T07:44:00+02:00,2025-05-25,15:44,2,8,10
68,2025-05-25T07:46:00+02:00,2025-05-25,15:46,8,3,11
68,2025-05-25T07:48:00+02:00,2025-05-25,15:48,4,8,12
68,2025-05-25T07:52:00+02:00,2025-05-25,15:52,10,2,12
72,2025-05-25T07:40:00+02:00,2025-05-25,15:40,6,18,24
72,2025-05-25T07:45:00+02:00,2025-05-25,15:45,11,14,25
72,2025-05-25T07:52:00+02:00,2025-05-25,15:52,6,5,11
79,2025-05-25T07:46:00+02:00,2025-05-25,15:46,16,13,29
79,2025-05-25T07:48:00+02:00,2025-05-25,15:48,15,2,17
79,2025-05-25T07:50:00+02:00,2025-05-25,15:50,24,8,32
79,2025-05-25T07:53:00+02:00,2025-05-25,15:53,17,13,30
79,2025-05-25T07:54:00+02:00,2025-05-25,15:54,10,8,18
85,2025-05-25T07:40:00+02:00,2025-05-25,15:40,1,1,2
85,2025-05-25T07:43:00+02:00,2025-05-25,15:43,2,1,3
85,2025-05-25T07:48:00+02:00,2025-05-25,15:48,2,3,5
85,2025-05-25T07:50:00+02:00,2025-05-25,15:50,1,2,3
85,2025-05-25T07:52:00+02:00,2025-05-25,15:52,0,1,1
85,2025-05-25T07:54:00+02:00,2025-05-25,15:54,2,1,3
86,2025-05-25T07:44:00+02:00,2025-05-25,15:44,0,2,2
86,2025-05-25T07:47:00+02:00,2025-05-25,15:47,2,5,7
86,2025-05-25T07:49:00+02:00,2025-05-25,15:49,3,0,3
109,2025-05-25T07:40:00+02:00,2025-05-25,15:40,7,5,12
123,2025-05-25T07:45:00+02:00,2025-05-25,15:45,5,3,8
130,2025-05-25T07:50:00+02:00,2025-05-25,15:50,4,11,15
136,2025-05-25T07:50:00+02:00,2025-05-25,15:50,14,2,16
139,2025-05-25T07:50:00+02:00,2025-05-25,15:50,3,3,6
141,2025-05-25T07:40:00+02:00,2025-05-25,15:40,19,7,26
141,2025-05-25T07:45:00+02:00,2025-05-25,15:45,22,10,32
142,2025-05-25T07:50:00+02:00,2025-05-25,15:50,41,55,96
181,2025-05-25T07:40:00+02:00,2025-05-25,15:40,16,19,35
181,2025-05-25T07:41:00+02:00,2025-05-25,15:41,14,20,34
181,2025-05-25T07:42:00+02:00,2025-05-25,15:42,10,21,31
181,2025-05-25T07:45:00+02:00,2025-05-25,15:45,19,12,31
181,2025-05-25T07:49:00+02:00,2025-05-25,15:49,6,15,21
181,2025-05-25T07:54:00+02:00,2025-05-25,15:54,16,22,38
182,2025-05-25T07:40:00+02:00,2025-05-25,15:40,10,19,29
182,2025-05-25T07:50:00+02:00,2025-05-25,15:50,20,19,39
180,2025-05-25T07:52:00+02:00,2025-05-25,15:52,2,0,2
3,2025-05-25T07:26:00+02:00,2025-05-25,15:26,15,23,38
3,2025-05-25T07:27:00+02:00,2025-05-25,15:27,21,33,54
3,2025-05-25T07:30:00+02:00,2025-05-25,15:30,22,19,41
3,2025-05-25T07:31:00+02:00,2025-05-25,15:31,15,26,41
3,2025-05-25T07:32:00+02:00,2025-05-25,15:32,18,30,48
3,2025-05-25T07:33:00+02:00,2025-05-25,15:33,20,31,51
3,2025-05-25T07:34:00+02:00,2025-05-25,15:34,21,30,51
3,2025-05-25T07:36:00+02:00,2025-05-25,15:36,22,28,50
3,2025-05-25T07:37:00+02:00,2025-05-25,15:37,24,18,42
3,2025-05-25T07:38:00+02:00,2025-05-25,15:38,21,17,38
3,2025-05-25T07:39:00+02:00,2025-05-25,15:39,24,28,52
4,2025-05-25T07:31:00+02:00,2025-05-25,15:31,21,29,50
4,2025-05-25T07:32:00+02:00,2025-05-25,15:32,54,33,87
4,2025-05-25T07:34:00+02:00,2025-05-25,15:34,34,35,69
4,2025-05-25T07:38:00+02:00,2025-05-25,15:38,37,27,64
5,2025-05-25T07:25:00+02:00,2025-05-25,15:25,87,82,169
5,2025-05-25T07:30:00+02:00,2025-05-25,15:30,80,107,187
6,2025-05-25T07:25:00+02:00,2025-05-25,15:25,14,8,22
6,2025-05-25T07:30:00+02:00,2025-05-25,15:30,13,30,43
6,2025-05-25T07:34:00+02:00,2025-05-25,15:34,12,4,16
6,2025-05-25T07:36:00+02:00,2025-05-25,15:36,10,19,29
6,2025-05-25T07:37:00+02:00,2025-05-25,15:37,12,12,24
6,2025-05-25T07:39:00+02:00,2025-05-25,15:39,14,10,24
8,2025-05-25T07:29:00+02:00,2025-05-25,15:29,4,2,6
8,2025-05-25T07:31:00+02:00,2025-05-25,15:31,5,6,11
28,2025-05-25T07:29:00+02:00,2025-05-25,15:29,10,8,18
28,2025-05-25T07:30:00+02:00,2025-05-25,15:30,10,9,19
28,2025-05-25T07:31:00+02:00,2025-05-25,15:31,12,29,41
28,2025-05-25T07:34:00+02:00,2025-05-25,15:34,9,23,32
28,2025-05-25T07:35:00+02:00,2025-05-25,15:35,14,11,25
29,2025-05-25T07:32:00+02:00,2025-05-25,15:32,14,14,28
29,2025-05-25T07:35:00+02:00,2025-05-25,15:35,6,14,20
29,2025-05-25T07:38:00+02:00,2025-05-25,15:38,13,17,30
31,2025-05-25T07:25:00+02:00,2025-05-25,15:25,6,0,6
31,2025-05-25T07:29:00+02:00,2025-05-25,15:29,7,7,14
31,2025-05-25T07:31:00+02:00,2025-05-25,15:31,7,8,15
31,2025-05-25T07:32:00+02:00,2025-05-25,15:32,5,4,9
31,2025-05-25T07:38:00+02:00,2025-05-25,15:38,8,3,11
36,2025-05-25T07:27:00+02:00,2025-05-25,15:27,1,0,1
36,2025-05-25T07:28:00+02:00,2025-05-25,15:28,2,1,3
36,2025-05-25T07:34:00+02:00,2025-05-25,15:34,1,1,2
36,2025-05-25T07:38:00+02:00,2025-05-25,15:38,1,1,2
39,2025-05-25T07:30:00+02:00,2025-05-25,15:30,1,1,2
39,2025-05-25T07:37:00+02:00,2025-05-25,15:37,1,0,1
40,2025-05-25T07:26:00+02:00,2025-05-25,15:26,9,5,14
40,2025-05-25T07:28:00+02:00,2025-05-25,15:28,1,2,3
40,2025-05-25T07:30:00+02:00,2025-05-25,15:30,3,0,3
40,2025-05-25T07:31:00+02:00,2025-05-25,15:31,2,2,4
40,2025-05-25T07:32:00+02:00,2025-05-25,15:32,1,2,3
41,2025-05-25T07:26:00+02:00,2025-05-25,15:26,4,7,11
41,2025-05-25T07:35:00+02:00,2025-05-25,15:35,3,0,3
41,2025-05-25T07:37:00+02:00,2025-05-25,15:37,8,7,15
43,2025-05-25T07:35:00+02:00,2025-05-25,15:35,9,8,17
44,2025-05-25T07:30:00+02:00,2025-05-25,15:30,2,2,4
45,2025-05-25T07:33:00+02:00,2025-05-25,15:33,8,29,37
45,2025-05-25T07:34:00+02:00,2025-05-25,15:34,24,20,44
45,2025-05-25T07:37:00+02:00,2025-05-25,15:37,9,21,30
47,2025-05-25T07:26:00+02:00,2025-05-25,15:26,15,25,40
47,2025-05-25T07:27:00+02:00,2025-05-25,15:27,20,20,40
47,2025-05-25T07:28:00+02:00,2025-05-25,15:28,15,27,42
47,2025-05-25T07:30:00+02:00,2025-05-25,15:30,19,21,40
47,2025-05-25T07:32:00+02:00,2025-05-25,15:32,13,16,29
47,2025-05-25T07:36:00+02:00,2025-05-25,15:36,22,21,43
47,2025-05-25T07:38:00+02:00,2025-05-25,15:38,15,11,26
50,2025-05-25T07:25:00+02:00,2025-05-25,15:25,5,4,9
50,2025-05-25T07:30:00+02:00,2025-05-25,15:30,11,2,13
50,2025-05-25T07:33:00+02:00,2025-05-25,15:33,1,6,7
50,2025-05-25T07:34:00+02:00,2025-05-25,15:34,2,5,7
50,2025-05-25T07:39:00+02:00,2025-05-25,15:39,3,2,5
54,2025-05-25T07:26:00+02:00,2025-05-25,15:26,10,3,13
54,2025-05-25T07:37:00+02:00,2025-05-25,15:37,0,2,2
61,2025-05-25T07:26:00+02:00,2025-05-25,15:26,2,5,7
61,2025-05-25T07:27:00+02:00,2025-05-25,15:27,6,14,20
61,2025-05-25T07:28:00+02:00,2025-05-25,15:28,11,7,18
61,2025-05-25T07:33:00+02:00,2025-05-25,15:33,8,3,11
61,2025-05-25T07:36:00+02:00,2025-05-25,15:36,13,10,23
61,2025-05-25T07:38:00+02:00,2025-05-25,15:38,16,18,34
66,2025-05-25T07:30:00+02:00,2025-05-25,15:30,24,45,69
66,2025-05-25T07:32:00+02:00,2025-05-25,15:32,22,41,63
66,2025-05-25T07:34:00+02:00,2025-05-25,15:34,26,29,55
66,2025-05-25T07:35:00+02:00,2025-05-25,15:35,31,39,70
66,2025-05-25T07:36:00+02:00,2025-05-25,15:36,23,29,52
66,2025-05-25T07:38:00+02:00,2025-05-25,15:38,33,31,64
69,2025-05-25T07:25:00+02:00,2025-05-25,15:25,5,3,8
69,2025-05-25T07:26:00+02:00,2025-05-25,15:26,1,4,5
69,2025-05-25T07:28:00+02:00,2025-05-25,15:28,4,6,10
69,2025-05-25T07:29:00+02:00,2025-05-25,15:29,8,2,10
69,2025-05-25T07:30:00+02:00,2025-05-25,15:30,3,8,11
69,2025-05-25T07:34:00+02:00,2025-05-25,15:34,3,5,8
70,2025-05-25T07:26:00+02:00,2025-05-25,15:26,5,1,6
70,2025-05-25T07:31:00+02:00,2025-05-25,15:31,3,2,5
70,2025-05-25T07:32:00+02:00,2025-05-25,15:32,1,0,1
71,2025-05-25T07:27:00+02:00,2025-05-25,15:27,0,1,1
75,2025-05-25T07:30:00+02:00,2025-05-25,15:30,0,5,5
75,2025-05-25T07:31:00+02:00,2025-05-25,15:31,2,2,4
77,2025-05-25T07:30:00+02:00,2025-05-25,15:30,12,11,23
78,2025-05-25T07:27:00+02:00,2025-05-25,15:27,1,3,4
78,2025-05-25T07:29:00+02:00,2025-05-25,15:29,0,1,1
78,2025-05-25T07:35:00+02:00,2025-05-25,15:35,1,2,3
84,2025-05-25T07:35:00+02:00,2025-05-25,15:35,99,142,241
87,2025-05-25T07:31:00+02:00,2025-05-25,15:31,3,0,3
87,2025-05-25T07:32:00+02:00,2025-05-25,15:32,0,1,1
87,2025-05-25T07:38:00+02:00,2025-05-25,15:38,5,2,7
107,2025-05-25T07:25:00+02:00,2025-05-25,15:25,6,9,15
108,2025-05-25T07:25:00+02:00,2025-05-25,15:25,2,0,2
108,2025-05-25T07:32:00+02:00,2025-05-25,15:32,5,5,10
108,2025-05-25T07:36:00+02:00,2025-05-25,15:36,6,5,11
108,2025-05-25T07:38:00+02:00,2025-05-25,15:38,1,4,5
108,2025-05-25T07:39:00+02:00,2025-05-25,15:39,2,1,3
118,2025-05-25T07:35:00+02:00,2025-05-25,15:35,3,1,4
124,2025-05-25T07:35:00+02:00,2025-05-25,15:35,1,2,3
131,2025-05-25T07:35:00+02:00,2025-05-25,15:35,7,2,9
132,2025-05-25T07:35:00+02:00,2025-05-25,15:35,9,22,31
133,2025-05-25T07:25:00+02:00,2025-05-25,15:25,38,40,78
133,2025-05-25T07:30:00+02:00,2025-05-25,15:30,36,37,73
140,2025-05-25T07:35:00+02:00,2025-05-25,15:35,14,5,19
162,2025-05-25T07:25:00+02:00,2025-05-25,15:25,38,71,109
162,2025-05-25T07:35:00+02:00,2025-05-25,15:35,41,74,115
167,2025-05-25T07:25:00+02:00,2025-05-25,15:25,7,7,14
167,2025-05-25T07:30:00+02:00,2025-05-25,15:30,4,7,11
167,2025-05-25T07:35:00+02:00,2025-05-25,15:35,2,12,14
179,2025-05-25T07:35:00+02:00,2025-05-25,15:35,8,2,10
1,2025-05-25T07:25:00+02:00,2025-05-25,15:25,40,23,63
1,2025-05-25T07:26:00+02:00,2025-05-25,15:26,25,36,61
1,2025-05-25T07:31:00+02:00,2025-05-25,15:31,31,12,43
1,2025-05-25T07:33:00+02:00,2025-05-25,15:33,24,39,63
2,2025-05-25T07:31:00+02:00,2025-05-25,15:31,11,10,21
9,2025-05-25T07:26:00+02:00,2025-05-25,15:26,0,2,2
9,2025-05-25T07:27:00+02:00,2025-05-25,15:27,2,0,2
9,2025-05-25T07:28:00+02:00,2025-05-25,15:28,1,0,1
9,2025-05-25T07:30:00+02:00,2025-05-25,15:30,1,2,3
9,2025-05-25T07:32:00+02:00,2025-05-25,15:32,1,3,4
9,2025-05-25T07:34:00+02:00,2025-05-25,15:34,0,6,6
9,2025-05-25T07:38:00+02:00,2025-05-25,15:38,2,1,3
9,2025-05-25T07:39:00+02:00,2025-05-25,15:39,0,2,2
10,2025-05-25T07:26:00+02:00,2025-05-25,15:26,1,2,3
10,2025-05-25T07:29:00+02:00,2025-05-25,15:29,1,6,7
10,2025-05-25T07:31:00+02:00,2025-05-25,15:31,2,1,3
10,2025-05-25T07:35:00+02:00,2025-05-25,15:35,1,0,1
10,2025-05-25T07:37:00+02:00,2025-05-25,15:37,2,0,2
10,2025-05-25T07:38:00+02:00,2025-05-25,15:38,1,0,1
11,2025-05-25T07:29:00+02:00,2025-05-25,15:29,0,1,1
11,2025-05-25T07:30:00+02:00,2025-05-25,15:30,57,2,59
11,2025-05-25T07:33:00+02:00,2025-05-25,15:33,15,3,18
11,2025-05-25T07:35:00+02:00,2025-05-25,15:35,16,6,22
11,2025-05-25T07:36:00+02:00,2025-05-25,15:36,2,0,2
11,2025-05-25T07:38:00+02:00,2025-05-25,15:38,2,0,2
12,2025-05-25T07:26:00+02:00,2025-05-25,15:26,8,10,18
12,2025-05-25T07:27:00+02:00,2025-05-25,15:27,9,0,9
12,2025-05-25T07:30:00+02:00,2025-05-25,15:30,6,0,6
12,2025-05-25T07:33:00+02:00,2025-05-25,15:33,1,3,4
12,2025-05-25T07:34:00+02:00,2025-05-25,15:34,4,4,8
12,2025-05-25T07:38:00+02:00,2025-05-25,15:38,7,3,10
12,2025-05-25T07:39:00+02:00,2025-05-25,15:39,10,3,13
17,2025-05-25T07:25:00+02:00,2025-05-25,15:25,3,3,6
17,2025-05-25T07:36:00+02:00,2025-05-25,15:36,1,2,3
18,2025-05-25T07:26:00+02:00,2025-05-25,15:26,2,0,2
18,2025-05-25T07:39:00+02:00,2025-05-25,15:39,2,1,3
19,2025-05-25T07:28:00+02:00,2025-05-25,15:28,5,8,13
19,2025-05-25T07:29:00+02:00,2025-05-25,15:29,7,5,12
19,2025-05-25T07:30:00+02:00,2025-05-25,15:30,11,6,17
19,2025-05-25T07:31:00+02:00,2025-05-25,15:31,9,8,17
19,2025-05-25T07:32:00+02:00,2025-05-25,15:32,6,4,10
19,2025-05-25T07:35:00+02:00,2025-05-25,15:35,14,8,22
19,2025-05-25T07:39:00+02:00,2025-05-25,15:39,8,6,14
20,2025-05-25T07:27:00+02:00,2025-05-25,15:27,4,6,10
20,2025-05-25T07:32:00+02:00,2025-05-25,15:32,3,7,10
20,2025-05-25T07:33:00+02:00,2025-05-25,15:33,6,9,15
20,2025-05-25T07:34:00+02:00,2025-05-25,15:34,3,7,10
20,2025-05-25T07:39:00+02:00,2025-05-25,15:39,7,5,12
23,2025-05-25T07:30:00+02:00,2025-05-25,15:30,4,0,4
23,2025-05-25T07:33:00+02:00,2025-05-25,15:33,1,2,3
23,2025-05-25T07:39:00+02:00,2025-05-25,15:39,3,6,9
24,2025-05-25T07:26:00+02:00,2025-05-25,15:26,14,8,22
24,2025-05-25T07:29:00+02:00,2025-05-25,15:29,5,12,17
24,2025-05-25T07:30:00+02:00,2025-05-25,15:30,8,2,10
24,2025-05-25T07:37:00+02:00,2025-05-25,15:37,8,27,35
27,2025-05-25T07:25:00+02:00,2025-05-25,15:25,5,4,9
27,2025-05-25T07:26:00+02:00,2025-05-25,15:26,3,1,4
27,2025-05-25T07:29:00+02:00,2025-05-25,15:29,2,5,7
27,2025-05-25T07:32:00+02:00,2025-05-25,15:32,1,7,8
27,2025-05-25T07:36:00+02:00,2025-05-25,15:36,1,2,3
27,2025-05-25T07:37:00+02:00,2025-05-25,15:37,12,3,15
30,2025-05-25T07:26:00+02:00,2025-05-25,15:26,1,14,15
30,2025-05-25T07:33:00+02:00,2025-05-25,15:33,3,2,5
30,2025-05-25T07:36:00+02:00,2025-05-25,15:36,0,7,7
30,2025-05-25T07:37:00+02:00,2025-05-25,15:37,4,8,12
30,2025-05-25T07:38:00+02:00,2025-05-25,15:38,1,9,10
35,2025-05-25T07:25:00+02:00,2025-05-25,15:25,25,52,77
35,2025-05-25T07:26:00+02:00,2025-05-25,15:26,16,25,41
35,2025-05-25T07:27:00+02:00,2025-05-25,15:27,20,39,59
35,2025-05-25T07:35:00+02:00,2025-05-25,15:35,11,42,53
46,2025-05-25T07:25:00+02:00,2025-05-25,15:25,0,5,5
46,2025-05-25T07:35:00+02:00,2025-05-25,15:35,5,6,11
48,2025-05-25T07:25:00+02:00,2025-05-25,15:25,12,0,12
48,2025-05-25T07:26:00+02:00,2025-05-25,15:26,25,4,29
48,2025-05-25T07:29:00+02:00,2025-05-25,15:29,9,6,15
48,2025-05-25T07:33:00+02:00,2025-05-25,15:33,6,7,13
48,2025-05-25T07:36:00+02:00,2025-05-25,15:36,11,10,21
49,2025-05-25T07:27:00+02:00,2025-05-25,15:27,9,17,26
49,2025-05-25T07:28:00+02:00,2025-05-25,15:28,5,8,13
49,2025-05-25T07:32:00+02:00,2025-05-25,15:32,1,12,13
49,2025-05-25T07:33:00+02:00,2025-05-25,15:33,0,12,12
51,2025-05-25T07:33:00+02:00,2025-05-25,15:33,1,2,3
51,2025-05-25T07:37:00+02:00,2025-05-25,15:37,4,0,4
52,2025-05-25T07:28:00+02:00,2025-05-25,15:28,6,2,8
52,2025-05-25T07:31:00+02:00,2025-05-25,15:31,4,2,6
52,2025-05-25T07:33:00+02:00,2025-05-25,15:33,7,2,9
52,2025-05-25T07:35:00+02:00,2025-05-25,15:35,7,12,19
52,2025-05-25T07:37:00+02:00,2025-05-25,15:37,5,7,12
53,2025-05-25T07:26:00+02:00,2025-05-25,15:26,9,8,17
53,2025-05-25T07:28:00+02:00,2025-05-25,15:28,5,8,13
53,2025-05-25T07:31:00+02:00,2025-05-25,15:31,7,10,17
53,2025-05-25T07:33:00+02:00,2025-05-25,15:33,13,22,35
53,2025-05-25T07:37:00+02:00,2025-05-25,15:37,9,13,22
56,2025-05-25T07:29:00+02:00,2025-05-25,15:29,10,4,14
56,2025-05-25T07:32:00+02:00,2025-05-25,15:32,5,9,14
56,2025-05-25T07:33:00+02:00,2025-05-25,15:33,7,2,9
58,2025-05-25T07:25:00+02:00,2025-05-25,15:25,5,11,16
58,2025-05-25T07:29:00+02:00,2025-05-25,15:29,7,8,15
58,2025-05-25T07:30:00+02:00,2025-05-25,15:30,13,3,16
62,2025-05-25T07:35:00+02:00,2025-05-25,15:35,4,5,9
62,2025-05-25T07:36:00+02:00,2025-05-25,15:36,2,1,3
63,2025-05-25T07:25:00+02:00,2025-05-25,15:25,2,13,15
63,2025-05-25T07:29:00+02:00,2025-05-25,15:29,3,15,18
63,2025-05-25T07:34:00+02:00,2025-05-25,15:34,2,5,7
63,2025-05-25T07:36:00+02:00,2025-05-25,15:36,5,9,14
63,2025-05-25T07:37:00+02:00,2025-05-25,15:37,6,10,16
67,2025-05-25T07:27:00+02:00,2025-05-25,15:27,4,7,11
67,2025-05-25T07:29:00+02:00,2025-05-25,15:29,2,6,8
67,2025-05-25T07:30:00+02:00,2025-05-25,15:30,6,17,23
67,2025-05-25T07:31:00+02:00,2025-05-25,15:31,3,13,16
67,2025-05-25T07:34:00+02:00,2025-05-25,15:34,4,19,23
67,2025-05-25T07:38:00+02:00,2025-05-25,15:38,8,13,21
67,2025-05-25T07:39:00+02:00,2025-05-25,15:39,4,15,19
68,2025-05-25T07:28:00+02:00,2025-05-25,15:28,7,1,8
68,2025-05-25T07:29:00+02:00,2025-05-25,15:29,7,7,14
68,2025-05-25T07:34:00+02:00,2025-05-25,15:34,6,3,9
68,2025-05-25T07:35:00+02:00,2025-05-25,15:35,4,12,16
68,2025-05-25T07:36:00+02:00,2025-05-25,15:36,8,7,15
68,2025-05-25T07:38:00+02:00,2025-05-25,15:38,7,4,11
72,2025-05-25T07:31:00+02:00,2025-05-25,15:31,2,14,16
72,2025-05-25T07:34:00+02:00,2025-05-25,15:34,0,9,9
72,2025-05-25T07:36:00+02:00,2025-05-25,15:36,7,11,18
72,2025-05-25T07:38:00+02:00,2025-05-25,15:38,7,17,24
72,2025-05-25T07:39:00+02:00,2025-05-25,15:39,8,9,17
76,2025-05-25T07:28:00+02:00,2025-05-25,15:28,0,2,2
76,2025-05-25T07:30:00+02:00,2025-05-25,15:30,1,0,1
79,2025-05-25T07:26:00+02:00,2025-05-25,15:26,5,4,9
79,2025-05-25T07:31:00+02:00,2025-05-25,15:31,7,9,16
79,2025-05-25T07:38:00+02:00,2025-05-25,15:38,20,8,28
85,2025-05-25T07:30:00+02:00,2025-05-25,15:30,3,3,6
85,2025-05-25T07:31:00+02:00,2025-05-25,15:31,1,1,2
85,2025-05-25T07:32:00+02:00,2025-05-25,15:32,0,2,2
86,2025-05-25T07:29:00+02:00,2025-05-25,15:29,0,2,2
86,2025-05-25T07:32:00+02:00,2025-05-25,15:32,2,0,2
86,2025-05-25T07:37:00+02:00,2025-05-25,15:37,1,3,4
136,2025-05-25T07:25:00+02:00,2025-05-25,15:25,45,5,50
136,2025-05-25T07:35:00+02:00,2025-05-25,15:35,11,10,21
137,2025-05-25T07:25:00+02:00,2025-05-25,15:25,2,2,4
137,2025-05-25T07:35:00+02:00,2025-05-25,15:35,0,4,4
139,2025-05-25T07:30:00+02:00,2025-05-25,15:30,2,5,7
139,2025-05-25T07:35:00+02:00,2025-05-25,15:35,3,3,6
141,2025-05-25T07:30:00+02:00,2025-05-25,15:30,15,9,24
142,2025-05-25T07:30:00+02:00,2025-05-25,15:30,78,41,119
161,2025-05-25T07:30:00+02:00,2025-05-25,15:30,27,17,44
164,2025-05-25T07:25:00+02:00,2025-05-25,15:25,10,11,21
164,2025-05-25T07:30:00+02:00,2025-05-25,15:30,3,3,6
3,2025-05-25T05:26:00+02:00,2025-05-25,13:26,21,12,33
3,2025-05-25T05:27:00+02:00,2025-05-25,13:27,12,24,36
3,2025-05-25T05:28:00+02:00,2025-05-25,13:28,24,21,45
3,2025-05-25T05:30:00+02:00,2025-05-25,13:30,8,28,36
3,2025-05-25T05:34:00+02:00,2025-05-25,13:34,21,23,44
3,2025-05-25T05:36:00+02:00,2025-05-25,13:36,16,22,38
4,2025-05-25T05:26:00+02:00,2025-05-25,13:26,31,18,49
4,2025-05-25T05:27:00+02:00,2025-05-25,13:27,44,27,71
4,2025-05-25T05:29:00+02:00,2025-05-25,13:29,46,43,89
4,2025-05-25T05:30:00+02:00,2025-05-25,13:30,48,36,84
4,2025-05-25T05:36:00+02:00,2025-05-25,13:36,44,23,67
5,2025-05-25T05:25:00+02:00,2025-05-25,13:25,84,91,175
5,2025-05-25T05:30:00+02:00,2025-05-25,13:30,99,82,181
5,2025-05-25T05:35:00+02:00,2025-05-25,13:35,80,85,165
6,2025-05-25T05:32:00+02:00,2025-05-25,13:32,14,6,20
6,2025-05-25T05:33:00+02:00,2025-05-25,13:33,17,10,27
6,2025-05-25T05:35:00+02:00,2025-05-25,13:35,21,16,37
6,2025-05-25T05:37:00+02:00,2025-05-25,13:37,18,10,28
6,2025-05-25T05:39:00+02:00,2025-05-25,13:39,11,20,31
8,2025-05-25T05:27:00+02:00,2025-05-25,13:27,4,4,8
8,2025-05-25T05:28:00+02:00,2025-05-25,13:28,4,4,8
8,2025-05-25T05:31:00+02:00,2025-05-25,13:31,1,5,6
8,2025-05-25T05:36:00+02:00,2025-05-25,13:36,0,2,2
8,2025-05-25T05:37:00+02:00,2025-05-25,13:37,4,5,9
28,2025-05-25T05:25:00+02:00,2025-05-25,13:25,6,8,14
28,2025-05-25T05:38:00+02:00,2025-05-25,13:38,6,7,13
28,2025-05-25T05:39:00+02:00,2025-05-25,13:39,13,12,25
29,2025-05-25T05:27:00+02:00,2025-05-25,13:27,2,10,12
29,2025-05-25T05:29:00+02:00,2025-05-25,13:29,11,8,19
29,2025-05-25T05:35:00+02:00,2025-05-25,13:35,21,13,34
31,2025-05-25T05:30:00+02:00,2025-05-25,13:30,5,1,6
31,2025-05-25T05:32:00+02:00,2025-05-25,13:32,4,7,11
31,2025-05-25T05:33:00+02:00,2025-05-25,13:33,2,3,5
31,2025-05-25T05:36:00+02:00,2025-05-25,13:36,2,6,8
31,2025-05-25T05:39:00+02:00,2025-05-25,13:39,4,0,4
36,2025-05-25T05:25:00+02:00,2025-05-25,13:25,1,3,4
36,2025-05-25T05:29:00+02:00,2025-05-25,13:29,1,2,3
36,2025-05-25T05:30:00+02:00,2025-05-25,13:30,1,0,1
36,2025-05-25T05:33:00+02:00,2025-05-25,13:33,5,1,6
36,2025-05-25T05:34:00+02:00,2025-05-25,13:34,7,1,8
36,2025-05-25T05:36:00+02:00,2025-05-25,13:36,3,2,5
36,2025-05-25T05:37:00+02:00,2025-05-25,13:37,3,5,8
39,2025-05-25T05:28:00+02:00,2025-05-25,13:28,1,0,1
40,2025-05-25T05:26:00+02:00,2025-05-25,13:26,8,4,12
40,2025-05-25T05:30:00+02:00,2025-05-25,13:30,2,1,3
40,2025-05-25T05:32:00+02:00,2025-05-25,13:32,4,0,4
41,2025-05-25T05:26:00+02:00,2025-05-25,13:26,7,5,12
41,2025-05-25T05:35:00+02:00,2025-05-25,13:35,6,5,11
44,2025-05-25T05:25:00+02:00,2025-05-25,13:25,0,6,6
44,2025-05-25T05:30:00+02:00,2025-05-25,13:30,1,4,5
45,2025-05-25T05:26:00+02:00,2025-05-25,13:26,27,16,43
45,2025-05-25T05:29:00+02:00,2025-05-25,13:29,11,27,38
45,2025-05-25T05:32:00+02:00,2025-05-25,13:32,11,12,23
45,2025-05-25T05:35:00+02:00,2025-05-25,13:35,17,19,36
45,2025-05-25T05:37:00+02:00,2025-05-25,13:37,9,11,20
45,2025-05-25T05:38:00+02:00,2025-05-25,13:38,21,25,46
47,2025-05-25T05:25:00+02:00,2025-05-25,13:25,24,24,48
47,2025-05-25T05:27:00+02:00,2025-05-25,13:27,16,5,21
47,2025-05-25T05:35:00+02:00,2025-05-25,13:35,14,11,25
47,2025-05-25T05:36:00+02:00,2025-05-25,13:36,17,16,33
47,2025-05-25T05:37:00+02:00,2025-05-25,13:37,4,26,30
47,2025-05-25T05:39:00+02:00,2025-05-25,13:39,13,16,29
50,2025-05-25T05:28:00+02:00,2025-05-25,13:28,4,5,9
50,2025-05-25T05:30:00+02:00,2025-05-25,13:30,3,8,11
50,2025-05-25T05:32:00+02:00,2025-05-25,13:32,7,3,10
50,2025-05-25T05:33:00+02:00,2025-05-25,13:33,9,4,13
50,2025-05-25T05:35:00+02:00,2025-05-25,13:35,2,0,2
50,2025-05-25T05:36:00+02:00,2025-05-25,13:36,14,7,21
50,2025-05-25T05:38:00+02:00,2025-05-25,13:38,10,5,15
50,2025-05-25T05:39:00+02:00,2025-05-25,13:39,5,5,10
54,2025-05-25T05:33:00+02:00,2025-05-25,13:33,1,2,3
59,2025-05-25T05:25:00+02:00,2025-05-25,13:25,21,41,62
61,2025-05-25T05:26:00+02:00,2025-05-25,13:26,3,5,8
61,2025-05-25T05:31:00+02:00,2025-05-25,13:31,11,20,31
61,2025-05-25T05:33:00+02:00,2025-05-25,13:33,7,26,33
61,2025-05-25T05:34:00+02:00,2025-05-25,13:34,6,6,12
61,2025-05-25T05:36:00+02:00,2025-05-25,13:36,16,8,24
61,2025-05-25T05:38:00+02:00,2025-05-25,13:38,11,9,20
66,2025-05-25T05:25:00+02:00,2025-05-25,13:25,24,34,58
66,2025-05-25T05:34:00+02:00,2025-05-25,13:34,23,19,42
66,2025-05-25T05:36:00+02:00,2025-05-25,13:36,33,24,57
69,2025-05-25T05:29:00+02:00,2025-05-25,13:29,5,4,9
69,2025-05-25T05:30:00+02:00,2025-05-25,13:30,6,0,6
69,2025-05-25T05:32:00+02:00,2025-05-25,13:32,2,3,5
69,2025-05-25T05:38:00+02:00,2025-05-25,13:38,8,2,10
70,2025-05-25T05:27:00+02:00,2025-05-25,13:27,2,2,4
70,2025-05-25T05:30:00+02:00,2025-05-25,13:30,2,4,6
70,2025-05-25T05:38:00+02:00,2025-05-25,13:38,3,2,5
75,2025-05-25T05:25:00+02:00,2025-05-25,13:25,0,1,1
75,2025-05-25T05:27:00+02:00,2025-05-25,13:27,0,3,3
75,2025-05-25T05:31:00+02:00,2025-05-25,13:31,1,0,1
77,2025-05-25T05:30:00+02:00,2025-05-25,13:30,7,6,13
78,2025-05-25T05:27:00+02:00,2025-05-25,13:27,2,1,3
78,2025-05-25T05:30:00+02:00,2025-05-25,13:30,2,4,6
78,2025-05-25T05:33:00+02:00,2025-05-25,13:33,0,4,4
78,2025-05-25T05:35:00+02:00,2025-05-25,13:35,0,1,1
78,2025-05-25T05:36:00+02:00,2025-05-25,13:36,0,1,1
78,2025-05-25T05:39:00+02:00,2025-05-25,13:39,1,1,2
84,2025-05-25T05:30:00+02:00,2025-05-25,13:30,105,112,217
87,2025-05-25T05:28:00+02:00,2025-05-25,13:28,1,5,6
87,2025-05-25T05:31:00+02:00,2025-05-25,13:31,2,4,6
87,2025-05-25T05:32:00+02:00,2025-05-25,13:32,2,8,10
87,2025-05-25T05:33:00+02:00,2025-05-25,13:33,1,0,1
87,2025-05-25T05:36:00+02:00,2025-05-25,13:36,1,0,1
107,2025-05-25T05:30:00+02:00,2025-05-25,13:30,12,15,27
107,2025-05-25T05:35:00+02:00,2025-05-25,13:35,22,12,34
108,2025-05-25T05:27:00+02:00,2025-05-25,13:27,5,5,10
108,2025-05-25T05:28:00+02:00,2025-05-25,13:28,4,3,7
108,2025-05-25T05:29:00+02:00,2025-05-25,13:29,4,2,6
108,2025-05-25T05:32:00+02:00,2025-05-25,13:32,5,4,9
108,2025-05-25T05:34:00+02:00,2025-05-25,13:34,6,2,8
108,2025-05-25T05:36:00+02:00,2025-05-25,13:36,2,9,11
108,2025-05-25T05:37:00+02:00,2025-05-25,13:37,4,5,9
108,2025-05-25T05:39:00+02:00,2025-05-25,13:39,4,3,7
118,2025-05-25T05:25:00+02:00,2025-05-25,13:25,3,5,8
118,2025-05-25T05:35:00+02:00,2025-05-25,13:35,0,1,1
131,2025-05-25T05:25:00+02:00,2025-05-25,13:25,12,9,21
132,2025-05-25T05:25:00+02:00,2025-05-25,13:25,15,13,28
135,2025-05-25T05:30:00+02:00,2025-05-25,13:30,35,23,58
162,2025-05-25T05:30:00+02:00,2025-05-25,13:30,68,86,154
165,2025-05-25T05:25:00+02:00,2025-05-25,13:25,2,2,4
165,2025-05-25T05:35:00+02:00,2025-05-25,13:35,2,0,2
166,2025-05-25T05:25:00+02:00,2025-05-25,13:25,10,3,13
1,2025-05-25T05:25:00+02:00,2025-05-25,13:25,19,14,33
1,2025-05-25T05:26:00+02:00,2025-05-25,13:26,22,16,38
1,2025-05-25T05:28:00+02:00,2025-05-25,13:28,16,26,42
1,2025-05-25T05:30:00+02:00,2025-05-25,13:30,25,14,39
1,2025-05-25T05:33:00+02:00,2025-05-25,13:33,21,27,48
1,2025-05-25T05:34:00+02:00,2025-05-25,13:34,26,22,48
1,2025-05-25T05:35:00+02:00,2025-05-25,13:35,13,13,26
1,2025-05-25T05:38:00+02:00,2025-05-25,13:38,24,26,50
2,2025-05-25T05:25:00+02:00,2025-05-25,13:25,9,11,20
2,2025-05-25T05:28:00+02:00,2025-05-25,13:28,22,20,42
2,2025-05-25T05:31:00+02:00,2025-05-25,13:31,2,12,14
2,2025-05-25T05:35:00+02:00,2025-05-25,13:35,19,5,24
2,2025-05-25T05:37:00+02:00,2025-05-25,13:37,13,6,19
9,2025-05-25T05:26:00+02:00,2025-05-25,13:26,0,10,10
9,2025-05-25T05:28:00+02:00,2025-05-25,13:28,1,1,2
9,2025-05-25T05:29:00+02:00,2025-05-25,13:29,0,2,2
9,2025-05-25T05:38:00+02:00,2025-05-25,13:38,4,1,5
10,2025-05-25T05:36:00+02:00,2025-05-25,13:36,2,0,2
10,2025-05-25T05:38:00+02:00,2025-05-25,13:38,3,0,3
11,2025-05-25T05:28:00+02:00,2025-05-25,13:28,0,4,4
11,2025-05-25T05:34:00+02:00,2025-05-25,13:34,0,2,2
12,2025-05-25T05:26:00+02:00,2025-05-25,13:26,3,2,5
12,2025-05-25T05:30:00+02:00,2025-05-25,13:30,2,5,7
12,2025-05-25T05:32:00+02:00,2025-05-25,13:32,2,5,7
12,2025-05-25T05:34:00+02:00,2025-05-25,13:34,0,5,5
12,2025-05-25T05:35:00+02:00,2025-05-25,13:35,2,0,2
17,2025-05-25T05:26:00+02:00,2025-05-25,13:26,4,2,6
17,2025-05-25T05:30:00+02:00,2025-05-25,13:30,2,0,2
17,2025-05-25T05:31:00+02:00,2025-05-25,13:31,0,2,2
17,2025-05-25T05:32:00+02:00,2025-05-25,13:32,4,3,7
17,2025-05-25T05:33:00+02:00,2025-05-25,13:33,5,1,6
18,2025-05-25T05:34:00+02:00,2025-05-25,13:34,3,3,6
18,2025-05-25T05:37:00+02:00,2025-05-25,13:37,4,5,9
18,2025-05-25T05:38:00+02:00,2025-05-25,13:38,1,2,3
19,2025-05-25T05:28:00+02:00,2025-05-25,13:28,14,6,20
19,2025-05-25T05:30:00+02:00,2025-05-25,13:30,24,5,29
19,2025-05-25T05:31:00+02:00,2025-05-25,13:31,5,17,22
19,2025-05-25T05:35:00+02:00,2025-05-25,13:35,6,10,16
20,2025-05-25T05:32:00+02:00,2025-05-25,13:32,5,7,12
20,2025-05-25T05:37:00+02:00,2025-05-25,13:37,13,7,20
20,2025-05-25T05:39:00+02:00,2025-05-25,13:39,14,4,18
23,2025-05-25T05:26:00+02:00,2025-05-25,13:26,1,1,2
23,2025-05-25T05:29:00+02:00,2025-05-25,13:29,5,0,5
23,2025-05-25T05:30:00+02:00,2025-05-25,13:30,1,1,2
23,2025-05-25T05:31:00+02:00,2025-05-25,13:31,5,5,10
23,2025-05-25T05:32:00+02:00,2025-05-25,13:32,4,7,11
23,2025-05-25T05:33:00+02:00,2025-05-25,13:33,0,5,5
23,2025-05-25T05:34:00+02:00,2025-05-25,13:34,3,0,3
24,2025-05-25T05:26:00+02:00,2025-05-25,13:26,8,13,21
24,2025-05-25T05:27:00+02:00,2025-05-25,13:27,5,3,8
24,2025-05-25T05:31:00+02:00,2025-05-25,13:31,1,18,19
24,2025-05-25T05:35:00+02:00,2025-05-25,13:35,10,9,19
27,2025-05-25T05:26:00+02:00,2025-05-25,13:26,2,6,8
27,2025-05-25T05:30:00+02:00,2025-05-25,13:30,2,6,8
27,2025-05-25T05:34:00+02:00,2025-05-25,13:34,3,6,9
27,2025-05-25T05:39:00+02:00,2025-05-25,13:39,7,0,7
30,2025-05-25T05:28:00+02:00,2025-05-25,13:28,4,6,10
30,2025-05-25T05:33:00+02:00,2025-05-25,13:33,7,13,20
35,2025-05-25T05:30:00+02:00,2025-05-25,13:30,13,12,25
35,2025-05-25T05:36:00+02:00,2025-05-25,13:36,18,28,46
35,2025-05-25T05:39:00+02:00,2025-05-25,13:39,17,21,38
46,2025-05-25T05:30:00+02:00,2025-05-25,13:30,8,11,19
48,2025-05-25T05:26:00+02:00,2025-05-25,13:26,19,10,29
48,2025-05-25T05:32:00+02:00,2025-05-25,13:32,8,1,9
48,2025-05-25T05:34:00+02:00,2025-05-25,13:34,7,11,18
48,2025-05-25T05:35:00+02:00,2025-05-25,13:35,8,7,15
48,2025-05-25T05:36:00+02:00,2025-05-25,13:36,8,6,14
49,2025-05-25T05:27:00+02:00,2025-05-25,13:27,14,13,27
49,2025-05-25T05:29:00+02:00,2025-05-25,13:29,13,12,25
49,2025-05-25T05:30:00+02:00,2025-05-25,13:30,8,16,24
49,2025-05-25T05:34:00+02:00,2025-05-25,13:34,3,20,23
49,2025-05-25T05:35:00+02:00,2025-05-25,13:35,9,12,21
49,2025-05-25T05:37:00+02:00,2025-05-25,13:37,6,11,17
49,2025-05-25T05:38:00+02:00,2025-05-25,13:38,12,17,29
51,2025-05-25T05:25:00+02:00,2025-05-25,13:25,0,7,7
51,2025-05-25T05:26:00+02:00,2025-05-25,13:26,1,5,6
51,2025-05-25T05:28:00+02:00,2025-05-25,13:28,5,4,9
51,2025-05-25T05:31:00+02:00,2025-05-25,13:31,0,3,3
51,2025-05-25T05:32:00+02:00,2025-05-25,13:32,3,4,7
51,2025-05-25T05:34:00+02:00,2025-05-25,13:34,0,6,6
51,2025-05-25T05:36:00+02:00,2025-05-25,13:36,4,5,9
51,2025-05-25T05:39:00+02:00,2025-05-25,13:39,0,5,5
52,2025-05-25T05:26:00+02:00,2025-05-25,13:26,9,5,14
52,2025-05-25T05:33:00+02:00,2025-05-25,13:33,7,5,12
52,2025-05-25T05:37:00+02:00,2025-05-25,13:37,12,10,22
53,2025-05-25T05:26:00+02:00,2025-05-25,13:26,11,11,22
53,2025-05-25T05:30:00+02:00,2025-05-25,13:30,22,6,28
53,2025-05-25T05:31:00+02:00,2025-05-25,13:31,16,4,20
53,2025-05-25T05:32:00+02:00,2025-05-25,13:32,17,9,26
53,2025-05-25T05:34:00+02:00,2025-05-25,13:34,7,8,15
53,2025-05-25T05:36:00+02:00,2025-05-25,13:36,5,9,14
53,2025-05-25T05:37:00+02:00,2025-05-25,13:37,15,6,21
56,2025-05-25T05:28:00+02:00,2025-05-25,13:28,12,2,14
56,2025-05-25T05:34:00+02:00,2025-05-25,13:34,23,5,28
56,2025-05-25T05:39:00+02:00,2025-05-25,13:39,20,10,30
58,2025-05-25T05:27:00+02:00,2025-05-25,13:27,5,4,9
58,2025-05-25T05:28:00+02:00,2025-05-25,13:28,4,21,25
58,2025-05-25T05:29:00+02:00,2025-05-25,13:29,3,7,10
58,2025-05-25T05:33:00+02:00,2025-05-25,13:33,25,2,27
58,2025-05-25T05:34:00+02:00,2025-05-25,13:34,3,13,16
58,2025-05-25T05:38:00+02:00,2025-05-25,13:38,14,2,16
62,2025-05-25T05:25:00+02:00,2025-05-25,13:25,4,4,8
62,2025-05-25T05:31:00+02:00,2025-05-25,13:31,2,8,10
62,2025-05-25T05:32:00+02:00,2025-05-25,13:32,7,4,11
62,2025-05-25T05:33:00+02:00,2025-05-25,13:33,10,2,12
62,2025-05-25T05:36:00+02:00,2025-05-25,13:36,0,2,2
62,2025-05-25T05:37:00+02:00,2025-05-25,13:37,1,3,4
63,2025-05-25T05:37:00+02:00,2025-05-25,13:37,10,3,13
63,2025-05-25T05:38:00+02:00,2025-05-25,13:38,7,3,10
63,2025-05-25T05:39:00+02:00,2025-05-25,13:39,7,10,17
67,2025-05-25T05:27:00+02:00,2025-05-25,13:27,14,3,17
67,2025-05-25T05:30:00+02:00,2025-05-25,13:30,10,12,22
67,2025-05-25T05:37:00+02:00,2025-05-25,13:37,5,14,19
67,2025-05-25T05:39:00+02:00,2025-05-25,13:39,4,3,7
68,2025-05-25T05:25:00+02:00,2025-05-25,13:25,10,6,16
68,2025-05-25T05:30:00+02:00,2025-05-25,13:30,8,0,8
68,2025-05-25T05:32:00+02:00,2025-05-25,13:32,2,10,12
68,2025-05-25T05:38:00+02:00,2025-05-25,13:38,4,5,9
72,2025-05-25T05:26:00+02:00,2025-05-25,13:26,2,16,18
76,2025-05-25T05:30:00+02:00,2025-05-25,13:30,1,3,4
76,2025-05-25T05:32:00+02:00,2025-05-25,13:32,1,0,1
76,2025-05-25T05:35:00+02:00,2025-05-25,13:35,0,1,1
79,2025-05-25T05:25:00+02:00,2025-05-25,13:25,10,14,24
79,2025-05-25T05:29:00+02:00,2025-05-25,13:29,23,1,24
79,2025-05-25T05:30:00+02:00,2025-05-25,13:30,23,12,35
79,2025-05-25T05:35:00+02:00,2025-05-25,13:35,15,6,21
85,2025-05-25T05:28:00+02:00,2025-05-25,13:28,2,0,2
85,2025-05-25T05:29:00+02:00,2025-05-25,13:29,3,1,4
86,2025-05-25T05:25:00+02:00,2025-05-25,13:25,0,1,1
86,2025-05-25T05:27:00+02:00,2025-05-25,13:27,2,2,4
86,2025-05-25T05:30:00+02:00,2025-05-25,13:30,0,1,1
86,2025-05-25T05:32:00+02:00,2025-05-25,13:32,3,0,3
86,2025-05-25T05:35:00+02:00,2025-05-25,13:35,0,2,2
86,2025-05-25T05:37:00+02:00,2025-05-25,13:37,3,0,3
86,2025-05-25T05:39:00+02:00,2025-05-25,13:39,0,3,3
117,2025-05-25T05:35:00+02:00,2025-05-25,13:35,14,8,22
123,2025-05-25T05:25:00+02:00,2025-05-25,13:25,6,12,18
123,2025-05-25T05:30:00+02:00,2025-05-25,13:30,2,1,3
123,2025-05-25T05:35:00+02:00,2025-05-25,13:35,9,2,11
130,2025-05-25T05:25:00+02:00,2025-05-25,13:25,3,4,7
130,2025-05-25T05:35:00+02:00,2025-05-25,13:35,3,6,9
136,2025-05-25T05:25:00+02:00,2025-05-25,13:25,21,5,26
136,2025-05-25T05:30:00+02:00,2025-05-25,13:30,30,4,34
137,2025-05-25T05:25:00+02:00,2025-05-25,13:25,2,0,2
138,2025-05-25T05:25:00+02:00,2025-05-25,13:25,2,0,2
139,2025-05-25T05:25:00+02:00,2025-05-25,13:25,5,3,8
181,2025-05-25T05:43:00+02:00,2025-05-25,13:43,12,21,33
181,2025-05-25T05:47:00+02:00,2025-05-25,13:47,10,23,33
180,2025-05-25T05:40:00+02:00,2025-05-25,13:40,0,2,2
180,2025-05-25T05:49:00+02:00,2025-05-25,13:49,1,0,1
3,2025-05-25T05:41:00+02:00,2025-05-25,13:41,23,24,47
3,2025-05-25T05:42:00+02:00,2025-05-25,13:42,12,15,27
3,2025-05-25T05:49:00+02:00,2025-05-25,13:49,29,19,48
3,2025-05-25T05:51:00+02:00,2025-05-25,13:51,7,23,30
3,2025-05-25T05:52:00+02:00,2025-05-25,13:52,37,13,50
3,2025-05-25T05:54:00+02:00,2025-05-25,13:54,11,26,37
4,2025-05-25T05:40:00+02:00,2025-05-25,13:40,31,30,61
4,2025-05-25T05:42:00+02:00,2025-05-25,13:42,49,21,70
4,2025-05-25T05:46:00+02:00,2025-05-25,13:46,67,14,81
4,2025-05-25T05:48:00+02:00,2025-05-25,13:48,14,19,33
4,2025-05-25T05:51:00+02:00,2025-05-25,13:51,29,19,48
4,2025-05-25T05:52:00+02:00,2025-05-25,13:52,20,32,52
6,2025-05-25T05:40:00+02:00,2025-05-25,13:40,20,7,27
6,2025-05-25T05:42:00+02:00,2025-05-25,13:42,13,20,33
6,2025-05-25T05:43:00+02:00,2025-05-25,13:43,13,14,27
6,2025-05-25T05:50:00+02:00,2025-05-25,13:50,13,14,27
6,2025-05-25T05:53:00+02:00,2025-05-25,13:53,14,7,21
8,2025-05-25T05:43:00+02:00,2025-05-25,13:43,3,6,9
8,2025-05-25T05:48:00+02:00,2025-05-25,13:48,1,5,6
8,2025-05-25T05:53:00+02:00,2025-05-25,13:53,7,5,12
8,2025-05-25T05:54:00+02:00,2025-05-25,13:54,1,14,15
28,2025-05-25T05:40:00+02:00,2025-05-25,13:40,6,5,11
28,2025-05-25T05:41:00+02:00,2025-05-25,13:41,8,7,15
28,2025-05-25T05:43:00+02:00,2025-05-25,13:43,3,12,15
28,2025-05-25T05:46:00+02:00,2025-05-25,13:46,5,5,10
28,2025-05-25T05:54:00+02:00,2025-05-25,13:54,6,11,17
29,2025-05-25T05:42:00+02:00,2025-05-25,13:42,16,18,34
29,2025-05-25T05:43:00+02:00,2025-05-25,13:43,18,18,36
29,2025-05-25T05:44:00+02:00,2025-05-25,13:44,11,9,20
29,2025-05-25T05:51:00+02:00,2025-05-25,13:51,2,8,10
29,2025-05-25T05:52:00+02:00,2025-05-25,13:52,10,14,24
29,2025-05-25T05:53:00+02:00,2025-05-25,13:53,12,12,24
29,2025-05-25T05:54:00+02:00,2025-05-25,13:54,10,8,18
31,2025-05-25T05:43:00+02:00,2025-05-25,13:43,10,1,11
31,2025-05-25T05:47:00+02:00,2025-05-25,13:47,6,6,12
31,2025-05-25T05:50:00+02:00,2025-05-25,13:50,4,3,7
31,2025-05-25T05:54:00+02:00,2025-05-25,13:54,1,7,8
36,2025-05-25T05:40:00+02:00,2025-05-25,13:40,2,0,2
36,2025-05-25T05:49:00+02:00,2025-05-25,13:49,6,1,7
36,2025-05-25T05:50:00+02:00,2025-05-25,13:50,1,1,2
39,2025-05-25T05:47:00+02:00,2025-05-25,13:47,0,1,1
39,2025-05-25T05:51:00+02:00,2025-05-25,13:51,1,3,4
40,2025-05-25T05:41:00+02:00,2025-05-25,13:41,1,5,6
40,2025-05-25T05:45:00+02:00,2025-05-25,13:45,3,0,3
40,2025-05-25T05:50:00+02:00,2025-05-25,13:50,4,2,6
40,2025-05-25T05:53:00+02:00,2025-05-25,13:53,5,1,6
41,2025-05-25T05:46:00+02:00,2025-05-25,13:46,2,6,8
41,2025-05-25T05:48:00+02:00,2025-05-25,13:48,8,2,10
41,2025-05-25T05:50:00+02:00,2025-05-25,13:50,13,11,24
41,2025-05-25T05:54:00+02:00,2025-05-25,13:54,7,8,15
45,2025-05-25T05:41:00+02:00,2025-05-25,13:41,25,27,52
45,2025-05-25T05:50:00+02:00,2025-05-25,13:50,22,22,44
45,2025-05-25T05:54:00+02:00,2025-05-25,13:54,28,15,43
47,2025-05-25T05:43:00+02:00,2025-05-25,13:43,17,31,48
47,2025-05-25T05:46:00+02:00,2025-05-25,13:46,20,29,49
47,2025-05-25T05:47:00+02:00,2025-05-25,13:47,26,31,57
47,2025-05-25T05:52:00+02:00,2025-05-25,13:52,22,28,50
50,2025-05-25T05:44:00+02:00,2025-05-25,13:44,8,7,15
50,2025-05-25T05:51:00+02:00,2025-05-25,13:51,9,2,11
54,2025-05-25T05:40:00+02:00,2025-05-25,13:40,4,0,4
54,2025-05-25T05:43:00+02:00,2025-05-25,13:43,0,6,6
54,2025-05-25T05:44:00+02:00,2025-05-25,13:44,0,5,5
54,2025-05-25T05:47:00+02:00,2025-05-25,13:47,0,7,7
54,2025-05-25T05:50:00+02:00,2025-05-25,13:50,1,0,1
54,2025-05-25T05:53:00+02:00,2025-05-25,13:53,4,2,6
61,2025-05-25T05:45:00+02:00,2025-05-25,13:45,6,9,15
61,2025-05-25T05:46:00+02:00,2025-05-25,13:46,4,14,18
61,2025-05-25T05:51:00+02:00,2025-05-25,13:51,8,31,39
61,2025-05-25T05:52:00+02:00,2025-05-25,13:52,12,4,16
61,2025-05-25T05:53:00+02:00,2025-05-25,13:53,11,11,22
61,2025-05-25T05:54:00+02:00,2025-05-25,13:54,9,3,12
66,2025-05-25T05:45:00+02:00,2025-05-25,13:45,26,43,69
66,2025-05-25T05:46:00+02:00,2025-05-25,13:46,28,32,60
66,2025-05-25T05:47:00+02:00,2025-05-25,13:47,29,14,43
66,2025-05-25T05:49:00+02:00,2025-05-25,13:49,22,27,49
66,2025-05-25T05:50:00+02:00,2025-05-25,13:50,16,20,36
66,2025-05-25T05:51:00+02:00,2025-05-25,13:51,20,35,55
66,2025-05-25T05:52:00+02:00,2025-05-25,13:52,25,23,48
69,2025-05-25T05:41:00+02:00,2025-05-25,13:41,10,8,18
69,2025-05-25T05:46:00+02:00,2025-05-25,13:46,6,6,12
69,2025-05-25T05:48:00+02:00,2025-05-25,13:48,4,2,6
69,2025-05-25T05:52:00+02:00,2025-05-25,13:52,2,2,4
70,2025-05-25T05:42:00+02:00,2025-05-25,13:42,4,3,7
70,2025-05-25T05:47:00+02:00,2025-05-25,13:47,3,3,6
71,2025-05-25T05:45:00+02:00,2025-05-25,13:45,1,0,1
75,2025-05-25T05:43:00+02:00,2025-05-25,13:43,0,3,3
78,2025-05-25T05:40:00+02:00,2025-05-25,13:40,0,1,1
78,2025-05-25T05:41:00+02:00,2025-05-25,13:41,2,1,3
78,2025-05-25T05:49:00+02:00,2025-05-25,13:49,0,4,4
78,2025-05-25T05:53:00+02:00,2025-05-25,13:53,0,1,1
84,2025-05-25T05:45:00+02:00,2025-05-25,13:45,107,89,196
84,2025-05-25T05:50:00+02:00,2025-05-25,13:50,85,106,191
87,2025-05-25T05:41:00+02:00,2025-05-25,13:41,1,1,2
87,2025-05-25T05:43:00+02:00,2025-05-25,13:43,2,2,4
87,2025-05-25T05:54:00+02:00,2025-05-25,13:54,0,5,5
107,2025-05-25T05:50:00+02:00,2025-05-25,13:50,65,18,83
108,2025-05-25T05:40:00+02:00,2025-05-25,13:40,1,4,5
108,2025-05-25T05:41:00+02:00,2025-05-25,13:41,3,2,5
108,2025-05-25T05:42:00+02:00,2025-05-25,13:42,2,3,5
108,2025-05-25T05:45:00+02:00,2025-05-25,13:45,2,0,2
108,2025-05-25T05:46:00+02:00,2025-05-25,13:46,3,3,6
108,2025-05-25T05:49:00+02:00,2025-05-25,13:49,5,0,5
118,2025-05-25T05:50:00+02:00,2025-05-25,13:50,4,2,6
124,2025-05-25T05:45:00+02:00,2025-05-25,13:45,2,2,4
131,2025-05-25T05:40:00+02:00,2025-05-25,13:40,7,8,15
132,2025-05-25T05:45:00+02:00,2025-05-25,13:45,16,29,45
133,2025-05-25T05:40:00+02:00,2025-05-25,13:40,47,35,82
133,2025-05-25T05:50:00+02:00,2025-05-25,13:50,42,50,92
134,2025-05-25T05:45:00+02:00,2025-05-25,13:45,41,18,59
134,2025-05-25T05:50:00+02:00,2025-05-25,13:50,34,30,64
135,2025-05-25T05:45:00+02:00,2025-05-25,13:45,34,36,70
140,2025-05-25T05:40:00+02:00,2025-05-25,13:40,13,2,15
140,2025-05-25T05:45:00+02:00,2025-05-25,13:45,4,7,11
162,2025-05-25T05:50:00+02:00,2025-05-25,13:50,60,95,155
166,2025-05-25T05:40:00+02:00,2025-05-25,13:40,4,1,5
179,2025-05-25T05:45:00+02:00,2025-05-25,13:45,7,3,10
1,2025-05-25T05:41:00+02:00,2025-05-25,13:41,17,14,31
1,2025-05-25T05:45:00+02:00,2025-05-25,13:45,34,23,57
1,2025-05-25T05:49:00+02:00,2025-05-25,13:49,27,24,51
1,2025-05-25T05:51:00+02:00,2025-05-25,13:51,23,29,52
1,2025-05-25T05:54:00+02:00,2025-05-25,13:54,27,24,51
2,2025-05-25T05:42:00+02:00,2025-05-25,13:42,16,17,33
2,2025-05-25T05:43:00+02:00,2025-05-25,13:43,9,11,20
2,2025-05-25T05:45:00+02:00,2025-05-25,13:45,26,12,38
2,2025-05-25T05:49:00+02:00,2025-05-25,13:49,10,9,19
9,2025-05-25T05:43:00+02:00,2025-05-25,13:43,0,3,3
9,2025-05-25T05:45:00+02:00,2025-05-25,13:45,1,0,1
9,2025-05-25T05:50:00+02:00,2025-05-25,13:50,3,0,3
9,2025-05-25T05:54:00+02:00,2025-05-25,13:54,2,0,2
10,2025-05-25T05:41:00+02:00,2025-05-25,13:41,1,4,5
10,2025-05-25T05:43:00+02:00,2025-05-25,13:43,0,1,1
10,2025-05-25T05:47:00+02:00,2025-05-25,13:47,2,1,3
10,2025-05-25T05:49:00+02:00,2025-05-25,13:49,2,0,2
10,2025-05-25T05:50:00+02:00,2025-05-25,13:50,1,1,2
10,2025-05-25T05:53:00+02:00,2025-05-25,13:53,0,1,1
11,2025-05-25T05:49:00+02:00,2025-05-25,13:49,0,2,2
11,2025-05-25T05:51:00+02:00,2025-05-25,13:51,2,4,6
12,2025-05-25T05:47:00+02:00,2025-05-25,13:47,2,1,3
12,2025-05-25T05:48:00+02:00,2025-05-25,13:48,0,8,8
12,2025-05-25T05:49:00+02:00,2025-05-25,13:49,4,2,6
17,2025-05-25T05:42:00+02:00,2025-05-25,13:42,4,1,5
17,2025-05-25T05:45:00+02:00,2025-05-25,13:45,2,0,2
17,2025-05-25T05:48:00+02:00,2025-05-25,13:48,4,0,4
18,2025-05-25T05:40:00+02:00,2025-05-25,13:40,0,2,2
18,2025-05-25T05:47:00+02:00,2025-05-25,13:47,6,1,7
19,2025-05-25T05:42:00+02:00,2025-05-25,13:42,18,7,25
19,2025-05-25T05:46:00+02:00,2025-05-25,13:46,7,13,20
19,2025-05-25T05:48:00+02:00,2025-05-25,13:48,13,19,32
19,2025-05-25T05:52:00+02:00,2025-05-25,13:52,16,14,30
20,2025-05-25T05:40:00+02:00,2025-05-25,13:40,1,7,8
20,2025-05-25T05:43:00+02:00,2025-05-25,13:43,0,11,11
20,2025-05-25T05:46:00+02:00,2025-05-25,13:46,1,10,11
20,2025-05-25T05:51:00+02:00,2025-05-25,13:51,0,5,5
20,2025-05-25T05:52:00+02:00,2025-05-25,13:52,4,8,12
20,2025-05-25T05:54:00+02:00,2025-05-25,13:54,4,7,11
23,2025-05-25T05:40:00+02:00,2025-05-25,13:40,1,3,4
23,2025-05-25T05:42:00+02:00,2025-05-25,13:42,2,8,10
23,2025-05-25T05:43:00+02:00,2025-05-25,13:43,2,3,5
23,2025-05-25T05:44:00+02:00,2025-05-25,13:44,1,5,6
23,2025-05-25T05:48:00+02:00,2025-05-25,13:48,5,0,5
23,2025-05-25T05:52:00+02:00,2025-05-25,13:52,3,6,9
23,2025-05-25T05:54:00+02:00,2025-05-25,13:54,5,3,8
24,2025-05-25T05:42:00+02:00,2025-05-25,13:42,4,15,19
24,2025-05-25T05:47:00+02:00,2025-05-25,13:47,10,17,27
24,2025-05-25T05:53:00+02:00,2025-05-25,13:53,12,6,18
25,2025-05-25T05:40:00+02:00,2025-05-25,13:40,80,112,192
27,2025-05-25T05:40:00+02:00,2025-05-25,13:40,9,5,14
27,2025-05-25T05:42:00+02:00,2025-05-25,13:42,9,6,15
27,2025-05-25T05:44:00+02:00,2025-05-25,13:44,5,5,10
27,2025-05-25T05:47:00+02:00,2025-05-25,13:47,5,0,5
27,2025-05-25T05:51:00+02:00,2025-05-25,13:51,5,0,5
27,2025-05-25T05:53:00+02:00,2025-05-25,13:53,6,2,8
30,2025-05-25T05:41:00+02:00,2025-05-25,13:41,5,17,22
30,2025-05-25T05:42:00+02:00,2025-05-25,13:42,4,2,6
30,2025-05-25T05:43:00+02:00,2025-05-25,13:43,9,6,15
30,2025-05-25T05:48:00+02:00,2025-05-25,13:48,1,14,15
30,2025-05-25T05:52:00+02:00,2025-05-25,13:52,2,3,5
35,2025-05-25T05:40:00+02:00,2025-05-25,13:40,24,34,58
35,2025-05-25T05:42:00+02:00,2025-05-25,13:42,24,22,46
35,2025-05-25T05:44:00+02:00,2025-05-25,13:44,13,21,34
35,2025-05-25T05:50:00+02:00,2025-05-25,13:50,30,27,57
35,2025-05-25T05:52:00+02:00,2025-05-25,13:52,16,24,40
35,2025-05-25T05:53:00+02:00,2025-05-25,13:53,18,24,42
46,2025-05-25T05:40:00+02:00,2025-05-25,13:40,10,5,15
48,2025-05-25T05:43:00+02:00,2025-05-25,13:43,10,6,16
48,2025-05-25T05:45:00+02:00,2025-05-25,13:45,4,6,10
48,2025-05-25T05:46:00+02:00,2025-05-25,13:46,5,11,16
48,2025-05-25T05:47:00+02:00,2025-05-25,13:47,16,9,25
48,2025-05-25T05:48:00+02:00,2025-05-25,13:48,13,13,26
48,2025-05-25T05:51:00+02:00,2025-05-25,13:51,8,3,11
49,2025-05-25T05:42:00+02:00,2025-05-25,13:42,9,7,16
49,2025-05-25T05:44:00+02:00,2025-05-25,13:44,10,7,17
49,2025-05-25T05:47:00+02:00,2025-05-25,13:47,5,10,15
51,2025-05-25T05:41:00+02:00,2025-05-25,13:41,1,4,5
51,2025-05-25T05:42:00+02:00,2025-05-25,13:42,0,3,3
51,2025-05-25T05:45:00+02:00,2025-05-25,13:45,4,2,6
51,2025-05-25T05:46:00+02:00,2025-05-25,13:46,1,1,2
51,2025-05-25T05:50:00+02:00,2025-05-25,13:50,5,4,9
51,2025-05-25T05:51:00+02:00,2025-05-25,13:51,1,2,3
51,2025-05-25T05:53:00+02:00,2025-05-25,13:53,1,2,3
52,2025-05-25T05:42:00+02:00,2025-05-25,13:42,13,6,19
52,2025-05-25T05:45:00+02:00,2025-05-25,13:45,2,16,18
52,2025-05-25T05:47:00+02:00,2025-05-25,13:47,10,1,11
52,2025-05-25T05:48:00+02:00,2025-05-25,13:48,11,9,20
52,2025-05-25T05:49:00+02:00,2025-05-25,13:49,2,3,5
52,2025-05-25T05:50:00+02:00,2025-05-25,13:50,4,7,11
52,2025-05-25T05:54:00+02:00,2025-05-25,13:54,8,6,14
53,2025-05-25T05:46:00+02:00,2025-05-25,13:46,11,3,14
53,2025-05-25T05:48:00+02:00,2025-05-25,13:48,12,2,14
53,2025-05-25T05:49:00+02:00,2025-05-25,13:49,17,4,21
53,2025-05-25T05:53:00+02:00,2025-05-25,13:53,4,2,6
53,2025-05-25T05:54:00+02:00,2025-05-25,13:54,13,5,18
56,2025-05-25T05:45:00+02:00,2025-05-25,13:45,3,1,4
56,2025-05-25T05:47:00+02:00,2025-05-25,13:47,13,12,25
56,2025-05-25T05:49:00+02:00,2025-05-25,13:49,9,0,9
56,2025-05-25T05:51:00+02:00,2025-05-25,13:51,7,10,17
58,2025-05-25T05:41:00+02:00,2025-05-25,13:41,17,7,24
58,2025-05-25T05:42:00+02:00,2025-05-25,13:42,7,6,13
58,2025-05-25T05:44:00+02:00,2025-05-25,13:44,3,8,11
58,2025-05-25T05:50:00+02:00,2025-05-25,13:50,18,2,20
58,2025-05-25T05:54:00+02:00,2025-05-25,13:54,7,3,10
62,2025-05-25T05:41:00+02:00,2025-05-25,13:41,12,4,16
62,2025-05-25T05:44:00+02:00,2025-05-25,13:44,3,5,8
62,2025-05-25T05:45:00+02:00,2025-05-25,13:45,4,1,5
62,2025-05-25T05:52:00+02:00,2025-05-25,13:52,5,2,7
63,2025-05-25T05:41:00+02:00,2025-05-25,13:41,17,9,26
63,2025-05-25T05:46:00+02:00,2025-05-25,13:46,7,4,11
63,2025-05-25T05:47:00+02:00,2025-05-25,13:47,13,4,17
63,2025-05-25T05:48:00+02:00,2025-05-25,13:48,2,4,6
63,2025-05-25T05:50:00+02:00,2025-05-25,13:50,9,11,20
63,2025-05-25T05:54:00+02:00,2025-05-25,13:54,15,2,17
67,2025-05-25T05:41:00+02:00,2025-05-25,13:41,3,12,15
67,2025-05-25T05:43:00+02:00,2025-05-25,13:43,7,11,18
67,2025-05-25T05:44:00+02:00,2025-05-25,13:44,4,6,10
67,2025-05-25T05:45:00+02:00,2025-05-25,13:45,9,10,19
67,2025-05-25T05:54:00+02:00,2025-05-25,13:54,4,12,16
68,2025-05-25T05:40:00+02:00,2025-05-25,13:40,3,9,12
68,2025-05-25T05:43:00+02:00,2025-05-25,13:43,13,4,17
68,2025-05-25T05:44:00+02:00,2025-05-25,13:44,8,3,11
68,2025-05-25T05:46:00+02:00,2025-05-25,13:46,2,17,19
68,2025-05-25T05:47:00+02:00,2025-05-25,13:47,3,3,6
68,2025-05-25T05:50:00+02:00,2025-05-25,13:50,6,3,9
68,2025-05-25T05:52:00+02:00,2025-05-25,13:52,7,2,9
68,2025-05-25T05:53:00+02:00,2025-05-25,13:53,1,3,4
72,2025-05-25T05:44:00+02:00,2025-05-25,13:44,1,0,1
72,2025-05-25T05:45:00+02:00,2025-05-25,13:45,4,4,8
72,2025-05-25T05:47:00+02:00,2025-05-25,13:47,8,6,14
72,2025-05-25T05:49:00+02:00,2025-05-25,13:49,6,2,8
72,2025-05-25T05:50:00+02:00,2025-05-25,13:50,10,9,19
72,2025-05-25T05:51:00+02:00,2025-05-25,13:51,22,16,38
76,2025-05-25T05:42:00+02:00,2025-05-25,13:42,1,4,5
79,2025-05-25T05:40:00+02:00,2025-05-25,13:40,13,13,26
79,2025-05-25T05:41:00+02:00,2025-05-25,13:41,19,13,32
79,2025-05-25T05:43:00+02:00,2025-05-25,13:43,6,8,14
79,2025-05-25T05:45:00+02:00,2025-05-25,13:45,9,12,21
85,2025-05-25T05:41:00+02:00,2025-05-25,13:41,2,0,2
85,2025-05-25T05:42:00+02:00,2025-05-25,13:42,2,4,6
85,2025-05-25T05:43:00+02:00,2025-05-25,13:43,0,1,1
85,2025-05-25T05:51:00+02:00,2025-05-25,13:51,4,0,4
85,2025-05-25T05:53:00+02:00,2025-05-25,13:53,0,1,1
86,2025-05-25T05:40:00+02:00,2025-05-25,13:40,2,1,3
86,2025-05-25T05:48:00+02:00,2025-05-25,13:48,1,2,3
86,2025-05-25T05:51:00+02:00,2025-05-25,13:51,0,2,2
86,2025-05-25T05:53:00+02:00,2025-05-25,13:53,0,3,3
109,2025-05-25T05:40:00+02:00,2025-05-25,13:40,3,18,21
109,2025-05-25T05:50:00+02:00,2025-05-25,13:50,29,7,36
123,2025-05-25T05:45:00+02:00,2025-05-25,13:45,11,3,14
130,2025-05-25T05:40:00+02:00,2025-05-25,13:40,10,2,12
136,2025-05-25T05:45:00+02:00,2025-05-25,13:45,51,9,60
139,2025-05-25T05:40:00+02:00,2025-05-25,13:40,9,4,13
139,2025-05-25T05:50:00+02:00,2025-05-25,13:50,10,2,12
142,2025-05-25T05:40:00+02:00,2025-05-25,13:40,45,46,91
161,2025-05-25T05:50:00+02:00,2025-05-25,13:50,78,11,89
181,2025-05-25T05:56:00+02:00,2025-05-25,13:56,9,35,44
181,2025-05-25T06:01:00+02:00,2025-05-25,14:01,22,23,45
181,2025-05-25T06:03:00+02:00,2025-05-25,14:03,8,15,23
181,2025-05-25T06:05:00+02:00,2025-05-25,14:05,13,15,28
182,2025-05-25T06:05:00+02:00,2025-05-25,14:05,18,26,44
180,2025-05-25T05:57:00+02:00,2025-05-25,13:57,1,0,1
180,2025-05-25T06:05:00+02:00,2025-05-25,14:05,2,0,2
180,2025-05-25T06:08:00+02:00,2025-05-25,14:08,0,2,2
180,2025-05-25T06:09:00+02:00,2025-05-25,14:09,1,0,1
3,2025-05-25T06:00:00+02:00,2025-05-25,14:00,19,22,41
3,2025-05-25T06:02:00+02:00,2025-05-25,14:02,14,14,28
4,2025-05-25T05:55:00+02:00,2025-05-25,13:55,21,33,54
4,2025-05-25T05:57:00+02:00,2025-05-25,13:57,31,16,47
4,2025-05-25T06:00:00+02:00,2025-05-25,14:00,30,21,51
4,2025-05-25T06:01:00+02:00,2025-05-25,14:01,35,31,66
4,2025-05-25T06:04:00+02:00,2025-05-25,14:04,25,30,55
4,2025-05-25T06:08:00+02:00,2025-05-25,14:08,24,19,43
4,2025-05-25T06:09:00+02:00,2025-05-25,14:09,21,37,58
5,2025-05-25T05:55:00+02:00,2025-05-25,13:55,76,73,149
5,2025-05-25T06:00:00+02:00,2025-05-25,14:00,86,82,168
5,2025-05-25T06:05:00+02:00,2025-05-25,14:05,81,81,162
6,2025-05-25T05:57:00+02:00,2025-05-25,13:57,13,11,24
6,2025-05-25T05:59:00+02:00,2025-05-25,13:59,17,16,33
6,2025-05-25T06:06:00+02:00,2025-05-25,14:06,10,32,42
8,2025-05-25T05:58:00+02:00,2025-05-25,13:58,2,2,4
8,2025-05-25T06:05:00+02:00,2025-05-25,14:05,1,13,14
8,2025-05-25T06:08:00+02:00,2025-05-25,14:08,1,5,6
8,2025-05-25T06:09:00+02:00,2025-05-25,14:09,6,13,19
28,2025-05-25T05:55:00+02:00,2025-05-25,13:55,19,12,31
28,2025-05-25T05:57:00+02:00,2025-05-25,13:57,3,9,12
28,2025-05-25T06:00:00+02:00,2025-05-25,14:00,5,17,22
28,2025-05-25T06:03:00+02:00,2025-05-25,14:03,9,6,15
28,2025-05-25T06:07:00+02:00,2025-05-25,14:07,13,10,23
28,2025-05-25T06:09:00+02:00,2025-05-25,14:09,5,14,19
29,2025-05-25T05:56:00+02:00,2025-05-25,13:56,10,11,21
29,2025-05-25T05:57:00+02:00,2025-05-25,13:57,8,22,30
29,2025-05-25T06:04:00+02:00,2025-05-25,14:04,22,4,26
29,2025-05-25T06:07:00+02:00,2025-05-25,14:07,13,15,28
31,2025-05-25T05:57:00+02:00,2025-05-25,13:57,4,5,9
31,2025-05-25T05:58:00+02:00,2025-05-25,13:58,2,10,12
31,2025-05-25T06:05:00+02:00,2025-05-25,14:05,3,2,5
31,2025-05-25T06:06:00+02:00,2025-05-25,14:06,1,5,6
31,2025-05-25T06:09:00+02:00,2025-05-25,14:09,2,1,3
36,2025-05-25T05:57:00+02:00,2025-05-25,13:57,9,1,10
36,2025-05-25T06:00:00+02:00,2025-05-25,14:00,2,3,5
39,2025-05-25T05:56:00+02:00,2025-05-25,13:56,0,2,2
39,2025-05-25T05:57:00+02:00,2025-05-25,13:57,0,1,1
39,2025-05-25T06:01:00+02:00,2025-05-25,14:01,1,0,1
39,2025-05-25T06:05:00+02:00,2025-05-25,14:05,2,0,2
40,2025-05-25T06:02:00+02:00,2025-05-25,14:02,0,4,4
40,2025-05-25T06:04:00+02:00,2025-05-25,14:04,1,4,5
40,2025-05-25T06:06:00+02:00,2025-05-25,14:06,2,3,5
41,2025-05-25T05:55:00+02:00,2025-05-25,13:55,4,4,8
41,2025-05-25T05:59:00+02:00,2025-05-25,13:59,10,3,13
41,2025-05-25T06:00:00+02:00,2025-05-25,14:00,3,17,20
41,2025-05-25T06:02:00+02:00,2025-05-25,14:02,25,12,37
41,2025-05-25T06:09:00+02:00,2025-05-25,14:09,6,6,12
44,2025-05-25T05:55:00+02:00,2025-05-25,13:55,3,0,3
44,2025-05-25T06:00:00+02:00,2025-05-25,14:00,9,6,15
45,2025-05-25T06:02:00+02:00,2025-05-25,14:02,12,19,31
45,2025-05-25T06:04:00+02:00,2025-05-25,14:04,15,17,32
47,2025-05-25T05:56:00+02:00,2025-05-25,13:56,13,16,29
47,2025-05-25T06:03:00+02:00,2025-05-25,14:03,15,8,23
50,2025-05-25T05:56:00+02:00,2025-05-25,13:56,13,2,15
50,2025-05-25T05:57:00+02:00,2025-05-25,13:57,5,3,8
50,2025-05-25T06:02:00+02:00,2025-05-25,14:02,3,5,8
50,2025-05-25T06:04:00+02:00,2025-05-25,14:04,5,4,9
50,2025-05-25T06:05:00+02:00,2025-05-25,14:05,4,4,8
50,2025-05-25T06:06:00+02:00,2025-05-25,14:06,1,6,7
50,2025-05-25T06:08:00+02:00,2025-05-25,14:08,2,5,7
54,2025-05-25T05:55:00+02:00,2025-05-25,13:55,1,7,8
54,2025-05-25T05:57:00+02:00,2025-05-25,13:57,4,2,6
54,2025-05-25T05:58:00+02:00,2025-05-25,13:58,0,1,1
54,2025-05-25T06:06:00+02:00,2025-05-25,14:06,1,1,2
54,2025-05-25T06:08:00+02:00,2025-05-25,14:08,5,4,9
54,2025-05-25T06:09:00+02:00,2025-05-25,14:09,1,4,5
59,2025-05-25T06:05:00+02:00,2025-05-25,14:05,28,44,72
61,2025-05-25T05:59:00+02:00,2025-05-25,13:59,13,11,24
61,2025-05-25T06:00:00+02:00,2025-05-25,14:00,13,3,16
61,2025-05-25T06:03:00+02:00,2025-05-25,14:03,4,0,4
61,2025-05-25T06:04:00+02:00,2025-05-25,14:04,13,10,23
61,2025-05-25T06:09:00+02:00,2025-05-25,14:09,12,3,15
66,2025-05-25T05:57:00+02:00,2025-05-25,13:57,26,24,50
66,2025-05-25T05:59:00+02:00,2025-05-25,13:59,25,25,50
66,2025-05-25T06:04:00+02:00,2025-05-25,14:04,19,20,39
66,2025-05-25T06:05:00+02:00,2025-05-25,14:05,21,28,49
66,2025-05-25T06:08:00+02:00,2025-05-25,14:08,23,25,48
69,2025-05-25T05:55:00+02:00,2025-05-25,13:55,0,4,4
69,2025-05-25T06:00:00+02:00,2025-05-25,14:00,5,3,8
69,2025-05-25T06:04:00+02:00,2025-05-25,14:04,1,3,4
70,2025-05-25T06:02:00+02:00,2025-05-25,14:02,0,4,4
70,2025-05-25T06:03:00+02:00,2025-05-25,14:03,0,3,3
70,2025-05-25T06:07:00+02:00,2025-05-25,14:07,1,5,6
70,2025-05-25T06:08:00+02:00,2025-05-25,14:08,0,2,2
71,2025-05-25T06:01:00+02:00,2025-05-25,14:01,0,1,1
75,2025-05-25T05:56:00+02:00,2025-05-25,13:56,7,5,12
75,2025-05-25T06:00:00+02:00,2025-05-25,14:00,0,1,1
75,2025-05-25T06:03:00+02:00,2025-05-25,14:03,1,0,1
75,2025-05-25T06:09:00+02:00,2025-05-25,14:09,1,1,2
78,2025-05-25T05:56:00+02:00,2025-05-25,13:56,0,1,1
78,2025-05-25T05:57:00+02:00,2025-05-25,13:57,2,0,2
78,2025-05-25T05:59:00+02:00,2025-05-25,13:59,7,1,8
78,2025-05-25T06:01:00+02:00,2025-05-25,14:01,0,5,5
78,2025-05-25T06:02:00+02:00,2025-05-25,14:02,2,2,4
78,2025-05-25T06:05:00+02:00,2025-05-25,14:05,0,1,1
84,2025-05-25T05:55:00+02:00,2025-05-25,13:55,62,99,161
84,2025-05-25T06:05:00+02:00,2025-05-25,14:05,103,95,198
87,2025-05-25T05:59:00+02:00,2025-05-25,13:59,2,3,5
87,2025-05-25T06:00:00+02:00,2025-05-25,14:00,2,3,5
87,2025-05-25T06:01:00+02:00,2025-05-25,14:01,3,2,5
107,2025-05-25T05:55:00+02:00,2025-05-25,13:55,12,32,44
107,2025-05-25T06:05:00+02:00,2025-05-25,14:05,20,16,36
108,2025-05-25T05:56:00+02:00,2025-05-25,13:56,3,14,17
108,2025-05-25T05:58:00+02:00,2025-05-25,13:58,5,3,8
108,2025-05-25T06:00:00+02:00,2025-05-25,14:00,6,6,12
108,2025-05-25T06:05:00+02:00,2025-05-25,14:05,1,9,10
108,2025-05-25T06:07:00+02:00,2025-05-25,14:07,1,0,1
133,2025-05-25T06:05:00+02:00,2025-05-25,14:05,25,39,64
134,2025-05-25T05:55:00+02:00,2025-05-25,13:55,33,32,65
135,2025-05-25T06:00:00+02:00,2025-05-25,14:00,38,31,69
135,2025-05-25T06:05:00+02:00,2025-05-25,14:05,25,29,54
140,2025-05-25T06:05:00+02:00,2025-05-25,14:05,4,2,6
165,2025-05-25T06:00:00+02:00,2025-05-25,14:00,2,3,5
166,2025-05-25T05:55:00+02:00,2025-05-25,13:55,3,10,13
166,2025-05-25T06:00:00+02:00,2025-05-25,14:00,2,3,5
1,2025-05-25T05:57:00+02:00,2025-05-25,13:57,24,15,39
1,2025-05-25T05:58:00+02:00,2025-05-25,13:58,46,24,70
1,2025-05-25T06:00:00+02:00,2025-05-25,14:00,17,31,48
1,2025-05-25T06:02:00+02:00,2025-05-25,14:02,27,32,59
1,2025-05-25T06:05:00+02:00,2025-05-25,14:05,26,26,52
1,2025-05-25T06:07:00+02:00,2025-05-25,14:07,22,27,49
2,2025-05-25T05:59:00+02:00,2025-05-25,13:59,19,5,24
2,2025-05-25T06:00:00+02:00,2025-05-25,14:00,13,5,18
2,2025-05-25T06:03:00+02:00,2025-05-25,14:03,10,9,19
9,2025-05-25T05:59:00+02:00,2025-05-25,13:59,1,2,3
9,2025-05-25T06:04:00+02:00,2025-05-25,14:04,3,0,3
9,2025-05-25T06:07:00+02:00,2025-05-25,14:07,0,2,2
10,2025-05-25T05:57:00+02:00,2025-05-25,13:57,0,1,1
10,2025-05-25T05:58:00+02:00,2025-05-25,13:58,0,1,1
10,2025-05-25T06:06:00+02:00,2025-05-25,14:06,1,0,1
10,2025-05-25T06:07:00+02:00,2025-05-25,14:07,1,1,2
11,2025-05-25T05:55:00+02:00,2025-05-25,13:55,4,2,6
11,2025-05-25T05:56:00+02:00,2025-05-25,13:56,2,0,2
11,2025-05-25T05:58:00+02:00,2025-05-25,13:58,0,1,1
11,2025-05-25T06:01:00+02:00,2025-05-25,14:01,1,2,3
11,2025-05-25T06:02:00+02:00,2025-05-25,14:02,0,2,2
11,2025-05-25T06:06:00+02:00,2025-05-25,14:06,0,2,2
12,2025-05-25T05:56:00+02:00,2025-05-25,13:56,1,6,7
12,2025-05-25T06:05:00+02:00,2025-05-25,14:05,0,12,12
12,2025-05-25T06:07:00+02:00,2025-05-25,14:07,5,3,8
12,2025-05-25T06:08:00+02:00,2025-05-25,14:08,3,3,6
12,2025-05-25T06:09:00+02:00,2025-05-25,14:09,8,7,15
17,2025-05-25T05:57:00+02:00,2025-05-25,13:57,8,1,9
17,2025-05-25T06:00:00+02:00,2025-05-25,14:00,1,5,6
17,2025-05-25T06:02:00+02:00,2025-05-25,14:02,9,1,10
17,2025-05-25T06:03:00+02:00,2025-05-25,14:03,3,5,8
17,2025-05-25T06:08:00+02:00,2025-05-25,14:08,4,0,4
18,2025-05-25T05:56:00+02:00,2025-05-25,13:56,2,2,4
18,2025-05-25T05:58:00+02:00,2025-05-25,13:58,1,0,1
18,2025-05-25T05:59:00+02:00,2025-05-25,13:59,4,0,4
18,2025-05-25T06:03:00+02:00,2025-05-25,14:03,1,1,2
18,2025-05-25T06:04:00+02:00,2025-05-25,14:04,0,1,1
19,2025-05-25T05:58:00+02:00,2025-05-25,13:58,18,16,34
19,2025-05-25T06:04:00+02:00,2025-05-25,14:04,12,14,26
19,2025-05-25T06:05:00+02:00,2025-05-25,14:05,10,12,22
19,2025-05-25T06:06:00+02:00,2025-05-25,14:06,9,8,17
19,2025-05-25T06:07:00+02:00,2025-05-25,14:07,15,9,24
20,2025-05-25T05:57:00+02:00,2025-05-25,13:57,1,6,7
20,2025-05-25T06:00:00+02:00,2025-05-25,14:00,1,7,8
20,2025-05-25T06:01:00+02:00,2025-05-25,14:01,4,3,7
20,2025-05-25T06:02:00+02:00,2025-05-25,14:02,7,25,32
20,2025-05-25T06:03:00+02:00,2025-05-25,14:03,10,5,15
20,2025-05-25T06:04:00+02:00,2025-05-25,14:04,2,4,6
20,2025-05-25T06:09:00+02:00,2025-05-25,14:09,4,14,18
23,2025-05-25T05:55:00+02:00,2025-05-25,13:55,3,3,6
23,2025-05-25T05:56:00+02:00,2025-05-25,13:56,3,1,4
23,2025-05-25T05:59:00+02:00,2025-05-25,13:59,1,5,6
23,2025-05-25T06:01:00+02:00,2025-05-25,14:01,1,6,7
23,2025-05-25T06:03:00+02:00,2025-05-25,14:03,6,2,8
23,2025-05-25T06:09:00+02:00,2025-05-25,14:09,0,4,4
24,2025-05-25T05:56:00+02:00,2025-05-25,13:56,19,4,23
24,2025-05-25T05:57:00+02:00,2025-05-25,13:57,3,22,25
24,2025-05-25T05:59:00+02:00,2025-05-25,13:59,6,2,8
24,2025-05-25T06:00:00+02:00,2025-05-25,14:00,5,3,8
24,2025-05-25T06:04:00+02:00,2025-05-25,14:04,0,13,13
24,2025-05-25T06:07:00+02:00,2025-05-25,14:07,4,5,9
25,2025-05-25T05:55:00+02:00,2025-05-25,13:55,68,58,126
25,2025-05-25T06:00:00+02:00,2025-05-25,14:00,67,69,136
25,2025-05-25T06:05:00+02:00,2025-05-25,14:05,69,54,123
27,2025-05-25T05:55:00+02:00,2025-05-25,13:55,5,3,8
27,2025-05-25T05:56:00+02:00,2025-05-25,13:56,2,9,11
27,2025-05-25T05:57:00+02:00,2025-05-25,13:57,3,2,5
27,2025-05-25T05:59:00+02:00,2025-05-25,13:59,4,5,9
27,2025-05-25T06:01:00+02:00,2025-05-25,14:01,8,2,10
27,2025-05-25T06:03:00+02:00,2025-05-25,14:03,4,5,9
27,2025-05-25T06:05:00+02:00,2025-05-25,14:05,2,0,2
27,2025-05-25T06:07:00+02:00,2025-05-25,14:07,2,1,3
27,2025-05-25T06:08:00+02:00,2025-05-25,14:08,4,5,9
27,2025-05-25T06:09:00+02:00,2025-05-25,14:09,5,6,11
30,2025-05-25T05:56:00+02:00,2025-05-25,13:56,7,8,15
30,2025-05-25T05:59:00+02:00,2025-05-25,13:59,4,13,17
30,2025-05-25T06:01:00+02:00,2025-05-25,14:01,7,4,11
30,2025-05-25T06:03:00+02:00,2025-05-25,14:03,2,11,13
35,2025-05-25T05:55:00+02:00,2025-05-25,13:55,17,19,36
35,2025-05-25T05:58:00+02:00,2025-05-25,13:58,21,16,37
35,2025-05-25T06:01:00+02:00,2025-05-25,14:01,36,23,59
35,2025-05-25T06:07:00+02:00,2025-05-25,14:07,22,22,44
46,2025-05-25T05:55:00+02:00,2025-05-25,13:55,9,4,13
48,2025-05-25T05:55:00+02:00,2025-05-25,13:55,4,3,7
48,2025-05-25T06:00:00+02:00,2025-05-25,14:00,6,11,17
48,2025-05-25T06:04:00+02:00,2025-05-25,14:04,14,8,22
48,2025-05-25T06:05:00+02:00,2025-05-25,14:05,7,11,18
49,2025-05-25T06:02:00+02:00,2025-05-25,14:02,6,13,19
49,2025-05-25T06:05:00+02:00,2025-05-25,14:05,6,4,10
49,2025-05-25T06:07:00+02:00,2025-05-25,14:07,6,9,15
49,2025-05-25T06:08:00+02:00,2025-05-25,14:08,7,8,15
49,2025-05-25T06:09:00+02:00,2025-05-25,14:09,6,6,12
51,2025-05-25T05:58:00+02:00,2025-05-25,13:58,7,3,10
51,2025-05-25T05:59:00+02:00,2025-05-25,13:59,3,8,11
51,2025-05-25T06:00:00+02:00,2025-05-25,14:00,1,10,11
51,2025-05-25T06:02:00+02:00,2025-05-25,14:02,12,2,14
52,2025-05-25T06:01:00+02:00,2025-05-25,14:01,10,0,10
52,2025-05-25T06:05:00+02:00,2025-05-25,14:05,7,4,11
53,2025-05-25T05:55:00+02:00,2025-05-25,13:55,8,4,12
53,2025-05-25T05:56:00+02:00,2025-05-25,13:56,11,10,21
53,2025-05-25T05:59:00+02:00,2025-05-25,13:59,8,13,21
53,2025-05-25T06:02:00+02:00,2025-05-25,14:02,9,5,14
53,2025-05-25T06:05:00+02:00,2025-05-25,14:05,13,10,23
53,2025-05-25T06:06:00+02:00,2025-05-25,14:06,3,9,12
53,2025-05-25T06:07:00+02:00,2025-05-25,14:07,7,4,11
53,2025-05-25T06:08:00+02:00,2025-05-25,14:08,11,5,16
56,2025-05-25T05:55:00+02:00,2025-05-25,13:55,7,11,18
56,2025-05-25T05:59:00+02:00,2025-05-25,13:59,16,6,22
56,2025-05-25T06:06:00+02:00,2025-05-25,14:06,10,2,12
58,2025-05-25T05:56:00+02:00,2025-05-25,13:56,14,6,20
58,2025-05-25T06:04:00+02:00,2025-05-25,14:04,4,9,13
58,2025-05-25T06:05:00+02:00,2025-05-25,14:05,16,3,19
58,2025-05-25T06:07:00+02:00,2025-05-25,14:07,14,8,22
62,2025-05-25T06:01:00+02:00,2025-05-25,14:01,17,0,17
62,2025-05-25T06:03:00+02:00,2025-05-25,14:03,3,1,4
62,2025-05-25T06:04:00+02:00,2025-05-25,14:04,6,3,9
62,2025-05-25T06:07:00+02:00,2025-05-25,14:07,12,3,15
63,2025-05-25T06:09:00+02:00,2025-05-25,14:09,7,1,8
67,2025-05-25T05:57:00+02:00,2025-05-25,13:57,3,17,20
67,2025-05-25T05:59:00+02:00,2025-05-25,13:59,11,6,17
67,2025-05-25T06:01:00+02:00,2025-05-25,14:01,12,4,16
67,2025-05-25T06:02:00+02:00,2025-05-25,14:02,7,21,28
67,2025-05-25T06:07:00+02:00,2025-05-25,14:07,3,8,11
67,2025-05-25T06:09:00+02:00,2025-05-25,14:09,10,11,21
68,2025-05-25T06:02:00+02:00,2025-05-25,14:02,8,4,12
68,2025-05-25T06:03:00+02:00,2025-05-25,14:03,9,6,15
68,2025-05-25T06:09:00+02:00,2025-05-25,14:09,3,11,14
72,2025-05-25T05:55:00+02:00,2025-05-25,13:55,7,18,25
72,2025-05-25T05:57:00+02:00,2025-05-25,13:57,6,3,9
72,2025-05-25T05:58:00+02:00,2025-05-25,13:58,2,6,8
72,2025-05-25T05:59:00+02:00,2025-05-25,13:59,4,5,9
72,2025-05-25T06:00:00+02:00,2025-05-25,14:00,2,11,13
72,2025-05-25T06:05:00+02:00,2025-05-25,14:05,5,17,22
72,2025-05-25T06:09:00+02:00,2025-05-25,14:09,6,5,11
76,2025-05-25T06:04:00+02:00,2025-05-25,14:04,1,1,2
76,2025-05-25T06:09:00+02:00,2025-05-25,14:09,2,1,3
79,2025-05-25T05:55:00+02:00,2025-05-25,13:55,19,4,23
79,2025-05-25T06:01:00+02:00,2025-05-25,14:01,23,10,33
79,2025-05-25T06:02:00+02:00,2025-05-25,14:02,9,20,29
79,2025-05-25T06:03:00+02:00,2025-05-25,14:03,21,5,26
85,2025-05-25T05:56:00+02:00,2025-05-25,13:56,2,0,2
85,2025-05-25T05:59:00+02:00,2025-05-25,13:59,1,1,2
85,2025-05-25T06:00:00+02:00,2025-05-25,14:00,5,1,6
85,2025-05-25T06:03:00+02:00,2025-05-25,14:03,6,1,7
85,2025-05-25T06:08:00+02:00,2025-05-25,14:08,3,3,6
85,2025-05-25T06:09:00+02:00,2025-05-25,14:09,2,2,4
86,2025-05-25T05:56:00+02:00,2025-05-25,13:56,0,1,1
86,2025-05-25T06:00:00+02:00,2025-05-25,14:00,2,4,6
86,2025-05-25T06:05:00+02:00,2025-05-25,14:05,0,3,3
86,2025-05-25T06:08:00+02:00,2025-05-25,14:08,0,6,6
109,2025-05-25T06:05:00+02:00,2025-05-25,14:05,11,12,23
136,2025-05-25T06:05:00+02:00,2025-05-25,14:05,89,5,94
138,2025-05-25T06:05:00+02:00,2025-05-25,14:05,0,3,3
139,2025-05-25T06:00:00+02:00,2025-05-25,14:00,3,3,6
141,2025-05-25T06:00:00+02:00,2025-05-25,14:00,19,19,38
142,2025-05-25T06:00:00+02:00,2025-05-25,14:00,75,48,123
164,2025-05-25T06:05:00+02:00,2025-05-25,14:05,15,6,21
181,2025-05-25T06:10:00+02:00,2025-05-25,14:10,15,19,34
181,2025-05-25T06:12:00+02:00,2025-05-25,14:12,15,23,38
181,2025-05-25T06:13:00+02:00,2025-05-25,14:13,16,18,34
181,2025-05-25T06:16:00+02:00,2025-05-25,14:16,14,15,29
181,2025-05-25T06:21:00+02:00,2025-05-25,14:21,18,27,45
181,2025-05-25T06:23:00+02:00,2025-05-25,14:23,1,12,13
182,2025-05-25T06:15:00+02:00,2025-05-25,14:15,21,12,33
182,2025-05-25T06:20:00+02:00,2025-05-25,14:20,7,8,15
180,2025-05-25T06:10:00+02:00,2025-05-25,14:10,1,0,1
180,2025-05-25T06:11:00+02:00,2025-05-25,14:11,0,1,1
180,2025-05-25T06:13:00+02:00,2025-05-25,14:13,1,0,1
180,2025-05-25T06:20:00+02:00,2025-05-25,14:20,4,0,4
180,2025-05-25T06:24:00+02:00,2025-05-25,14:24,0,4,4
3,2025-05-25T06:25:00+02:00,2025-05-25,14:25,22,21,43
3,2025-05-25T06:26:00+02:00,2025-05-25,14:26,16,17,33
3,2025-05-25T06:27:00+02:00,2025-05-25,14:27,7,44,51
3,2025-05-25T06:29:00+02:00,2025-05-25,14:29,26,17,43
3,2025-05-25T06:33:00+02:00,2025-05-25,14:33,8,27,35
3,2025-05-25T06:36:00+02:00,2025-05-25,14:36,12,22,34
3,2025-05-25T06:37:00+02:00,2025-05-25,14:37,31,25,56
3,2025-05-25T06:39:00+02:00,2025-05-25,14:39,14,21,35
4,2025-05-25T06:31:00+02:00,2025-05-25,14:31,29,25,54
4,2025-05-25T06:33:00+02:00,2025-05-25,14:33,23,23,46
4,2025-05-25T06:39:00+02:00,2025-05-25,14:39,16,37,53
5,2025-05-25T06:30:00+02:00,2025-05-25,14:30,98,96,194
6,2025-05-25T06:29:00+02:00,2025-05-25,14:29,16,16,32
8,2025-05-25T06:27:00+02:00,2025-05-25,14:27,1,2,3
8,2025-05-25T06:28:00+02:00,2025-05-25,14:28,8,4,12
8,2025-05-25T06:29:00+02:00,2025-05-25,14:29,4,12,16
8,2025-05-25T06:33:00+02:00,2025-05-25,14:33,2,0,2
8,2025-05-25T06:38:00+02:00,2025-05-25,14:38,2,5,7
8,2025-05-25T06:39:00+02:00,2025-05-25,14:39,2,7,9
28,2025-05-25T06:27:00+02:00,2025-05-25,14:27,6,4,10
28,2025-05-25T06:29:00+02:00,2025-05-25,14:29,5,11,16
28,2025-05-25T06:32:00+02:00,2025-05-25,14:32,9,10,19
28,2025-05-25T06:33:00+02:00,2025-05-25,14:33,11,14,25
28,2025-05-25T06:35:00+02:00,2025-05-25,14:35,7,12,19
28,2025-05-25T06:36:00+02:00,2025-05-25,14:36,14,8,22
29,2025-05-25T06:28:00+02:00,2025-05-25,14:28,24,5,29
29,2025-05-25T06:34:00+02:00,2025-05-25,14:34,14,6,20
29,2025-05-25T06:39:00+02:00,2025-05-25,14:39,7,11,18
31,2025-05-25T06:26:00+02:00,2025-05-25,14:26,4,2,6
31,2025-05-25T06:31:00+02:00,2025-05-25,14:31,7,0,7
31,2025-05-25T06:32:00+02:00,2025-05-25,14:32,11,5,16
31,2025-05-25T06:39:00+02:00,2025-05-25,14:39,1,6,7
36,2025-05-25T06:26:00+02:00,2025-05-25,14:26,3,1,4
36,2025-05-25T06:31:00+02:00,2025-05-25,14:31,3,1,4
36,2025-05-25T06:38:00+02:00,2025-05-25,14:38,0,3,3
36,2025-05-25T06:39:00+02:00,2025-05-25,14:39,2,0,2
39,2025-05-25T06:28:00+02:00,2025-05-25,14:28,1,0,1
39,2025-05-25T06:30:00+02:00,2025-05-25,14:30,0,5,5
39,2025-05-25T06:33:00+02:00,2025-05-25,14:33,2,0,2
39,2025-05-25T06:34:00+02:00,2025-05-25,14:34,0,2,2
40,2025-05-25T06:28:00+02:00,2025-05-25,14:28,1,2,3
40,2025-05-25T06:29:00+02:00,2025-05-25,14:29,2,9,11
40,2025-05-25T06:30:00+02:00,2025-05-25,14:30,2,1,3
40,2025-05-25T06:34:00+02:00,2025-05-25,14:34,2,0,2
40,2025-05-25T06:35:00+02:00,2025-05-25,14:35,1,2,3
40,2025-05-25T06:37:00+02:00,2025-05-25,14:37,1,4,5
40,2025-05-25T06:39:00+02:00,2025-05-25,14:39,1,3,4
41,2025-05-25T06:25:00+02:00,2025-05-25,14:25,5,2,7
41,2025-05-25T06:26:00+02:00,2025-05-25,14:26,3,7,10
41,2025-05-25T06:34:00+02:00,2025-05-25,14:34,8,12,20
41,2025-05-25T06:39:00+02:00,2025-05-25,14:39,8,7,15
43,2025-05-25T06:30:00+02:00,2025-05-25,14:30,4,4,8
44,2025-05-25T06:25:00+02:00,2025-05-25,14:25,2,3,5
44,2025-05-25T06:30:00+02:00,2025-05-25,14:30,2,6,8
44,2025-05-25T06:35:00+02:00,2025-05-25,14:35,7,6,13
45,2025-05-25T06:26:00+02:00,2025-05-25,14:26,5,20,25
45,2025-05-25T06:27:00+02:00,2025-05-25,14:27,28,30,58
45,2025-05-25T06:28:00+02:00,2025-05-25,14:28,20,14,34
45,2025-05-25T06:31:00+02:00,2025-05-25,14:31,13,8,21
45,2025-05-25T06:33:00+02:00,2025-05-25,14:33,12,14,26
45,2025-05-25T06:34:00+02:00,2025-05-25,14:34,14,14,28
47,2025-05-25T06:25:00+02:00,2025-05-25,14:25,24,25,49
47,2025-05-25T06:32:00+02:00,2025-05-25,14:32,7,15,22
47,2025-05-25T06:33:00+02:00,2025-05-25,14:33,21,21,42
47,2025-05-25T06:34:00+02:00,2025-05-25,14:34,6,35,41
47,2025-05-25T06:38:00+02:00,2025-05-25,14:38,21,12,33
50,2025-05-25T06:25:00+02:00,2025-05-25,14:25,6,1,7
50,2025-05-25T06:32:00+02:00,2025-05-25,14:32,7,5,12
50,2025-05-25T06:34:00+02:00,2025-05-25,14:34,5,0,5
50,2025-05-25T06:35:00+02:00,2025-05-25,14:35,2,0,2
50,2025-05-25T06:39:00+02:00,2025-05-25,14:39,3,3,6
54,2025-05-25T06:25:00+02:00,2025-05-25,14:25,0,1,1
54,2025-05-25T06:26:00+02:00,2025-05-25,14:26,8,0,8
54,2025-05-25T06:28:00+02:00,2025-05-25,14:28,5,0,5
54,2025-05-25T06:35:00+02:00,2025-05-25,14:35,5,3,8
54,2025-05-25T06:39:00+02:00,2025-05-25,14:39,2,6,8
61,2025-05-25T06:25:00+02:00,2025-05-25,14:25,10,10,20
61,2025-05-25T06:33:00+02:00,2025-05-25,14:33,12,3,15
61,2025-05-25T06:34:00+02:00,2025-05-25,14:34,9,8,17
61,2025-05-25T06:36:00+02:00,2025-05-25,14:36,7,8,15
61,2025-05-25T06:38:00+02:00,2025-05-25,14:38,8,11,19
66,2025-05-25T06:25:00+02:00,2025-05-25,14:25,22,28,50
66,2025-05-25T06:33:00+02:00,2025-05-25,14:33,17,30,47
66,2025-05-25T06:38:00+02:00,2025-05-25,14:38,31,25,56
69,2025-05-25T06:25:00+02:00,2025-05-25,14:25,3,4,7
69,2025-05-25T06:26:00+02:00,2025-05-25,14:26,10,0,10
69,2025-05-25T06:29:00+02:00,2025-05-25,14:29,0,2,2
69,2025-05-25T06:30:00+02:00,2025-05-25,14:30,5,5,10
69,2025-05-25T06:32:00+02:00,2025-05-25,14:32,8,5,13
69,2025-05-25T06:34:00+02:00,2025-05-25,14:34,6,4,10
69,2025-05-25T06:36:00+02:00,2025-05-25,14:36,11,6,17
70,2025-05-25T06:29:00+02:00,2025-05-25,14:29,1,4,5
70,2025-05-25T06:30:00+02:00,2025-05-25,14:30,6,4,10
70,2025-05-25T06:32:00+02:00,2025-05-25,14:32,4,1,5
70,2025-05-25T06:33:00+02:00,2025-05-25,14:33,1,2,3
70,2025-05-25T06:37:00+02:00,2025-05-25,14:37,5,3,8
75,2025-05-25T06:28:00+02:00,2025-05-25,14:28,1,1,2
77,2025-05-25T06:25:00+02:00,2025-05-25,14:25,16,11,27
78,2025-05-25T06:28:00+02:00,2025-05-25,14:28,1,2,3
78,2025-05-25T06:32:00+02:00,2025-05-25,14:32,2,1,3
78,2025-05-25T06:36:00+02:00,2025-05-25,14:36,3,0,3
78,2025-05-25T06:37:00+02:00,2025-05-25,14:37,0,2,2
84,2025-05-25T06:30:00+02:00,2025-05-25,14:30,82,115,197
87,2025-05-25T06:29:00+02:00,2025-05-25,14:29,4,0,4
87,2025-05-25T06:33:00+02:00,2025-05-25,14:33,0,3,3
87,2025-05-25T06:37:00+02:00,2025-05-25,14:37,0,3,3
107,2025-05-25T06:30:00+02:00,2025-05-25,14:30,6,12,18
108,2025-05-25T06:26:00+02:00,2025-05-25,14:26,0,6,6
108,2025-05-25T06:28:00+02:00,2025-05-25,14:28,5,2,7
108,2025-05-25T06:35:00+02:00,2025-05-25,14:35,1,0,1
108,2025-05-25T06:39:00+02:00,2025-05-25,14:39,3,4,7
118,2025-05-25T06:25:00+02:00,2025-05-25,14:25,0,5,5
118,2025-05-25T06:30:00+02:00,2025-05-25,14:30,1,4,5
124,2025-05-25T06:25:00+02:00,2025-05-25,14:25,2,0,2
124,2025-05-25T06:35:00+02:00,2025-05-25,14:35,1,4,5
132,2025-05-25T06:25:00+02:00,2025-05-25,14:25,13,15,28
133,2025-05-25T06:25:00+02:00,2025-05-25,14:25,34,39,73
140,2025-05-25T06:35:00+02:00,2025-05-25,14:35,18,6,24
165,2025-05-25T06:25:00+02:00,2025-05-25,14:25,4,3,7
165,2025-05-25T06:30:00+02:00,2025-05-25,14:30,3,2,5
166,2025-05-25T06:30:00+02:00,2025-05-25,14:30,4,4,8
167,2025-05-25T06:25:00+02:00,2025-05-25,14:25,1,4,5
179,2025-05-25T06:30:00+02:00,2025-05-25,14:30,1,8,9
1,2025-05-25T06:26:00+02:00,2025-05-25,14:26,31,32,63
1,2025-05-25T06:28:00+02:00,2025-05-25,14:28,21,18,39
1,2025-05-25T06:29:00+02:00,2025-05-25,14:29,28,27,55
1,2025-05-25T06:33:00+02:00,2025-05-25,14:33,24,28,52
1,2025-05-25T06:34:00+02:00,2025-05-25,14:34,3,0,3
1,2025-05-25T06:38:00+02:00,2025-05-25,14:38,31,32,63
2,2025-05-25T06:32:00+02:00,2025-05-25,14:32,2,8,10
2,2025-05-25T06:37:00+02:00,2025-05-25,14:37,16,13,29
9,2025-05-25T06:31:00+02:00,2025-05-25,14:31,0,3,3
9,2025-05-25T06:34:00+02:00,2025-05-25,14:34,1,2,3
9,2025-05-25T06:36:00+02:00,2025-05-25,14:36,2,0,2
10,2025-05-25T06:26:00+02:00,2025-05-25,14:26,1,0,1
10,2025-05-25T06:28:00+02:00,2025-05-25,14:28,0,1,1
10,2025-05-25T06:35:00+02:00,2025-05-25,14:35,1,1,2
10,2025-05-25T06:37:00+02:00,2025-05-25,14:37,2,1,3
11,2025-05-25T06:25:00+02:00,2025-05-25,14:25,7,2,9
11,2025-05-25T06:26:00+02:00,2025-05-25,14:26,2,0,2
11,2025-05-25T06:28:00+02:00,2025-05-25,14:28,1,0,1
11,2025-05-25T06:32:00+02:00,2025-05-25,14:32,4,1,5
11,2025-05-25T06:33:00+02:00,2025-05-25,14:33,6,2,8
11,2025-05-25T06:34:00+02:00,2025-05-25,14:34,14,0,14
11,2025-05-25T06:35:00+02:00,2025-05-25,14:35,14,2,16
11,2025-05-25T06:38:00+02:00,2025-05-25,14:38,1,2,3
11,2025-05-25T06:39:00+02:00,2025-05-25,14:39,1,3,4
12,2025-05-25T06:25:00+02:00,2025-05-25,14:25,5,3,8
12,2025-05-25T06:27:00+02:00,2025-05-25,14:27,2,3,5
12,2025-05-25T06:29:00+02:00,2025-05-25,14:29,5,1,6
12,2025-05-25T06:30:00+02:00,2025-05-25,14:30,2,0,2
12,2025-05-25T06:31:00+02:00,2025-05-25,14:31,9,7,16
12,2025-05-25T06:36:00+02:00,2025-05-25,14:36,7,4,11
12,2025-05-25T06:39:00+02:00,2025-05-25,14:39,8,3,11
17,2025-05-25T06:30:00+02:00,2025-05-25,14:30,2,1,3
17,2025-05-25T06:32:00+02:00,2025-05-25,14:32,3,4,7
17,2025-05-25T06:35:00+02:00,2025-05-25,14:35,1,0,1
17,2025-05-25T06:36:00+02:00,2025-05-25,14:36,3,0,3
17,2025-05-25T06:38:00+02:00,2025-05-25,14:38,2,1,3
18,2025-05-25T06:29:00+02:00,2025-05-25,14:29,1,0,1
18,2025-05-25T06:30:00+02:00,2025-05-25,14:30,4,1,5
18,2025-05-25T06:33:00+02:00,2025-05-25,14:33,0,1,1
18,2025-05-25T06:38:00+02:00,2025-05-25,14:38,4,1,5
19,2025-05-25T06:25:00+02:00,2025-05-25,14:25,17,8,25
19,2025-05-25T06:26:00+02:00,2025-05-25,14:26,1,15,16
19,2025-05-25T06:27:00+02:00,2025-05-25,14:27,7,8,15
19,2025-05-25T06:29:00+02:00,2025-05-25,14:29,3,18,21
19,2025-05-25T06:31:00+02:00,2025-05-25,14:31,15,12,27
19,2025-05-25T06:34:00+02:00,2025-05-25,14:34,8,8,16
19,2025-05-25T06:37:00+02:00,2025-05-25,14:37,12,16,28
19,2025-05-25T06:39:00+02:00,2025-05-25,14:39,27,8,35
20,2025-05-25T06:27:00+02:00,2025-05-25,14:27,7,9,16
20,2025-05-25T06:29:00+02:00,2025-05-25,14:29,11,6,17
20,2025-05-25T06:30:00+02:00,2025-05-25,14:30,5,7,12
20,2025-05-25T06:31:00+02:00,2025-05-25,14:31,2,6,8
20,2025-05-25T06:39:00+02:00,2025-05-25,14:39,16,3,19
23,2025-05-25T06:30:00+02:00,2025-05-25,14:30,2,2,4
23,2025-05-25T06:32:00+02:00,2025-05-25,14:32,3,11,14
23,2025-05-25T06:39:00+02:00,2025-05-25,14:39,2,0,2
24,2025-05-25T06:27:00+02:00,2025-05-25,14:27,9,17,26
24,2025-05-25T06:29:00+02:00,2025-05-25,14:29,13,7,20
24,2025-05-25T06:31:00+02:00,2025-05-25,14:31,3,17,20
24,2025-05-25T06:39:00+02:00,2025-05-25,14:39,4,23,27
27,2025-05-25T06:27:00+02:00,2025-05-25,14:27,2,1,3
27,2025-05-25T06:31:00+02:00,2025-05-25,14:31,6,2,8
27,2025-05-25T06:39:00+02:00,2025-05-25,14:39,2,2,4
30,2025-05-25T06:25:00+02:00,2025-05-25,14:25,10,5,15
30,2025-05-25T06:27:00+02:00,2025-05-25,14:27,7,8,15
30,2025-05-25T06:28:00+02:00,2025-05-25,14:28,0,6,6
30,2025-05-25T06:33:00+02:00,2025-05-25,14:33,5,5,10
30,2025-05-25T06:36:00+02:00,2025-05-25,14:36,8,8,16
30,2025-05-25T06:38:00+02:00,2025-05-25,14:38,0,11,11
30,2025-05-25T06:39:00+02:00,2025-05-25,14:39,7,4,11
35,2025-05-25T06:26:00+02:00,2025-05-25,14:26,33,19,52
35,2025-05-25T06:32:00+02:00,2025-05-25,14:32,14,32,46
35,2025-05-25T06:37:00+02:00,2025-05-25,14:37,37,17,54
35,2025-05-25T06:38:00+02:00,2025-05-25,14:38,19,10,29
35,2025-05-25T06:39:00+02:00,2025-05-25,14:39,18,21,39
48,2025-05-25T06:25:00+02:00,2025-05-25,14:25,11,13,24
48,2025-05-25T06:28:00+02:00,2025-05-25,14:28,13,9,22
49,2025-05-25T06:28:00+02:00,2025-05-25,14:28,7,4,11
49,2025-05-25T06:31:00+02:00,2025-05-25,14:31,4,6,10
49,2025-05-25T06:32:00+02:00,2025-05-25,14:32,16,9,25
49,2025-05-25T06:35:00+02:00,2025-05-25,14:35,19,10,29
49,2025-05-25T06:39:00+02:00,2025-05-25,14:39,7,4,11
51,2025-05-25T06:27:00+02:00,2025-05-25,14:27,0,2,2
51,2025-05-25T06:28:00+02:00,2025-05-25,14:28,1,4,5
51,2025-05-25T06:30:00+02:00,2025-05-25,14:30,1,0,1
51,2025-05-25T06:33:00+02:00,2025-05-25,14:33,6,3,9
51,2025-05-25T06:34:00+02:00,2025-05-25,14:34,1,4,5
52,2025-05-25T06:32:00+02:00,2025-05-25,14:32,4,2,6
52,2025-05-25T06:33:00+02:00,2025-05-25,14:33,5,9,14
52,2025-05-25T06:36:00+02:00,2025-05-25,14:36,3,9,12
52,2025-05-25T06:37:00+02:00,2025-05-25,14:37,11,6,17
53,2025-05-25T06:27:00+02:00,2025-05-25,14:27,11,7,18
53,2025-05-25T06:28:00+02:00,2025-05-25,14:28,10,3,13
53,2025-05-25T06:29:00+02:00,2025-05-25,14:29,12,9,21
53,2025-05-25T06:30:00+02:00,2025-05-25,14:30,10,6,16
53,2025-05-25T06:31:00+02:00,2025-05-25,14:31,14,6,20
56,2025-05-25T06:28:00+02:00,2025-05-25,14:28,7,9,16
56,2025-05-25T06:32:00+02:00,2025-05-25,14:32,10,15,25
56,2025-05-25T06:34:00+02:00,2025-05-25,14:34,11,9,20
56,2025-05-25T06:35:00+02:00,2025-05-25,14:35,7,4,11
56,2025-05-25T06:36:00+02:00,2025-05-25,14:36,9,8,17
56,2025-05-25T06:37:00+02:00,2025-05-25,14:37,8,1,9
56,2025-05-25T06:38:00+02:00,2025-05-25,14:38,16,5,21
56,2025-05-25T06:39:00+02:00,2025-05-25,14:39,8,1,9
58,2025-05-25T06:26:00+02:00,2025-05-25,14:26,8,1,9
58,2025-05-25T06:29:00+02:00,2025-05-25,14:29,10,11,21
58,2025-05-25T06:30:00+02:00,2025-05-25,14:30,5,8,13
58,2025-05-25T06:31:00+02:00,2025-05-25,14:31,1,3,4
58,2025-05-25T06:32:00+02:00,2025-05-25,14:32,16,1,17
58,2025-05-25T06:34:00+02:00,2025-05-25,14:34,4,4,8
58,2025-05-25T06:36:00+02:00,2025-05-25,14:36,13,1,14
62,2025-05-25T06:25:00+02:00,2025-05-25,14:25,1,9,10
62,2025-05-25T06:26:00+02:00,2025-05-25,14:26,5,1,6
62,2025-05-25T06:27:00+02:00,2025-05-25,14:27,3,1,4
62,2025-05-25T06:28:00+02:00,2025-05-25,14:28,3,3,6
62,2025-05-25T06:29:00+02:00,2025-05-25,14:29,6,3,9
62,2025-05-25T06:30:00+02:00,2025-05-25,14:30,7,4,11
62,2025-05-25T06:31:00+02:00,2025-05-25,14:31,11,4,15
62,2025-05-25T06:33:00+02:00,2025-05-25,14:33,2,1,3
63,2025-05-25T06:33:00+02:00,2025-05-25,14:33,11,5,16
63,2025-05-25T06:37:00+02:00,2025-05-25,14:37,5,4,9
67,2025-05-25T06:30:00+02:00,2025-05-25,14:30,5,12,17
67,2025-05-25T06:35:00+02:00,2025-05-25,14:35,9,9,18
68,2025-05-25T06:26:00+02:00,2025-05-25,14:26,8,3,11
68,2025-05-25T06:33:00+02:00,2025-05-25,14:33,6,8,14
68,2025-05-25T06:34:00+02:00,2025-05-25,14:34,5,5,10
68,2025-05-25T06:35:00+02:00,2025-05-25,14:35,5,3,8
68,2025-05-25T06:37:00+02:00,2025-05-25,14:37,8,2,10
68,2025-05-25T06:38:00+02:00,2025-05-25,14:38,15,5,20
72,2025-05-25T06:27:00+02:00,2025-05-25,14:27,13,9,22
72,2025-05-25T06:31:00+02:00,2025-05-25,14:31,9,15,24
72,2025-05-25T06:34:00+02:00,2025-05-25,14:34,3,11,14
72,2025-05-25T06:37:00+02:00,2025-05-25,14:37,5,18,23
72,2025-05-25T06:38:00+02:00,2025-05-25,14:38,0,13,13
76,2025-05-25T06:30:00+02:00,2025-05-25,14:30,1,2,3
76,2025-05-25T06:31:00+02:00,2025-05-25,14:31,1,0,1
76,2025-05-25T06:36:00+02:00,2025-05-25,14:36,0,3,3
76,2025-05-25T06:37:00+02:00,2025-05-25,14:37,1,2,3
76,2025-05-25T06:38:00+02:00,2025-05-25,14:38,0,2,2
79,2025-05-25T06:26:00+02:00,2025-05-25,14:26,17,7,24
79,2025-05-25T06:29:00+02:00,2025-05-25,14:29,30,4,34
79,2025-05-25T06:32:00+02:00,2025-05-25,14:32,21,1,22
79,2025-05-25T06:35:00+02:00,2025-05-25,14:35,14,14,28
79,2025-05-25T06:36:00+02:00,2025-05-25,14:36,8,9,17
79,2025-05-25T06:37:00+02:00,2025-05-25,14:37,13,18,31
79,2025-05-25T06:39:00+02:00,2025-05-25,14:39,7,11,18
85,2025-05-25T06:28:00+02:00,2025-05-25,14:28,0,2,2
85,2025-05-25T06:32:00+02:00,2025-05-25,14:32,3,5,8
85,2025-05-25T06:39:00+02:00,2025-05-25,14:39,2,0,2
86,2025-05-25T06:27:00+02:00,2025-05-25,14:27,4,3,7
86,2025-05-25T06:39:00+02:00,2025-05-25,14:39,1,1,2
109,2025-05-25T06:30:00+02:00,2025-05-25,14:30,11,6,17
123,2025-05-25T06:30:00+02:00,2025-05-25,14:30,17,3,20
137,2025-05-25T06:25:00+02:00,2025-05-25,14:25,3,3,6
137,2025-05-25T06:30:00+02:00,2025-05-25,14:30,0,3,3
137,2025-05-25T06:35:00+02:00,2025-05-25,14:35,1,2,3
139,2025-05-25T06:25:00+02:00,2025-05-25,14:25,14,11,25
142,2025-05-25T06:25:00+02:00,2025-05-25,14:25,75,55,130
142,2025-05-25T06:35:00+02:00,2025-05-25,14:35,73,42,115
181,2025-05-25T06:41:00+02:00,2025-05-25,14:41,6,37,43
181,2025-05-25T06:47:00+02:00,2025-05-25,14:47,7,26,33
181,2025-05-25T06:48:00+02:00,2025-05-25,14:48,13,21,34
181,2025-05-25T06:49:00+02:00,2025-05-25,14:49,8,38,46
181,2025-05-25T06:54:00+02:00,2025-05-25,14:54,12,15,27
182,2025-05-25T06:45:00+02:00,2025-05-25,14:45,10,17,27
180,2025-05-25T06:44:00+02:00,2025-05-25,14:44,1,3,4
3,2025-05-25T06:43:00+02:00,2025-05-25,14:43,26,22,48
3,2025-05-25T06:45:00+02:00,2025-05-25,14:45,15,14,29
3,2025-05-25T06:46:00+02:00,2025-05-25,14:46,17,19,36
3,2025-05-25T06:54:00+02:00,2025-05-25,14:54,25,23,48
4,2025-05-25T06:40:00+02:00,2025-05-25,14:40,16,29,45
4,2025-05-25T06:41:00+02:00,2025-05-25,14:41,37,29,66
4,2025-05-25T06:42:00+02:00,2025-05-25,14:42,19,21,40
4,2025-05-25T06:44:00+02:00,2025-05-25,14:44,36,40,76
4,2025-05-25T06:45:00+02:00,2025-05-25,14:45,56,43,99
4,2025-05-25T06:46:00+02:00,2025-05-25,14:46,25,35,60
5,2025-05-25T06:45:00+02:00,2025-05-25,14:45,107,72,179
6,2025-05-25T06:40:00+02:00,2025-05-25,14:40,16,13,29
6,2025-05-25T06:47:00+02:00,2025-05-25,14:47,16,18,34
6,2025-05-25T06:51:00+02:00,2025-05-25,14:51,6,21,27
8,2025-05-25T06:40:00+02:00,2025-05-25,14:40,7,8,15
8,2025-05-25T06:42:00+02:00,2025-05-25,14:42,2,5,7
8,2025-05-25T06:46:00+02:00,2025-05-25,14:46,0,3,3
8,2025-05-25T06:49:00+02:00,2025-05-25,14:49,2,14,16
28,2025-05-25T06:42:00+02:00,2025-05-25,14:42,17,2,19
28,2025-05-25T06:48:00+02:00,2025-05-25,14:48,6,13,19
28,2025-05-25T06:54:00+02:00,2025-05-25,14:54,5,5,10
29,2025-05-25T06:43:00+02:00,2025-05-25,14:43,11,9,20
29,2025-05-25T06:44:00+02:00,2025-05-25,14:44,19,22,41
29,2025-05-25T06:46:00+02:00,2025-05-25,14:46,9,11,20
29,2025-05-25T06:50:00+02:00,2025-05-25,14:50,4,10,14
29,2025-05-25T06:51:00+02:00,2025-05-25,14:51,4,13,17
29,2025-05-25T06:52:00+02:00,2025-05-25,14:52,9,14,23
31,2025-05-25T06:41:00+02:00,2025-05-25,14:41,4,2,6
31,2025-05-25T06:45:00+02:00,2025-05-25,14:45,6,4,10
31,2025-05-25T06:47:00+02:00,2025-05-25,14:47,3,0,3
31,2025-05-25T06:49:00+02:00,2025-05-25,14:49,1,5,6
31,2025-05-25T06:50:00+02:00,2025-05-25,14:50,1,7,8
31,2025-05-25T06:54:00+02:00,2025-05-25,14:54,3,5,8
36,2025-05-25T06:40:00+02:00,2025-05-25,14:40,2,1,3
36,2025-05-25T06:41:00+02:00,2025-05-25,14:41,0,4,4
36,2025-05-25T06:48:00+02:00,2025-05-25,14:48,1,0,1
36,2025-05-25T06:50:00+02:00,2025-05-25,14:50,1,2,3
39,2025-05-25T06:40:00+02:00,2025-05-25,14:40,0,1,1
39,2025-05-25T06:42:00+02:00,2025-05-25,14:42,2,3,5
39,2025-05-25T06:45:00+02:00,2025-05-25,14:45,2,0,2
39,2025-05-25T06:49:00+02:00,2025-05-25,14:49,0,1,1
39,2025-05-25T06:51:00+02:00,2025-05-25,14:51,1,2,3
39,2025-05-25T06:54:00+02:00,2025-05-25,14:54,1,3,4
40,2025-05-25T06:40:00+02:00,2025-05-25,14:40,3,3,6
40,2025-05-25T06:43:00+02:00,2025-05-25,14:43,9,0,9
40,2025-05-25T06:53:00+02:00,2025-05-25,14:53,2,3,5
41,2025-05-25T06:41:00+02:00,2025-05-25,14:41,15,8,23
41,2025-05-25T06:43:00+02:00,2025-05-25,14:43,25,6,31
41,2025-05-25T06:46:00+02:00,2025-05-25,14:46,13,19,32
41,2025-05-25T06:50:00+02:00,2025-05-25,14:50,10,12,22
41,2025-05-25T06:51:00+02:00,2025-05-25,14:51,7,3,10
41,2025-05-25T06:54:00+02:00,2025-05-25,14:54,3,11,14
43,2025-05-25T06:45:00+02:00,2025-05-25,14:45,14,5,19
44,2025-05-25T06:45:00+02:00,2025-05-25,14:45,10,1,11
45,2025-05-25T06:43:00+02:00,2025-05-25,14:43,9,24,33
45,2025-05-25T06:47:00+02:00,2025-05-25,14:47,20,25,45
45,2025-05-25T06:49:00+02:00,2025-05-25,14:49,11,32,43
45,2025-05-25T06:50:00+02:00,2025-05-25,14:50,18,36,54
45,2025-05-25T06:53:00+02:00,2025-05-25,14:53,20,16,36
47,2025-05-25T06:43:00+02:00,2025-05-25,14:43,18,20,38
47,2025-05-25T06:48:00+02:00,2025-05-25,14:48,27,7,34
47,2025-05-25T06:49:00+02:00,2025-05-25,14:49,21,22,43
47,2025-05-25T06:50:00+02:00,2025-05-25,14:50,22,11,33
50,2025-05-25T06:45:00+02:00,2025-05-25,14:45,13,3,16
50,2025-05-25T06:46:00+02:00,2025-05-25,14:46,5,4,9
50,2025-05-25T06:48:00+02:00,2025-05-25,14:48,4,2,6
50,2025-05-25T06:51:00+02:00,2025-05-25,14:51,2,2,4
50,2025-05-25T06:52:00+02:00,2025-05-25,14:52,4,3,7
50,2025-05-25T06:53:00+02:00,2025-05-25,14:53,2,3,5
54,2025-05-25T06:41:00+02:00,2025-05-25,14:41,4,3,7
54,2025-05-25T06:46:00+02:00,2025-05-25,14:46,0,1,1
54,2025-05-25T06:49:00+02:00,2025-05-25,14:49,1,1,2
59,2025-05-25T06:45:00+02:00,2025-05-25,14:45,21,34,55
61,2025-05-25T06:40:00+02:00,2025-05-25,14:40,6,10,16
61,2025-05-25T06:43:00+02:00,2025-05-25,14:43,8,1,9
61,2025-05-25T06:45:00+02:00,2025-05-25,14:45,11,11,22
61,2025-05-25T06:47:00+02:00,2025-05-25,14:47,11,6,17
61,2025-05-25T06:51:00+02:00,2025-05-25,14:51,9,10,19
61,2025-05-25T06:52:00+02:00,2025-05-25,14:52,7,8,15
61,2025-05-25T06:54:00+02:00,2025-05-25,14:54,9,6,15
66,2025-05-25T06:40:00+02:00,2025-05-25,14:40,24,17,41
66,2025-05-25T06:43:00+02:00,2025-05-25,14:43,26,37,63
66,2025-05-25T06:44:00+02:00,2025-05-25,14:44,21,18,39
66,2025-05-25T06:48:00+02:00,2025-05-25,14:48,40,24,64
66,2025-05-25T06:49:00+02:00,2025-05-25,14:49,17,25,42
69,2025-05-25T06:40:00+02:00,2025-05-25,14:40,4,2,6
69,2025-05-25T06:47:00+02:00,2025-05-25,14:47,0,2,2
69,2025-05-25T06:48:00+02:00,2025-05-25,14:48,4,5,9
69,2025-05-25T06:51:00+02:00,2025-05-25,14:51,4,7,11
70,2025-05-25T06:43:00+02:00,2025-05-25,14:43,2,2,4
70,2025-05-25T06:44:00+02:00,2025-05-25,14:44,3,1,4
70,2025-05-25T06:48:00+02:00,2025-05-25,14:48,5,0,5
70,2025-05-25T06:49:00+02:00,2025-05-25,14:49,1,2,3
75,2025-05-25T06:43:00+02:00,2025-05-25,14:43,2,2,4
75,2025-05-25T06:47:00+02:00,2025-05-25,14:47,2,2,4
75,2025-05-25T06:48:00+02:00,2025-05-25,14:48,1,7,8
75,2025-05-25T06:53:00+02:00,2025-05-25,14:53,0,2,2
75,2025-05-25T06:54:00+02:00,2025-05-25,14:54,1,0,1
77,2025-05-25T06:50:00+02:00,2025-05-25,14:50,11,28,39
78,2025-05-25T06:41:00+02:00,2025-05-25,14:41,1,1,2
78,2025-05-25T06:42:00+02:00,2025-05-25,14:42,2,0,2
78,2025-05-25T06:43:00+02:00,2025-05-25,14:43,3,0,3
78,2025-05-25T06:44:00+02:00,2025-05-25,14:44,1,1,2
78,2025-05-25T06:47:00+02:00,2025-05-25,14:47,0,1,1
78,2025-05-25T06:49:00+02:00,2025-05-25,14:49,3,0,3
78,2025-05-25T06:53:00+02:00,2025-05-25,14:53,0,4,4
78,2025-05-25T06:54:00+02:00,2025-05-25,14:54,2,0,2
87,2025-05-25T06:45:00+02:00,2025-05-25,14:45,3,1,4
87,2025-05-25T06:47:00+02:00,2025-05-25,14:47,3,1,4
87,2025-05-25T06:49:00+02:00,2025-05-25,14:49,2,1,3
87,2025-05-25T06:53:00+02:00,2025-05-25,14:53,2,0,2
107,2025-05-25T06:40:00+02:00,2025-05-25,14:40,2,10,12
107,2025-05-25T06:45:00+02:00,2025-05-25,14:45,13,14,27
108,2025-05-25T06:40:00+02:00,2025-05-25,14:40,2,9,11
108,2025-05-25T06:41:00+02:00,2025-05-25,14:41,1,4,5
108,2025-05-25T06:42:00+02:00,2025-05-25,14:42,1,5,6
108,2025-05-25T06:43:00+02:00,2025-05-25,14:43,0,2,2
108,2025-05-25T06:44:00+02:00,2025-05-25,14:44,1,0,1
108,2025-05-25T06:46:00+02:00,2025-05-25,14:46,0,5,5
108,2025-05-25T06:49:00+02:00,2025-05-25,14:49,1,0,1
108,2025-05-25T06:50:00+02:00,2025-05-25,14:50,2,1,3
108,2025-05-25T06:52:00+02:00,2025-05-25,14:52,2,8,10
108,2025-05-25T06:53:00+02:00,2025-05-25,14:53,1,4,5
131,2025-05-25T06:40:00+02:00,2025-05-25,14:40,24,13,37
131,2025-05-25T06:50:00+02:00,2025-05-25,14:50,10,2,12
132,2025-05-25T06:50:00+02:00,2025-05-25,14:50,18,9,27
133,2025-05-25T06:50:00+02:00,2025-05-25,14:50,41,23,64
134,2025-05-25T06:50:00+02:00,2025-05-25,14:50,51,29,80
135,2025-05-25T06:50:00+02:00,2025-05-25,14:50,40,39,79
162,2025-05-25T06:50:00+02:00,2025-05-25,14:50,22,16,38
165,2025-05-25T06:50:00+02:00,2025-05-25,14:50,5,2,7
179,2025-05-25T06:40:00+02:00,2025-05-25,14:40,5,5,10
1,2025-05-25T06:41:00+02:00,2025-05-25,14:41,26,23,49
1,2025-05-25T06:42:00+02:00,2025-05-25,14:42,29,26,55
1,2025-05-25T06:49:00+02:00,2025-05-25,14:49,24,18,42
1,2025-05-25T06:51:00+02:00,2025-05-25,14:51,14,20,34
1,2025-05-25T06:53:00+02:00,2025-05-25,14:53,27,22,49
2,2025-05-25T06:42:00+02:00,2025-05-25,14:42,16,16,32
2,2025-05-25T06:45:00+02:00,2025-05-25,14:45,8,14,22
2,2025-05-25T06:46:00+02:00,2025-05-25,14:46,14,5,19
2,2025-05-25T06:48:00+02:00,2025-05-25,14:48,11,13,24
2,2025-05-25T06:52:00+02:00,2025-05-25,14:52,9,18,27
2,2025-05-25T06:53:00+02:00,2025-05-25,14:53,10,21,31
9,2025-05-25T06:44:00+02:00,2025-05-25,14:44,1,1,2
9,2025-05-25T06:50:00+02:00,2025-05-25,14:50,0,4,4
9,2025-05-25T06:54:00+02:00,2025-05-25,14:54,1,0,1
10,2025-05-25T06:47:00+02:00,2025-05-25,14:47,1,0,1
10,2025-05-25T06:50:00+02:00,2025-05-25,14:50,2,3,5
10,2025-05-25T06:52:00+02:00,2025-05-25,14:52,3,1,4
10,2025-05-25T06:54:00+02:00,2025-05-25,14:54,1,4,5
11,2025-05-25T06:40:00+02:00,2025-05-25,14:40,8,6,14
11,2025-05-25T06:43:00+02:00,2025-05-25,14:43,0,2,2
11,2025-05-25T06:45:00+02:00,2025-05-25,14:45,7,7,14
11,2025-05-25T06:47:00+02:00,2025-05-25,14:47,3,3,6
11,2025-05-25T06:50:00+02:00,2025-05-25,14:50,10,3,13
11,2025-05-25T06:52:00+02:00,2025-05-25,14:52,7,1,8
11,2025-05-25T06:53:00+02:00,2025-05-25,14:53,0,2,2
12,2025-05-25T06:49:00+02:00,2025-05-25,14:49,6,7,13
12,2025-05-25T06:50:00+02:00,2025-05-25,14:50,8,5,13
12,2025-05-25T06:53:00+02:00,2025-05-25,14:53,7,4,11
12,2025-05-25T06:54:00+02:00,2025-05-25,14:54,14,7,21
17,2025-05-25T06:42:00+02:00,2025-05-25,14:42,0,1,1
17,2025-05-25T06:51:00+02:00,2025-05-25,14:51,0,6,6
18,2025-05-25T06:42:00+02:00,2025-05-25,14:42,4,0,4
18,2025-05-25T06:52:00+02:00,2025-05-25,14:52,3,2,5
18,2025-05-25T06:54:00+02:00,2025-05-25,14:54,2,0,2
19,2025-05-25T06:41:00+02:00,2025-05-25,14:41,9,18,27
19,2025-05-25T06:45:00+02:00,2025-05-25,14:45,3,19,22
19,2025-05-25T06:47:00+02:00,2025-05-25,14:47,20,14,34
19,2025-05-25T06:51:00+02:00,2025-05-25,14:51,9,5,14
20,2025-05-25T06:41:00+02:00,2025-05-25,14:41,11,7,18
20,2025-05-25T06:43:00+02:00,2025-05-25,14:43,4,8,12
20,2025-05-25T06:45:00+02:00,2025-05-25,14:45,2,4,6
20,2025-05-25T06:46:00+02:00,2025-05-25,14:46,1,5,6
20,2025-05-25T06:50:00+02:00,2025-05-25,14:50,4,5,9
20,2025-05-25T06:51:00+02:00,2025-05-25,14:51,12,13,25
20,2025-05-25T06:53:00+02:00,2025-05-25,14:53,4,11,15
23,2025-05-25T06:40:00+02:00,2025-05-25,14:40,1,1,2
23,2025-05-25T06:48:00+02:00,2025-05-25,14:48,3,1,4
24,2025-05-25T06:51:00+02:00,2025-05-25,14:51,5,5,10
24,2025-05-25T06:54:00+02:00,2025-05-25,14:54,0,19,19
27,2025-05-25T06:40:00+02:00,2025-05-25,14:40,10,1,11
27,2025-05-25T06:41:00+02:00,2025-05-25,14:41,5,3,8
27,2025-05-25T06:48:00+02:00,2025-05-25,14:48,7,12,19
27,2025-05-25T06:50:00+02:00,2025-05-25,14:50,4,3,7
27,2025-05-25T06:53:00+02:00,2025-05-25,14:53,0,2,2
27,2025-05-25T06:54:00+02:00,2025-05-25,14:54,8,7,15
30,2025-05-25T06:42:00+02:00,2025-05-25,14:42,4,3,7
30,2025-05-25T06:49:00+02:00,2025-05-25,14:49,6,3,9
30,2025-05-25T06:50:00+02:00,2025-05-25,14:50,5,13,18
30,2025-05-25T06:54:00+02:00,2025-05-25,14:54,5,4,9
35,2025-05-25T06:40:00+02:00,2025-05-25,14:40,27,14,41
35,2025-05-25T06:44:00+02:00,2025-05-25,14:44,17,33,50
35,2025-05-25T06:45:00+02:00,2025-05-25,14:45,17,12,29
35,2025-05-25T06:47:00+02:00,2025-05-25,14:47,28,24,52
35,2025-05-25T06:49:00+02:00,2025-05-25,14:49,17,40,57
35,2025-05-25T06:53:00+02:00,2025-05-25,14:53,21,33,54
46,2025-05-25T06:40:00+02:00,2025-05-25,14:40,6,5,11
46,2025-05-25T06:45:00+02:00,2025-05-25,14:45,6,5,11
48,2025-05-25T06:40:00+02:00,2025-05-25,14:40,10,2,12
48,2025-05-25T06:47:00+02:00,2025-05-25,14:47,14,6,20
48,2025-05-25T06:50:00+02:00,2025-05-25,14:50,11,7,18
49,2025-05-25T06:43:00+02:00,2025-05-25,14:43,3,9,12
49,2025-05-25T06:52:00+02:00,2025-05-25,14:52,0,6,6
49,2025-05-25T06:53:00+02:00,2025-05-25,14:53,6,7,13
51,2025-05-25T06:41:00+02:00,2025-05-25,14:41,3,0,3
51,2025-05-25T06:51:00+02:00,2025-05-25,14:51,2,2,4
52,2025-05-25T06:40:00+02:00,2025-05-25,14:40,12,3,15
52,2025-05-25T06:42:00+02:00,2025-05-25,14:42,5,8,13
52,2025-05-25T06:43:00+02:00,2025-05-25,14:43,9,6,15
52,2025-05-25T06:48:00+02:00,2025-05-25,14:48,11,6,17
52,2025-05-25T06:49:00+02:00,2025-05-25,14:49,3,3,6
52,2025-05-25T06:54:00+02:00,2025-05-25,14:54,3,11,14
53,2025-05-25T06:41:00+02:00,2025-05-25,14:41,16,6,22
53,2025-05-25T06:44:00+02:00,2025-05-25,14:44,12,8,20
53,2025-05-25T06:47:00+02:00,2025-05-25,14:47,7,7,14
53,2025-05-25T06:49:00+02:00,2025-05-25,14:49,17,5,22
53,2025-05-25T06:51:00+02:00,2025-05-25,14:51,11,10,21
53,2025-05-25T06:54:00+02:00,2025-05-25,14:54,15,1,16
56,2025-05-25T06:42:00+02:00,2025-05-25,14:42,19,8,27
56,2025-05-25T06:46:00+02:00,2025-05-25,14:46,3,8,11
56,2025-05-25T06:47:00+02:00,2025-05-25,14:47,5,9,14
56,2025-05-25T06:48:00+02:00,2025-05-25,14:48,10,14,24
56,2025-05-25T06:51:00+02:00,2025-05-25,14:51,10,6,16
56,2025-05-25T06:52:00+02:00,2025-05-25,14:52,12,7,19
56,2025-05-25T06:53:00+02:00,2025-05-25,14:53,8,5,13
56,2025-05-25T06:54:00+02:00,2025-05-25,14:54,5,10,15
58,2025-05-25T06:40:00+02:00,2025-05-25,14:40,13,7,20
58,2025-05-25T06:41:00+02:00,2025-05-25,14:41,10,9,19
58,2025-05-25T06:42:00+02:00,2025-05-25,14:42,10,7,17
58,2025-05-25T06:44:00+02:00,2025-05-25,14:44,6,9,15
58,2025-05-25T06:48:00+02:00,2025-05-25,14:48,9,4,13
62,2025-05-25T06:43:00+02:00,2025-05-25,14:43,6,5,11
62,2025-05-25T06:50:00+02:00,2025-05-25,14:50,6,3,9
62,2025-05-25T06:53:00+02:00,2025-05-25,14:53,2,1,3
62,2025-05-25T06:54:00+02:00,2025-05-25,14:54,6,1,7
63,2025-05-25T06:46:00+02:00,2025-05-25,14:46,7,6,13
63,2025-05-25T06:51:00+02:00,2025-05-25,14:51,7,6,13
67,2025-05-25T06:40:00+02:00,2025-05-25,14:40,6,6,12
67,2025-05-25T06:47:00+02:00,2025-05-25,14:47,3,8,11
67,2025-05-25T06:50:00+02:00,2025-05-25,14:50,19,15,34
67,2025-05-25T06:53:00+02:00,2025-05-25,14:53,0,10,10
68,2025-05-25T06:40:00+02:00,2025-05-25,14:40,8,4,12
68,2025-05-25T06:43:00+02:00,2025-05-25,14:43,13,5,18
68,2025-05-25T06:45:00+02:00,2025-05-25,14:45,5,4,9
68,2025-05-25T06:46:00+02:00,2025-05-25,14:46,4,1,5
68,2025-05-25T06:49:00+02:00,2025-05-25,14:49,6,3,9
68,2025-05-25T06:50:00+02:00,2025-05-25,14:50,2,8,10
68,2025-05-25T06:51:00+02:00,2025-05-25,14:51,9,9,18
68,2025-05-25T06:52:00+02:00,2025-05-25,14:52,11,4,15
68,2025-05-25T06:54:00+02:00,2025-05-25,14:54,6,3,9
72,2025-05-25T06:40:00+02:00,2025-05-25,14:40,13,7,20
72,2025-05-25T06:46:00+02:00,2025-05-25,14:46,2,17,19
72,2025-05-25T06:47:00+02:00,2025-05-25,14:47,7,9,16
72,2025-05-25T06:48:00+02:00,2025-05-25,14:48,7,2,9
72,2025-05-25T06:51:00+02:00,2025-05-25,14:51,5,12,17
72,2025-05-25T06:52:00+02:00,2025-05-25,14:52,12,2,14
72,2025-05-25T06:53:00+02:00,2025-05-25,14:53,7,21,28
76,2025-05-25T06:44:00+02:00,2025-05-25,14:44,1,1,2
76,2025-05-25T06:46:00+02:00,2025-05-25,14:46,1,2,3
79,2025-05-25T06:40:00+02:00,2025-05-25,14:40,7,14,21
79,2025-05-25T06:41:00+02:00,2025-05-25,14:41,14,11,25
79,2025-05-25T06:45:00+02:00,2025-05-25,14:45,8,15,23
79,2025-05-25T06:47:00+02:00,2025-05-25,14:47,28,9,37
79,2025-05-25T06:53:00+02:00,2025-05-25,14:53,13,13,26
85,2025-05-25T06:41:00+02:00,2025-05-25,14:41,4,0,4
85,2025-05-25T06:46:00+02:00,2025-05-25,14:46,1,0,1
85,2025-05-25T06:48:00+02:00,2025-05-25,14:48,2,2,4
86,2025-05-25T06:43:00+02:00,2025-05-25,14:43,1,2,3
86,2025-05-25T06:48:00+02:00,2025-05-25,14:48,1,0,1
86,2025-05-25T06:52:00+02:00,2025-05-25,14:52,2,0,2
86,2025-05-25T06:53:00+02:00,2025-05-25,14:53,0,2,2
136,2025-05-25T06:40:00+02:00,2025-05-25,14:40,119,7,126
136,2025-05-25T06:45:00+02:00,2025-05-25,14:45,164,0,164
136,2025-05-25T06:50:00+02:00,2025-05-25,14:50,172,5,177
138,2025-05-25T06:50:00+02:00,2025-05-25,14:50,2,3,5
139,2025-05-25T06:40:00+02:00,2025-05-25,14:40,1,0,1
139,2025-05-25T06:45:00+02:00,2025-05-25,14:45,3,4,7
139,2025-05-25T06:50:00+02:00,2025-05-25,14:50,13,2,15
141,2025-05-25T06:40:00+02:00,2025-05-25,14:40,25,7,32
161,2025-05-25T06:50:00+02:00,2025-05-25,14:50,140,13,153
181,2025-05-25T06:59:00+02:00,2025-05-25,14:59,16,20,36
181,2025-05-25T07:02:00+02:00,2025-05-25,15:02,11,21,32
181,2025-05-25T07:03:00+02:00,2025-05-25,15:03,16,9,25
181,2025-05-25T07:07:00+02:00,2025-05-25,15:07,12,14,26
180,2025-05-25T06:55:00+02:00,2025-05-25,14:55,3,0,3
180,2025-05-25T06:58:00+02:00,2025-05-25,14:58,5,2,7
180,2025-05-25T07:05:00+02:00,2025-05-25,15:05,0,3,3
3,2025-05-25T06:55:00+02:00,2025-05-25,14:55,21,21,42
3,2025-05-25T06:56:00+02:00,2025-05-25,14:56,10,23,33
3,2025-05-25T06:58:00+02:00,2025-05-25,14:58,20,24,44
3,2025-05-25T07:00:00+02:00,2025-05-25,15:00,23,26,49
3,2025-05-25T07:07:00+02:00,2025-05-25,15:07,37,32,69
3,2025-05-25T07:08:00+02:00,2025-05-25,15:08,21,17,38
3,2025-05-25T07:09:00+02:00,2025-05-25,15:09,17,29,46
4,2025-05-25T06:56:00+02:00,2025-05-25,14:56,23,27,50
4,2025-05-25T06:57:00+02:00,2025-05-25,14:57,26,36,62
4,2025-05-25T07:00:00+02:00,2025-05-25,15:00,33,30,63
4,2025-05-25T07:01:00+02:00,2025-05-25,15:01,52,31,83
4,2025-05-25T07:03:00+02:00,2025-05-25,15:03,26,50,76
4,2025-05-25T07:04:00+02:00,2025-05-25,15:04,47,22,69
4,2025-05-25T07:05:00+02:00,2025-05-25,15:05,42,41,83
4,2025-05-25T07:06:00+02:00,2025-05-25,15:06,12,24,36
4,2025-05-25T07:07:00+02:00,2025-05-25,15:07,27,17,44
5,2025-05-25T07:05:00+02:00,2025-05-25,15:05,88,101,189
6,2025-05-25T06:57:00+02:00,2025-05-25,14:57,14,19,33
6,2025-05-25T06:58:00+02:00,2025-05-25,14:58,13,12,25
6,2025-05-25T07:02:00+02:00,2025-05-25,15:02,19,15,34
6,2025-05-25T07:08:00+02:00,2025-05-25,15:08,6,15,21
8,2025-05-25T06:58:00+02:00,2025-05-25,14:58,3,1,4
8,2025-05-25T07:05:00+02:00,2025-05-25,15:05,2,11,13
8,2025-05-25T07:06:00+02:00,2025-05-25,15:06,0,2,2
8,2025-05-25T07:08:00+02:00,2025-05-25,15:08,3,4,7
8,2025-05-25T07:09:00+02:00,2025-05-25,15:09,3,4,7
28,2025-05-25T06:58:00+02:00,2025-05-25,14:58,13,11,24
28,2025-05-25T06:59:00+02:00,2025-05-25,14:59,9,7,16
28,2025-05-25T07:00:00+02:00,2025-05-25,15:00,2,6,8
28,2025-05-25T07:01:00+02:00,2025-05-25,15:01,0,7,7
28,2025-05-25T07:02:00+02:00,2025-05-25,15:02,4,11,15
28,2025-05-25T07:04:00+02:00,2025-05-25,15:04,11,9,20
28,2025-05-25T07:07:00+02:00,2025-05-25,15:07,11,18,29
29,2025-05-25T06:56:00+02:00,2025-05-25,14:56,2,18,20
29,2025-05-25T06:58:00+02:00,2025-05-25,14:58,28,5,33
29,2025-05-25T07:06:00+02:00,2025-05-25,15:06,2,10,12
29,2025-05-25T07:09:00+02:00,2025-05-25,15:09,17,13,30
31,2025-05-25T06:55:00+02:00,2025-05-25,14:55,2,7,9
31,2025-05-25T06:56:00+02:00,2025-05-25,14:56,4,0,4
31,2025-05-25T07:00:00+02:00,2025-05-25,15:00,3,1,4
31,2025-05-25T07:04:00+02:00,2025-05-25,15:04,5,1,6
31,2025-05-25T07:08:00+02:00,2025-05-25,15:08,7,3,10
36,2025-05-25T06:55:00+02:00,2025-05-25,14:55,2,1,3
36,2025-05-25T06:56:00+02:00,2025-05-25,14:56,3,4,7
36,2025-05-25T06:58:00+02:00,2025-05-25,14:58,1,7,8
36,2025-05-25T07:00:00+02:00,2025-05-25,15:00,4,0,4
36,2025-05-25T07:01:00+02:00,2025-05-25,15:01,1,1,2
36,2025-05-25T07:05:00+02:00,2025-05-25,15:05,2,4,6
39,2025-05-25T06:57:00+02:00,2025-05-25,14:57,4,0,4
39,2025-05-25T06:59:00+02:00,2025-05-25,14:59,3,2,5
39,2025-05-25T07:00:00+02:00,2025-05-25,15:00,1,1,2
39,2025-05-25T07:09:00+02:00,2025-05-25,15:09,3,2,5
40,2025-05-25T06:57:00+02:00,2025-05-25,14:57,3,2,5
40,2025-05-25T07:01:00+02:00,2025-05-25,15:01,4,2,6
40,2025-05-25T07:08:00+02:00,2025-05-25,15:08,26,0,26
41,2025-05-25T06:56:00+02:00,2025-05-25,14:56,6,8,14
41,2025-05-25T07:01:00+02:00,2025-05-25,15:01,10,15,25
41,2025-05-25T07:03:00+02:00,2025-05-25,15:03,9,18,27
41,2025-05-25T07:04:00+02:00,2025-05-25,15:04,10,3,13
41,2025-05-25T07:05:00+02:00,2025-05-25,15:05,2,8,10
43,2025-05-25T06:55:00+02:00,2025-05-25,14:55,12,4,16
43,2025-05-25T07:05:00+02:00,2025-05-25,15:05,2,11,13
44,2025-05-25T07:00:00+02:00,2025-05-25,15:00,2,5,7
45,2025-05-25T06:55:00+02:00,2025-05-25,14:55,25,14,39
45,2025-05-25T06:57:00+02:00,2025-05-25,14:57,25,17,42
45,2025-05-25T06:58:00+02:00,2025-05-25,14:58,24,32,56
45,2025-05-25T07:06:00+02:00,2025-05-25,15:06,14,26,40
47,2025-05-25T06:55:00+02:00,2025-05-25,14:55,11,24,35
47,2025-05-25T07:03:00+02:00,2025-05-25,15:03,21,10,31
47,2025-05-25T07:04:00+02:00,2025-05-25,15:04,18,21,39
47,2025-05-25T07:05:00+02:00,2025-05-25,15:05,10,14,24
47,2025-05-25T07:08:00+02:00,2025-05-25,15:08,24,15,39
50,2025-05-25T06:57:00+02:00,2025-05-25,14:57,2,0,2
50,2025-05-25T07:02:00+02:00,2025-05-25,15:02,3,6,9
50,2025-05-25T07:06:00+02:00,2025-05-25,15:06,9,2,11
54,2025-05-25T07:00:00+02:00,2025-05-25,15:00,3,4,7
54,2025-05-25T07:01:00+02:00,2025-05-25,15:01,1,3,4
54,2025-05-25T07:03:00+02:00,2025-05-25,15:03,1,7,8
54,2025-05-25T07:04:00+02:00,2025-05-25,15:04,0,1,1
54,2025-05-25T07:08:00+02:00,2025-05-25,15:08,2,1,3
59,2025-05-25T06:55:00+02:00,2025-05-25,14:55,31,41,72
59,2025-05-25T07:00:00+02:00,2025-05-25,15:00,19,35,54
59,2025-05-25T07:05:00+02:00,2025-05-25,15:05,31,34,65
61,2025-05-25T07:03:00+02:00,2025-05-25,15:03,13,1,14
61,2025-05-25T07:08:00+02:00,2025-05-25,15:08,8,7,15
61,2025-05-25T07:09:00+02:00,2025-05-25,15:09,15,9,24
66,2025-05-25T06:58:00+02:00,2025-05-25,14:58,11,14,25
66,2025-05-25T07:00:00+02:00,2025-05-25,15:00,35,35,70
66,2025-05-25T07:03:00+02:00,2025-05-25,15:03,38,34,72
66,2025-05-25T07:06:00+02:00,2025-05-25,15:06,20,23,43
66,2025-05-25T07:08:00+02:00,2025-05-25,15:08,23,37,60
69,2025-05-25T06:59:00+02:00,2025-05-25,14:59,2,4,6
69,2025-05-25T07:01:00+02:00,2025-05-25,15:01,6,5,11
69,2025-05-25T07:04:00+02:00,2025-05-25,15:04,5,3,8
69,2025-05-25T07:05:00+02:00,2025-05-25,15:05,1,9,10
70,2025-05-25T06:55:00+02:00,2025-05-25,14:55,0,1,1
70,2025-05-25T07:01:00+02:00,2025-05-25,15:01,0,1,1
70,2025-05-25T07:06:00+02:00,2025-05-25,15:06,0,2,2
70,2025-05-25T07:07:00+02:00,2025-05-25,15:07,3,1,4
75,2025-05-25T06:55:00+02:00,2025-05-25,14:55,1,0,1
75,2025-05-25T06:59:00+02:00,2025-05-25,14:59,1,5,6
75,2025-05-25T07:02:00+02:00,2025-05-25,15:02,1,2,3
75,2025-05-25T07:06:00+02:00,2025-05-25,15:06,2,3,5
77,2025-05-25T07:00:00+02:00,2025-05-25,15:00,28,13,41
84,2025-05-25T07:00:00+02:00,2025-05-25,15:00,101,125,226
84,2025-05-25T07:05:00+02:00,2025-05-25,15:05,97,119,216
87,2025-05-25T07:07:00+02:00,2025-05-25,15:07,3,0,3
87,2025-05-25T07:08:00+02:00,2025-05-25,15:08,3,1,4
107,2025-05-25T07:00:00+02:00,2025-05-25,15:00,11,8,19
108,2025-05-25T07:02:00+02:00,2025-05-25,15:02,7,2,9
108,2025-05-25T07:07:00+02:00,2025-05-25,15:07,3,2,5
118,2025-05-25T07:05:00+02:00,2025-05-25,15:05,2,2,4
124,2025-05-25T06:55:00+02:00,2025-05-25,14:55,0,4,4
124,2025-05-25T07:00:00+02:00,2025-05-25,15:00,2,1,3
124,2025-05-25T07:05:00+02:00,2025-05-25,15:05,0,3,3
131,2025-05-25T06:55:00+02:00,2025-05-25,14:55,17,8,25
132,2025-05-25T07:05:00+02:00,2025-05-25,15:05,10,11,21
133,2025-05-25T07:05:00+02:00,2025-05-25,15:05,27,38,65
140,2025-05-25T06:55:00+02:00,2025-05-25,14:55,4,10,14
140,2025-05-25T07:00:00+02:00,2025-05-25,15:00,12,12,24
162,2025-05-25T06:55:00+02:00,2025-05-25,14:55,69,93,162
162,2025-05-25T07:05:00+02:00,2025-05-25,15:05,59,68,127
165,2025-05-25T06:55:00+02:00,2025-05-25,14:55,6,1,7
165,2025-05-25T07:05:00+02:00,2025-05-25,15:05,5,0,5
167,2025-05-25T07:00:00+02:00,2025-05-25,15:00,1,2,3
179,2025-05-25T07:00:00+02:00,2025-05-25,15:00,1,2,3
179,2025-05-25T07:05:00+02:00,2025-05-25,15:05,12,7,19
1,2025-05-25T07:00:00+02:00,2025-05-25,15:00,29,17,46
1,2025-05-25T07:02:00+02:00,2025-05-25,15:02,25,29,54
1,2025-05-25T07:06:00+02:00,2025-05-25,15:06,19,19,38
2,2025-05-25T06:56:00+02:00,2025-05-25,14:56,11,6,17
2,2025-05-25T06:58:00+02:00,2025-05-25,14:58,20,17,37
2,2025-05-25T07:07:00+02:00,2025-05-25,15:07,10,19,29
2,2025-05-25T07:09:00+02:00,2025-05-25,15:09,6,14,20
9,2025-05-25T06:56:00+02:00,2025-05-25,14:56,1,0,1
9,2025-05-25T07:00:00+02:00,2025-05-25,15:00,0,2,2
9,2025-05-25T07:06:00+02:00,2025-05-25,15:06,2,11,13
9,2025-05-25T07:08:00+02:00,2025-05-25,15:08,2,2,4
10,2025-05-25T07:00:00+02:00,2025-05-25,15:00,1,0,1
10,2025-05-25T07:06:00+02:00,2025-05-25,15:06,6,3,9
10,2025-05-25T07:07:00+02:00,2025-05-25,15:07,1,0,1
11,2025-05-25T06:55:00+02:00,2025-05-25,14:55,9,6,15
11,2025-05-25T06:56:00+02:00,2025-05-25,14:56,0,3,3
11,2025-05-25T07:00:00+02:00,2025-05-25,15:00,13,8,21
11,2025-05-25T07:06:00+02:00,2025-05-25,15:06,0,9,9
12,2025-05-25T07:00:00+02:00,2025-05-25,15:00,5,7,12
17,2025-05-25T06:57:00+02:00,2025-05-25,14:57,4,0,4
17,2025-05-25T06:58:00+02:00,2025-05-25,14:58,3,6,9
17,2025-05-25T07:01:00+02:00,2025-05-25,15:01,0,4,4
17,2025-05-25T07:03:00+02:00,2025-05-25,15:03,2,3,5
17,2025-05-25T07:09:00+02:00,2025-05-25,15:09,6,12,18
18,2025-05-25T06:55:00+02:00,2025-05-25,14:55,1,2,3
18,2025-05-25T06:56:00+02:00,2025-05-25,14:56,4,0,4
18,2025-05-25T06:59:00+02:00,2025-05-25,14:59,1,0,1
18,2025-05-25T07:02:00+02:00,2025-05-25,15:02,4,2,6
19,2025-05-25T06:58:00+02:00,2025-05-25,14:58,13,12,25
19,2025-05-25T07:03:00+02:00,2025-05-25,15:03,11,11,22
19,2025-05-25T07:08:00+02:00,2025-05-25,15:08,9,9,18
20,2025-05-25T06:55:00+02:00,2025-05-25,14:55,0,4,4
20,2025-05-25T07:01:00+02:00,2025-05-25,15:01,2,2,4
20,2025-05-25T07:02:00+02:00,2025-05-25,15:02,2,11,13
20,2025-05-25T07:03:00+02:00,2025-05-25,15:03,7,2,9
20,2025-05-25T07:05:00+02:00,2025-05-25,15:05,2,5,7
20,2025-05-25T07:07:00+02:00,2025-05-25,15:07,5,2,7
20,2025-05-25T07:08:00+02:00,2025-05-25,15:08,3,2,5
20,2025-05-25T07:09:00+02:00,2025-05-25,15:09,1,2,3
23,2025-05-25T06:57:00+02:00,2025-05-25,14:57,2,2,4
23,2025-05-25T06:58:00+02:00,2025-05-25,14:58,0,3,3
23,2025-05-25T07:02:00+02:00,2025-05-25,15:02,2,6,8
23,2025-05-25T07:04:00+02:00,2025-05-25,15:04,0,3,3
23,2025-05-25T07:06:00+02:00,2025-05-25,15:06,2,1,3
23,2025-05-25T07:07:00+02:00,2025-05-25,15:07,2,2,4
24,2025-05-25T07:05:00+02:00,2025-05-25,15:05,6,5,11
24,2025-05-25T07:07:00+02:00,2025-05-25,15:07,4,29,33
25,2025-05-25T07:00:00+02:00,2025-05-25,15:00,114,73,187
27,2025-05-25T06:57:00+02:00,2025-05-25,14:57,1,0,1
27,2025-05-25T07:03:00+02:00,2025-05-25,15:03,3,1,4
27,2025-05-25T07:04:00+02:00,2025-05-25,15:04,9,1,10
27,2025-05-25T07:05:00+02:00,2025-05-25,15:05,5,9,14
30,2025-05-25T06:56:00+02:00,2025-05-25,14:56,1,11,12
30,2025-05-25T06:59:00+02:00,2025-05-25,14:59,0,23,23
30,2025-05-25T07:01:00+02:00,2025-05-25,15:01,3,10,13
30,2025-05-25T07:03:00+02:00,2025-05-25,15:03,5,6,11
30,2025-05-25T07:08:00+02:00,2025-05-25,15:08,4,13,17
30,2025-05-25T07:09:00+02:00,2025-05-25,15:09,1,16,17
35,2025-05-25T06:55:00+02:00,2025-05-25,14:55,24,29,53
35,2025-05-25T06:58:00+02:00,2025-05-25,14:58,23,25,48
46,2025-05-25T06:55:00+02:00,2025-05-25,14:55,1,7,8
46,2025-05-25T07:00:00+02:00,2025-05-25,15:00,10,6,16
48,2025-05-25T06:56:00+02:00,2025-05-25,14:56,9,1,10
48,2025-05-25T06:57:00+02:00,2025-05-25,14:57,6,4,10
48,2025-05-25T07:09:00+02:00,2025-05-25,15:09,17,1,18
49,2025-05-25T06:59:00+02:00,2025-05-25,14:59,10,8,18
49,2025-05-25T07:05:00+02:00,2025-05-25,15:05,5,9,14
49,2025-05-25T07:08:00+02:00,2025-05-25,15:08,6,9,15
49,2025-05-25T07:09:00+02:00,2025-05-25,15:09,3,7,10
51,2025-05-25T07:00:00+02:00,2025-05-25,15:00,4,0,4
51,2025-05-25T07:01:00+02:00,2025-05-25,15:01,6,2,8
51,2025-05-25T07:03:00+02:00,2025-05-25,15:03,8,1,9
51,2025-05-25T07:04:00+02:00,2025-05-25,15:04,3,1,4
51,2025-05-25T07:06:00+02:00,2025-05-25,15:06,1,1,2
51,2025-05-25T07:08:00+02:00,2025-05-25,15:08,3,3,6
52,2025-05-25T06:57:00+02:00,2025-05-25,14:57,13,3,16
52,2025-05-25T06:59:00+02:00,2025-05-25,14:59,7,9,16
52,2025-05-25T07:07:00+02:00,2025-05-25,15:07,7,19,26
53,2025-05-25T06:59:00+02:00,2025-05-25,14:59,9,3,12
53,2025-05-25T07:03:00+02:00,2025-05-25,15:03,11,3,14
53,2025-05-25T07:06:00+02:00,2025-05-25,15:06,15,3,18
53,2025-05-25T07:08:00+02:00,2025-05-25,15:08,7,8,15
56,2025-05-25T06:56:00+02:00,2025-05-25,14:56,8,7,15
56,2025-05-25T06:59:00+02:00,2025-05-25,14:59,1,12,13
56,2025-05-25T07:05:00+02:00,2025-05-25,15:05,10,15,25
56,2025-05-25T07:06:00+02:00,2025-05-25,15:06,12,13,25
56,2025-05-25T07:07:00+02:00,2025-05-25,15:07,16,5,21
58,2025-05-25T06:56:00+02:00,2025-05-25,14:56,5,10,15
58,2025-05-25T06:58:00+02:00,2025-05-25,14:58,10,6,16
58,2025-05-25T07:01:00+02:00,2025-05-25,15:01,9,7,16
58,2025-05-25T07:02:00+02:00,2025-05-25,15:02,13,8,21
58,2025-05-25T07:03:00+02:00,2025-05-25,15:03,14,3,17
58,2025-05-25T07:04:00+02:00,2025-05-25,15:04,2,8,10
62,2025-05-25T06:57:00+02:00,2025-05-25,14:57,3,1,4
62,2025-05-25T06:59:00+02:00,2025-05-25,14:59,3,2,5
62,2025-05-25T07:03:00+02:00,2025-05-25,15:03,1,3,4
62,2025-05-25T07:08:00+02:00,2025-05-25,15:08,3,2,5
63,2025-05-25T06:55:00+02:00,2025-05-25,14:55,4,15,19
63,2025-05-25T06:56:00+02:00,2025-05-25,14:56,6,9,15
63,2025-05-25T06:57:00+02:00,2025-05-25,14:57,6,5,11
63,2025-05-25T07:06:00+02:00,2025-05-25,15:06,6,10,16
67,2025-05-25T06:55:00+02:00,2025-05-25,14:55,5,15,20
67,2025-05-25T07:00:00+02:00,2025-05-25,15:00,13,8,21
67,2025-05-25T07:02:00+02:00,2025-05-25,15:02,5,8,13
68,2025-05-25T06:57:00+02:00,2025-05-25,14:57,9,8,17
68,2025-05-25T06:58:00+02:00,2025-05-25,14:58,6,4,10
68,2025-05-25T07:03:00+02:00,2025-05-25,15:03,7,0,7
68,2025-05-25T07:04:00+02:00,2025-05-25,15:04,3,6,9
68,2025-05-25T07:06:00+02:00,2025-05-25,15:06,3,6,9
68,2025-05-25T07:08:00+02:00,2025-05-25,15:08,8,3,11
72,2025-05-25T06:57:00+02:00,2025-05-25,14:57,3,13,16
72,2025-05-25T06:59:00+02:00,2025-05-25,14:59,5,15,20
72,2025-05-25T07:00:00+02:00,2025-05-25,15:00,3,12,15
72,2025-05-25T07:01:00+02:00,2025-05-25,15:01,5,13,18
72,2025-05-25T07:03:00+02:00,2025-05-25,15:03,8,13,21
72,2025-05-25T07:08:00+02:00,2025-05-25,15:08,2,17,19
76,2025-05-25T06:55:00+02:00,2025-05-25,14:55,1,0,1
76,2025-05-25T07:06:00+02:00,2025-05-25,15:06,0,1,1
76,2025-05-25T07:07:00+02:00,2025-05-25,15:07,0,3,3
76,2025-05-25T07:09:00+02:00,2025-05-25,15:09,3,0,3
79,2025-05-25T06:58:00+02:00,2025-05-25,14:58,19,17,36
79,2025-05-25T07:00:00+02:00,2025-05-25,15:00,31,4,35
79,2025-05-25T07:01:00+02:00,2025-05-25,15:01,12,8,20
79,2025-05-25T07:02:00+02:00,2025-05-25,15:02,22,4,26
79,2025-05-25T07:04:00+02:00,2025-05-25,15:04,6,0,6
85,2025-05-25T06:55:00+02:00,2025-05-25,14:55,1,0,1
85,2025-05-25T06:56:00+02:00,2025-05-25,14:56,1,0,1
85,2025-05-25T06:58:00+02:00,2025-05-25,14:58,1,0,1
85,2025-05-25T07:00:00+02:00,2025-05-25,15:00,1,1,2
85,2025-05-25T07:06:00+02:00,2025-05-25,15:06,5,0,5
85,2025-05-25T07:09:00+02:00,2025-05-25,15:09,2,4,6
86,2025-05-25T06:56:00+02:00,2025-05-25,14:56,0,1,1
86,2025-05-25T07:03:00+02:00,2025-05-25,15:03,2,0,2
86,2025-05-25T07:08:00+02:00,2025-05-25,15:08,0,3,3
86,2025-05-25T07:09:00+02:00,2025-05-25,15:09,0,2,2
109,2025-05-25T07:00:00+02:00,2025-05-25,15:00,13,8,21
123,2025-05-25T06:55:00+02:00,2025-05-25,14:55,8,4,12
123,2025-05-25T07:00:00+02:00,2025-05-25,15:00,13,3,16
123,2025-05-25T07:05:00+02:00,2025-05-25,15:05,5,5,10
130,2025-05-25T07:00:00+02:00,2025-05-25,15:00,20,2,22
136,2025-05-25T07:00:00+02:00,2025-05-25,15:00,110,1,111
136,2025-05-25T07:05:00+02:00,2025-05-25,15:05,108,5,113
137,2025-05-25T06:55:00+02:00,2025-05-25,14:55,1,3,4
139,2025-05-25T06:55:00+02:00,2025-05-25,14:55,4,6,10
161,2025-05-25T07:00:00+02:00,2025-05-25,15:00,143,5,148
164,2025-05-25T06:55:00+02:00,2025-05-25,14:55,11,14,25
181,2025-05-25T07:10:00+02:00,2025-05-25,15:10,7,25,32
181,2025-05-25T07:17:00+02:00,2025-05-25,15:17,16,29,45
181,2025-05-25T07:19:00+02:00,2025-05-25,15:19,15,21,36
181,2025-05-25T07:20:00+02:00,2025-05-25,15:20,10,36,46
182,2025-05-25T07:15:00+02:00,2025-05-25,15:15,8,12,20
180,2025-05-25T07:14:00+02:00,2025-05-25,15:14,0,2,2
180,2025-05-25T07:19:00+02:00,2025-05-25,15:19,2,0,2
180,2025-05-25T07:21:00+02:00,2025-05-25,15:21,2,0,2
180,2025-05-25T07:22:00+02:00,2025-05-25,15:22,0,3,3
3,2025-05-25T04:55:00+02:00,2025-05-25,12:55,27,39,66
3,2025-05-25T04:57:00+02:00,2025-05-25,12:57,19,15,34
3,2025-05-25T05:03:00+02:00,2025-05-25,13:03,15,24,39
3,2025-05-25T05:06:00+02:00,2025-05-25,13:06,13,23,36
3,2025-05-25T05:08:00+02:00,2025-05-25,13:08,15,16,31
4,2025-05-25T04:56:00+02:00,2025-05-25,12:56,42,39,81
4,2025-05-25T04:59:00+02:00,2025-05-25,12:59,47,25,72
5,2025-05-25T04:55:00+02:00,2025-05-25,12:55,83,71,154
5,2025-05-25T05:05:00+02:00,2025-05-25,13:05,80,88,168
6,2025-05-25T04:55:00+02:00,2025-05-25,12:55,11,13,24
6,2025-05-25T04:58:00+02:00,2025-05-25,12:58,5,20,25
6,2025-05-25T05:04:00+02:00,2025-05-25,13:04,13,9,22
6,2025-05-25T05:07:00+02:00,2025-05-25,13:07,17,9,26
6,2025-05-25T05:09:00+02:00,2025-05-25,13:09,9,16,25
8,2025-05-25T04:57:00+02:00,2025-05-25,12:57,0,6,6
8,2025-05-25T04:58:00+02:00,2025-05-25,12:58,0,3,3
8,2025-05-25T05:04:00+02:00,2025-05-25,13:04,4,0,4
8,2025-05-25T05:06:00+02:00,2025-05-25,13:06,3,5,8
28,2025-05-25T04:55:00+02:00,2025-05-25,12:55,4,19,23
28,2025-05-25T04:56:00+02:00,2025-05-25,12:56,10,16,26
28,2025-05-25T04:58:00+02:00,2025-05-25,12:58,1,9,10
28,2025-05-25T05:01:00+02:00,2025-05-25,13:01,8,17,25
28,2025-05-25T05:05:00+02:00,2025-05-25,13:05,5,11,16
28,2025-05-25T05:06:00+02:00,2025-05-25,13:06,3,14,17
28,2025-05-25T05:07:00+02:00,2025-05-25,13:07,8,10,18
28,2025-05-25T05:09:00+02:00,2025-05-25,13:09,17,7,24
29,2025-05-25T04:57:00+02:00,2025-05-25,12:57,9,7,16
29,2025-05-25T05:03:00+02:00,2025-05-25,13:03,13,14,27
29,2025-05-25T05:04:00+02:00,2025-05-25,13:04,9,14,23
29,2025-05-25T05:07:00+02:00,2025-05-25,13:07,15,12,27
31,2025-05-25T04:55:00+02:00,2025-05-25,12:55,2,9,11
31,2025-05-25T04:57:00+02:00,2025-05-25,12:57,1,6,7
31,2025-05-25T05:03:00+02:00,2025-05-25,13:03,7,10,17
31,2025-05-25T05:04:00+02:00,2025-05-25,13:04,7,1,8
31,2025-05-25T05:05:00+02:00,2025-05-25,13:05,3,2,5
31,2025-05-25T05:07:00+02:00,2025-05-25,13:07,1,3,4
36,2025-05-25T04:59:00+02:00,2025-05-25,12:59,0,1,1
36,2025-05-25T05:03:00+02:00,2025-05-25,13:03,5,2,7
36,2025-05-25T05:06:00+02:00,2025-05-25,13:06,3,0,3
39,2025-05-25T04:57:00+02:00,2025-05-25,12:57,7,0,7
39,2025-05-25T05:01:00+02:00,2025-05-25,13:01,0,2,2
39,2025-05-25T05:09:00+02:00,2025-05-25,13:09,0,2,2
40,2025-05-25T04:57:00+02:00,2025-05-25,12:57,1,0,1
40,2025-05-25T05:00:00+02:00,2025-05-25,13:00,4,3,7
40,2025-05-25T05:09:00+02:00,2025-05-25,13:09,3,8,11
41,2025-05-25T04:57:00+02:00,2025-05-25,12:57,2,1,3
41,2025-05-25T05:00:00+02:00,2025-05-25,13:00,11,1,12
41,2025-05-25T05:01:00+02:00,2025-05-25,13:01,10,7,17
41,2025-05-25T05:04:00+02:00,2025-05-25,13:04,11,15,26
43,2025-05-25T05:05:00+02:00,2025-05-25,13:05,3,4,7
44,2025-05-25T04:55:00+02:00,2025-05-25,12:55,2,0,2
44,2025-05-25T05:00:00+02:00,2025-05-25,13:00,1,4,5
45,2025-05-25T04:58:00+02:00,2025-05-25,12:58,22,19,41
45,2025-05-25T05:03:00+02:00,2025-05-25,13:03,18,10,28
47,2025-05-25T04:55:00+02:00,2025-05-25,12:55,16,22,38
47,2025-05-25T04:56:00+02:00,2025-05-25,12:56,12,14,26
47,2025-05-25T04:57:00+02:00,2025-05-25,12:57,25,13,38
47,2025-05-25T05:03:00+02:00,2025-05-25,13:03,13,12,25
47,2025-05-25T05:04:00+02:00,2025-05-25,13:04,19,20,39
47,2025-05-25T05:05:00+02:00,2025-05-25,13:05,9,25,34
47,2025-05-25T05:09:00+02:00,2025-05-25,13:09,27,11,38
50,2025-05-25T04:55:00+02:00,2025-05-25,12:55,3,7,10
50,2025-05-25T04:58:00+02:00,2025-05-25,12:58,0,5,5
50,2025-05-25T05:03:00+02:00,2025-05-25,13:03,7,2,9
50,2025-05-25T05:07:00+02:00,2025-05-25,13:07,4,2,6
54,2025-05-25T04:55:00+02:00,2025-05-25,12:55,5,2,7
54,2025-05-25T04:56:00+02:00,2025-05-25,12:56,1,0,1
54,2025-05-25T04:57:00+02:00,2025-05-25,12:57,1,3,4
54,2025-05-25T05:00:00+02:00,2025-05-25,13:00,3,0,3
54,2025-05-25T05:05:00+02:00,2025-05-25,13:05,3,1,4
54,2025-05-25T05:06:00+02:00,2025-05-25,13:06,6,3,9
54,2025-05-25T05:09:00+02:00,2025-05-25,13:09,0,3,3
59,2025-05-25T05:00:00+02:00,2025-05-25,13:00,33,26,59
61,2025-05-25T04:56:00+02:00,2025-05-25,12:56,10,11,21
61,2025-05-25T05:06:00+02:00,2025-05-25,13:06,9,8,17
61,2025-05-25T05:09:00+02:00,2025-05-25,13:09,12,15,27
66,2025-05-25T04:59:00+02:00,2025-05-25,12:59,22,54,76
66,2025-05-25T05:00:00+02:00,2025-05-25,13:00,20,48,68
66,2025-05-25T05:01:00+02:00,2025-05-25,13:01,26,31,57
66,2025-05-25T05:02:00+02:00,2025-05-25,13:02,22,35,57
66,2025-05-25T05:04:00+02:00,2025-05-25,13:04,17,30,47
66,2025-05-25T05:06:00+02:00,2025-05-25,13:06,23,45,68
66,2025-05-25T05:08:00+02:00,2025-05-25,13:08,29,64,93
69,2025-05-25T04:55:00+02:00,2025-05-25,12:55,4,2,6
69,2025-05-25T04:57:00+02:00,2025-05-25,12:57,3,4,7
69,2025-05-25T05:01:00+02:00,2025-05-25,13:01,5,2,7
69,2025-05-25T05:04:00+02:00,2025-05-25,13:04,6,3,9
69,2025-05-25T05:07:00+02:00,2025-05-25,13:07,4,4,8
70,2025-05-25T04:55:00+02:00,2025-05-25,12:55,5,1,6
70,2025-05-25T04:58:00+02:00,2025-05-25,12:58,1,4,5
70,2025-05-25T05:00:00+02:00,2025-05-25,13:00,2,3,5
70,2025-05-25T05:04:00+02:00,2025-05-25,13:04,0,2,2
71,2025-05-25T05:00:00+02:00,2025-05-25,13:00,2,0,2
75,2025-05-25T04:56:00+02:00,2025-05-25,12:56,2,0,2
75,2025-05-25T05:00:00+02:00,2025-05-25,13:00,0,1,1
75,2025-05-25T05:06:00+02:00,2025-05-25,13:06,1,0,1
75,2025-05-25T05:07:00+02:00,2025-05-25,13:07,0,1,1
78,2025-05-25T05:03:00+02:00,2025-05-25,13:03,1,2,3
78,2025-05-25T05:07:00+02:00,2025-05-25,13:07,3,0,3
84,2025-05-25T05:05:00+02:00,2025-05-25,13:05,85,95,180
87,2025-05-25T04:55:00+02:00,2025-05-25,12:55,1,2,3
87,2025-05-25T04:58:00+02:00,2025-05-25,12:58,4,1,5
87,2025-05-25T05:01:00+02:00,2025-05-25,13:01,3,9,12
87,2025-05-25T05:03:00+02:00,2025-05-25,13:03,4,1,5
87,2025-05-25T05:05:00+02:00,2025-05-25,13:05,0,1,1
107,2025-05-25T05:05:00+02:00,2025-05-25,13:05,14,5,19
108,2025-05-25T04:55:00+02:00,2025-05-25,12:55,1,0,1
108,2025-05-25T05:03:00+02:00,2025-05-25,13:03,2,3,5
108,2025-05-25T05:08:00+02:00,2025-05-25,13:08,2,1,3
118,2025-05-25T04:55:00+02:00,2025-05-25,12:55,2,1,3
118,2025-05-25T05:00:00+02:00,2025-05-25,13:00,0,1,1
118,2025-05-25T05:05:00+02:00,2025-05-25,13:05,4,4,8
131,2025-05-25T04:55:00+02:00,2025-05-25,12:55,6,13,19
133,2025-05-25T04:55:00+02:00,2025-05-25,12:55,37,38,75
134,2025-05-25T04:55:00+02:00,2025-05-25,12:55,26,35,61
134,2025-05-25T05:00:00+02:00,2025-05-25,13:00,24,22,46
134,2025-05-25T05:05:00+02:00,2025-05-25,13:05,23,9,32
140,2025-05-25T05:00:00+02:00,2025-05-25,13:00,13,8,21
140,2025-05-25T05:05:00+02:00,2025-05-25,13:05,7,7,14
162,2025-05-25T04:55:00+02:00,2025-05-25,12:55,61,76,137
165,2025-05-25T05:00:00+02:00,2025-05-25,13:00,1,8,9
166,2025-05-25T05:00:00+02:00,2025-05-25,13:00,4,5,9
166,2025-05-25T05:05:00+02:00,2025-05-25,13:05,2,8,10
179,2025-05-25T04:55:00+02:00,2025-05-25,12:55,8,4,12
179,2025-05-25T05:00:00+02:00,2025-05-25,13:00,1,2,3
1,2025-05-25T04:55:00+02:00,2025-05-25,12:55,19,16,35
1,2025-05-25T05:07:00+02:00,2025-05-25,13:07,42,30,72
2,2025-05-25T04:58:00+02:00,2025-05-25,12:58,8,11,19
2,2025-05-25T05:01:00+02:00,2025-05-25,13:01,6,11,17
2,2025-05-25T05:02:00+02:00,2025-05-25,13:02,10,15,25
2,2025-05-25T05:04:00+02:00,2025-05-25,13:04,11,25,36
2,2025-05-25T05:05:00+02:00,2025-05-25,13:05,7,17,24
2,2025-05-25T05:08:00+02:00,2025-05-25,13:08,16,11,27
2,2025-05-25T05:09:00+02:00,2025-05-25,13:09,8,6,14
9,2025-05-25T04:56:00+02:00,2025-05-25,12:56,0,3,3
9,2025-05-25T04:57:00+02:00,2025-05-25,12:57,1,1,2
9,2025-05-25T05:09:00+02:00,2025-05-25,13:09,0,6,6
10,2025-05-25T04:55:00+02:00,2025-05-25,12:55,4,0,4
10,2025-05-25T05:02:00+02:00,2025-05-25,13:02,2,0,2
10,2025-05-25T05:05:00+02:00,2025-05-25,13:05,1,0,1
10,2025-05-25T05:08:00+02:00,2025-05-25,13:08,2,0,2
11,2025-05-25T04:55:00+02:00,2025-05-25,12:55,5,4,9
11,2025-05-25T04:59:00+02:00,2025-05-25,12:59,4,4,8
11,2025-05-25T05:00:00+02:00,2025-05-25,13:00,9,6,15
11,2025-05-25T05:08:00+02:00,2025-05-25,13:08,0,4,4
12,2025-05-25T04:57:00+02:00,2025-05-25,12:57,3,4,7
12,2025-05-25T04:58:00+02:00,2025-05-25,12:58,3,7,10
12,2025-05-25T04:59:00+02:00,2025-05-25,12:59,1,5,6
12,2025-05-25T05:08:00+02:00,2025-05-25,13:08,3,4,7
17,2025-05-25T04:56:00+02:00,2025-05-25,12:56,2,3,5
17,2025-05-25T04:57:00+02:00,2025-05-25,12:57,8,2,10
17,2025-05-25T05:06:00+02:00,2025-05-25,13:06,4,4,8
18,2025-05-25T04:56:00+02:00,2025-05-25,12:56,2,0,2
18,2025-05-25T04:59:00+02:00,2025-05-25,12:59,3,1,4
18,2025-05-25T05:00:00+02:00,2025-05-25,13:00,3,0,3
18,2025-05-25T05:01:00+02:00,2025-05-25,13:01,4,2,6
18,2025-05-25T05:03:00+02:00,2025-05-25,13:03,1,0,1
18,2025-05-25T05:06:00+02:00,2025-05-25,13:06,3,0,3
18,2025-05-25T05:09:00+02:00,2025-05-25,13:09,1,0,1
19,2025-05-25T04:56:00+02:00,2025-05-25,12:56,8,5,13
19,2025-05-25T04:57:00+02:00,2025-05-25,12:57,13,15,28
19,2025-05-25T05:01:00+02:00,2025-05-25,13:01,20,5,25
19,2025-05-25T05:02:00+02:00,2025-05-25,13:02,8,10,18
19,2025-05-25T05:03:00+02:00,2025-05-25,13:03,9,8,17
20,2025-05-25T04:57:00+02:00,2025-05-25,12:57,15,1,16
20,2025-05-25T04:58:00+02:00,2025-05-25,12:58,3,4,7
20,2025-05-25T04:59:00+02:00,2025-05-25,12:59,3,16,19
20,2025-05-25T05:06:00+02:00,2025-05-25,13:06,5,15,20
23,2025-05-25T04:55:00+02:00,2025-05-25,12:55,3,9,12
23,2025-05-25T04:56:00+02:00,2025-05-25,12:56,9,1,10
23,2025-05-25T04:58:00+02:00,2025-05-25,12:58,7,2,9
23,2025-05-25T04:59:00+02:00,2025-05-25,12:59,2,2,4
23,2025-05-25T05:06:00+02:00,2025-05-25,13:06,0,2,2
23,2025-05-25T05:08:00+02:00,2025-05-25,13:08,1,1,2
24,2025-05-25T04:56:00+02:00,2025-05-25,12:56,6,10,16
24,2025-05-25T04:58:00+02:00,2025-05-25,12:58,6,7,13
24,2025-05-25T05:01:00+02:00,2025-05-25,13:01,1,12,13
24,2025-05-25T05:07:00+02:00,2025-05-25,13:07,22,7,29
27,2025-05-25T04:55:00+02:00,2025-05-25,12:55,3,12,15
27,2025-05-25T04:56:00+02:00,2025-05-25,12:56,4,5,9
27,2025-05-25T05:04:00+02:00,2025-05-25,13:04,6,4,10
27,2025-05-25T05:05:00+02:00,2025-05-25,13:05,5,7,12
30,2025-05-25T05:07:00+02:00,2025-05-25,13:07,0,6,6
35,2025-05-25T04:57:00+02:00,2025-05-25,12:57,23,29,52
35,2025-05-25T05:03:00+02:00,2025-05-25,13:03,30,26,56
35,2025-05-25T05:04:00+02:00,2025-05-25,13:04,12,16,28
35,2025-05-25T05:05:00+02:00,2025-05-25,13:05,29,16,45
46,2025-05-25T05:05:00+02:00,2025-05-25,13:05,5,8,13
48,2025-05-25T04:56:00+02:00,2025-05-25,12:56,12,7,19
48,2025-05-25T04:57:00+02:00,2025-05-25,12:57,14,6,20
48,2025-05-25T04:58:00+02:00,2025-05-25,12:58,11,13,24
48,2025-05-25T05:00:00+02:00,2025-05-25,13:00,11,8,19
48,2025-05-25T05:08:00+02:00,2025-05-25,13:08,25,13,38
48,2025-05-25T05:09:00+02:00,2025-05-25,13:09,9,8,17
49,2025-05-25T04:57:00+02:00,2025-05-25,12:57,4,13,17
49,2025-05-25T04:58:00+02:00,2025-05-25,12:58,16,6,22
49,2025-05-25T05:02:00+02:00,2025-05-25,13:02,2,7,9
49,2025-05-25T05:04:00+02:00,2025-05-25,13:04,11,16,27
49,2025-05-25T05:07:00+02:00,2025-05-25,13:07,11,7,18
51,2025-05-25T04:55:00+02:00,2025-05-25,12:55,2,5,7
51,2025-05-25T04:58:00+02:00,2025-05-25,12:58,0,2,2
51,2025-05-25T05:04:00+02:00,2025-05-25,13:04,2,0,2
51,2025-05-25T05:06:00+02:00,2025-05-25,13:06,0,4,4
51,2025-05-25T05:07:00+02:00,2025-05-25,13:07,2,3,5
51,2025-05-25T05:08:00+02:00,2025-05-25,13:08,4,3,7
51,2025-05-25T05:09:00+02:00,2025-05-25,13:09,3,4,7
52,2025-05-25T04:56:00+02:00,2025-05-25,12:56,17,13,30
52,2025-05-25T04:57:00+02:00,2025-05-25,12:57,4,6,10
52,2025-05-25T04:58:00+02:00,2025-05-25,12:58,4,0,4
52,2025-05-25T05:02:00+02:00,2025-05-25,13:02,5,5,10
52,2025-05-25T05:06:00+02:00,2025-05-25,13:06,9,4,13
52,2025-05-25T05:08:00+02:00,2025-05-25,13:08,4,9,13
53,2025-05-25T04:55:00+02:00,2025-05-25,12:55,10,4,14
53,2025-05-25T04:59:00+02:00,2025-05-25,12:59,10,31,41
53,2025-05-25T05:02:00+02:00,2025-05-25,13:02,13,8,21
53,2025-05-25T05:05:00+02:00,2025-05-25,13:05,19,11,30
53,2025-05-25T05:09:00+02:00,2025-05-25,13:09,12,9,21
56,2025-05-25T04:56:00+02:00,2025-05-25,12:56,7,10,17
56,2025-05-25T04:57:00+02:00,2025-05-25,12:57,10,5,15
56,2025-05-25T05:05:00+02:00,2025-05-25,13:05,11,4,15
56,2025-05-25T05:08:00+02:00,2025-05-25,13:08,7,17,24
56,2025-05-25T05:09:00+02:00,2025-05-25,13:09,6,7,13
58,2025-05-25T04:55:00+02:00,2025-05-25,12:55,16,2,18
58,2025-05-25T04:59:00+02:00,2025-05-25,12:59,8,15,23
58,2025-05-25T05:00:00+02:00,2025-05-25,13:00,28,2,30
58,2025-05-25T05:06:00+02:00,2025-05-25,13:06,2,0,2
58,2025-05-25T05:08:00+02:00,2025-05-25,13:08,11,14,25
58,2025-05-25T05:09:00+02:00,2025-05-25,13:09,8,5,13
62,2025-05-25T04:56:00+02:00,2025-05-25,12:56,0,1,1
62,2025-05-25T04:57:00+02:00,2025-05-25,12:57,2,3,5
62,2025-05-25T05:01:00+02:00,2025-05-25,13:01,1,7,8
62,2025-05-25T05:02:00+02:00,2025-05-25,13:02,2,6,8
62,2025-05-25T05:04:00+02:00,2025-05-25,13:04,2,3,5
62,2025-05-25T05:07:00+02:00,2025-05-25,13:07,4,4,8
62,2025-05-25T05:08:00+02:00,2025-05-25,13:08,1,1,2
63,2025-05-25T04:59:00+02:00,2025-05-25,12:59,7,4,11
63,2025-05-25T05:05:00+02:00,2025-05-25,13:05,9,4,13
67,2025-05-25T04:55:00+02:00,2025-05-25,12:55,1,6,7
67,2025-05-25T04:57:00+02:00,2025-05-25,12:57,5,8,13
67,2025-05-25T04:59:00+02:00,2025-05-25,12:59,4,7,11
67,2025-05-25T05:00:00+02:00,2025-05-25,13:00,9,2,11
67,2025-05-25T05:01:00+02:00,2025-05-25,13:01,5,10,15
67,2025-05-25T05:05:00+02:00,2025-05-25,13:05,6,8,14
67,2025-05-25T05:06:00+02:00,2025-05-25,13:06,1,6,7
68,2025-05-25T04:58:00+02:00,2025-05-25,12:58,3,1,4
68,2025-05-25T04:59:00+02:00,2025-05-25,12:59,8,4,12
68,2025-05-25T05:02:00+02:00,2025-05-25,13:02,5,12,17
68,2025-05-25T05:05:00+02:00,2025-05-25,13:05,6,11,17
68,2025-05-25T05:06:00+02:00,2025-05-25,13:06,6,4,10
68,2025-05-25T05:07:00+02:00,2025-05-25,13:07,8,5,13
68,2025-05-25T05:08:00+02:00,2025-05-25,13:08,5,3,8
72,2025-05-25T04:58:00+02:00,2025-05-25,12:58,1,7,8
72,2025-05-25T05:00:00+02:00,2025-05-25,13:00,13,5,18
72,2025-05-25T05:07:00+02:00,2025-05-25,13:07,3,13,16
76,2025-05-25T04:55:00+02:00,2025-05-25,12:55,0,1,1
76,2025-05-25T05:00:00+02:00,2025-05-25,13:00,1,0,1
76,2025-05-25T05:03:00+02:00,2025-05-25,13:03,0,1,1
76,2025-05-25T05:06:00+02:00,2025-05-25,13:06,4,2,6
76,2025-05-25T05:07:00+02:00,2025-05-25,13:07,4,2,6
76,2025-05-25T05:08:00+02:00,2025-05-25,13:08,1,2,3
79,2025-05-25T05:00:00+02:00,2025-05-25,13:00,10,7,17
79,2025-05-25T05:02:00+02:00,2025-05-25,13:02,8,7,15
79,2025-05-25T05:04:00+02:00,2025-05-25,13:04,10,10,20
79,2025-05-25T05:06:00+02:00,2025-05-25,13:06,8,13,21
79,2025-05-25T05:07:00+02:00,2025-05-25,13:07,19,7,26
79,2025-05-25T05:09:00+02:00,2025-05-25,13:09,6,12,18
85,2025-05-25T04:56:00+02:00,2025-05-25,12:56,3,0,3
85,2025-05-25T04:58:00+02:00,2025-05-25,12:58,0,2,2
85,2025-05-25T05:00:00+02:00,2025-05-25,13:00,0,4,4
85,2025-05-25T05:01:00+02:00,2025-05-25,13:01,0,1,1
86,2025-05-25T04:55:00+02:00,2025-05-25,12:55,0,6,6
86,2025-05-25T04:56:00+02:00,2025-05-25,12:56,2,0,2
86,2025-05-25T04:58:00+02:00,2025-05-25,12:58,0,2,2
86,2025-05-25T04:59:00+02:00,2025-05-25,12:59,1,2,3
86,2025-05-25T05:00:00+02:00,2025-05-25,13:00,0,3,3
86,2025-05-25T05:04:00+02:00,2025-05-25,13:04,2,1,3
86,2025-05-25T05:08:00+02:00,2025-05-25,13:08,0,2,2
109,2025-05-25T05:05:00+02:00,2025-05-25,13:05,7,1,8
123,2025-05-25T04:55:00+02:00,2025-05-25,12:55,2,3,5
130,2025-05-25T04:55:00+02:00,2025-05-25,12:55,3,4,7
139,2025-05-25T05:05:00+02:00,2025-05-25,13:05,5,3,8
141,2025-05-25T05:00:00+02:00,2025-05-25,13:00,14,19,33
142,2025-05-25T04:55:00+02:00,2025-05-25,12:55,59,44,103
161,2025-05-25T05:05:00+02:00,2025-05-25,13:05,23,19,42
164,2025-05-25T05:00:00+02:00,2025-05-25,13:00,27,2,29
164,2025-05-25T05:05:00+02:00,2025-05-25,13:05,8,7,15
181,2025-05-25T04:56:00+02:00,2025-05-25,12:56,10,14,24
181,2025-05-25T04:58:00+02:00,2025-05-25,12:58,6,17,23
181,2025-05-25T05:07:00+02:00,2025-05-25,13:07,4,21,25
181,2025-05-25T05:08:00+02:00,2025-05-25,13:08,14,16,30
181,2025-05-25T05:09:00+02:00,2025-05-25,13:09,15,22,37
182,2025-05-25T04:55:00+02:00,2025-05-25,12:55,24,6,30
180,2025-05-25T05:05:00+02:00,2025-05-25,13:05,0,2,2
3,2025-05-25T04:44:00+02:00,2025-05-25,12:44,9,24,33
3,2025-05-25T04:49:00+02:00,2025-05-25,12:49,35,15,50
3,2025-05-25T04:53:00+02:00,2025-05-25,12:53,13,32,45
4,2025-05-25T04:47:00+02:00,2025-05-25,12:47,84,17,101
4,2025-05-25T04:49:00+02:00,2025-05-25,12:49,37,31,68
6,2025-05-25T04:40:00+02:00,2025-05-25,12:40,14,2,16
6,2025-05-25T04:41:00+02:00,2025-05-25,12:41,9,16,25
6,2025-05-25T04:43:00+02:00,2025-05-25,12:43,18,16,34
6,2025-05-25T04:45:00+02:00,2025-05-25,12:45,9,31,40
6,2025-05-25T04:47:00+02:00,2025-05-25,12:47,13,8,21
6,2025-05-25T04:48:00+02:00,2025-05-25,12:48,12,12,24
6,2025-05-25T04:53:00+02:00,2025-05-25,12:53,20,6,26
8,2025-05-25T04:40:00+02:00,2025-05-25,12:40,3,2,5
8,2025-05-25T04:46:00+02:00,2025-05-25,12:46,0,3,3
28,2025-05-25T04:41:00+02:00,2025-05-25,12:41,8,8,16
28,2025-05-25T04:42:00+02:00,2025-05-25,12:42,14,14,28
29,2025-05-25T04:41:00+02:00,2025-05-25,12:41,7,8,15
29,2025-05-25T04:44:00+02:00,2025-05-25,12:44,9,15,24
29,2025-05-25T04:45:00+02:00,2025-05-25,12:45,8,14,22
29,2025-05-25T04:50:00+02:00,2025-05-25,12:50,11,14,25
31,2025-05-25T04:40:00+02:00,2025-05-25,12:40,1,7,8
31,2025-05-25T04:42:00+02:00,2025-05-25,12:42,13,11,24
31,2025-05-25T04:44:00+02:00,2025-05-25,12:44,1,3,4
31,2025-05-25T04:45:00+02:00,2025-05-25,12:45,5,2,7
31,2025-05-25T04:49:00+02:00,2025-05-25,12:49,3,2,5
31,2025-05-25T04:50:00+02:00,2025-05-25,12:50,2,2,4
31,2025-05-25T04:51:00+02:00,2025-05-25,12:51,3,5,8
31,2025-05-25T04:52:00+02:00,2025-05-25,12:52,3,8,11
36,2025-05-25T04:44:00+02:00,2025-05-25,12:44,1,0,1
36,2025-05-25T04:45:00+02:00,2025-05-25,12:45,0,2,2
36,2025-05-25T04:48:00+02:00,2025-05-25,12:48,0,1,1
36,2025-05-25T04:50:00+02:00,2025-05-25,12:50,0,2,2
36,2025-05-25T04:52:00+02:00,2025-05-25,12:52,4,7,11
40,2025-05-25T04:47:00+02:00,2025-05-25,12:47,4,3,7
40,2025-05-25T04:50:00+02:00,2025-05-25,12:50,3,5,8
40,2025-05-25T04:53:00+02:00,2025-05-25,12:53,1,9,10
40,2025-05-25T04:54:00+02:00,2025-05-25,12:54,3,5,8
41,2025-05-25T04:42:00+02:00,2025-05-25,12:42,7,3,10
41,2025-05-25T04:43:00+02:00,2025-05-25,12:43,4,16,20
41,2025-05-25T04:48:00+02:00,2025-05-25,12:48,9,0,9
41,2025-05-25T04:50:00+02:00,2025-05-25,12:50,5,2,7
43,2025-05-25T04:40:00+02:00,2025-05-25,12:40,2,8,10
45,2025-05-25T04:41:00+02:00,2025-05-25,12:41,20,11,31
45,2025-05-25T04:44:00+02:00,2025-05-25,12:44,25,23,48
45,2025-05-25T04:45:00+02:00,2025-05-25,12:45,25,23,48
45,2025-05-25T04:46:00+02:00,2025-05-25,12:46,13,23,36
45,2025-05-25T04:53:00+02:00,2025-05-25,12:53,12,20,32
47,2025-05-25T04:40:00+02:00,2025-05-25,12:40,20,14,34
47,2025-05-25T04:44:00+02:00,2025-05-25,12:44,8,19,27
47,2025-05-25T04:45:00+02:00,2025-05-25,12:45,9,5,14
47,2025-05-25T04:50:00+02:00,2025-05-25,12:50,12,15,27
47,2025-05-25T04:52:00+02:00,2025-05-25,12:52,9,29,38
47,2025-05-25T04:54:00+02:00,2025-05-25,12:54,25,21,46
50,2025-05-25T04:45:00+02:00,2025-05-25,12:45,1,2,3
50,2025-05-25T04:49:00+02:00,2025-05-25,12:49,6,4,10
50,2025-05-25T04:51:00+02:00,2025-05-25,12:51,1,1,2
50,2025-05-25T04:54:00+02:00,2025-05-25,12:54,7,5,12
54,2025-05-25T04:41:00+02:00,2025-05-25,12:41,2,2,4
54,2025-05-25T04:47:00+02:00,2025-05-25,12:47,11,1,12
54,2025-05-25T04:48:00+02:00,2025-05-25,12:48,4,5,9
61,2025-05-25T04:47:00+02:00,2025-05-25,12:47,8,1,9
61,2025-05-25T04:49:00+02:00,2025-05-25,12:49,7,7,14
61,2025-05-25T04:50:00+02:00,2025-05-25,12:50,7,0,7
61,2025-05-25T04:52:00+02:00,2025-05-25,12:52,10,8,18
61,2025-05-25T04:53:00+02:00,2025-05-25,12:53,8,13,21
61,2025-05-25T04:54:00+02:00,2025-05-25,12:54,16,9,25
66,2025-05-25T04:40:00+02:00,2025-05-25,12:40,24,25,49
66,2025-05-25T04:41:00+02:00,2025-05-25,12:41,12,13,25
66,2025-05-25T04:42:00+02:00,2025-05-25,12:42,14,24,38
66,2025-05-25T04:43:00+02:00,2025-05-25,12:43,12,22,34
66,2025-05-25T04:45:00+02:00,2025-05-25,12:45,22,40,62
66,2025-05-25T04:46:00+02:00,2025-05-25,12:46,17,21,38
66,2025-05-25T04:48:00+02:00,2025-05-25,12:48,27,31,58
66,2025-05-25T04:49:00+02:00,2025-05-25,12:49,13,28,41
69,2025-05-25T04:42:00+02:00,2025-05-25,12:42,6,2,8
69,2025-05-25T04:43:00+02:00,2025-05-25,12:43,9,4,13
69,2025-05-25T04:47:00+02:00,2025-05-25,12:47,0,6,6
70,2025-05-25T04:40:00+02:00,2025-05-25,12:40,0,5,5
70,2025-05-25T04:42:00+02:00,2025-05-25,12:42,0,1,1
70,2025-05-25T04:44:00+02:00,2025-05-25,12:44,5,1,6
70,2025-05-25T04:50:00+02:00,2025-05-25,12:50,3,6,9
71,2025-05-25T04:42:00+02:00,2025-05-25,12:42,4,0,4
75,2025-05-25T04:42:00+02:00,2025-05-25,12:42,3,2,5
75,2025-05-25T04:49:00+02:00,2025-05-25,12:49,2,2,4
78,2025-05-25T04:44:00+02:00,2025-05-25,12:44,0,2,2
78,2025-05-25T04:46:00+02:00,2025-05-25,12:46,0,2,2
84,2025-05-25T04:40:00+02:00,2025-05-25,12:40,81,97,178
87,2025-05-25T04:43:00+02:00,2025-05-25,12:43,1,1,2
87,2025-05-25T04:47:00+02:00,2025-05-25,12:47,2,4,6
87,2025-05-25T04:49:00+02:00,2025-05-25,12:49,2,3,5
87,2025-05-25T04:50:00+02:00,2025-05-25,12:50,0,2,2
87,2025-05-25T04:54:00+02:00,2025-05-25,12:54,2,3,5
107,2025-05-25T04:40:00+02:00,2025-05-25,12:40,5,12,17
107,2025-05-25T04:45:00+02:00,2025-05-25,12:45,11,14,25
108,2025-05-25T04:40:00+02:00,2025-05-25,12:40,2,0,2
108,2025-05-25T04:42:00+02:00,2025-05-25,12:42,10,6,16
108,2025-05-25T04:45:00+02:00,2025-05-25,12:45,1,1,2
108,2025-05-25T04:51:00+02:00,2025-05-25,12:51,7,0,7
108,2025-05-25T04:52:00+02:00,2025-05-25,12:52,2,3,5
118,2025-05-25T04:50:00+02:00,2025-05-25,12:50,4,3,7
124,2025-05-25T04:45:00+02:00,2025-05-25,12:45,0,2,2
131,2025-05-25T04:40:00+02:00,2025-05-25,12:40,4,14,18
133,2025-05-25T04:45:00+02:00,2025-05-25,12:45,40,42,82
134,2025-05-25T04:50:00+02:00,2025-05-25,12:50,52,33,85
140,2025-05-25T04:40:00+02:00,2025-05-25,12:40,7,7,14
140,2025-05-25T04:45:00+02:00,2025-05-25,12:45,11,4,15
162,2025-05-25T04:45:00+02:00,2025-05-25,12:45,54,71,125
166,2025-05-25T04:40:00+02:00,2025-05-25,12:40,7,8,15
166,2025-05-25T04:45:00+02:00,2025-05-25,12:45,8,4,12
167,2025-05-25T04:40:00+02:00,2025-05-25,12:40,1,3,4
167,2025-05-25T04:45:00+02:00,2025-05-25,12:45,1,1,2
167,2025-05-25T04:50:00+02:00,2025-05-25,12:50,0,4,4
179,2025-05-25T04:45:00+02:00,2025-05-25,12:45,5,3,8
1,2025-05-25T04:43:00+02:00,2025-05-25,12:43,38,16,54
1,2025-05-25T04:50:00+02:00,2025-05-25,12:50,32,13,45
1,2025-05-25T04:51:00+02:00,2025-05-25,12:51,15,10,25
1,2025-05-25T04:52:00+02:00,2025-05-25,12:52,24,33,57
1,2025-05-25T04:53:00+02:00,2025-05-25,12:53,21,17,38
1,2025-05-25T04:54:00+02:00,2025-05-25,12:54,21,29,50
2,2025-05-25T04:40:00+02:00,2025-05-25,12:40,19,15,34
2,2025-05-25T04:41:00+02:00,2025-05-25,12:41,19,5,24
2,2025-05-25T04:43:00+02:00,2025-05-25,12:43,16,12,28
2,2025-05-25T04:51:00+02:00,2025-05-25,12:51,13,11,24
9,2025-05-25T04:40:00+02:00,2025-05-25,12:40,3,1,4
9,2025-05-25T04:44:00+02:00,2025-05-25,12:44,0,2,2
9,2025-05-25T04:45:00+02:00,2025-05-25,12:45,0,2,2
10,2025-05-25T04:43:00+02:00,2025-05-25,12:43,0,1,1
10,2025-05-25T04:44:00+02:00,2025-05-25,12:44,4,5,9
10,2025-05-25T04:52:00+02:00,2025-05-25,12:52,2,0,2
10,2025-05-25T04:53:00+02:00,2025-05-25,12:53,3,1,4
11,2025-05-25T04:40:00+02:00,2025-05-25,12:40,5,7,12
11,2025-05-25T04:43:00+02:00,2025-05-25,12:43,0,1,1
11,2025-05-25T04:46:00+02:00,2025-05-25,12:46,2,2,4
11,2025-05-25T04:47:00+02:00,2025-05-25,12:47,1,0,1
11,2025-05-25T04:50:00+02:00,2025-05-25,12:50,1,7,8
11,2025-05-25T04:53:00+02:00,2025-05-25,12:53,0,4,4
12,2025-05-25T04:41:00+02:00,2025-05-25,12:41,3,3,6
12,2025-05-25T04:42:00+02:00,2025-05-25,12:42,2,1,3
12,2025-05-25T04:43:00+02:00,2025-05-25,12:43,5,6,11
12,2025-05-25T04:44:00+02:00,2025-05-25,12:44,2,5,7
12,2025-05-25T04:53:00+02:00,2025-05-25,12:53,1,8,9
17,2025-05-25T04:43:00+02:00,2025-05-25,12:43,11,2,13
17,2025-05-25T04:46:00+02:00,2025-05-25,12:46,3,3,6
17,2025-05-25T04:47:00+02:00,2025-05-25,12:47,5,2,7
17,2025-05-25T04:53:00+02:00,2025-05-25,12:53,12,1,13
17,2025-05-25T04:54:00+02:00,2025-05-25,12:54,9,1,10
18,2025-05-25T04:40:00+02:00,2025-05-25,12:40,3,0,3
18,2025-05-25T04:42:00+02:00,2025-05-25,12:42,3,0,3
18,2025-05-25T04:45:00+02:00,2025-05-25,12:45,2,2,4
18,2025-05-25T04:46:00+02:00,2025-05-25,12:46,1,0,1
18,2025-05-25T04:49:00+02:00,2025-05-25,12:49,4,2,6
18,2025-05-25T04:53:00+02:00,2025-05-25,12:53,0,2,2
18,2025-05-25T04:54:00+02:00,2025-05-25,12:54,1,0,1
181,2025-05-25T05:10:00+02:00,2025-05-25,13:10,19,37,56
181,2025-05-25T05:11:00+02:00,2025-05-25,13:11,9,27,36
181,2025-05-25T05:15:00+02:00,2025-05-25,13:15,13,17,30
181,2025-05-25T05:17:00+02:00,2025-05-25,13:17,8,17,25
181,2025-05-25T05:20:00+02:00,2025-05-25,13:20,16,25,41
182,2025-05-25T05:15:00+02:00,2025-05-25,13:15,20,14,34
180,2025-05-25T05:20:00+02:00,2025-05-25,13:20,1,0,1
3,2025-05-25T05:13:00+02:00,2025-05-25,13:13,29,23,52
3,2025-05-25T05:15:00+02:00,2025-05-25,13:15,7,21,28
3,2025-05-25T05:19:00+02:00,2025-05-25,13:19,24,34,58
3,2025-05-25T05:20:00+02:00,2025-05-25,13:20,15,14,29
3,2025-05-25T05:23:00+02:00,2025-05-25,13:23,20,33,53
3,2025-05-25T05:24:00+02:00,2025-05-25,13:24,22,22,44
4,2025-05-25T05:11:00+02:00,2025-05-25,13:11,39,27,66
4,2025-05-25T05:13:00+02:00,2025-05-25,13:13,40,30,70
4,2025-05-25T05:14:00+02:00,2025-05-25,13:14,39,24,63
4,2025-05-25T05:15:00+02:00,2025-05-25,13:15,30,31,61
4,2025-05-25T05:16:00+02:00,2025-05-25,13:16,33,25,58
4,2025-05-25T05:17:00+02:00,2025-05-25,13:17,28,26,54
4,2025-05-25T05:20:00+02:00,2025-05-25,13:20,29,13,42
4,2025-05-25T05:23:00+02:00,2025-05-25,13:23,20,24,44
5,2025-05-25T05:10:00+02:00,2025-05-25,13:10,60,81,141
5,2025-05-25T05:20:00+02:00,2025-05-25,13:20,91,93,184
6,2025-05-25T05:12:00+02:00,2025-05-25,13:12,19,11,30
6,2025-05-25T05:14:00+02:00,2025-05-25,13:14,8,5,13
6,2025-05-25T05:15:00+02:00,2025-05-25,13:15,12,22,34
6,2025-05-25T05:16:00+02:00,2025-05-25,13:16,14,2,16
6,2025-05-25T05:17:00+02:00,2025-05-25,13:17,11,9,20
6,2025-05-25T05:19:00+02:00,2025-05-25,13:19,15,10,25
6,2025-05-25T05:21:00+02:00,2025-05-25,13:21,5,10,15
8,2025-05-25T05:10:00+02:00,2025-05-25,13:10,4,0,4
8,2025-05-25T05:12:00+02:00,2025-05-25,13:12,1,7,8
8,2025-05-25T05:13:00+02:00,2025-05-25,13:13,2,12,14
8,2025-05-25T05:15:00+02:00,2025-05-25,13:15,11,3,14
8,2025-05-25T05:19:00+02:00,2025-05-25,13:19,4,1,5
8,2025-05-25T05:21:00+02:00,2025-05-25,13:21,3,0,3
28,2025-05-25T05:10:00+02:00,2025-05-25,13:10,14,4,18
28,2025-05-25T05:11:00+02:00,2025-05-25,13:11,12,8,20
28,2025-05-25T05:12:00+02:00,2025-05-25,13:12,12,7,19
28,2025-05-25T05:17:00+02:00,2025-05-25,13:17,9,12,21
28,2025-05-25T05:19:00+02:00,2025-05-25,13:19,6,19,25
28,2025-05-25T05:21:00+02:00,2025-05-25,13:21,7,7,14
28,2025-05-25T05:22:00+02:00,2025-05-25,13:22,2,12,14
28,2025-05-25T05:24:00+02:00,2025-05-25,13:24,14,6,20
29,2025-05-25T05:10:00+02:00,2025-05-25,13:10,2,9,11
29,2025-05-25T05:13:00+02:00,2025-05-25,13:13,5,1,6
29,2025-05-25T05:14:00+02:00,2025-05-25,13:14,6,9,15
29,2025-05-25T05:19:00+02:00,2025-05-25,13:19,7,14,21
29,2025-05-25T05:22:00+02:00,2025-05-25,13:22,20,20,40
29,2025-05-25T05:24:00+02:00,2025-05-25,13:24,10,20,30
31,2025-05-25T05:11:00+02:00,2025-05-25,13:11,2,4,6
31,2025-05-25T05:18:00+02:00,2025-05-25,13:18,0,8,8
36,2025-05-25T05:14:00+02:00,2025-05-25,13:14,3,2,5
36,2025-05-25T05:17:00+02:00,2025-05-25,13:17,6,1,7
39,2025-05-25T05:10:00+02:00,2025-05-25,13:10,1,1,2
40,2025-05-25T05:11:00+02:00,2025-05-25,13:11,2,2,4
40,2025-05-25T05:13:00+02:00,2025-05-25,13:13,3,8,11
40,2025-05-25T05:16:00+02:00,2025-05-25,13:16,2,1,3
40,2025-05-25T05:17:00+02:00,2025-05-25,13:17,4,6,10
40,2025-05-25T05:22:00+02:00,2025-05-25,13:22,5,0,5
40,2025-05-25T05:24:00+02:00,2025-05-25,13:24,1,2,3
41,2025-05-25T05:15:00+02:00,2025-05-25,13:15,12,2,14
41,2025-05-25T05:20:00+02:00,2025-05-25,13:20,0,2,2
41,2025-05-25T05:21:00+02:00,2025-05-25,13:21,0,9,9
44,2025-05-25T05:20:00+02:00,2025-05-25,13:20,7,6,13
45,2025-05-25T05:15:00+02:00,2025-05-25,13:15,37,13,50
45,2025-05-25T05:20:00+02:00,2025-05-25,13:20,25,23,48
45,2025-05-25T05:23:00+02:00,2025-05-25,13:23,9,14,23
47,2025-05-25T05:10:00+02:00,2025-05-25,13:10,21,18,39
47,2025-05-25T05:13:00+02:00,2025-05-25,13:13,14,10,24
47,2025-05-25T05:17:00+02:00,2025-05-25,13:17,16,22,38
47,2025-05-25T05:23:00+02:00,2025-05-25,13:23,15,23,38
50,2025-05-25T05:13:00+02:00,2025-05-25,13:13,5,6,11
50,2025-05-25T05:14:00+02:00,2025-05-25,13:14,2,4,6
50,2025-05-25T05:20:00+02:00,2025-05-25,13:20,6,4,10
50,2025-05-25T05:22:00+02:00,2025-05-25,13:22,3,2,5
54,2025-05-25T05:10:00+02:00,2025-05-25,13:10,4,4,8
54,2025-05-25T05:11:00+02:00,2025-05-25,13:11,0,1,1
54,2025-05-25T05:18:00+02:00,2025-05-25,13:18,0,1,1
54,2025-05-25T05:22:00+02:00,2025-05-25,13:22,1,2,3
54,2025-05-25T05:24:00+02:00,2025-05-25,13:24,4,0,4
61,2025-05-25T05:10:00+02:00,2025-05-25,13:10,12,6,18
61,2025-05-25T05:11:00+02:00,2025-05-25,13:11,10,10,20
61,2025-05-25T05:13:00+02:00,2025-05-25,13:13,7,17,24
61,2025-05-25T05:15:00+02:00,2025-05-25,13:15,14,9,23
61,2025-05-25T05:23:00+02:00,2025-05-25,13:23,4,4,8
66,2025-05-25T05:11:00+02:00,2025-05-25,13:11,25,14,39
66,2025-05-25T05:13:00+02:00,2025-05-25,13:13,10,27,37
66,2025-05-25T05:15:00+02:00,2025-05-25,13:15,24,26,50
66,2025-05-25T05:16:00+02:00,2025-05-25,13:16,12,48,60
66,2025-05-25T05:21:00+02:00,2025-05-25,13:21,24,40,64
66,2025-05-25T05:22:00+02:00,2025-05-25,13:22,16,38,54
69,2025-05-25T05:12:00+02:00,2025-05-25,13:12,2,2,4
69,2025-05-25T05:17:00+02:00,2025-05-25,13:17,6,2,8
69,2025-05-25T05:18:00+02:00,2025-05-25,13:18,7,3,10
69,2025-05-25T05:22:00+02:00,2025-05-25,13:22,3,1,4
70,2025-05-25T05:17:00+02:00,2025-05-25,13:17,4,2,6
70,2025-05-25T05:22:00+02:00,2025-05-25,13:22,4,1,5
70,2025-05-25T05:24:00+02:00,2025-05-25,13:24,1,2,3
75,2025-05-25T05:14:00+02:00,2025-05-25,13:14,0,1,1
75,2025-05-25T05:22:00+02:00,2025-05-25,13:22,2,0,2
77,2025-05-25T05:10:00+02:00,2025-05-25,13:10,13,4,17
77,2025-05-25T05:15:00+02:00,2025-05-25,13:15,12,7,19
78,2025-05-25T05:11:00+02:00,2025-05-25,13:11,1,1,2
78,2025-05-25T05:15:00+02:00,2025-05-25,13:15,0,2,2
78,2025-05-25T05:20:00+02:00,2025-05-25,13:20,2,4,6
84,2025-05-25T05:10:00+02:00,2025-05-25,13:10,74,117,191
87,2025-05-25T05:14:00+02:00,2025-05-25,13:14,0,2,2
87,2025-05-25T05:15:00+02:00,2025-05-25,13:15,1,4,5
87,2025-05-25T05:18:00+02:00,2025-05-25,13:18,1,3,4
87,2025-05-25T05:19:00+02:00,2025-05-25,13:19,1,1,2
87,2025-05-25T05:22:00+02:00,2025-05-25,13:22,4,4,8
87,2025-05-25T05:24:00+02:00,2025-05-25,13:24,2,2,4
107,2025-05-25T05:15:00+02:00,2025-05-25,13:15,8,12,20
108,2025-05-25T05:13:00+02:00,2025-05-25,13:13,4,1,5
108,2025-05-25T05:14:00+02:00,2025-05-25,13:14,9,5,14
108,2025-05-25T05:16:00+02:00,2025-05-25,13:16,6,4,10
108,2025-05-25T05:19:00+02:00,2025-05-25,13:19,0,7,7
108,2025-05-25T05:23:00+02:00,2025-05-25,13:23,3,1,4
118,2025-05-25T05:20:00+02:00,2025-05-25,13:20,0,4,4
131,2025-05-25T05:10:00+02:00,2025-05-25,13:10,10,8,18
131,2025-05-25T05:15:00+02:00,2025-05-25,13:15,10,4,14
131,2025-05-25T05:20:00+02:00,2025-05-25,13:20,11,8,19
132,2025-05-25T05:10:00+02:00,2025-05-25,13:10,22,10,32
133,2025-05-25T05:20:00+02:00,2025-05-25,13:20,29,34,63
134,2025-05-25T05:20:00+02:00,2025-05-25,13:20,27,23,50
135,2025-05-25T05:15:00+02:00,2025-05-25,13:15,40,32,72
140,2025-05-25T05:20:00+02:00,2025-05-25,13:20,10,10,20
162,2025-05-25T05:20:00+02:00,2025-05-25,13:20,49,81,130
165,2025-05-25T05:15:00+02:00,2025-05-25,13:15,2,5,7
166,2025-05-25T05:10:00+02:00,2025-05-25,13:10,2,7,9
166,2025-05-25T05:20:00+02:00,2025-05-25,13:20,2,9,11
179,2025-05-25T05:10:00+02:00,2025-05-25,13:10,5,3,8
179,2025-05-25T05:20:00+02:00,2025-05-25,13:20,8,6,14
1,2025-05-25T05:10:00+02:00,2025-05-25,13:10,35,23,58
1,2025-05-25T05:11:00+02:00,2025-05-25,13:11,24,22,46
1,2025-05-25T05:19:00+02:00,2025-05-25,13:19,23,13,36
1,2025-05-25T05:20:00+02:00,2025-05-25,13:20,16,13,29
2,2025-05-25T05:13:00+02:00,2025-05-25,13:13,22,5,27
2,2025-05-25T05:14:00+02:00,2025-05-25,13:14,14,12,26
2,2025-05-25T05:17:00+02:00,2025-05-25,13:17,13,9,22
2,2025-05-25T05:18:00+02:00,2025-05-25,13:18,19,12,31
2,2025-05-25T05:20:00+02:00,2025-05-25,13:20,17,8,25
9,2025-05-25T05:12:00+02:00,2025-05-25,13:12,0,1,1
9,2025-05-25T05:15:00+02:00,2025-05-25,13:15,1,6,7
9,2025-05-25T05:17:00+02:00,2025-05-25,13:17,3,0,3
9,2025-05-25T05:19:00+02:00,2025-05-25,13:19,0,1,1
9,2025-05-25T05:20:00+02:00,2025-05-25,13:20,0,3,3
9,2025-05-25T05:22:00+02:00,2025-05-25,13:22,2,3,5
9,2025-05-25T05:23:00+02:00,2025-05-25,13:23,1,1,2
10,2025-05-25T05:11:00+02:00,2025-05-25,13:11,0,1,1
10,2025-05-25T05:12:00+02:00,2025-05-25,13:12,0,2,2
10,2025-05-25T05:14:00+02:00,2025-05-25,13:14,1,0,1
10,2025-05-25T05:21:00+02:00,2025-05-25,13:21,2,0,2
10,2025-05-25T05:23:00+02:00,2025-05-25,13:23,3,0,3
11,2025-05-25T05:12:00+02:00,2025-05-25,13:12,2,4,6
11,2025-05-25T05:15:00+02:00,2025-05-25,13:15,8,2,10
11,2025-05-25T05:17:00+02:00,2025-05-25,13:17,4,4,8
11,2025-05-25T05:21:00+02:00,2025-05-25,13:21,2,0,2
12,2025-05-25T05:10:00+02:00,2025-05-25,13:10,3,5,8
12,2025-05-25T05:12:00+02:00,2025-05-25,13:12,6,2,8
12,2025-05-25T05:14:00+02:00,2025-05-25,13:14,3,4,7
12,2025-05-25T05:24:00+02:00,2025-05-25,13:24,1,5,6
17,2025-05-25T05:13:00+02:00,2025-05-25,13:13,6,1,7
17,2025-05-25T05:16:00+02:00,2025-05-25,13:16,5,0,5
17,2025-05-25T05:18:00+02:00,2025-05-25,13:18,7,1,8
17,2025-05-25T05:19:00+02:00,2025-05-25,13:19,2,3,5
18,2025-05-25T05:16:00+02:00,2025-05-25,13:16,1,2,3
18,2025-05-25T05:23:00+02:00,2025-05-25,13:23,2,1,3
19,2025-05-25T05:10:00+02:00,2025-05-25,13:10,8,8,16
19,2025-05-25T05:12:00+02:00,2025-05-25,13:12,3,7,10
19,2025-05-25T05:13:00+02:00,2025-05-25,13:13,16,6,22
19,2025-05-25T05:14:00+02:00,2025-05-25,13:14,14,4,18
19,2025-05-25T05:17:00+02:00,2025-05-25,13:17,9,7,16
19,2025-05-25T05:18:00+02:00,2025-05-25,13:18,7,4,11
19,2025-05-25T05:22:00+02:00,2025-05-25,13:22,4,12,16
20,2025-05-25T05:11:00+02:00,2025-05-25,13:11,7,0,7
20,2025-05-25T05:14:00+02:00,2025-05-25,13:14,3,4,7
20,2025-05-25T05:23:00+02:00,2025-05-25,13:23,1,6,7
20,2025-05-25T05:24:00+02:00,2025-05-25,13:24,4,12,16
23,2025-05-25T05:10:00+02:00,2025-05-25,13:10,3,4,7
23,2025-05-25T05:12:00+02:00,2025-05-25,13:12,1,5,6
23,2025-05-25T05:15:00+02:00,2025-05-25,13:15,5,2,7
24,2025-05-25T05:15:00+02:00,2025-05-25,13:15,13,4,17
24,2025-05-25T05:19:00+02:00,2025-05-25,13:19,10,12,22
24,2025-05-25T05:23:00+02:00,2025-05-25,13:23,4,0,4
24,2025-05-25T05:24:00+02:00,2025-05-25,13:24,8,1,9
25,2025-05-25T05:15:00+02:00,2025-05-25,13:15,66,75,141
25,2025-05-25T05:20:00+02:00,2025-05-25,13:20,88,76,164
27,2025-05-25T05:14:00+02:00,2025-05-25,13:14,1,2,3
27,2025-05-25T05:22:00+02:00,2025-05-25,13:22,10,1,11
30,2025-05-25T05:10:00+02:00,2025-05-25,13:10,8,6,14
30,2025-05-25T05:11:00+02:00,2025-05-25,13:11,6,13,19
30,2025-05-25T05:15:00+02:00,2025-05-25,13:15,5,6,11
30,2025-05-25T05:16:00+02:00,2025-05-25,13:16,3,12,15
30,2025-05-25T05:19:00+02:00,2025-05-25,13:19,6,8,14
30,2025-05-25T05:22:00+02:00,2025-05-25,13:22,11,4,15
35,2025-05-25T05:12:00+02:00,2025-05-25,13:12,8,20,28
35,2025-05-25T05:17:00+02:00,2025-05-25,13:17,17,30,47
35,2025-05-25T05:18:00+02:00,2025-05-25,13:18,14,27,41
35,2025-05-25T05:19:00+02:00,2025-05-25,13:19,16,12,28
46,2025-05-25T05:15:00+02:00,2025-05-25,13:15,1,7,8
46,2025-05-25T05:20:00+02:00,2025-05-25,13:20,5,6,11
48,2025-05-25T05:13:00+02:00,2025-05-25,13:13,5,6,11
48,2025-05-25T05:15:00+02:00,2025-05-25,13:15,13,7,20
48,2025-05-25T05:17:00+02:00,2025-05-25,13:17,17,3,20
48,2025-05-25T05:18:00+02:00,2025-05-25,13:18,11,13,24
48,2025-05-25T05:19:00+02:00,2025-05-25,13:19,11,1,12
48,2025-05-25T05:22:00+02:00,2025-05-25,13:22,13,16,29
48,2025-05-25T05:24:00+02:00,2025-05-25,13:24,22,8,30
49,2025-05-25T05:10:00+02:00,2025-05-25,13:10,2,9,11
49,2025-05-25T05:11:00+02:00,2025-05-25,13:11,15,8,23
49,2025-05-25T05:14:00+02:00,2025-05-25,13:14,12,19,31
49,2025-05-25T05:17:00+02:00,2025-05-25,13:17,5,19,24
49,2025-05-25T05:18:00+02:00,2025-05-25,13:18,3,7,10
49,2025-05-25T05:22:00+02:00,2025-05-25,13:22,13,13,26
51,2025-05-25T05:15:00+02:00,2025-05-25,13:15,4,2,6
51,2025-05-25T05:18:00+02:00,2025-05-25,13:18,3,3,6
51,2025-05-25T05:22:00+02:00,2025-05-25,13:22,1,2,3
51,2025-05-25T05:23:00+02:00,2025-05-25,13:23,1,0,1
51,2025-05-25T05:24:00+02:00,2025-05-25,13:24,5,1,6
52,2025-05-25T05:11:00+02:00,2025-05-25,13:11,13,10,23
52,2025-05-25T05:19:00+02:00,2025-05-25,13:19,6,4,10
52,2025-05-25T05:20:00+02:00,2025-05-25,13:20,6,4,10
52,2025-05-25T05:22:00+02:00,2025-05-25,13:22,3,3,6
53,2025-05-25T05:14:00+02:00,2025-05-25,13:14,9,11,20
53,2025-05-25T05:15:00+02:00,2025-05-25,13:15,7,4,11
53,2025-05-25T05:18:00+02:00,2025-05-25,13:18,5,6,11
53,2025-05-25T05:22:00+02:00,2025-05-25,13:22,8,8,16
53,2025-05-25T05:23:00+02:00,2025-05-25,13:23,11,15,26
56,2025-05-25T05:13:00+02:00,2025-05-25,13:13,4,4,8
58,2025-05-25T05:10:00+02:00,2025-05-25,13:10,15,3,18
58,2025-05-25T05:11:00+02:00,2025-05-25,13:11,1,10,11
58,2025-05-25T05:12:00+02:00,2025-05-25,13:12,14,9,23
58,2025-05-25T05:17:00+02:00,2025-05-25,13:17,10,12,22
58,2025-05-25T05:19:00+02:00,2025-05-25,13:19,1,4,5
58,2025-05-25T05:21:00+02:00,2025-05-25,13:21,6,8,14
58,2025-05-25T05:22:00+02:00,2025-05-25,13:22,7,5,12
58,2025-05-25T05:23:00+02:00,2025-05-25,13:23,5,3,8
62,2025-05-25T05:13:00+02:00,2025-05-25,13:13,2,2,4
62,2025-05-25T05:18:00+02:00,2025-05-25,13:18,3,1,4
62,2025-05-25T05:19:00+02:00,2025-05-25,13:19,6,1,7
62,2025-05-25T05:21:00+02:00,2025-05-25,13:21,0,3,3
63,2025-05-25T05:12:00+02:00,2025-05-25,13:12,8,4,12
63,2025-05-25T05:13:00+02:00,2025-05-25,13:13,16,4,20
63,2025-05-25T05:16:00+02:00,2025-05-25,13:16,7,5,12
63,2025-05-25T05:17:00+02:00,2025-05-25,13:17,3,0,3
63,2025-05-25T05:21:00+02:00,2025-05-25,13:21,13,9,22
63,2025-05-25T05:24:00+02:00,2025-05-25,13:24,7,11,18
67,2025-05-25T05:13:00+02:00,2025-05-25,13:13,6,7,13
67,2025-05-25T05:19:00+02:00,2025-05-25,13:19,14,12,26
67,2025-05-25T05:21:00+02:00,2025-05-25,13:21,15,9,24
68,2025-05-25T05:12:00+02:00,2025-05-25,13:12,7,8,15
68,2025-05-25T05:14:00+02:00,2025-05-25,13:14,8,12,20
68,2025-05-25T05:16:00+02:00,2025-05-25,13:16,5,6,11
68,2025-05-25T05:17:00+02:00,2025-05-25,13:17,1,3,4
72,2025-05-25T05:12:00+02:00,2025-05-25,13:12,5,1,6
72,2025-05-25T05:16:00+02:00,2025-05-25,13:16,3,4,7
72,2025-05-25T05:17:00+02:00,2025-05-25,13:17,4,10,14
72,2025-05-25T05:21:00+02:00,2025-05-25,13:21,6,10,16
79,2025-05-25T05:14:00+02:00,2025-05-25,13:14,11,5,16
79,2025-05-25T05:18:00+02:00,2025-05-25,13:18,12,7,19
79,2025-05-25T05:19:00+02:00,2025-05-25,13:19,16,6,22
79,2025-05-25T05:22:00+02:00,2025-05-25,13:22,12,7,19
79,2025-05-25T05:23:00+02:00,2025-05-25,13:23,13,12,25
85,2025-05-25T05:10:00+02:00,2025-05-25,13:10,0,2,2
85,2025-05-25T05:11:00+02:00,2025-05-25,13:11,6,0,6
85,2025-05-25T05:14:00+02:00,2025-05-25,13:14,0,3,3
85,2025-05-25T05:17:00+02:00,2025-05-25,13:17,0,1,1
85,2025-05-25T05:24:00+02:00,2025-05-25,13:24,3,1,4
86,2025-05-25T05:10:00+02:00,2025-05-25,13:10,0,3,3
86,2025-05-25T05:13:00+02:00,2025-05-25,13:13,1,0,1
86,2025-05-25T05:15:00+02:00,2025-05-25,13:15,1,0,1
86,2025-05-25T05:17:00+02:00,2025-05-25,13:17,0,1,1
86,2025-05-25T05:21:00+02:00,2025-05-25,13:21,1,3,4
86,2025-05-25T05:22:00+02:00,2025-05-25,13:22,3,0,3
86,2025-05-25T05:24:00+02:00,2025-05-25,13:24,0,3,3
109,2025-05-25T05:10:00+02:00,2025-05-25,13:10,12,6,18
136,2025-05-25T05:15:00+02:00,2025-05-25,13:15,29,10,39
136,2025-05-25T05:20:00+02:00,2025-05-25,13:20,29,18,47
139,2025-05-25T05:10:00+02:00,2025-05-25,13:10,1,1,2
141,2025-05-25T05:10:00+02:00,2025-05-25,13:10,7,8,15
141,2025-05-25T05:15:00+02:00,2025-05-25,13:15,4,14,18
142,2025-05-25T05:15:00+02:00,2025-05-25,13:15,68,40,108
142,2025-05-25T05:20:00+02:00,2025-05-25,13:20,51,59,110
161,2025-05-25T05:10:00+02:00,2025-05-25,13:10,36,10,46
164,2025-05-25T05:15:00+02:00,2025-05-25,13:15,9,2,11
181,2025-05-25T05:26:00+02:00,2025-05-25,13:26,2,21,23
181,2025-05-25T05:28:00+02:00,2025-05-25,13:28,29,22,51
181,2025-05-25T05:29:00+02:00,2025-05-25,13:29,12,17,29
181,2025-05-25T05:31:00+02:00,2025-05-25,13:31,8,11,19
181,2025-05-25T05:32:00+02:00,2025-05-25,13:32,15,30,45
181,2025-05-25T05:37:00+02:00,2025-05-25,13:37,17,15,32
180,2025-05-25T05:32:00+02:00,2025-05-25,13:32,1,0,1
180,2025-05-25T05:35:00+02:00,2025-05-25,13:35,1,0,1
3,2025-05-25T06:11:00+02:00,2025-05-25,14:11,21,21,42
3,2025-05-25T06:13:00+02:00,2025-05-25,14:13,28,18,46
3,2025-05-25T06:20:00+02:00,2025-05-25,14:20,15,25,40
3,2025-05-25T06:21:00+02:00,2025-05-25,14:21,29,23,52
3,2025-05-25T06:22:00+02:00,2025-05-25,14:22,37,25,62
3,2025-05-25T06:24:00+02:00,2025-05-25,14:24,19,13,32
4,2025-05-25T06:10:00+02:00,2025-05-25,14:10,32,29,61
4,2025-05-25T06:15:00+02:00,2025-05-25,14:15,37,29,66
4,2025-05-25T06:19:00+02:00,2025-05-25,14:19,32,19,51
5,2025-05-25T06:20:00+02:00,2025-05-25,14:20,97,103,200
6,2025-05-25T06:10:00+02:00,2025-05-25,14:10,17,9,26
6,2025-05-25T06:13:00+02:00,2025-05-25,14:13,25,11,36
6,2025-05-25T06:16:00+02:00,2025-05-25,14:16,12,19,31
6,2025-05-25T06:18:00+02:00,2025-05-25,14:18,19,21,40
6,2025-05-25T06:21:00+02:00,2025-05-25,14:21,10,7,17
6,2025-05-25T06:22:00+02:00,2025-05-25,14:22,17,12,29
6,2025-05-25T06:23:00+02:00,2025-05-25,14:23,14,20,34
8,2025-05-25T06:13:00+02:00,2025-05-25,14:13,8,4,12
8,2025-05-25T06:14:00+02:00,2025-05-25,14:14,6,2,8
8,2025-05-25T06:17:00+02:00,2025-05-25,14:17,6,2,8
8,2025-05-25T06:19:00+02:00,2025-05-25,14:19,3,6,9
8,2025-05-25T06:24:00+02:00,2025-05-25,14:24,3,5,8
28,2025-05-25T06:11:00+02:00,2025-05-25,14:11,11,8,19
28,2025-05-25T06:12:00+02:00,2025-05-25,14:12,8,8,16
28,2025-05-25T06:21:00+02:00,2025-05-25,14:21,4,13,17
28,2025-05-25T06:23:00+02:00,2025-05-25,14:23,12,12,24
29,2025-05-25T06:14:00+02:00,2025-05-25,14:14,14,13,27
29,2025-05-25T06:19:00+02:00,2025-05-25,14:19,27,5,32
29,2025-05-25T06:20:00+02:00,2025-05-25,14:20,17,5,22
29,2025-05-25T06:22:00+02:00,2025-05-25,14:22,10,25,35
29,2025-05-25T06:23:00+02:00,2025-05-25,14:23,20,11,31
31,2025-05-25T06:10:00+02:00,2025-05-25,14:10,3,3,6
31,2025-05-25T06:12:00+02:00,2025-05-25,14:12,8,0,8
31,2025-05-25T06:15:00+02:00,2025-05-25,14:15,8,0,8
31,2025-05-25T06:17:00+02:00,2025-05-25,14:17,0,3,3
31,2025-05-25T06:19:00+02:00,2025-05-25,14:19,5,4,9
36,2025-05-25T06:12:00+02:00,2025-05-25,14:12,3,4,7
36,2025-05-25T06:13:00+02:00,2025-05-25,14:13,2,4,6
36,2025-05-25T06:17:00+02:00,2025-05-25,14:17,0,2,2
36,2025-05-25T06:24:00+02:00,2025-05-25,14:24,4,0,4
39,2025-05-25T06:12:00+02:00,2025-05-25,14:12,0,2,2
39,2025-05-25T06:18:00+02:00,2025-05-25,14:18,4,0,4
39,2025-05-25T06:20:00+02:00,2025-05-25,14:20,2,0,2
40,2025-05-25T06:13:00+02:00,2025-05-25,14:13,1,4,5
40,2025-05-25T06:14:00+02:00,2025-05-25,14:14,0,3,3
40,2025-05-25T06:16:00+02:00,2025-05-25,14:16,1,13,14
40,2025-05-25T06:17:00+02:00,2025-05-25,14:17,1,4,5
40,2025-05-25T06:19:00+02:00,2025-05-25,14:19,2,0,2
40,2025-05-25T06:22:00+02:00,2025-05-25,14:22,1,1,2
40,2025-05-25T06:23:00+02:00,2025-05-25,14:23,0,2,2
41,2025-05-25T06:10:00+02:00,2025-05-25,14:10,2,5,7
41,2025-05-25T06:11:00+02:00,2025-05-25,14:11,6,5,11
41,2025-05-25T06:13:00+02:00,2025-05-25,14:13,6,15,21
41,2025-05-25T06:14:00+02:00,2025-05-25,14:14,7,6,13
41,2025-05-25T06:15:00+02:00,2025-05-25,14:15,7,5,12
41,2025-05-25T06:21:00+02:00,2025-05-25,14:21,28,12,40
43,2025-05-25T06:20:00+02:00,2025-05-25,14:20,5,1,6
44,2025-05-25T06:15:00+02:00,2025-05-25,14:15,1,1,2
45,2025-05-25T06:15:00+02:00,2025-05-25,14:15,11,15,26
45,2025-05-25T06:19:00+02:00,2025-05-25,14:19,18,34,52
45,2025-05-25T06:24:00+02:00,2025-05-25,14:24,5,32,37
47,2025-05-25T06:18:00+02:00,2025-05-25,14:18,15,28,43
47,2025-05-25T06:19:00+02:00,2025-05-25,14:19,8,25,33
47,2025-05-25T06:22:00+02:00,2025-05-25,14:22,19,15,34
50,2025-05-25T06:12:00+02:00,2025-05-25,14:12,8,4,12
50,2025-05-25T06:13:00+02:00,2025-05-25,14:13,6,6,12
50,2025-05-25T06:15:00+02:00,2025-05-25,14:15,7,3,10
50,2025-05-25T06:24:00+02:00,2025-05-25,14:24,1,3,4
54,2025-05-25T06:13:00+02:00,2025-05-25,14:13,5,0,5
54,2025-05-25T06:15:00+02:00,2025-05-25,14:15,1,3,4
54,2025-05-25T06:16:00+02:00,2025-05-25,14:16,2,0,2
54,2025-05-25T06:21:00+02:00,2025-05-25,14:21,1,4,5
54,2025-05-25T06:22:00+02:00,2025-05-25,14:22,3,0,3
54,2025-05-25T06:24:00+02:00,2025-05-25,14:24,2,1,3
59,2025-05-25T06:10:00+02:00,2025-05-25,14:10,23,39,62
61,2025-05-25T06:10:00+02:00,2025-05-25,14:10,11,4,15
61,2025-05-25T06:12:00+02:00,2025-05-25,14:12,8,15,23
61,2025-05-25T06:14:00+02:00,2025-05-25,14:14,14,5,19
61,2025-05-25T06:15:00+02:00,2025-05-25,14:15,14,7,21
61,2025-05-25T06:18:00+02:00,2025-05-25,14:18,11,2,13
61,2025-05-25T06:23:00+02:00,2025-05-25,14:23,9,8,17
66,2025-05-25T06:15:00+02:00,2025-05-25,14:15,25,43,68
66,2025-05-25T06:17:00+02:00,2025-05-25,14:17,26,28,54
66,2025-05-25T06:21:00+02:00,2025-05-25,14:21,29,34,63
66,2025-05-25T06:23:00+02:00,2025-05-25,14:23,20,21,41
66,2025-05-25T06:24:00+02:00,2025-05-25,14:24,44,29,73
69,2025-05-25T06:13:00+02:00,2025-05-25,14:13,2,6,8
69,2025-05-25T06:18:00+02:00,2025-05-25,14:18,7,8,15
69,2025-05-25T06:22:00+02:00,2025-05-25,14:22,1,7,8
70,2025-05-25T06:10:00+02:00,2025-05-25,14:10,0,9,9
70,2025-05-25T06:11:00+02:00,2025-05-25,14:11,1,0,1
70,2025-05-25T06:14:00+02:00,2025-05-25,14:14,1,3,4
70,2025-05-25T06:16:00+02:00,2025-05-25,14:16,1,6,7
70,2025-05-25T06:22:00+02:00,2025-05-25,14:22,6,5,11
70,2025-05-25T06:24:00+02:00,2025-05-25,14:24,1,1,2
71,2025-05-25T06:14:00+02:00,2025-05-25,14:14,0,4,4
71,2025-05-25T06:22:00+02:00,2025-05-25,14:22,1,0,1
75,2025-05-25T06:10:00+02:00,2025-05-25,14:10,1,0,1
75,2025-05-25T06:13:00+02:00,2025-05-25,14:13,1,2,3
75,2025-05-25T06:16:00+02:00,2025-05-25,14:16,0,4,4
75,2025-05-25T06:18:00+02:00,2025-05-25,14:18,0,2,2
75,2025-05-25T06:23:00+02:00,2025-05-25,14:23,3,0,3
77,2025-05-25T06:15:00+02:00,2025-05-25,14:15,23,15,38
78,2025-05-25T06:19:00+02:00,2025-05-25,14:19,2,0,2
78,2025-05-25T06:21:00+02:00,2025-05-25,14:21,0,1,1
84,2025-05-25T06:10:00+02:00,2025-05-25,14:10,96,122,218
84,2025-05-25T06:15:00+02:00,2025-05-25,14:15,76,146,222
84,2025-05-25T06:20:00+02:00,2025-05-25,14:20,87,132,219
87,2025-05-25T06:10:00+02:00,2025-05-25,14:10,1,3,4
87,2025-05-25T06:13:00+02:00,2025-05-25,14:13,1,0,1
87,2025-05-25T06:19:00+02:00,2025-05-25,14:19,4,4,8
87,2025-05-25T06:21:00+02:00,2025-05-25,14:21,3,6,9
107,2025-05-25T06:10:00+02:00,2025-05-25,14:10,16,20,36
108,2025-05-25T06:15:00+02:00,2025-05-25,14:15,1,1,2
108,2025-05-25T06:16:00+02:00,2025-05-25,14:16,3,2,5
108,2025-05-25T06:17:00+02:00,2025-05-25,14:17,3,9,12
108,2025-05-25T06:18:00+02:00,2025-05-25,14:18,3,1,4
108,2025-05-25T06:19:00+02:00,2025-05-25,14:19,4,6,10
108,2025-05-25T06:20:00+02:00,2025-05-25,14:20,1,4,5
118,2025-05-25T06:10:00+02:00,2025-05-25,14:10,3,5,8
118,2025-05-25T06:20:00+02:00,2025-05-25,14:20,2,6,8
124,2025-05-25T06:15:00+02:00,2025-05-25,14:15,0,4,4
131,2025-05-25T06:10:00+02:00,2025-05-25,14:10,16,16,32
131,2025-05-25T06:15:00+02:00,2025-05-25,14:15,11,14,25
132,2025-05-25T06:10:00+02:00,2025-05-25,14:10,13,14,27
132,2025-05-25T06:15:00+02:00,2025-05-25,14:15,16,8,24
132,2025-05-25T06:20:00+02:00,2025-05-25,14:20,11,9,20
134,2025-05-25T06:15:00+02:00,2025-05-25,14:15,36,40,76
134,2025-05-25T06:20:00+02:00,2025-05-25,14:20,32,21,53
162,2025-05-25T06:10:00+02:00,2025-05-25,14:10,73,87,160
166,2025-05-25T06:10:00+02:00,2025-05-25,14:10,3,5,8
179,2025-05-25T06:10:00+02:00,2025-05-25,14:10,3,7,10
179,2025-05-25T06:20:00+02:00,2025-05-25,14:20,10,4,14
1,2025-05-25T06:13:00+02:00,2025-05-25,14:13,29,23,52
1,2025-05-25T06:18:00+02:00,2025-05-25,14:18,11,31,42
1,2025-05-25T06:23:00+02:00,2025-05-25,14:23,19,31,50
2,2025-05-25T06:12:00+02:00,2025-05-25,14:12,5,11,16
2,2025-05-25T06:13:00+02:00,2025-05-25,14:13,14,12,26
2,2025-05-25T06:19:00+02:00,2025-05-25,14:19,14,8,22
2,2025-05-25T06:21:00+02:00,2025-05-25,14:21,11,9,20
2,2025-05-25T06:22:00+02:00,2025-05-25,14:22,12,8,20
9,2025-05-25T06:10:00+02:00,2025-05-25,14:10,3,0,3
9,2025-05-25T06:22:00+02:00,2025-05-25,14:22,2,3,5
10,2025-05-25T06:16:00+02:00,2025-05-25,14:16,0,2,2
11,2025-05-25T06:10:00+02:00,2025-05-25,14:10,10,54,64
11,2025-05-25T06:14:00+02:00,2025-05-25,14:14,1,58,59
11,2025-05-25T06:23:00+02:00,2025-05-25,14:23,2,2,4
12,2025-05-25T06:10:00+02:00,2025-05-25,14:10,3,2,5
12,2025-05-25T06:11:00+02:00,2025-05-25,14:11,6,18,24
12,2025-05-25T06:12:00+02:00,2025-05-25,14:12,10,5,15
12,2025-05-25T06:14:00+02:00,2025-05-25,14:14,1,10,11
12,2025-05-25T06:16:00+02:00,2025-05-25,14:16,9,6,15
12,2025-05-25T06:18:00+02:00,2025-05-25,14:18,5,5,10
12,2025-05-25T06:22:00+02:00,2025-05-25,14:22,6,0,6
17,2025-05-25T06:10:00+02:00,2025-05-25,14:10,2,3,5
17,2025-05-25T06:15:00+02:00,2025-05-25,14:15,2,2,4
17,2025-05-25T06:21:00+02:00,2025-05-25,14:21,0,2,2
17,2025-05-25T06:23:00+02:00,2025-05-25,14:23,0,1,1
18,2025-05-25T06:11:00+02:00,2025-05-25,14:11,2,3,5
18,2025-05-25T06:12:00+02:00,2025-05-25,14:12,2,0,2
18,2025-05-25T06:13:00+02:00,2025-05-25,14:13,3,3,6
18,2025-05-25T06:15:00+02:00,2025-05-25,14:15,1,0,1
18,2025-05-25T06:18:00+02:00,2025-05-25,14:18,0,1,1
18,2025-05-25T06:20:00+02:00,2025-05-25,14:20,1,1,2
19,2025-05-25T06:12:00+02:00,2025-05-25,14:12,13,7,20
19,2025-05-25T06:17:00+02:00,2025-05-25,14:17,13,10,23
19,2025-05-25T06:19:00+02:00,2025-05-25,14:19,12,5,17
19,2025-05-25T06:20:00+02:00,2025-05-25,14:20,8,5,13
19,2025-05-25T06:21:00+02:00,2025-05-25,14:21,14,6,20
19,2025-05-25T06:23:00+02:00,2025-05-25,14:23,7,11,18
20,2025-05-25T06:21:00+02:00,2025-05-25,14:21,10,0,10
20,2025-05-25T06:24:00+02:00,2025-05-25,14:24,5,14,19
23,2025-05-25T06:12:00+02:00,2025-05-25,14:12,2,1,3
23,2025-05-25T06:13:00+02:00,2025-05-25,14:13,2,3,5
23,2025-05-25T06:15:00+02:00,2025-05-25,14:15,2,1,3
23,2025-05-25T06:20:00+02:00,2025-05-25,14:20,0,2,2
24,2025-05-25T06:11:00+02:00,2025-05-25,14:11,3,14,17
24,2025-05-25T06:12:00+02:00,2025-05-25,14:12,7,14,21
24,2025-05-25T06:17:00+02:00,2025-05-25,14:17,7,4,11
24,2025-05-25T06:20:00+02:00,2025-05-25,14:20,5,4,9
24,2025-05-25T06:23:00+02:00,2025-05-25,14:23,14,22,36
25,2025-05-25T06:10:00+02:00,2025-05-25,14:10,71,57,128
25,2025-05-25T06:20:00+02:00,2025-05-25,14:20,81,56,137
27,2025-05-25T06:11:00+02:00,2025-05-25,14:11,2,10,12
27,2025-05-25T06:14:00+02:00,2025-05-25,14:14,1,0,1
27,2025-05-25T06:15:00+02:00,2025-05-25,14:15,4,3,7
27,2025-05-25T06:16:00+02:00,2025-05-25,14:16,6,0,6
27,2025-05-25T06:17:00+02:00,2025-05-25,14:17,4,0,4
27,2025-05-25T06:18:00+02:00,2025-05-25,14:18,0,2,2
27,2025-05-25T06:19:00+02:00,2025-05-25,14:19,1,1,2
30,2025-05-25T06:13:00+02:00,2025-05-25,14:13,4,6,10
30,2025-05-25T06:19:00+02:00,2025-05-25,14:19,4,9,13
30,2025-05-25T06:20:00+02:00,2025-05-25,14:20,6,8,14
30,2025-05-25T06:22:00+02:00,2025-05-25,14:22,3,7,10
30,2025-05-25T06:23:00+02:00,2025-05-25,14:23,4,6,10
35,2025-05-25T06:11:00+02:00,2025-05-25,14:11,28,17,45
35,2025-05-25T06:12:00+02:00,2025-05-25,14:12,20,25,45
35,2025-05-25T06:22:00+02:00,2025-05-25,14:22,37,18,55
35,2025-05-25T06:23:00+02:00,2025-05-25,14:23,22,25,47
35,2025-05-25T06:24:00+02:00,2025-05-25,14:24,22,17,39
48,2025-05-25T06:11:00+02:00,2025-05-25,14:11,14,7,21
48,2025-05-25T06:15:00+02:00,2025-05-25,14:15,7,8,15
48,2025-05-25T06:16:00+02:00,2025-05-25,14:16,13,6,19
48,2025-05-25T06:20:00+02:00,2025-05-25,14:20,13,8,21
48,2025-05-25T06:21:00+02:00,2025-05-25,14:21,17,6,23
48,2025-05-25T06:24:00+02:00,2025-05-25,14:24,12,2,14
49,2025-05-25T06:12:00+02:00,2025-05-25,14:12,8,12,20
49,2025-05-25T06:13:00+02:00,2025-05-25,14:13,6,13,19
49,2025-05-25T06:16:00+02:00,2025-05-25,14:16,3,6,9
49,2025-05-25T06:20:00+02:00,2025-05-25,14:20,8,3,11
49,2025-05-25T06:22:00+02:00,2025-05-25,14:22,12,10,22
49,2025-05-25T06:24:00+02:00,2025-05-25,14:24,6,4,10
51,2025-05-25T06:11:00+02:00,2025-05-25,14:11,3,5,8
51,2025-05-25T06:14:00+02:00,2025-05-25,14:14,3,7,10
51,2025-05-25T06:15:00+02:00,2025-05-25,14:15,0,6,6
51,2025-05-25T06:17:00+02:00,2025-05-25,14:17,4,0,4
51,2025-05-25T06:18:00+02:00,2025-05-25,14:18,6,0,6
51,2025-05-25T06:19:00+02:00,2025-05-25,14:19,2,2,4
51,2025-05-25T06:20:00+02:00,2025-05-25,14:20,5,5,10
51,2025-05-25T06:21:00+02:00,2025-05-25,14:21,0,4,4
51,2025-05-25T06:22:00+02:00,2025-05-25,14:22,2,6,8
52,2025-05-25T06:12:00+02:00,2025-05-25,14:12,3,4,7
52,2025-05-25T06:14:00+02:00,2025-05-25,14:14,5,15,20
52,2025-05-25T06:18:00+02:00,2025-05-25,14:18,8,5,13
52,2025-05-25T06:21:00+02:00,2025-05-25,14:21,6,8,14
52,2025-05-25T06:22:00+02:00,2025-05-25,14:22,4,4,8
52,2025-05-25T06:24:00+02:00,2025-05-25,14:24,2,4,6
53,2025-05-25T06:14:00+02:00,2025-05-25,14:14,12,17,29
53,2025-05-25T06:15:00+02:00,2025-05-25,14:15,7,10,17
53,2025-05-25T06:18:00+02:00,2025-05-25,14:18,6,11,17
53,2025-05-25T06:20:00+02:00,2025-05-25,14:20,8,3,11
53,2025-05-25T06:24:00+02:00,2025-05-25,14:24,11,1,12
56,2025-05-25T06:10:00+02:00,2025-05-25,14:10,8,13,21
56,2025-05-25T06:12:00+02:00,2025-05-25,14:12,11,7,18
56,2025-05-25T06:15:00+02:00,2025-05-25,14:15,14,4,18
56,2025-05-25T06:20:00+02:00,2025-05-25,14:20,6,11,17
56,2025-05-25T06:22:00+02:00,2025-05-25,14:22,6,4,10
58,2025-05-25T06:10:00+02:00,2025-05-25,14:10,15,3,18
58,2025-05-25T06:19:00+02:00,2025-05-25,14:19,5,7,12
62,2025-05-25T06:12:00+02:00,2025-05-25,14:12,6,5,11
62,2025-05-25T06:14:00+02:00,2025-05-25,14:14,6,3,9
62,2025-05-25T06:15:00+02:00,2025-05-25,14:15,9,2,11
62,2025-05-25T06:16:00+02:00,2025-05-25,14:16,6,6,12
62,2025-05-25T06:24:00+02:00,2025-05-25,14:24,6,9,15
63,2025-05-25T06:10:00+02:00,2025-05-25,14:10,8,0,8
63,2025-05-25T06:11:00+02:00,2025-05-25,14:11,5,7,12
63,2025-05-25T06:20:00+02:00,2025-05-25,14:20,7,10,17
63,2025-05-25T06:21:00+02:00,2025-05-25,14:21,9,5,14
63,2025-05-25T06:24:00+02:00,2025-05-25,14:24,7,12,19
67,2025-05-25T06:15:00+02:00,2025-05-25,14:15,4,9,13
67,2025-05-25T06:20:00+02:00,2025-05-25,14:20,3,18,21
68,2025-05-25T06:10:00+02:00,2025-05-25,14:10,4,0,4
68,2025-05-25T06:11:00+02:00,2025-05-25,14:11,5,4,9
68,2025-05-25T06:13:00+02:00,2025-05-25,14:13,6,5,11
68,2025-05-25T06:14:00+02:00,2025-05-25,14:14,0,3,3
68,2025-05-25T06:18:00+02:00,2025-05-25,14:18,3,5,8
68,2025-05-25T06:19:00+02:00,2025-05-25,14:19,4,10,14
68,2025-05-25T06:20:00+02:00,2025-05-25,14:20,6,0,6
68,2025-05-25T06:24:00+02:00,2025-05-25,14:24,4,10,14
72,2025-05-25T06:10:00+02:00,2025-05-25,14:10,9,6,15
72,2025-05-25T06:14:00+02:00,2025-05-25,14:14,8,9,17
72,2025-05-25T06:16:00+02:00,2025-05-25,14:16,4,29,33
72,2025-05-25T06:18:00+02:00,2025-05-25,14:18,2,14,16
72,2025-05-25T06:23:00+02:00,2025-05-25,14:23,10,5,15
76,2025-05-25T06:20:00+02:00,2025-05-25,14:20,2,1,3
76,2025-05-25T06:22:00+02:00,2025-05-25,14:22,2,0,2
79,2025-05-25T06:16:00+02:00,2025-05-25,14:16,13,8,21
79,2025-05-25T06:17:00+02:00,2025-05-25,14:17,12,7,19
79,2025-05-25T06:19:00+02:00,2025-05-25,14:19,28,6,34
79,2025-05-25T06:21:00+02:00,2025-05-25,14:21,12,13,25
85,2025-05-25T06:17:00+02:00,2025-05-25,14:17,2,1,3
85,2025-05-25T06:18:00+02:00,2025-05-25,14:18,1,4,5
85,2025-05-25T06:24:00+02:00,2025-05-25,14:24,1,1,2
86,2025-05-25T06:10:00+02:00,2025-05-25,14:10,1,0,1
86,2025-05-25T06:11:00+02:00,2025-05-25,14:11,1,1,2
86,2025-05-25T06:12:00+02:00,2025-05-25,14:12,0,4,4
86,2025-05-25T06:15:00+02:00,2025-05-25,14:15,1,0,1
86,2025-05-25T06:21:00+02:00,2025-05-25,14:21,0,1,1
86,2025-05-25T06:22:00+02:00,2025-05-25,14:22,5,2,7
109,2025-05-25T06:20:00+02:00,2025-05-25,14:20,8,6,14
123,2025-05-25T06:15:00+02:00,2025-05-25,14:15,3,10,13
123,2025-05-25T06:20:00+02:00,2025-05-25,14:20,9,0,9
138,2025-05-25T06:15:00+02:00,2025-05-25,14:15,0,1,1
139,2025-05-25T06:15:00+02:00,2025-05-25,14:15,10,12,22
141,2025-05-25T06:15:00+02:00,2025-05-25,14:15,24,19,43
142,2025-05-25T06:10:00+02:00,2025-05-25,14:10,49,30,79
142,2025-05-25T06:20:00+02:00,2025-05-25,14:20,63,54,117
161,2025-05-25T06:10:00+02:00,2025-05-25,14:10,126,9,135
161,2025-05-25T06:15:00+02:00,2025-05-25,14:15,96,20,116
161,2025-05-25T06:20:00+02:00,2025-05-25,14:20,143,27,170
164,2025-05-25T06:15:00+02:00,2025-05-25,14:15,28,8,36
181,2025-05-25T06:27:00+02:00,2025-05-25,14:27,7,27,34
181,2025-05-25T06:28:00+02:00,2025-05-25,14:28,6,10,16
181,2025-05-25T06:30:00+02:00,2025-05-25,14:30,13,35,48
181,2025-05-25T06:31:00+02:00,2025-05-25,14:31,14,20,34
181,2025-05-25T06:36:00+02:00,2025-05-25,14:36,10,25,35
180,2025-05-25T06:27:00+02:00,2025-05-25,14:27,1,0,1
180,2025-05-25T06:28:00+02:00,2025-05-25,14:28,3,0,3
180,2025-05-25T06:29:00+02:00,2025-05-25,14:29,4,1,5
180,2025-05-25T06:30:00+02:00,2025-05-25,14:30,1,0,1
180,2025-05-25T06:32:00+02:00,2025-05-25,14:32,1,0,1
180,2025-05-25T06:37:00+02:00,2025-05-25,14:37,6,2,8
3,2025-05-25T07:10:00+02:00,2025-05-25,15:10,25,13,38
3,2025-05-25T07:11:00+02:00,2025-05-25,15:11,18,25,43
3,2025-05-25T07:12:00+02:00,2025-05-25,15:12,18,20,38
3,2025-05-25T07:13:00+02:00,2025-05-25,15:13,14,11,25
3,2025-05-25T07:20:00+02:00,2025-05-25,15:20,8,20,28
3,2025-05-25T07:21:00+02:00,2025-05-25,15:21,25,37,62
3,2025-05-25T07:22:00+02:00,2025-05-25,15:22,31,17,48
3,2025-05-25T07:24:00+02:00,2025-05-25,15:24,30,18,48
4,2025-05-25T07:10:00+02:00,2025-05-25,15:10,24,38,62
4,2025-05-25T07:13:00+02:00,2025-05-25,15:13,40,30,70
4,2025-05-25T07:14:00+02:00,2025-05-25,15:14,26,45,71
4,2025-05-25T07:15:00+02:00,2025-05-25,15:15,31,26,57
4,2025-05-25T07:16:00+02:00,2025-05-25,15:16,34,54,88
4,2025-05-25T07:17:00+02:00,2025-05-25,15:17,29,25,54
4,2025-05-25T07:21:00+02:00,2025-05-25,15:21,22,25,47
5,2025-05-25T07:10:00+02:00,2025-05-25,15:10,100,120,220
5,2025-05-25T07:15:00+02:00,2025-05-25,15:15,91,129,220
6,2025-05-25T07:10:00+02:00,2025-05-25,15:10,16,8,24
6,2025-05-25T07:15:00+02:00,2025-05-25,15:15,20,19,39
6,2025-05-25T07:20:00+02:00,2025-05-25,15:20,14,11,25
6,2025-05-25T07:24:00+02:00,2025-05-25,15:24,24,17,41
8,2025-05-25T07:10:00+02:00,2025-05-25,15:10,0,9,9
8,2025-05-25T07:15:00+02:00,2025-05-25,15:15,1,8,9
8,2025-05-25T07:18:00+02:00,2025-05-25,15:18,5,5,10
8,2025-05-25T07:19:00+02:00,2025-05-25,15:19,0,4,4
8,2025-05-25T07:21:00+02:00,2025-05-25,15:21,2,3,5
28,2025-05-25T07:11:00+02:00,2025-05-25,15:11,8,8,16
28,2025-05-25T07:14:00+02:00,2025-05-25,15:14,11,13,24
28,2025-05-25T07:15:00+02:00,2025-05-25,15:15,16,11,27
28,2025-05-25T07:19:00+02:00,2025-05-25,15:19,14,22,36
28,2025-05-25T07:20:00+02:00,2025-05-25,15:20,5,14,19
29,2025-05-25T07:10:00+02:00,2025-05-25,15:10,10,11,21
29,2025-05-25T07:11:00+02:00,2025-05-25,15:11,11,17,28
29,2025-05-25T07:13:00+02:00,2025-05-25,15:13,10,24,34
29,2025-05-25T07:17:00+02:00,2025-05-25,15:17,21,12,33
29,2025-05-25T07:23:00+02:00,2025-05-25,15:23,12,15,27
31,2025-05-25T07:13:00+02:00,2025-05-25,15:13,1,1,2
31,2025-05-25T07:14:00+02:00,2025-05-25,15:14,2,7,9
31,2025-05-25T07:17:00+02:00,2025-05-25,15:17,8,5,13
31,2025-05-25T07:19:00+02:00,2025-05-25,15:19,0,11,11
31,2025-05-25T07:21:00+02:00,2025-05-25,15:21,6,0,6
36,2025-05-25T07:11:00+02:00,2025-05-25,15:11,4,4,8
36,2025-05-25T07:21:00+02:00,2025-05-25,15:21,1,6,7
36,2025-05-25T07:22:00+02:00,2025-05-25,15:22,0,2,2
36,2025-05-25T07:23:00+02:00,2025-05-25,15:23,1,2,3
39,2025-05-25T07:10:00+02:00,2025-05-25,15:10,3,0,3
39,2025-05-25T07:12:00+02:00,2025-05-25,15:12,1,2,3
40,2025-05-25T07:10:00+02:00,2025-05-25,15:10,11,3,14
40,2025-05-25T07:16:00+02:00,2025-05-25,15:16,0,2,2
40,2025-05-25T07:17:00+02:00,2025-05-25,15:17,9,4,13
40,2025-05-25T07:23:00+02:00,2025-05-25,15:23,4,1,5
41,2025-05-25T07:12:00+02:00,2025-05-25,15:12,2,1,3
41,2025-05-25T07:16:00+02:00,2025-05-25,15:16,1,5,6
41,2025-05-25T07:20:00+02:00,2025-05-25,15:20,7,17,24
41,2025-05-25T07:22:00+02:00,2025-05-25,15:22,10,6,16
41,2025-05-25T07:24:00+02:00,2025-05-25,15:24,2,4,6
44,2025-05-25T07:10:00+02:00,2025-05-25,15:10,7,1,8
45,2025-05-25T07:12:00+02:00,2025-05-25,15:12,19,13,32
45,2025-05-25T07:13:00+02:00,2025-05-25,15:13,15,19,34
45,2025-05-25T07:19:00+02:00,2025-05-25,15:19,24,19,43
45,2025-05-25T07:20:00+02:00,2025-05-25,15:20,6,26,32
45,2025-05-25T07:23:00+02:00,2025-05-25,15:23,13,19,32
47,2025-05-25T07:10:00+02:00,2025-05-25,15:10,13,20,33
47,2025-05-25T07:11:00+02:00,2025-05-25,15:11,11,21,32
47,2025-05-25T07:12:00+02:00,2025-05-25,15:12,9,3,12
47,2025-05-25T07:16:00+02:00,2025-05-25,15:16,10,10,20
47,2025-05-25T07:18:00+02:00,2025-05-25,15:18,15,31,46
47,2025-05-25T07:22:00+02:00,2025-05-25,15:22,6,21,27
47,2025-05-25T07:23:00+02:00,2025-05-25,15:23,23,8,31
50,2025-05-25T07:14:00+02:00,2025-05-25,15:14,2,3,5
50,2025-05-25T07:16:00+02:00,2025-05-25,15:16,4,3,7
50,2025-05-25T07:18:00+02:00,2025-05-25,15:18,13,0,13
50,2025-05-25T07:22:00+02:00,2025-05-25,15:22,3,6,9
54,2025-05-25T07:10:00+02:00,2025-05-25,15:10,2,0,2
54,2025-05-25T07:17:00+02:00,2025-05-25,15:17,0,1,1
54,2025-05-25T07:23:00+02:00,2025-05-25,15:23,1,0,1
59,2025-05-25T07:15:00+02:00,2025-05-25,15:15,23,27,50
61,2025-05-25T07:11:00+02:00,2025-05-25,15:11,5,19,24
61,2025-05-25T07:12:00+02:00,2025-05-25,15:12,14,5,19
61,2025-05-25T07:20:00+02:00,2025-05-25,15:20,3,14,17
66,2025-05-25T07:16:00+02:00,2025-05-25,15:16,36,20,56
69,2025-05-25T07:10:00+02:00,2025-05-25,15:10,6,5,11
69,2025-05-25T07:11:00+02:00,2025-05-25,15:11,4,8,12
69,2025-05-25T07:15:00+02:00,2025-05-25,15:15,2,1,3
69,2025-05-25T07:16:00+02:00,2025-05-25,15:16,4,6,10
69,2025-05-25T07:21:00+02:00,2025-05-25,15:21,0,2,2
69,2025-05-25T07:22:00+02:00,2025-05-25,15:22,3,7,10
70,2025-05-25T07:14:00+02:00,2025-05-25,15:14,2,0,2
70,2025-05-25T07:16:00+02:00,2025-05-25,15:16,1,1,2
70,2025-05-25T07:20:00+02:00,2025-05-25,15:20,2,0,2
70,2025-05-25T07:21:00+02:00,2025-05-25,15:21,4,1,5
70,2025-05-25T07:23:00+02:00,2025-05-25,15:23,2,2,4
75,2025-05-25T07:10:00+02:00,2025-05-25,15:10,1,1,2
75,2025-05-25T07:12:00+02:00,2025-05-25,15:12,1,1,2
75,2025-05-25T07:14:00+02:00,2025-05-25,15:14,0,1,1
75,2025-05-25T07:15:00+02:00,2025-05-25,15:15,0,4,4
75,2025-05-25T07:18:00+02:00,2025-05-25,15:18,2,0,2
75,2025-05-25T07:20:00+02:00,2025-05-25,15:20,4,4,8
75,2025-05-25T07:23:00+02:00,2025-05-25,15:23,2,0,2
78,2025-05-25T07:10:00+02:00,2025-05-25,15:10,0,1,1
78,2025-05-25T07:11:00+02:00,2025-05-25,15:11,2,4,6
78,2025-05-25T07:14:00+02:00,2025-05-25,15:14,3,0,3
78,2025-05-25T07:23:00+02:00,2025-05-25,15:23,1,1,2
84,2025-05-25T07:10:00+02:00,2025-05-25,15:10,92,117,209
84,2025-05-25T07:20:00+02:00,2025-05-25,15:20,78,114,192
87,2025-05-25T07:10:00+02:00,2025-05-25,15:10,5,3,8
87,2025-05-25T07:15:00+02:00,2025-05-25,15:15,4,1,5
87,2025-05-25T07:17:00+02:00,2025-05-25,15:17,2,0,2
87,2025-05-25T07:18:00+02:00,2025-05-25,15:18,0,3,3
107,2025-05-25T07:20:00+02:00,2025-05-25,15:20,6,16,22
108,2025-05-25T07:17:00+02:00,2025-05-25,15:17,0,1,1
108,2025-05-25T07:24:00+02:00,2025-05-25,15:24,0,8,8
131,2025-05-25T07:20:00+02:00,2025-05-25,15:20,21,6,27
132,2025-05-25T07:10:00+02:00,2025-05-25,15:10,27,14,41
133,2025-05-25T07:15:00+02:00,2025-05-25,15:15,51,15,66
134,2025-05-25T07:20:00+02:00,2025-05-25,15:20,28,20,48
135,2025-05-25T07:15:00+02:00,2025-05-25,15:15,32,31,63
140,2025-05-25T07:10:00+02:00,2025-05-25,15:10,12,9,21
162,2025-05-25T07:15:00+02:00,2025-05-25,15:15,56,83,139
162,2025-05-25T07:20:00+02:00,2025-05-25,15:20,49,54,103
165,2025-05-25T07:10:00+02:00,2025-05-25,15:10,3,3,6
165,2025-05-25T07:15:00+02:00,2025-05-25,15:15,4,2,6
167,2025-05-25T07:20:00+02:00,2025-05-25,15:20,2,7,9
179,2025-05-25T07:20:00+02:00,2025-05-25,15:20,5,1,6
1,2025-05-25T07:13:00+02:00,2025-05-25,15:13,31,16,47
1,2025-05-25T07:14:00+02:00,2025-05-25,15:14,22,27,49
1,2025-05-25T07:18:00+02:00,2025-05-25,15:18,28,31,59
1,2025-05-25T07:19:00+02:00,2025-05-25,15:19,18,24,42
2,2025-05-25T07:13:00+02:00,2025-05-25,15:13,10,12,22
2,2025-05-25T07:15:00+02:00,2025-05-25,15:15,13,15,28
2,2025-05-25T07:16:00+02:00,2025-05-25,15:16,9,14,23
2,2025-05-25T07:17:00+02:00,2025-05-25,15:17,10,12,22
2,2025-05-25T07:20:00+02:00,2025-05-25,15:20,11,12,23
2,2025-05-25T07:23:00+02:00,2025-05-25,15:23,14,9,23
9,2025-05-25T07:12:00+02:00,2025-05-25,15:12,1,0,1
9,2025-05-25T07:17:00+02:00,2025-05-25,15:17,0,2,2
9,2025-05-25T07:24:00+02:00,2025-05-25,15:24,0,5,5
10,2025-05-25T07:10:00+02:00,2025-05-25,15:10,0,4,4
10,2025-05-25T07:14:00+02:00,2025-05-25,15:14,1,0,1
11,2025-05-25T07:10:00+02:00,2025-05-25,15:10,8,54,62
11,2025-05-25T07:12:00+02:00,2025-05-25,15:12,5,10,15
11,2025-05-25T07:13:00+02:00,2025-05-25,15:13,1,17,18
11,2025-05-25T07:15:00+02:00,2025-05-25,15:15,7,14,21
11,2025-05-25T07:17:00+02:00,2025-05-25,15:17,1,6,7
11,2025-05-25T07:24:00+02:00,2025-05-25,15:24,7,2,9
12,2025-05-25T07:11:00+02:00,2025-05-25,15:11,2,4,6
12,2025-05-25T07:12:00+02:00,2025-05-25,15:12,6,3,9
12,2025-05-25T07:13:00+02:00,2025-05-25,15:13,7,1,8
12,2025-05-25T07:15:00+02:00,2025-05-25,15:15,4,1,5
12,2025-05-25T07:17:00+02:00,2025-05-25,15:17,10,4,14
12,2025-05-25T07:19:00+02:00,2025-05-25,15:19,1,4,5
17,2025-05-25T07:10:00+02:00,2025-05-25,15:10,2,0,2
17,2025-05-25T07:13:00+02:00,2025-05-25,15:13,4,0,4
17,2025-05-25T07:14:00+02:00,2025-05-25,15:14,4,0,4
17,2025-05-25T07:16:00+02:00,2025-05-25,15:16,6,3,9
17,2025-05-25T07:20:00+02:00,2025-05-25,15:20,5,6,11
18,2025-05-25T07:13:00+02:00,2025-05-25,15:13,0,1,1
18,2025-05-25T07:15:00+02:00,2025-05-25,15:15,2,2,4
18,2025-05-25T07:16:00+02:00,2025-05-25,15:16,0,2,2
18,2025-05-25T07:20:00+02:00,2025-05-25,15:20,2,2,4
18,2025-05-25T07:21:00+02:00,2025-05-25,15:21,0,1,1
18,2025-05-25T07:23:00+02:00,2025-05-25,15:23,2,2,4
19,2025-05-25T07:11:00+02:00,2025-05-25,15:11,11,4,15
19,2025-05-25T07:13:00+02:00,2025-05-25,15:13,18,13,31
19,2025-05-25T07:14:00+02:00,2025-05-25,15:14,9,15,24
19,2025-05-25T07:16:00+02:00,2025-05-25,15:16,18,11,29
19,2025-05-25T07:17:00+02:00,2025-05-25,15:17,13,9,22
19,2025-05-25T07:23:00+02:00,2025-05-25,15:23,10,8,18
20,2025-05-25T07:23:00+02:00,2025-05-25,15:23,0,7,7
23,2025-05-25T07:12:00+02:00,2025-05-25,15:12,2,0,2
23,2025-05-25T07:13:00+02:00,2025-05-25,15:13,3,0,3
23,2025-05-25T07:19:00+02:00,2025-05-25,15:19,4,2,6
23,2025-05-25T07:22:00+02:00,2025-05-25,15:22,0,4,4
23,2025-05-25T07:23:00+02:00,2025-05-25,15:23,1,8,9
24,2025-05-25T07:12:00+02:00,2025-05-25,15:12,3,12,15
24,2025-05-25T07:13:00+02:00,2025-05-25,15:13,11,7,18
24,2025-05-25T07:22:00+02:00,2025-05-25,15:22,3,10,13
25,2025-05-25T07:15:00+02:00,2025-05-25,15:15,111,96,207
25,2025-05-25T07:20:00+02:00,2025-05-25,15:20,67,49,116
27,2025-05-25T07:11:00+02:00,2025-05-25,15:11,3,10,13
27,2025-05-25T07:12:00+02:00,2025-05-25,15:12,1,0,1
27,2025-05-25T07:13:00+02:00,2025-05-25,15:13,1,6,7
27,2025-05-25T07:18:00+02:00,2025-05-25,15:18,2,2,4
30,2025-05-25T07:14:00+02:00,2025-05-25,15:14,2,12,14
30,2025-05-25T07:18:00+02:00,2025-05-25,15:18,1,4,5
30,2025-05-25T07:22:00+02:00,2025-05-25,15:22,1,3,4
30,2025-05-25T07:24:00+02:00,2025-05-25,15:24,11,14,25
35,2025-05-25T07:14:00+02:00,2025-05-25,15:14,11,18,29
35,2025-05-25T07:17:00+02:00,2025-05-25,15:17,32,17,49
35,2025-05-25T07:18:00+02:00,2025-05-25,15:18,20,19,39
35,2025-05-25T07:20:00+02:00,2025-05-25,15:20,22,28,50
46,2025-05-25T07:10:00+02:00,2025-05-25,15:10,6,11,17
48,2025-05-25T07:10:00+02:00,2025-05-25,15:10,11,6,17
48,2025-05-25T07:14:00+02:00,2025-05-25,15:14,6,4,10
48,2025-05-25T07:15:00+02:00,2025-05-25,15:15,9,6,15
48,2025-05-25T07:16:00+02:00,2025-05-25,15:16,6,9,15
48,2025-05-25T07:21:00+02:00,2025-05-25,15:21,8,11,19
48,2025-05-25T07:22:00+02:00,2025-05-25,15:22,7,4,11
48,2025-05-25T07:24:00+02:00,2025-05-25,15:24,12,4,16
49,2025-05-25T07:11:00+02:00,2025-05-25,15:11,5,5,10
49,2025-05-25T07:13:00+02:00,2025-05-25,15:13,7,8,15
49,2025-05-25T07:15:00+02:00,2025-05-25,15:15,4,9,13
49,2025-05-25T07:16:00+02:00,2025-05-25,15:16,10,1,11
49,2025-05-25T07:19:00+02:00,2025-05-25,15:19,15,3,18
51,2025-05-25T07:11:00+02:00,2025-05-25,15:11,4,0,4
51,2025-05-25T07:19:00+02:00,2025-05-25,15:19,3,2,5
51,2025-05-25T07:20:00+02:00,2025-05-25,15:20,0,2,2
51,2025-05-25T07:21:00+02:00,2025-05-25,15:21,1,1,2
51,2025-05-25T07:24:00+02:00,2025-05-25,15:24,0,5,5
52,2025-05-25T07:13:00+02:00,2025-05-25,15:13,6,1,7
52,2025-05-25T07:15:00+02:00,2025-05-25,15:15,7,1,8
52,2025-05-25T07:16:00+02:00,2025-05-25,15:16,7,3,10
52,2025-05-25T07:23:00+02:00,2025-05-25,15:23,3,8,11
53,2025-05-25T07:10:00+02:00,2025-05-25,15:10,9,3,12
53,2025-05-25T07:13:00+02:00,2025-05-25,15:13,4,9,13
53,2025-05-25T07:14:00+02:00,2025-05-25,15:14,16,1,17
53,2025-05-25T07:16:00+02:00,2025-05-25,15:16,11,6,17
53,2025-05-25T07:18:00+02:00,2025-05-25,15:18,11,6,17
53,2025-05-25T07:19:00+02:00,2025-05-25,15:19,10,7,17
53,2025-05-25T07:20:00+02:00,2025-05-25,15:20,26,9,35
53,2025-05-25T07:23:00+02:00,2025-05-25,15:23,14,2,16
53,2025-05-25T07:24:00+02:00,2025-05-25,15:24,7,6,13
56,2025-05-25T07:10:00+02:00,2025-05-25,15:10,13,14,27
56,2025-05-25T07:14:00+02:00,2025-05-25,15:14,17,18,35
56,2025-05-25T07:16:00+02:00,2025-05-25,15:16,17,9,26
56,2025-05-25T07:17:00+02:00,2025-05-25,15:17,24,9,33
56,2025-05-25T07:19:00+02:00,2025-05-25,15:19,8,13,21
56,2025-05-25T07:20:00+02:00,2025-05-25,15:20,15,13,28
56,2025-05-25T07:21:00+02:00,2025-05-25,15:21,14,8,22
56,2025-05-25T07:22:00+02:00,2025-05-25,15:22,9,6,15
56,2025-05-25T07:24:00+02:00,2025-05-25,15:24,12,3,15
58,2025-05-25T07:12:00+02:00,2025-05-25,15:12,12,5,17
58,2025-05-25T07:13:00+02:00,2025-05-25,15:13,10,7,17
58,2025-05-25T07:23:00+02:00,2025-05-25,15:23,5,4,9
62,2025-05-25T07:10:00+02:00,2025-05-25,15:10,8,1,9
62,2025-05-25T07:11:00+02:00,2025-05-25,15:11,4,3,7
62,2025-05-25T07:13:00+02:00,2025-05-25,15:13,3,2,5
62,2025-05-25T07:15:00+02:00,2025-05-25,15:15,7,9,16
62,2025-05-25T07:16:00+02:00,2025-05-25,15:16,8,1,9
62,2025-05-25T07:18:00+02:00,2025-05-25,15:18,6,2,8
62,2025-05-25T07:24:00+02:00,2025-05-25,15:24,4,2,6
63,2025-05-25T07:10:00+02:00,2025-05-25,15:10,3,5,8
63,2025-05-25T07:14:00+02:00,2025-05-25,15:14,4,6,10
63,2025-05-25T07:15:00+02:00,2025-05-25,15:15,9,10,19
63,2025-05-25T07:18:00+02:00,2025-05-25,15:18,3,3,6
63,2025-05-25T07:20:00+02:00,2025-05-25,15:20,4,17,21
63,2025-05-25T07:21:00+02:00,2025-05-25,15:21,14,8,22
67,2025-05-25T07:11:00+02:00,2025-05-25,15:11,5,9,14
67,2025-05-25T07:13:00+02:00,2025-05-25,15:13,6,9,15
67,2025-05-25T07:16:00+02:00,2025-05-25,15:16,6,11,17
68,2025-05-25T07:12:00+02:00,2025-05-25,15:12,6,9,15
68,2025-05-25T07:20:00+02:00,2025-05-25,15:20,8,5,13
68,2025-05-25T07:23:00+02:00,2025-05-25,15:23,2,3,5
72,2025-05-25T07:15:00+02:00,2025-05-25,15:15,6,15,21
72,2025-05-25T07:16:00+02:00,2025-05-25,15:16,15,6,21
72,2025-05-25T07:24:00+02:00,2025-05-25,15:24,1,27,28
76,2025-05-25T07:14:00+02:00,2025-05-25,15:14,3,0,3
76,2025-05-25T07:17:00+02:00,2025-05-25,15:17,3,1,4
76,2025-05-25T07:23:00+02:00,2025-05-25,15:23,1,0,1
79,2025-05-25T07:15:00+02:00,2025-05-25,15:15,8,8,16
79,2025-05-25T07:16:00+02:00,2025-05-25,15:16,11,6,17
79,2025-05-25T07:20:00+02:00,2025-05-25,15:20,22,13,35
85,2025-05-25T07:12:00+02:00,2025-05-25,15:12,1,2,3
85,2025-05-25T07:19:00+02:00,2025-05-25,15:19,0,2,2
85,2025-05-25T07:20:00+02:00,2025-05-25,15:20,2,2,4
85,2025-05-25T07:22:00+02:00,2025-05-25,15:22,1,1,2
86,2025-05-25T07:11:00+02:00,2025-05-25,15:11,2,0,2
123,2025-05-25T07:10:00+02:00,2025-05-25,15:10,8,0,8
130,2025-05-25T07:10:00+02:00,2025-05-25,15:10,6,2,8
137,2025-05-25T07:20:00+02:00,2025-05-25,15:20,3,0,3
138,2025-05-25T07:10:00+02:00,2025-05-25,15:10,0,11,11
138,2025-05-25T07:15:00+02:00,2025-05-25,15:15,3,0,3
141,2025-05-25T07:10:00+02:00,2025-05-25,15:10,9,12,21
141,2025-05-25T07:15:00+02:00,2025-05-25,15:15,17,18,35
142,2025-05-25T07:15:00+02:00,2025-05-25,15:15,56,61,117
161,2025-05-25T07:10:00+02:00,2025-05-25,15:10,73,14,87
161,2025-05-25T07:20:00+02:00,2025-05-25,15:20,48,13,61
181,2025-05-25T07:26:00+02:00,2025-05-25,15:26,14,17,31
181,2025-05-25T07:29:00+02:00,2025-05-25,15:29,3,27,30
181,2025-05-25T07:31:00+02:00,2025-05-25,15:31,14,36,50
181,2025-05-25T07:32:00+02:00,2025-05-25,15:32,15,26,41
181,2025-05-25T07:34:00+02:00,2025-05-25,15:34,9,12,21
182,2025-05-25T07:35:00+02:00,2025-05-25,15:35,8,24,32
180,2025-05-25T07:25:00+02:00,2025-05-25,15:25,0,3,3
180,2025-05-25T07:34:00+02:00,2025-05-25,15:34,0,1,1
180,2025-05-25T07:35:00+02:00,2025-05-25,15:35,4,0,4
180,2025-05-25T07:37:00+02:00,2025-05-25,15:37,1,0,1
180,2025-05-25T07:38:00+02:00,2025-05-25,15:38,2,0,2
3,2025-05-25T07:56:00+02:00,2025-05-25,15:56,19,20,39
3,2025-05-25T07:58:00+02:00,2025-05-25,15:58,18,23,41
3,2025-05-25T08:02:00+02:00,2025-05-25,16:02,11,18,29
4,2025-05-25T07:55:00+02:00,2025-05-25,15:55,47,34,81
4,2025-05-25T07:57:00+02:00,2025-05-25,15:57,50,42,92
4,2025-05-25T07:58:00+02:00,2025-05-25,15:58,20,37,57
4,2025-05-25T08:04:00+02:00,2025-05-25,16:04,24,34,58
4,2025-05-25T08:07:00+02:00,2025-05-25,16:07,26,13,39
4,2025-05-25T08:08:00+02:00,2025-05-25,16:08,24,13,37
4,2025-05-25T08:09:00+02:00,2025-05-25,16:09,16,16,32
6,2025-05-25T08:00:00+02:00,2025-05-25,16:00,19,23,42
6,2025-05-25T08:05:00+02:00,2025-05-25,16:05,15,10,25
6,2025-05-25T08:06:00+02:00,2025-05-25,16:06,21,7,28
8,2025-05-25T08:02:00+02:00,2025-05-25,16:02,0,3,3
8,2025-05-25T08:04:00+02:00,2025-05-25,16:04,4,4,8
8,2025-05-25T08:06:00+02:00,2025-05-25,16:06,6,2,8
8,2025-05-25T08:09:00+02:00,2025-05-25,16:09,12,3,15
28,2025-05-25T07:55:00+02:00,2025-05-25,15:55,7,0,7
28,2025-05-25T07:57:00+02:00,2025-05-25,15:57,8,16,24
28,2025-05-25T08:03:00+02:00,2025-05-25,16:03,9,6,15
28,2025-05-25T08:06:00+02:00,2025-05-25,16:06,19,5,24
29,2025-05-25T07:59:00+02:00,2025-05-25,15:59,6,23,29
29,2025-05-25T08:00:00+02:00,2025-05-25,16:00,7,15,22
29,2025-05-25T08:01:00+02:00,2025-05-25,16:01,5,11,16
29,2025-05-25T08:05:00+02:00,2025-05-25,16:05,18,8,26
29,2025-05-25T08:07:00+02:00,2025-05-25,16:07,12,10,22
31,2025-05-25T07:55:00+02:00,2025-05-25,15:55,0,1,1
31,2025-05-25T07:57:00+02:00,2025-05-25,15:57,2,0,2
31,2025-05-25T07:58:00+02:00,2025-05-25,15:58,0,8,8
31,2025-05-25T08:01:00+02:00,2025-05-25,16:01,9,1,10
31,2025-05-25T08:04:00+02:00,2025-05-25,16:04,1,1,2
31,2025-05-25T08:08:00+02:00,2025-05-25,16:08,5,4,9
31,2025-05-25T08:09:00+02:00,2025-05-25,16:09,6,1,7
36,2025-05-25T07:55:00+02:00,2025-05-25,15:55,1,0,1
36,2025-05-25T07:57:00+02:00,2025-05-25,15:57,2,2,4
36,2025-05-25T08:02:00+02:00,2025-05-25,16:02,1,3,4
36,2025-05-25T08:03:00+02:00,2025-05-25,16:03,0,1,1
36,2025-05-25T08:08:00+02:00,2025-05-25,16:08,0,5,5
39,2025-05-25T08:02:00+02:00,2025-05-25,16:02,5,2,7
39,2025-05-25T08:04:00+02:00,2025-05-25,16:04,0,1,1
39,2025-05-25T08:06:00+02:00,2025-05-25,16:06,0,4,4
39,2025-05-25T08:09:00+02:00,2025-05-25,16:09,2,0,2
40,2025-05-25T07:57:00+02:00,2025-05-25,15:57,1,1,2
40,2025-05-25T08:01:00+02:00,2025-05-25,16:01,1,3,4
40,2025-05-25T08:02:00+02:00,2025-05-25,16:02,3,2,5
40,2025-05-25T08:08:00+02:00,2025-05-25,16:08,2,2,4
41,2025-05-25T07:58:00+02:00,2025-05-25,15:58,11,14,25
41,2025-05-25T08:02:00+02:00,2025-05-25,16:02,12,5,17
41,2025-05-25T08:03:00+02:00,2025-05-25,16:03,15,16,31
41,2025-05-25T08:04:00+02:00,2025-05-25,16:04,13,12,25
41,2025-05-25T08:07:00+02:00,2025-05-25,16:07,14,3,17
43,2025-05-25T07:55:00+02:00,2025-05-25,15:55,5,0,5
44,2025-05-25T08:05:00+02:00,2025-05-25,16:05,11,2,13
45,2025-05-25T07:55:00+02:00,2025-05-25,15:55,31,21,52
45,2025-05-25T08:02:00+02:00,2025-05-25,16:02,9,45,54
45,2025-05-25T08:04:00+02:00,2025-05-25,16:04,19,31,50
45,2025-05-25T08:07:00+02:00,2025-05-25,16:07,14,19,33
45,2025-05-25T08:09:00+02:00,2025-05-25,16:09,17,11,28
47,2025-05-25T07:59:00+02:00,2025-05-25,15:59,17,26,43
47,2025-05-25T08:01:00+02:00,2025-05-25,16:01,24,29,53
47,2025-05-25T08:02:00+02:00,2025-05-25,16:02,26,24,50
47,2025-05-25T08:03:00+02:00,2025-05-25,16:03,15,17,32
47,2025-05-25T08:06:00+02:00,2025-05-25,16:06,32,9,41
47,2025-05-25T08:08:00+02:00,2025-05-25,16:08,16,17,33
50,2025-05-25T08:02:00+02:00,2025-05-25,16:02,5,2,7
50,2025-05-25T08:03:00+02:00,2025-05-25,16:03,4,6,10
50,2025-05-25T08:08:00+02:00,2025-05-25,16:08,4,5,9
54,2025-05-25T07:55:00+02:00,2025-05-25,15:55,2,0,2
54,2025-05-25T08:00:00+02:00,2025-05-25,16:00,1,0,1
54,2025-05-25T08:03:00+02:00,2025-05-25,16:03,0,2,2
61,2025-05-25T07:56:00+02:00,2025-05-25,15:56,5,8,13
61,2025-05-25T07:57:00+02:00,2025-05-25,15:57,7,11,18
61,2025-05-25T08:00:00+02:00,2025-05-25,16:00,5,5,10
61,2025-05-25T08:02:00+02:00,2025-05-25,16:02,7,12,19
61,2025-05-25T08:04:00+02:00,2025-05-25,16:04,10,13,23
61,2025-05-25T08:06:00+02:00,2025-05-25,16:06,13,3,16
61,2025-05-25T08:09:00+02:00,2025-05-25,16:09,13,9,22
66,2025-05-25T07:55:00+02:00,2025-05-25,15:55,24,24,48
66,2025-05-25T07:56:00+02:00,2025-05-25,15:56,23,14,37
66,2025-05-25T07:57:00+02:00,2025-05-25,15:57,28,16,44
66,2025-05-25T08:04:00+02:00,2025-05-25,16:04,25,31,56
66,2025-05-25T08:05:00+02:00,2025-05-25,16:05,15,12,27
66,2025-05-25T08:07:00+02:00,2025-05-25,16:07,28,22,50
69,2025-05-25T08:03:00+02:00,2025-05-25,16:03,1,0,1
69,2025-05-25T08:06:00+02:00,2025-05-25,16:06,1,2,3
70,2025-05-25T07:58:00+02:00,2025-05-25,15:58,1,8,9
70,2025-05-25T08:00:00+02:00,2025-05-25,16:00,1,1,2
70,2025-05-25T08:04:00+02:00,2025-05-25,16:04,1,5,6
70,2025-05-25T08:05:00+02:00,2025-05-25,16:05,1,1,2
70,2025-05-25T08:08:00+02:00,2025-05-25,16:08,5,4,9
71,2025-05-25T07:57:00+02:00,2025-05-25,15:57,0,1,1
75,2025-05-25T07:55:00+02:00,2025-05-25,15:55,1,1,2
75,2025-05-25T07:56:00+02:00,2025-05-25,15:56,1,0,1
78,2025-05-25T07:58:00+02:00,2025-05-25,15:58,2,0,2
78,2025-05-25T08:03:00+02:00,2025-05-25,16:03,2,0,2
78,2025-05-25T08:05:00+02:00,2025-05-25,16:05,0,2,2
84,2025-05-25T07:55:00+02:00,2025-05-25,15:55,51,134,185
87,2025-05-25T07:59:00+02:00,2025-05-25,15:59,2,0,2
87,2025-05-25T08:00:00+02:00,2025-05-25,16:00,1,1,2
87,2025-05-25T08:01:00+02:00,2025-05-25,16:01,2,0,2
87,2025-05-25T08:03:00+02:00,2025-05-25,16:03,1,0,1
107,2025-05-25T08:00:00+02:00,2025-05-25,16:00,7,12,19
107,2025-05-25T08:05:00+02:00,2025-05-25,16:05,4,7,11
108,2025-05-25T08:01:00+02:00,2025-05-25,16:01,2,5,7
108,2025-05-25T08:02:00+02:00,2025-05-25,16:02,3,2,5
108,2025-05-25T08:03:00+02:00,2025-05-25,16:03,2,1,3
108,2025-05-25T08:04:00+02:00,2025-05-25,16:04,3,2,5
108,2025-05-25T08:05:00+02:00,2025-05-25,16:05,0,4,4
108,2025-05-25T08:08:00+02:00,2025-05-25,16:08,1,4,5
118,2025-05-25T07:55:00+02:00,2025-05-25,15:55,2,0,2
132,2025-05-25T07:55:00+02:00,2025-05-25,15:55,11,13,24
133,2025-05-25T08:05:00+02:00,2025-05-25,16:05,29,53,82
134,2025-05-25T07:55:00+02:00,2025-05-25,15:55,34,34,68
140,2025-05-25T08:05:00+02:00,2025-05-25,16:05,15,7,22
162,2025-05-25T08:05:00+02:00,2025-05-25,16:05,21,57,78
165,2025-05-25T07:55:00+02:00,2025-05-25,15:55,6,2,8
165,2025-05-25T08:00:00+02:00,2025-05-25,16:00,1,1,2
165,2025-05-25T08:05:00+02:00,2025-05-25,16:05,1,3,4
166,2025-05-25T07:55:00+02:00,2025-05-25,15:55,3,3,6
166,2025-05-25T08:00:00+02:00,2025-05-25,16:00,10,8,18
167,2025-05-25T07:55:00+02:00,2025-05-25,15:55,3,11,14
167,2025-05-25T08:05:00+02:00,2025-05-25,16:05,5,6,11
179,2025-05-25T07:55:00+02:00,2025-05-25,15:55,6,6,12
1,2025-05-25T07:56:00+02:00,2025-05-25,15:56,23,20,43
1,2025-05-25T07:57:00+02:00,2025-05-25,15:57,39,21,60
1,2025-05-25T08:01:00+02:00,2025-05-25,16:01,23,31,54
1,2025-05-25T08:02:00+02:00,2025-05-25,16:02,22,20,42
1,2025-05-25T08:07:00+02:00,2025-05-25,16:07,27,11,38
2,2025-05-25T07:55:00+02:00,2025-05-25,15:55,15,2,17
2,2025-05-25T07:56:00+02:00,2025-05-25,15:56,7,8,15
9,2025-05-25T08:02:00+02:00,2025-05-25,16:02,0,2,2
9,2025-05-25T08:03:00+02:00,2025-05-25,16:03,2,0,2
9,2025-05-25T08:08:00+02:00,2025-05-25,16:08,0,1,1
9,2025-05-25T08:09:00+02:00,2025-05-25,16:09,2,0,2
10,2025-05-25T07:57:00+02:00,2025-05-25,15:57,1,0,1
10,2025-05-25T07:58:00+02:00,2025-05-25,15:58,0,1,1
10,2025-05-25T08:05:00+02:00,2025-05-25,16:05,6,0,6
11,2025-05-25T07:55:00+02:00,2025-05-25,15:55,18,5,23
11,2025-05-25T08:03:00+02:00,2025-05-25,16:03,0,2,2
11,2025-05-25T08:08:00+02:00,2025-05-25,16:08,1,0,1
12,2025-05-25T07:56:00+02:00,2025-05-25,15:56,4,4,8
12,2025-05-25T08:02:00+02:00,2025-05-25,16:02,0,6,6
12,2025-05-25T08:09:00+02:00,2025-05-25,16:09,5,3,8
17,2025-05-25T08:01:00+02:00,2025-05-25,16:01,1,2,3
17,2025-05-25T08:02:00+02:00,2025-05-25,16:02,5,5,10
17,2025-05-25T08:03:00+02:00,2025-05-25,16:03,2,3,5
17,2025-05-25T08:06:00+02:00,2025-05-25,16:06,2,2,4
18,2025-05-25T07:58:00+02:00,2025-05-25,15:58,2,0,2
18,2025-05-25T08:04:00+02:00,2025-05-25,16:04,1,1,2
19,2025-05-25T07:56:00+02:00,2025-05-25,15:56,4,9,13
19,2025-05-25T07:57:00+02:00,2025-05-25,15:57,8,7,15
19,2025-05-25T08:00:00+02:00,2025-05-25,16:00,5,4,9
19,2025-05-25T08:05:00+02:00,2025-05-25,16:05,8,8,16
20,2025-05-25T07:58:00+02:00,2025-05-25,15:58,4,3,7
20,2025-05-25T08:03:00+02:00,2025-05-25,16:03,1,1,2
23,2025-05-25T07:58:00+02:00,2025-05-25,15:58,2,0,2
23,2025-05-25T08:02:00+02:00,2025-05-25,16:02,5,8,13
23,2025-05-25T08:04:00+02:00,2025-05-25,16:04,2,5,7
23,2025-05-25T08:06:00+02:00,2025-05-25,16:06,3,5,8
23,2025-05-25T08:07:00+02:00,2025-05-25,16:07,3,8,11
24,2025-05-25T07:56:00+02:00,2025-05-25,15:56,6,39,45
24,2025-05-25T07:59:00+02:00,2025-05-25,15:59,0,3,3
24,2025-05-25T08:00:00+02:00,2025-05-25,16:00,2,4,6
24,2025-05-25T08:01:00+02:00,2025-05-25,16:01,2,4,6
24,2025-05-25T08:07:00+02:00,2025-05-25,16:07,17,20,37
24,2025-05-25T08:08:00+02:00,2025-05-25,16:08,3,10,13
25,2025-05-25T07:55:00+02:00,2025-05-25,15:55,81,99,180
25,2025-05-25T08:00:00+02:00,2025-05-25,16:00,81,60,141
27,2025-05-25T08:00:00+02:00,2025-05-25,16:00,5,1,6
27,2025-05-25T08:01:00+02:00,2025-05-25,16:01,0,1,1
27,2025-05-25T08:06:00+02:00,2025-05-25,16:06,5,4,9
27,2025-05-25T08:07:00+02:00,2025-05-25,16:07,2,1,3
27,2025-05-25T08:08:00+02:00,2025-05-25,16:08,2,5,7
30,2025-05-25T07:56:00+02:00,2025-05-25,15:56,4,9,13
30,2025-05-25T07:58:00+02:00,2025-05-25,15:58,6,5,11
30,2025-05-25T08:00:00+02:00,2025-05-25,16:00,6,5,11
30,2025-05-25T08:05:00+02:00,2025-05-25,16:05,4,5,9
30,2025-05-25T08:08:00+02:00,2025-05-25,16:08,2,3,5
30,2025-05-25T08:09:00+02:00,2025-05-25,16:09,5,6,11
35,2025-05-25T07:55:00+02:00,2025-05-25,15:55,17,21,38
35,2025-05-25T07:58:00+02:00,2025-05-25,15:58,22,29,51
35,2025-05-25T07:59:00+02:00,2025-05-25,15:59,8,31,39
35,2025-05-25T08:00:00+02:00,2025-05-25,16:00,24,15,39
35,2025-05-25T08:03:00+02:00,2025-05-25,16:03,15,18,33
35,2025-05-25T08:08:00+02:00,2025-05-25,16:08,13,18,31
48,2025-05-25T07:57:00+02:00,2025-05-25,15:57,11,6,17
48,2025-05-25T08:06:00+02:00,2025-05-25,16:06,5,4,9
49,2025-05-25T07:55:00+02:00,2025-05-25,15:55,3,11,14
49,2025-05-25T07:57:00+02:00,2025-05-25,15:57,5,22,27
49,2025-05-25T07:58:00+02:00,2025-05-25,15:58,4,12,16
49,2025-05-25T08:00:00+02:00,2025-05-25,16:00,1,17,18
49,2025-05-25T08:02:00+02:00,2025-05-25,16:02,1,18,19
49,2025-05-25T08:08:00+02:00,2025-05-25,16:08,3,7,10
51,2025-05-25T07:55:00+02:00,2025-05-25,15:55,1,0,1
51,2025-05-25T07:56:00+02:00,2025-05-25,15:56,2,0,2
51,2025-05-25T08:04:00+02:00,2025-05-25,16:04,4,0,4
51,2025-05-25T08:06:00+02:00,2025-05-25,16:06,0,2,2
52,2025-05-25T07:57:00+02:00,2025-05-25,15:57,4,5,9
52,2025-05-25T08:01:00+02:00,2025-05-25,16:01,3,0,3
52,2025-05-25T08:02:00+02:00,2025-05-25,16:02,3,6,9
52,2025-05-25T08:04:00+02:00,2025-05-25,16:04,12,4,16
52,2025-05-25T08:05:00+02:00,2025-05-25,16:05,4,16,20
52,2025-05-25T08:06:00+02:00,2025-05-25,16:06,3,8,11
53,2025-05-25T07:55:00+02:00,2025-05-25,15:55,18,1,19
53,2025-05-25T07:56:00+02:00,2025-05-25,15:56,5,5,10
53,2025-05-25T07:59:00+02:00,2025-05-25,15:59,10,3,13
53,2025-05-25T08:03:00+02:00,2025-05-25,16:03,6,9,15
53,2025-05-25T08:06:00+02:00,2025-05-25,16:06,3,4,7
56,2025-05-25T07:55:00+02:00,2025-05-25,15:55,13,11,24
56,2025-05-25T08:07:00+02:00,2025-05-25,16:07,10,6,16
58,2025-05-25T07:55:00+02:00,2025-05-25,15:55,9,7,16
58,2025-05-25T07:57:00+02:00,2025-05-25,15:57,1,12,13
58,2025-05-25T08:02:00+02:00,2025-05-25,16:02,4,14,18
58,2025-05-25T08:09:00+02:00,2025-05-25,16:09,13,9,22
62,2025-05-25T07:55:00+02:00,2025-05-25,15:55,3,1,4
62,2025-05-25T08:05:00+02:00,2025-05-25,16:05,0,5,5
62,2025-05-25T08:07:00+02:00,2025-05-25,16:07,6,1,7
62,2025-05-25T08:09:00+02:00,2025-05-25,16:09,2,2,4
63,2025-05-25T07:56:00+02:00,2025-05-25,15:56,1,5,6
63,2025-05-25T07:57:00+02:00,2025-05-25,15:57,2,10,12
63,2025-05-25T07:58:00+02:00,2025-05-25,15:58,6,11,17
63,2025-05-25T07:59:00+02:00,2025-05-25,15:59,12,12,24
63,2025-05-25T08:01:00+02:00,2025-05-25,16:01,4,10,14
63,2025-05-25T08:06:00+02:00,2025-05-25,16:06,3,4,7
63,2025-05-25T08:09:00+02:00,2025-05-25,16:09,0,12,12
67,2025-05-25T07:55:00+02:00,2025-05-25,15:55,7,6,13
67,2025-05-25T07:57:00+02:00,2025-05-25,15:57,6,16,22
67,2025-05-25T08:02:00+02:00,2025-05-25,16:02,8,8,16
67,2025-05-25T08:07:00+02:00,2025-05-25,16:07,7,8,15
67,2025-05-25T08:08:00+02:00,2025-05-25,16:08,3,11,14
67,2025-05-25T08:09:00+02:00,2025-05-25,16:09,3,16,19
68,2025-05-25T07:55:00+02:00,2025-05-25,15:55,8,2,10
68,2025-05-25T07:59:00+02:00,2025-05-25,15:59,7,2,9
68,2025-05-25T08:00:00+02:00,2025-05-25,16:00,11,0,11
68,2025-05-25T08:03:00+02:00,2025-05-25,16:03,5,4,9
68,2025-05-25T08:04:00+02:00,2025-05-25,16:04,2,5,7
68,2025-05-25T08:06:00+02:00,2025-05-25,16:06,4,2,6
72,2025-05-25T08:01:00+02:00,2025-05-25,16:01,7,6,13
72,2025-05-25T08:02:00+02:00,2025-05-25,16:02,11,11,22
72,2025-05-25T08:03:00+02:00,2025-05-25,16:03,3,11,14
72,2025-05-25T08:06:00+02:00,2025-05-25,16:06,10,14,24
72,2025-05-25T08:08:00+02:00,2025-05-25,16:08,5,5,10
72,2025-05-25T08:09:00+02:00,2025-05-25,16:09,8,15,23
76,2025-05-25T07:59:00+02:00,2025-05-25,15:59,0,1,1
76,2025-05-25T08:08:00+02:00,2025-05-25,16:08,2,0,2
76,2025-05-25T08:09:00+02:00,2025-05-25,16:09,0,2,2
79,2025-05-25T07:57:00+02:00,2025-05-25,15:57,9,5,14
79,2025-05-25T07:58:00+02:00,2025-05-25,15:58,15,3,18
79,2025-05-25T08:03:00+02:00,2025-05-25,16:03,9,7,16
79,2025-05-25T08:06:00+02:00,2025-05-25,16:06,8,4,12
85,2025-05-25T08:08:00+02:00,2025-05-25,16:08,2,0,2
86,2025-05-25T08:00:00+02:00,2025-05-25,16:00,1,1,2
86,2025-05-25T08:07:00+02:00,2025-05-25,16:07,0,1,1
117,2025-05-25T08:05:00+02:00,2025-05-25,16:05,17,26,43
130,2025-05-25T08:05:00+02:00,2025-05-25,16:05,2,9,11
136,2025-05-25T07:55:00+02:00,2025-05-25,15:55,13,30,43
138,2025-05-25T08:00:00+02:00,2025-05-25,16:00,1,1,2
139,2025-05-25T07:55:00+02:00,2025-05-25,15:55,4,4,8
141,2025-05-25T08:00:00+02:00,2025-05-25,16:00,8,10,18
161,2025-05-25T08:05:00+02:00,2025-05-25,16:05,7,243,250
164,2025-05-25T07:55:00+02:00,2025-05-25,15:55,5,17,22
164,2025-05-25T08:00:00+02:00,2025-05-25,16:00,5,1,6
164,2025-05-25T08:05:00+02:00,2025-05-25,16:05,7,18,25
181,2025-05-25T07:58:00+02:00,2025-05-25,15:58,5,22,27
181,2025-05-25T07:59:00+02:00,2025-05-25,15:59,14,12,26
181,2025-05-25T08:01:00+02:00,2025-05-25,16:01,18,18,36
181,2025-05-25T08:03:00+02:00,2025-05-25,16:03,9,16,25
181,2025-05-25T08:04:00+02:00,2025-05-25,16:04,14,17,31
181,2025-05-25T08:05:00+02:00,2025-05-25,16:05,22,23,45
181,2025-05-25T08:08:00+02:00,2025-05-25,16:08,10,19,29
181,2025-05-25T08:09:00+02:00,2025-05-25,16:09,11,37,48
182,2025-05-25T08:00:00+02:00,2025-05-25,16:00,27,7,34
182,2025-05-25T08:05:00+02:00,2025-05-25,16:05,10,26,36
180,2025-05-25T07:57:00+02:00,2025-05-25,15:57,1,2,3
181,2025-05-25T08:10:00+02:00,2025-05-25,16:10,11,31,42
181,2025-05-25T08:15:00+02:00,2025-05-25,16:15,14,7,21
181,2025-05-25T08:18:00+02:00,2025-05-25,16:18,7,27,34
181,2025-05-25T08:19:00+02:00,2025-05-25,16:19,1,16,17
181,2025-05-25T08:21:00+02:00,2025-05-25,16:21,13,12,25
181,2025-05-25T08:24:00+02:00,2025-05-25,16:24,18,11,29
182,2025-05-25T08:10:00+02:00,2025-05-25,16:10,8,17,25
182,2025-05-25T08:20:00+02:00,2025-05-25,16:20,9,17,26
180,2025-05-25T08:11:00+02:00,2025-05-25,16:11,2,2,4
180,2025-05-25T08:18:00+02:00,2025-05-25,16:18,5,2,7
180,2025-05-25T08:19:00+02:00,2025-05-25,16:19,1,0,1
3,2025-05-25T08:12:00+02:00,2025-05-25,16:12,3,24,27
3,2025-05-25T08:13:00+02:00,2025-05-25,16:13,25,21,46
3,2025-05-25T08:16:00+02:00,2025-05-25,16:16,19,33,52
3,2025-05-25T08:19:00+02:00,2025-05-25,16:19,23,25,48
3,2025-05-25T08:20:00+02:00,2025-05-25,16:20,9,24,33
3,2025-05-25T08:21:00+02:00,2025-05-25,16:21,13,10,23
3,2025-05-25T08:22:00+02:00,2025-05-25,16:22,18,16,34
3,2025-05-25T08:23:00+02:00,2025-05-25,16:23,22,16,38
4,2025-05-25T08:13:00+02:00,2025-05-25,16:13,27,30,57
4,2025-05-25T08:14:00+02:00,2025-05-25,16:14,28,24,52
4,2025-05-25T08:16:00+02:00,2025-05-25,16:16,40,13,53
4,2025-05-25T08:20:00+02:00,2025-05-25,16:20,22,19,41
4,2025-05-25T08:23:00+02:00,2025-05-25,16:23,16,29,45
5,2025-05-25T08:20:00+02:00,2025-05-25,16:20,84,102,186
6,2025-05-25T08:11:00+02:00,2025-05-25,16:11,18,14,32
6,2025-05-25T08:13:00+02:00,2025-05-25,16:13,13,11,24
6,2025-05-25T08:14:00+02:00,2025-05-25,16:14,20,11,31
6,2025-05-25T08:16:00+02:00,2025-05-25,16:16,16,20,36
6,2025-05-25T08:18:00+02:00,2025-05-25,16:18,18,22,40
8,2025-05-25T08:11:00+02:00,2025-05-25,16:11,12,7,19
8,2025-05-25T08:14:00+02:00,2025-05-25,16:14,6,3,9
8,2025-05-25T08:19:00+02:00,2025-05-25,16:19,6,3,9
8,2025-05-25T08:21:00+02:00,2025-05-25,16:21,2,2,4
8,2025-05-25T08:23:00+02:00,2025-05-25,16:23,3,2,5
28,2025-05-25T08:13:00+02:00,2025-05-25,16:13,11,5,16
28,2025-05-25T08:16:00+02:00,2025-05-25,16:16,9,3,12
28,2025-05-25T08:20:00+02:00,2025-05-25,16:20,5,11,16
28,2025-05-25T08:21:00+02:00,2025-05-25,16:21,20,17,37
28,2025-05-25T08:23:00+02:00,2025-05-25,16:23,18,14,32
29,2025-05-25T08:11:00+02:00,2025-05-25,16:11,9,14,23
29,2025-05-25T08:18:00+02:00,2025-05-25,16:18,14,21,35
29,2025-05-25T08:20:00+02:00,2025-05-25,16:20,9,17,26
29,2025-05-25T08:22:00+02:00,2025-05-25,16:22,7,9,16
31,2025-05-25T08:12:00+02:00,2025-05-25,16:12,6,3,9
31,2025-05-25T08:15:00+02:00,2025-05-25,16:15,1,6,7
31,2025-05-25T08:16:00+02:00,2025-05-25,16:16,8,11,19
31,2025-05-25T08:17:00+02:00,2025-05-25,16:17,2,13,15
31,2025-05-25T08:18:00+02:00,2025-05-25,16:18,5,9,14
31,2025-05-25T08:19:00+02:00,2025-05-25,16:19,4,0,4
36,2025-05-25T08:21:00+02:00,2025-05-25,16:21,0,3,3
36,2025-05-25T08:23:00+02:00,2025-05-25,16:23,1,2,3
39,2025-05-25T08:10:00+02:00,2025-05-25,16:10,1,1,2
39,2025-05-25T08:21:00+02:00,2025-05-25,16:21,0,2,2
39,2025-05-25T08:23:00+02:00,2025-05-25,16:23,1,0,1
40,2025-05-25T08:16:00+02:00,2025-05-25,16:16,0,8,8
41,2025-05-25T08:13:00+02:00,2025-05-25,16:13,15,4,19
41,2025-05-25T08:22:00+02:00,2025-05-25,16:22,3,2,5
41,2025-05-25T08:23:00+02:00,2025-05-25,16:23,5,6,11
43,2025-05-25T08:10:00+02:00,2025-05-25,16:10,17,2,19
43,2025-05-25T08:20:00+02:00,2025-05-25,16:20,11,7,18
44,2025-05-25T08:10:00+02:00,2025-05-25,16:10,15,2,17
44,2025-05-25T08:15:00+02:00,2025-05-25,16:15,5,6,11
45,2025-05-25T08:10:00+02:00,2025-05-25,16:10,24,11,35
45,2025-05-25T08:11:00+02:00,2025-05-25,16:11,4,12,16
45,2025-05-25T08:20:00+02:00,2025-05-25,16:20,22,16,38
45,2025-05-25T08:24:00+02:00,2025-05-25,16:24,15,25,40
47,2025-05-25T08:12:00+02:00,2025-05-25,16:12,27,10,37
47,2025-05-25T08:16:00+02:00,2025-05-25,16:16,24,19,43
47,2025-05-25T08:19:00+02:00,2025-05-25,16:19,19,13,32
47,2025-05-25T08:20:00+02:00,2025-05-25,16:20,15,26,41
47,2025-05-25T08:21:00+02:00,2025-05-25,16:21,28,11,39
50,2025-05-25T08:10:00+02:00,2025-05-25,16:10,4,3,7
50,2025-05-25T08:11:00+02:00,2025-05-25,16:11,2,4,6
50,2025-05-25T08:13:00+02:00,2025-05-25,16:13,11,4,15
50,2025-05-25T08:16:00+02:00,2025-05-25,16:16,0,3,3
50,2025-05-25T08:18:00+02:00,2025-05-25,16:18,2,0,2
50,2025-05-25T08:20:00+02:00,2025-05-25,16:20,1,4,5
50,2025-05-25T08:22:00+02:00,2025-05-25,16:22,1,1,2
54,2025-05-25T08:13:00+02:00,2025-05-25,16:13,0,2,2
54,2025-05-25T08:14:00+02:00,2025-05-25,16:14,9,0,9
54,2025-05-25T08:18:00+02:00,2025-05-25,16:18,1,6,7
54,2025-05-25T08:22:00+02:00,2025-05-25,16:22,2,3,5
54,2025-05-25T08:24:00+02:00,2025-05-25,16:24,1,4,5
59,2025-05-25T08:10:00+02:00,2025-05-25,16:10,22,22,44
61,2025-05-25T08:13:00+02:00,2025-05-25,16:13,6,3,9
61,2025-05-25T08:18:00+02:00,2025-05-25,16:18,9,9,18
61,2025-05-25T08:19:00+02:00,2025-05-25,16:19,10,3,13
61,2025-05-25T08:23:00+02:00,2025-05-25,16:23,13,6,19
61,2025-05-25T08:24:00+02:00,2025-05-25,16:24,18,3,21
66,2025-05-25T08:11:00+02:00,2025-05-25,16:11,22,19,41
66,2025-05-25T08:24:00+02:00,2025-05-25,16:24,21,15,36
69,2025-05-25T08:12:00+02:00,2025-05-25,16:12,1,5,6
69,2025-05-25T08:17:00+02:00,2025-05-25,16:17,3,0,3
69,2025-05-25T08:20:00+02:00,2025-05-25,16:20,6,3,9
70,2025-05-25T08:13:00+02:00,2025-05-25,16:13,4,1,5
70,2025-05-25T08:15:00+02:00,2025-05-25,16:15,1,3,4
70,2025-05-25T08:16:00+02:00,2025-05-25,16:16,0,5,5
70,2025-05-25T08:20:00+02:00,2025-05-25,16:20,0,5,5
70,2025-05-25T08:22:00+02:00,2025-05-25,16:22,1,1,2
70,2025-05-25T08:23:00+02:00,2025-05-25,16:23,5,0,5
70,2025-05-25T08:24:00+02:00,2025-05-25,16:24,2,3,5
75,2025-05-25T08:13:00+02:00,2025-05-25,16:13,3,0,3
75,2025-05-25T08:14:00+02:00,2025-05-25,16:14,0,2,2
75,2025-05-25T08:21:00+02:00,2025-05-25,16:21,0,2,2
75,2025-05-25T08:22:00+02:00,2025-05-25,16:22,0,3,3
77,2025-05-25T08:20:00+02:00,2025-05-25,16:20,6,34,40
78,2025-05-25T08:12:00+02:00,2025-05-25,16:12,4,1,5
78,2025-05-25T08:13:00+02:00,2025-05-25,16:13,1,3,4
78,2025-05-25T08:16:00+02:00,2025-05-25,16:16,1,3,4
78,2025-05-25T08:22:00+02:00,2025-05-25,16:22,0,1,1
87,2025-05-25T08:10:00+02:00,2025-05-25,16:10,1,1,2
87,2025-05-25T08:12:00+02:00,2025-05-25,16:12,1,2,3
87,2025-05-25T08:14:00+02:00,2025-05-25,16:14,1,0,1
87,2025-05-25T08:15:00+02:00,2025-05-25,16:15,1,3,4
87,2025-05-25T08:16:00+02:00,2025-05-25,16:16,0,1,1
87,2025-05-25T08:18:00+02:00,2025-05-25,16:18,2,2,4
108,2025-05-25T08:13:00+02:00,2025-05-25,16:13,5,3,8
108,2025-05-25T08:14:00+02:00,2025-05-25,16:14,0,2,2
108,2025-05-25T08:20:00+02:00,2025-05-25,16:20,2,1,3
108,2025-05-25T08:22:00+02:00,2025-05-25,16:22,0,1,1
118,2025-05-25T08:10:00+02:00,2025-05-25,16:10,7,2,9
131,2025-05-25T08:15:00+02:00,2025-05-25,16:15,5,2,7
133,2025-05-25T08:15:00+02:00,2025-05-25,16:15,25,70,95
135,2025-05-25T08:15:00+02:00,2025-05-25,16:15,40,44,84
135,2025-05-25T08:20:00+02:00,2025-05-25,16:20,34,33,67
140,2025-05-25T08:10:00+02:00,2025-05-25,16:10,7,11,18
162,2025-05-25T08:10:00+02:00,2025-05-25,16:10,19,85,104
162,2025-05-25T08:20:00+02:00,2025-05-25,16:20,22,36,58
165,2025-05-25T08:10:00+02:00,2025-05-25,16:10,10,2,12
165,2025-05-25T08:15:00+02:00,2025-05-25,16:15,2,9,11
179,2025-05-25T08:15:00+02:00,2025-05-25,16:15,8,4,12
1,2025-05-25T08:12:00+02:00,2025-05-25,16:12,23,24,47
1,2025-05-25T08:22:00+02:00,2025-05-25,16:22,37,18,55
2,2025-05-25T08:14:00+02:00,2025-05-25,16:14,10,8,18
2,2025-05-25T08:18:00+02:00,2025-05-25,16:18,3,12,15
2,2025-05-25T08:20:00+02:00,2025-05-25,16:20,12,5,17
2,2025-05-25T08:21:00+02:00,2025-05-25,16:21,11,5,16
2,2025-05-25T08:22:00+02:00,2025-05-25,16:22,12,4,16
2,2025-05-25T08:23:00+02:00,2025-05-25,16:23,13,6,19
2,2025-05-25T08:24:00+02:00,2025-05-25,16:24,15,3,18
9,2025-05-25T08:10:00+02:00,2025-05-25,16:10,1,0,1
9,2025-05-25T08:15:00+02:00,2025-05-25,16:15,0,1,1
9,2025-05-25T08:23:00+02:00,2025-05-25,16:23,5,1,6
9,2025-05-25T08:24:00+02:00,2025-05-25,16:24,2,3,5
10,2025-05-25T08:14:00+02:00,2025-05-25,16:14,2,0,2
10,2025-05-25T08:20:00+02:00,2025-05-25,16:20,0,1,1
10,2025-05-25T08:21:00+02:00,2025-05-25,16:21,2,1,3
11,2025-05-25T08:11:00+02:00,2025-05-25,16:11,0,3,3
11,2025-05-25T08:13:00+02:00,2025-05-25,16:13,0,12,12
11,2025-05-25T08:15:00+02:00,2025-05-25,16:15,11,38,49
11,2025-05-25T08:16:00+02:00,2025-05-25,16:16,0,4,4
11,2025-05-25T08:17:00+02:00,2025-05-25,16:17,0,2,2
11,2025-05-25T08:18:00+02:00,2025-05-25,16:18,1,1,2
11,2025-05-25T08:19:00+02:00,2025-05-25,16:19,3,0,3
11,2025-05-25T08:21:00+02:00,2025-05-25,16:21,3,0,3
12,2025-05-25T08:10:00+02:00,2025-05-25,16:10,5,2,7
12,2025-05-25T08:12:00+02:00,2025-05-25,16:12,5,1,6
12,2025-05-25T08:13:00+02:00,2025-05-25,16:13,12,4,16
12,2025-05-25T08:15:00+02:00,2025-05-25,16:15,13,4,17
12,2025-05-25T08:22:00+02:00,2025-05-25,16:22,5,5,10
12,2025-05-25T08:23:00+02:00,2025-05-25,16:23,5,8,13
12,2025-05-25T08:24:00+02:00,2025-05-25,16:24,11,8,19
17,2025-05-25T08:13:00+02:00,2025-05-25,16:13,4,4,8
17,2025-05-25T08:16:00+02:00,2025-05-25,16:16,0,1,1
17,2025-05-25T08:21:00+02:00,2025-05-25,16:21,0,3,3
17,2025-05-25T08:23:00+02:00,2025-05-25,16:23,2,0,2
18,2025-05-25T08:20:00+02:00,2025-05-25,16:20,2,1,3
18,2025-05-25T08:24:00+02:00,2025-05-25,16:24,1,0,1
19,2025-05-25T08:10:00+02:00,2025-05-25,16:10,7,7,14
19,2025-05-25T08:11:00+02:00,2025-05-25,16:11,13,7,20
19,2025-05-25T08:13:00+02:00,2025-05-25,16:13,16,10,26
19,2025-05-25T08:14:00+02:00,2025-05-25,16:14,12,3,15
19,2025-05-25T08:15:00+02:00,2025-05-25,16:15,16,11,27
19,2025-05-25T08:19:00+02:00,2025-05-25,16:19,8,3,11
19,2025-05-25T08:21:00+02:00,2025-05-25,16:21,2,16,18
19,2025-05-25T08:23:00+02:00,2025-05-25,16:23,6,11,17
20,2025-05-25T08:11:00+02:00,2025-05-25,16:11,0,1,1
20,2025-05-25T08:15:00+02:00,2025-05-25,16:15,4,1,5
20,2025-05-25T08:17:00+02:00,2025-05-25,16:17,0,3,3
20,2025-05-25T08:19:00+02:00,2025-05-25,16:19,3,2,5
20,2025-05-25T08:24:00+02:00,2025-05-25,16:24,5,4,9
23,2025-05-25T08:11:00+02:00,2025-05-25,16:11,1,1,2
23,2025-05-25T08:14:00+02:00,2025-05-25,16:14,6,2,8
23,2025-05-25T08:17:00+02:00,2025-05-25,16:17,1,0,1
23,2025-05-25T08:18:00+02:00,2025-05-25,16:18,2,3,5
24,2025-05-25T08:13:00+02:00,2025-05-25,16:13,3,35,38
24,2025-05-25T08:15:00+02:00,2025-05-25,16:15,6,6,12
24,2025-05-25T08:16:00+02:00,2025-05-25,16:16,5,6,11
24,2025-05-25T08:22:00+02:00,2025-05-25,16:22,1,33,34
24,2025-05-25T08:23:00+02:00,2025-05-25,16:23,5,17,22
25,2025-05-25T08:10:00+02:00,2025-05-25,16:10,91,69,160
25,2025-05-25T08:15:00+02:00,2025-05-25,16:15,87,61,148
27,2025-05-25T08:11:00+02:00,2025-05-25,16:11,5,2,7
27,2025-05-25T08:14:00+02:00,2025-05-25,16:14,2,5,7
27,2025-05-25T08:17:00+02:00,2025-05-25,16:17,2,0,2
27,2025-05-25T08:18:00+02:00,2025-05-25,16:18,1,8,9
27,2025-05-25T08:20:00+02:00,2025-05-25,16:20,5,2,7
27,2025-05-25T08:21:00+02:00,2025-05-25,16:21,2,1,3
27,2025-05-25T08:22:00+02:00,2025-05-25,16:22,1,0,1
27,2025-05-25T08:24:00+02:00,2025-05-25,16:24,3,3,6
30,2025-05-25T08:11:00+02:00,2025-05-25,16:11,4,15,19
30,2025-05-25T08:14:00+02:00,2025-05-25,16:14,7,15,22
30,2025-05-25T08:18:00+02:00,2025-05-25,16:18,5,19,24
30,2025-05-25T08:22:00+02:00,2025-05-25,16:22,3,9,12
30,2025-05-25T08:24:00+02:00,2025-05-25,16:24,2,17,19
35,2025-05-25T08:13:00+02:00,2025-05-25,16:13,21,51,72
35,2025-05-25T08:14:00+02:00,2025-05-25,16:14,18,27,45
35,2025-05-25T08:18:00+02:00,2025-05-25,16:18,22,21,43
35,2025-05-25T08:19:00+02:00,2025-05-25,16:19,23,35,58
35,2025-05-25T08:21:00+02:00,2025-05-25,16:21,14,19,33
35,2025-05-25T08:22:00+02:00,2025-05-25,16:22,18,25,43
46,2025-05-25T08:10:00+02:00,2025-05-25,16:10,4,12,16
46,2025-05-25T08:15:00+02:00,2025-05-25,16:15,8,7,15
48,2025-05-25T08:13:00+02:00,2025-05-25,16:13,5,0,5
48,2025-05-25T08:15:00+02:00,2025-05-25,16:15,19,0,19
48,2025-05-25T08:17:00+02:00,2025-05-25,16:17,8,2,10
48,2025-05-25T08:20:00+02:00,2025-05-25,16:20,5,2,7
48,2025-05-25T08:22:00+02:00,2025-05-25,16:22,5,1,6
48,2025-05-25T08:23:00+02:00,2025-05-25,16:23,8,1,9
49,2025-05-25T08:10:00+02:00,2025-05-25,16:10,10,11,21
49,2025-05-25T08:13:00+02:00,2025-05-25,16:13,1,16,17
49,2025-05-25T08:14:00+02:00,2025-05-25,16:14,2,9,11
49,2025-05-25T08:21:00+02:00,2025-05-25,16:21,5,10,15
49,2025-05-25T08:24:00+02:00,2025-05-25,16:24,0,2,2
51,2025-05-25T08:13:00+02:00,2025-05-25,16:13,3,2,5
51,2025-05-25T08:17:00+02:00,2025-05-25,16:17,4,0,4
51,2025-05-25T08:21:00+02:00,2025-05-25,16:21,3,0,3
51,2025-05-25T08:22:00+02:00,2025-05-25,16:22,0,4,4
52,2025-05-25T08:15:00+02:00,2025-05-25,16:15,7,6,13
52,2025-05-25T08:16:00+02:00,2025-05-25,16:16,4,8,12
52,2025-05-25T08:22:00+02:00,2025-05-25,16:22,2,12,14
53,2025-05-25T08:12:00+02:00,2025-05-25,16:12,8,3,11
53,2025-05-25T08:13:00+02:00,2025-05-25,16:13,5,10,15
53,2025-05-25T08:15:00+02:00,2025-05-25,16:15,14,5,19
53,2025-05-25T08:17:00+02:00,2025-05-25,16:17,17,7,24
53,2025-05-25T08:19:00+02:00,2025-05-25,16:19,14,5,19
53,2025-05-25T08:20:00+02:00,2025-05-25,16:20,12,2,14
53,2025-05-25T08:22:00+02:00,2025-05-25,16:22,7,2,9
56,2025-05-25T08:13:00+02:00,2025-05-25,16:13,5,5,10
56,2025-05-25T08:15:00+02:00,2025-05-25,16:15,3,4,7
56,2025-05-25T08:20:00+02:00,2025-05-25,16:20,3,5,8
56,2025-05-25T08:21:00+02:00,2025-05-25,16:21,6,11,17
58,2025-05-25T08:12:00+02:00,2025-05-25,16:12,13,17,30
58,2025-05-25T08:18:00+02:00,2025-05-25,16:18,3,13,16
58,2025-05-25T08:22:00+02:00,2025-05-25,16:22,1,12,13
58,2025-05-25T08:23:00+02:00,2025-05-25,16:23,9,12,21
62,2025-05-25T08:13:00+02:00,2025-05-25,16:13,2,2,4
62,2025-05-25T08:20:00+02:00,2025-05-25,16:20,6,9,15
62,2025-05-25T08:22:00+02:00,2025-05-25,16:22,4,5,9
62,2025-05-25T08:23:00+02:00,2025-05-25,16:23,1,3,4
63,2025-05-25T08:11:00+02:00,2025-05-25,16:11,3,11,14
63,2025-05-25T08:14:00+02:00,2025-05-25,16:14,1,3,4
63,2025-05-25T08:24:00+02:00,2025-05-25,16:24,4,2,6
67,2025-05-25T08:10:00+02:00,2025-05-25,16:10,3,7,10
67,2025-05-25T08:13:00+02:00,2025-05-25,16:13,7,12,19
68,2025-05-25T08:10:00+02:00,2025-05-25,16:10,8,1,9
68,2025-05-25T08:11:00+02:00,2025-05-25,16:11,6,3,9
68,2025-05-25T08:12:00+02:00,2025-05-25,16:12,5,11,16
68,2025-05-25T08:14:00+02:00,2025-05-25,16:14,2,1,3
68,2025-05-25T08:15:00+02:00,2025-05-25,16:15,2,8,10
72,2025-05-25T08:11:00+02:00,2025-05-25,16:11,10,15,25
72,2025-05-25T08:12:00+02:00,2025-05-25,16:12,1,11,12
72,2025-05-25T08:20:00+02:00,2025-05-25,16:20,3,18,21
72,2025-05-25T08:21:00+02:00,2025-05-25,16:21,14,11,25
72,2025-05-25T08:22:00+02:00,2025-05-25,16:22,4,12,16
76,2025-05-25T08:12:00+02:00,2025-05-25,16:12,2,2,4
76,2025-05-25T08:16:00+02:00,2025-05-25,16:16,0,1,1
76,2025-05-25T08:19:00+02:00,2025-05-25,16:19,1,0,1
79,2025-05-25T08:10:00+02:00,2025-05-25,16:10,18,10,28
79,2025-05-25T08:13:00+02:00,2025-05-25,16:13,17,8,25
85,2025-05-25T08:10:00+02:00,2025-05-25,16:10,1,2,3
85,2025-05-25T08:16:00+02:00,2025-05-25,16:16,2,0,2
85,2025-05-25T08:19:00+02:00,2025-05-25,16:19,1,1,2
85,2025-05-25T08:22:00+02:00,2025-05-25,16:22,1,1,2
86,2025-05-25T08:14:00+02:00,2025-05-25,16:14,0,1,1
109,2025-05-25T08:10:00+02:00,2025-05-25,16:10,14,6,20
117,2025-05-25T08:15:00+02:00,2025-05-25,16:15,20,44,64
117,2025-05-25T08:20:00+02:00,2025-05-25,16:20,37,21,58
123,2025-05-25T08:20:00+02:00,2025-05-25,16:20,14,10,24
136,2025-05-25T08:10:00+02:00,2025-05-25,16:10,11,37,48
136,2025-05-25T08:15:00+02:00,2025-05-25,16:15,9,21,30
137,2025-05-25T08:15:00+02:00,2025-05-25,16:15,0,4,4
139,2025-05-25T08:10:00+02:00,2025-05-25,16:10,3,1,4
141,2025-05-25T08:15:00+02:00,2025-05-25,16:15,25,16,41
142,2025-05-25T08:20:00+02:00,2025-05-25,16:20,47,60,107
164,2025-05-25T08:15:00+02:00,2025-05-25,16:15,8,4,12
181,2025-05-25T08:25:00+02:00,2025-05-25,16:25,16,18,34
181,2025-05-25T08:28:00+02:00,2025-05-25,16:28,10,17,27
181,2025-05-25T08:30:00+02:00,2025-05-25,16:30,12,27,39
181,2025-05-25T08:33:00+02:00,2025-05-25,16:33,20,32,52
181,2025-05-25T08:34:00+02:00,2025-05-25,16:34,13,16,29
181,2025-05-25T08:37:00+02:00,2025-05-25,16:37,14,13,27
182,2025-05-25T08:25:00+02:00,2025-05-25,16:25,13,15,28
182,2025-05-25T08:30:00+02:00,2025-05-25,16:30,16,9,25
182,2025-05-25T08:35:00+02:00,2025-05-25,16:35,15,20,35
180,2025-05-25T08:27:00+02:00,2025-05-25,16:27,0,2,2
180,2025-05-25T08:37:00+02:00,2025-05-25,16:37,1,0,1
3,2025-05-25T09:57:00+02:00,2025-05-25,17:57,9,27,36
3,2025-05-25T10:05:00+02:00,2025-05-25,18:05,14,18,32
3,2025-05-25T10:07:00+02:00,2025-05-25,18:07,9,16,25
3,2025-05-25T10:09:00+02:00,2025-05-25,18:09,16,18,34
4,2025-05-25T09:55:00+02:00,2025-05-25,17:55,23,31,54
4,2025-05-25T10:00:00+02:00,2025-05-25,18:00,17,20,37
4,2025-05-25T10:05:00+02:00,2025-05-25,18:05,21,13,34
4,2025-05-25T10:08:00+02:00,2025-05-25,18:08,15,26,41
5,2025-05-25T10:00:00+02:00,2025-05-25,18:00,59,58,117
5,2025-05-25T10:05:00+02:00,2025-05-25,18:05,114,77,191
6,2025-05-25T09:56:00+02:00,2025-05-25,17:56,18,9,27
6,2025-05-25T09:58:00+02:00,2025-05-25,17:58,19,11,30
6,2025-05-25T09:59:00+02:00,2025-05-25,17:59,20,3,23
6,2025-05-25T10:04:00+02:00,2025-05-25,18:04,12,5,17
8,2025-05-25T10:02:00+02:00,2025-05-25,18:02,1,0,1
8,2025-05-25T10:03:00+02:00,2025-05-25,18:03,2,0,2
8,2025-05-25T10:04:00+02:00,2025-05-25,18:04,0,1,1
8,2025-05-25T10:09:00+02:00,2025-05-25,18:09,2,0,2
28,2025-05-25T09:55:00+02:00,2025-05-25,17:55,2,6,8
28,2025-05-25T09:56:00+02:00,2025-05-25,17:56,5,2,7
28,2025-05-25T10:00:00+02:00,2025-05-25,18:00,6,13,19
28,2025-05-25T10:03:00+02:00,2025-05-25,18:03,8,26,34
28,2025-05-25T10:04:00+02:00,2025-05-25,18:04,1,19,20
28,2025-05-25T10:07:00+02:00,2025-05-25,18:07,2,24,26
28,2025-05-25T10:09:00+02:00,2025-05-25,18:09,6,19,25
29,2025-05-25T09:55:00+02:00,2025-05-25,17:55,14,6,20
29,2025-05-25T10:01:00+02:00,2025-05-25,18:01,7,8,15
29,2025-05-25T10:05:00+02:00,2025-05-25,18:05,4,14,18
29,2025-05-25T10:07:00+02:00,2025-05-25,18:07,15,3,18
31,2025-05-25T09:59:00+02:00,2025-05-25,17:59,1,1,2
36,2025-05-25T10:00:00+02:00,2025-05-25,18:00,6,0,6
36,2025-05-25T10:01:00+02:00,2025-05-25,18:01,0,3,3
36,2025-05-25T10:03:00+02:00,2025-05-25,18:03,3,0,3
36,2025-05-25T10:04:00+02:00,2025-05-25,18:04,0,1,1
36,2025-05-25T10:06:00+02:00,2025-05-25,18:06,2,1,3
36,2025-05-25T10:08:00+02:00,2025-05-25,18:08,0,1,1
39,2025-05-25T10:00:00+02:00,2025-05-25,18:00,1,2,3
39,2025-05-25T10:07:00+02:00,2025-05-25,18:07,0,1,1
40,2025-05-25T09:56:00+02:00,2025-05-25,17:56,2,3,5
40,2025-05-25T09:57:00+02:00,2025-05-25,17:57,2,5,7
40,2025-05-25T09:58:00+02:00,2025-05-25,17:58,7,0,7
40,2025-05-25T09:59:00+02:00,2025-05-25,17:59,0,2,2
40,2025-05-25T10:01:00+02:00,2025-05-25,18:01,1,1,2
40,2025-05-25T10:03:00+02:00,2025-05-25,18:03,0,3,3
40,2025-05-25T10:09:00+02:00,2025-05-25,18:09,0,1,1
41,2025-05-25T09:55:00+02:00,2025-05-25,17:55,8,2,10
41,2025-05-25T10:00:00+02:00,2025-05-25,18:00,11,3,14
41,2025-05-25T10:04:00+02:00,2025-05-25,18:04,0,4,4
41,2025-05-25T10:08:00+02:00,2025-05-25,18:08,3,1,4
43,2025-05-25T09:55:00+02:00,2025-05-25,17:55,1,6,7
43,2025-05-25T10:05:00+02:00,2025-05-25,18:05,8,12,20
45,2025-05-25T09:57:00+02:00,2025-05-25,17:57,23,15,38
45,2025-05-25T09:59:00+02:00,2025-05-25,17:59,17,7,24
45,2025-05-25T10:00:00+02:00,2025-05-25,18:00,12,18,30
45,2025-05-25T10:01:00+02:00,2025-05-25,18:01,11,22,33
45,2025-05-25T10:02:00+02:00,2025-05-25,18:02,8,28,36
45,2025-05-25T10:04:00+02:00,2025-05-25,18:04,9,27,36
45,2025-05-25T10:05:00+02:00,2025-05-25,18:05,17,22,39
47,2025-05-25T09:57:00+02:00,2025-05-25,17:57,8,16,24
47,2025-05-25T09:58:00+02:00,2025-05-25,17:58,11,23,34
47,2025-05-25T09:59:00+02:00,2025-05-25,17:59,15,17,32
47,2025-05-25T10:00:00+02:00,2025-05-25,18:00,7,13,20
47,2025-05-25T10:05:00+02:00,2025-05-25,18:05,12,19,31
47,2025-05-25T10:08:00+02:00,2025-05-25,18:08,4,11,15
47,2025-05-25T10:09:00+02:00,2025-05-25,18:09,17,10,27
50,2025-05-25T09:57:00+02:00,2025-05-25,17:57,6,5,11
50,2025-05-25T09:59:00+02:00,2025-05-25,17:59,3,3,6
50,2025-05-25T10:02:00+02:00,2025-05-25,18:02,6,8,14
50,2025-05-25T10:04:00+02:00,2025-05-25,18:04,2,1,3
50,2025-05-25T10:07:00+02:00,2025-05-25,18:07,1,1,2
54,2025-05-25T09:55:00+02:00,2025-05-25,17:55,1,0,1
54,2025-05-25T09:58:00+02:00,2025-05-25,17:58,6,0,6
54,2025-05-25T09:59:00+02:00,2025-05-25,17:59,1,1,2
54,2025-05-25T10:02:00+02:00,2025-05-25,18:02,3,2,5
54,2025-05-25T10:04:00+02:00,2025-05-25,18:04,2,3,5
54,2025-05-25T10:07:00+02:00,2025-05-25,18:07,9,1,10
59,2025-05-25T09:55:00+02:00,2025-05-25,17:55,20,35,55
61,2025-05-25T09:56:00+02:00,2025-05-25,17:56,6,4,10
61,2025-05-25T10:03:00+02:00,2025-05-25,18:03,4,4,8
61,2025-05-25T10:04:00+02:00,2025-05-25,18:04,6,8,14
61,2025-05-25T10:07:00+02:00,2025-05-25,18:07,1,5,6
66,2025-05-25T09:56:00+02:00,2025-05-25,17:56,17,20,37
66,2025-05-25T09:57:00+02:00,2025-05-25,17:57,25,25,50
66,2025-05-25T10:00:00+02:00,2025-05-25,18:00,24,29,53
66,2025-05-25T10:07:00+02:00,2025-05-25,18:07,17,50,67
66,2025-05-25T10:09:00+02:00,2025-05-25,18:09,19,16,35
69,2025-05-25T10:08:00+02:00,2025-05-25,18:08,1,1,2
70,2025-05-25T10:04:00+02:00,2025-05-25,18:04,2,3,5
70,2025-05-25T10:09:00+02:00,2025-05-25,18:09,4,2,6
77,2025-05-25T09:55:00+02:00,2025-05-25,17:55,12,13,25
84,2025-05-25T09:55:00+02:00,2025-05-25,17:55,77,65,142
84,2025-05-25T10:00:00+02:00,2025-05-25,18:00,79,106,185
84,2025-05-25T10:05:00+02:00,2025-05-25,18:05,78,102,180
87,2025-05-25T09:57:00+02:00,2025-05-25,17:57,0,2,2
87,2025-05-25T10:00:00+02:00,2025-05-25,18:00,1,0,1
87,2025-05-25T10:05:00+02:00,2025-05-25,18:05,0,2,2
107,2025-05-25T09:55:00+02:00,2025-05-25,17:55,7,2,9
107,2025-05-25T10:05:00+02:00,2025-05-25,18:05,3,14,17
108,2025-05-25T09:56:00+02:00,2025-05-25,17:56,1,0,1
108,2025-05-25T09:58:00+02:00,2025-05-25,17:58,2,1,3
108,2025-05-25T10:02:00+02:00,2025-05-25,18:02,1,1,2
108,2025-05-25T10:05:00+02:00,2025-05-25,18:05,1,0,1
108,2025-05-25T10:08:00+02:00,2025-05-25,18:08,3,0,3
118,2025-05-25T10:00:00+02:00,2025-05-25,18:00,0,9,9
118,2025-05-25T10:05:00+02:00,2025-05-25,18:05,3,3,6
131,2025-05-25T10:00:00+02:00,2025-05-25,18:00,9,2,11
132,2025-05-25T09:55:00+02:00,2025-05-25,17:55,10,9,19
133,2025-05-25T10:00:00+02:00,2025-05-25,18:00,52,39,91
133,2025-05-25T10:05:00+02:00,2025-05-25,18:05,64,38,102
134,2025-05-25T09:55:00+02:00,2025-05-25,17:55,34,28,62
162,2025-05-25T10:00:00+02:00,2025-05-25,18:00,12,28,40
162,2025-05-25T10:05:00+02:00,2025-05-25,18:05,22,20,42
165,2025-05-25T10:05:00+02:00,2025-05-25,18:05,5,0,5
179,2025-05-25T10:00:00+02:00,2025-05-25,18:00,1,0,1
179,2025-05-25T10:05:00+02:00,2025-05-25,18:05,11,8,19
1,2025-05-25T09:55:00+02:00,2025-05-25,17:55,9,10,19
1,2025-05-25T10:03:00+02:00,2025-05-25,18:03,21,11,32
1,2025-05-25T10:08:00+02:00,2025-05-25,18:08,14,9,23
1,2025-05-25T10:09:00+02:00,2025-05-25,18:09,15,6,21
2,2025-05-25T09:56:00+02:00,2025-05-25,17:56,7,2,9
9,2025-05-25T09:55:00+02:00,2025-05-25,17:55,1,0,1
9,2025-05-25T09:57:00+02:00,2025-05-25,17:57,4,0,4
9,2025-05-25T10:07:00+02:00,2025-05-25,18:07,2,0,2
9,2025-05-25T10:09:00+02:00,2025-05-25,18:09,8,2,10
10,2025-05-25T10:00:00+02:00,2025-05-25,18:00,5,1,6
10,2025-05-25T10:03:00+02:00,2025-05-25,18:03,0,1,1
10,2025-05-25T10:05:00+02:00,2025-05-25,18:05,1,1,2
10,2025-05-25T10:07:00+02:00,2025-05-25,18:07,2,1,3
12,2025-05-25T10:04:00+02:00,2025-05-25,18:04,7,2,9
12,2025-05-25T10:05:00+02:00,2025-05-25,18:05,4,3,7
12,2025-05-25T10:07:00+02:00,2025-05-25,18:07,1,3,4
17,2025-05-25T09:55:00+02:00,2025-05-25,17:55,1,0,1
17,2025-05-25T09:56:00+02:00,2025-05-25,17:56,4,0,4
17,2025-05-25T10:00:00+02:00,2025-05-25,18:00,3,3,6
17,2025-05-25T10:09:00+02:00,2025-05-25,18:09,1,2,3
18,2025-05-25T09:55:00+02:00,2025-05-25,17:55,1,0,1
18,2025-05-25T09:58:00+02:00,2025-05-25,17:58,2,1,3
18,2025-05-25T10:05:00+02:00,2025-05-25,18:05,0,2,2
19,2025-05-25T09:55:00+02:00,2025-05-25,17:55,11,7,18
19,2025-05-25T09:59:00+02:00,2025-05-25,17:59,11,5,16
19,2025-05-25T10:00:00+02:00,2025-05-25,18:00,9,17,26
19,2025-05-25T10:04:00+02:00,2025-05-25,18:04,23,7,30
19,2025-05-25T10:06:00+02:00,2025-05-25,18:06,5,7,12
19,2025-05-25T10:08:00+02:00,2025-05-25,18:08,13,15,28
20,2025-05-25T09:57:00+02:00,2025-05-25,17:57,14,6,20
20,2025-05-25T10:00:00+02:00,2025-05-25,18:00,6,5,11
20,2025-05-25T10:07:00+02:00,2025-05-25,18:07,2,6,8
20,2025-05-25T10:08:00+02:00,2025-05-25,18:08,1,10,11
20,2025-05-25T10:09:00+02:00,2025-05-25,18:09,5,5,10
23,2025-05-25T09:59:00+02:00,2025-05-25,17:59,1,4,5
23,2025-05-25T10:09:00+02:00,2025-05-25,18:09,4,1,5
24,2025-05-25T09:55:00+02:00,2025-05-25,17:55,9,11,20
24,2025-05-25T09:59:00+02:00,2025-05-25,17:59,4,10,14
24,2025-05-25T10:02:00+02:00,2025-05-25,18:02,7,28,35
24,2025-05-25T10:09:00+02:00,2025-05-25,18:09,8,12,20
25,2025-05-25T10:05:00+02:00,2025-05-25,18:05,94,31,125
27,2025-05-25T09:55:00+02:00,2025-05-25,17:55,5,1,6
27,2025-05-25T09:59:00+02:00,2025-05-25,17:59,4,1,5
27,2025-05-25T10:01:00+02:00,2025-05-25,18:01,5,1,6
27,2025-05-25T10:02:00+02:00,2025-05-25,18:02,0,1,1
27,2025-05-25T10:04:00+02:00,2025-05-25,18:04,2,4,6
27,2025-05-25T10:05:00+02:00,2025-05-25,18:05,1,0,1
30,2025-05-25T09:57:00+02:00,2025-05-25,17:57,5,4,9
30,2025-05-25T09:58:00+02:00,2025-05-25,17:58,4,8,12
30,2025-05-25T09:59:00+02:00,2025-05-25,17:59,16,4,20
30,2025-05-25T10:00:00+02:00,2025-05-25,18:00,4,5,9
30,2025-05-25T10:09:00+02:00,2025-05-25,18:09,7,9,16
35,2025-05-25T09:56:00+02:00,2025-05-25,17:56,12,6,18
35,2025-05-25T09:58:00+02:00,2025-05-25,17:58,20,12,32
35,2025-05-25T10:03:00+02:00,2025-05-25,18:03,8,20,28
35,2025-05-25T10:06:00+02:00,2025-05-25,18:06,18,18,36
35,2025-05-25T10:08:00+02:00,2025-05-25,18:08,6,13,19
35,2025-05-25T10:09:00+02:00,2025-05-25,18:09,15,14,29
48,2025-05-25T09:56:00+02:00,2025-05-25,17:56,0,3,3
48,2025-05-25T10:00:00+02:00,2025-05-25,18:00,2,1,3
48,2025-05-25T10:06:00+02:00,2025-05-25,18:06,1,1,2
48,2025-05-25T10:07:00+02:00,2025-05-25,18:07,0,2,2
48,2025-05-25T10:08:00+02:00,2025-05-25,18:08,3,2,5
49,2025-05-25T09:57:00+02:00,2025-05-25,17:57,1,4,5
49,2025-05-25T10:02:00+02:00,2025-05-25,18:02,5,3,8
49,2025-05-25T10:08:00+02:00,2025-05-25,18:08,0,4,4
51,2025-05-25T10:00:00+02:00,2025-05-25,18:00,1,1,2
51,2025-05-25T10:02:00+02:00,2025-05-25,18:02,1,3,4
52,2025-05-25T09:59:00+02:00,2025-05-25,17:59,4,4,8
52,2025-05-25T10:01:00+02:00,2025-05-25,18:01,3,4,7
52,2025-05-25T10:02:00+02:00,2025-05-25,18:02,4,6,10
52,2025-05-25T10:03:00+02:00,2025-05-25,18:03,2,8,10
52,2025-05-25T10:04:00+02:00,2025-05-25,18:04,3,7,10
52,2025-05-25T10:07:00+02:00,2025-05-25,18:07,3,7,10
52,2025-05-25T10:08:00+02:00,2025-05-25,18:08,4,2,6
53,2025-05-25T09:59:00+02:00,2025-05-25,17:59,6,6,12
53,2025-05-25T10:04:00+02:00,2025-05-25,18:04,15,0,15
56,2025-05-25T09:55:00+02:00,2025-05-25,17:55,12,4,16
56,2025-05-25T10:07:00+02:00,2025-05-25,18:07,8,5,13
58,2025-05-25T09:55:00+02:00,2025-05-25,17:55,6,6,12
58,2025-05-25T09:57:00+02:00,2025-05-25,17:57,12,4,16
58,2025-05-25T10:00:00+02:00,2025-05-25,18:00,13,10,23
58,2025-05-25T10:01:00+02:00,2025-05-25,18:01,4,1,5
58,2025-05-25T10:06:00+02:00,2025-05-25,18:06,11,3,14
62,2025-05-25T09:56:00+02:00,2025-05-25,17:56,7,3,10
62,2025-05-25T09:57:00+02:00,2025-05-25,17:57,3,2,5
62,2025-05-25T09:58:00+02:00,2025-05-25,17:58,2,0,2
62,2025-05-25T10:00:00+02:00,2025-05-25,18:00,2,1,3
62,2025-05-25T10:02:00+02:00,2025-05-25,18:02,1,7,8
62,2025-05-25T10:07:00+02:00,2025-05-25,18:07,0,2,2
62,2025-05-25T10:09:00+02:00,2025-05-25,18:09,3,3,6
63,2025-05-25T09:57:00+02:00,2025-05-25,17:57,3,4,7
63,2025-05-25T09:58:00+02:00,2025-05-25,17:58,2,7,9
63,2025-05-25T10:01:00+02:00,2025-05-25,18:01,3,8,11
63,2025-05-25T10:03:00+02:00,2025-05-25,18:03,2,5,7
63,2025-05-25T10:06:00+02:00,2025-05-25,18:06,3,10,13
63,2025-05-25T10:07:00+02:00,2025-05-25,18:07,0,5,5
63,2025-05-25T10:09:00+02:00,2025-05-25,18:09,0,6,6
67,2025-05-25T09:59:00+02:00,2025-05-25,17:59,2,4,6
67,2025-05-25T10:00:00+02:00,2025-05-25,18:00,7,9,16
67,2025-05-25T10:03:00+02:00,2025-05-25,18:03,1,3,4
68,2025-05-25T09:56:00+02:00,2025-05-25,17:56,0,1,1
68,2025-05-25T09:59:00+02:00,2025-05-25,17:59,5,0,5
68,2025-05-25T10:00:00+02:00,2025-05-25,18:00,1,1,2
68,2025-05-25T10:01:00+02:00,2025-05-25,18:01,3,1,4
68,2025-05-25T10:04:00+02:00,2025-05-25,18:04,1,1,2
68,2025-05-25T10:05:00+02:00,2025-05-25,18:05,7,2,9
68,2025-05-25T10:06:00+02:00,2025-05-25,18:06,2,5,7
68,2025-05-25T10:09:00+02:00,2025-05-25,18:09,1,2,3
72,2025-05-25T10:02:00+02:00,2025-05-25,18:02,0,1,1
72,2025-05-25T10:05:00+02:00,2025-05-25,18:05,8,6,14
76,2025-05-25T10:05:00+02:00,2025-05-25,18:05,1,0,1
76,2025-05-25T10:06:00+02:00,2025-05-25,18:06,2,0,2
76,2025-05-25T10:07:00+02:00,2025-05-25,18:07,1,0,1
79,2025-05-25T09:55:00+02:00,2025-05-25,17:55,3,13,16
79,2025-05-25T09:56:00+02:00,2025-05-25,17:56,3,7,10
79,2025-05-25T09:57:00+02:00,2025-05-25,17:57,15,4,19
79,2025-05-25T10:00:00+02:00,2025-05-25,18:00,0,6,6
79,2025-05-25T10:01:00+02:00,2025-05-25,18:01,17,6,23
79,2025-05-25T10:02:00+02:00,2025-05-25,18:02,17,8,25
79,2025-05-25T10:04:00+02:00,2025-05-25,18:04,11,8,19
85,2025-05-25T09:57:00+02:00,2025-05-25,17:57,1,1,2
85,2025-05-25T09:59:00+02:00,2025-05-25,17:59,1,1,2
85,2025-05-25T10:03:00+02:00,2025-05-25,18:03,0,2,2
86,2025-05-25T09:55:00+02:00,2025-05-25,17:55,1,0,1
86,2025-05-25T09:57:00+02:00,2025-05-25,17:57,1,0,1
86,2025-05-25T10:08:00+02:00,2025-05-25,18:08,0,1,1
86,2025-05-25T10:09:00+02:00,2025-05-25,18:09,0,1,1
109,2025-05-25T09:55:00+02:00,2025-05-25,17:55,5,10,15
109,2025-05-25T10:00:00+02:00,2025-05-25,18:00,3,11,14
117,2025-05-25T09:55:00+02:00,2025-05-25,17:55,18,24,42
123,2025-05-25T09:55:00+02:00,2025-05-25,17:55,1,0,1
123,2025-05-25T10:00:00+02:00,2025-05-25,18:00,2,0,2
130,2025-05-25T10:00:00+02:00,2025-05-25,18:00,0,2,2
136,2025-05-25T09:55:00+02:00,2025-05-25,17:55,15,13,28
139,2025-05-25T10:00:00+02:00,2025-05-25,18:00,3,1,4
141,2025-05-25T10:05:00+02:00,2025-05-25,18:05,5,14,19
161,2025-05-25T10:05:00+02:00,2025-05-25,18:05,0,3,3
164,2025-05-25T10:05:00+02:00,2025-05-25,18:05,11,2,13
181,2025-05-25T10:13:00+02:00,2025-05-25,18:13,17,28,45
181,2025-05-25T10:17:00+02:00,2025-05-25,18:17,8,15,23
181,2025-05-25T10:21:00+02:00,2025-05-25,18:21,14,15,29
181,2025-05-25T10:24:00+02:00,2025-05-25,18:24,10,15,25
3,2025-05-25T10:13:00+02:00,2025-05-25,18:13,11,21,32
3,2025-05-25T10:14:00+02:00,2025-05-25,18:14,11,17,28
3,2025-05-25T10:16:00+02:00,2025-05-25,18:16,20,24,44
3,2025-05-25T10:17:00+02:00,2025-05-25,18:17,10,23,33
3,2025-05-25T10:19:00+02:00,2025-05-25,18:19,21,12,33
3,2025-05-25T10:20:00+02:00,2025-05-25,18:20,10,20,30
3,2025-05-25T10:24:00+02:00,2025-05-25,18:24,17,20,37
4,2025-05-25T10:10:00+02:00,2025-05-25,18:10,12,29,41
4,2025-05-25T10:11:00+02:00,2025-05-25,18:11,23,20,43
4,2025-05-25T10:12:00+02:00,2025-05-25,18:12,29,23,52
4,2025-05-25T10:19:00+02:00,2025-05-25,18:19,29,16,45
5,2025-05-25T10:20:00+02:00,2025-05-25,18:20,58,89,147
6,2025-05-25T10:10:00+02:00,2025-05-25,18:10,10,7,17
6,2025-05-25T10:12:00+02:00,2025-05-25,18:12,11,5,16
6,2025-05-25T10:18:00+02:00,2025-05-25,18:18,20,15,35
6,2025-05-25T10:22:00+02:00,2025-05-25,18:22,18,11,29
8,2025-05-25T10:11:00+02:00,2025-05-25,18:11,2,0,2
8,2025-05-25T10:21:00+02:00,2025-05-25,18:21,1,0,1
8,2025-05-25T10:24:00+02:00,2025-05-25,18:24,1,1,2
28,2025-05-25T10:15:00+02:00,2025-05-25,18:15,2,13,15
28,2025-05-25T10:18:00+02:00,2025-05-25,18:18,6,10,16
28,2025-05-25T10:19:00+02:00,2025-05-25,18:19,2,6,8
28,2025-05-25T10:20:00+02:00,2025-05-25,18:20,1,4,5
28,2025-05-25T10:23:00+02:00,2025-05-25,18:23,4,9,13
29,2025-05-25T10:11:00+02:00,2025-05-25,18:11,7,2,9
29,2025-05-25T10:15:00+02:00,2025-05-25,18:15,7,4,11
29,2025-05-25T10:16:00+02:00,2025-05-25,18:16,1,11,12
29,2025-05-25T10:18:00+02:00,2025-05-25,18:18,8,0,8
29,2025-05-25T10:20:00+02:00,2025-05-25,18:20,5,9,14
29,2025-05-25T10:24:00+02:00,2025-05-25,18:24,9,7,16
31,2025-05-25T10:15:00+02:00,2025-05-25,18:15,3,1,4
31,2025-05-25T10:17:00+02:00,2025-05-25,18:17,0,2,2
31,2025-05-25T10:19:00+02:00,2025-05-25,18:19,4,0,4
36,2025-05-25T10:11:00+02:00,2025-05-25,18:11,1,0,1
36,2025-05-25T10:12:00+02:00,2025-05-25,18:12,5,0,5
36,2025-05-25T10:13:00+02:00,2025-05-25,18:13,1,1,2
36,2025-05-25T10:17:00+02:00,2025-05-25,18:17,1,4,5
36,2025-05-25T10:21:00+02:00,2025-05-25,18:21,0,3,3
36,2025-05-25T10:23:00+02:00,2025-05-25,18:23,1,6,7
39,2025-05-25T10:10:00+02:00,2025-05-25,18:10,1,0,1
39,2025-05-25T10:11:00+02:00,2025-05-25,18:11,4,0,4
39,2025-05-25T10:12:00+02:00,2025-05-25,18:12,3,0,3
39,2025-05-25T10:17:00+02:00,2025-05-25,18:17,0,1,1
39,2025-05-25T10:21:00+02:00,2025-05-25,18:21,1,0,1
40,2025-05-25T10:10:00+02:00,2025-05-25,18:10,1,7,8
40,2025-05-25T10:15:00+02:00,2025-05-25,18:15,2,2,4
40,2025-05-25T10:17:00+02:00,2025-05-25,18:17,1,3,4
40,2025-05-25T10:19:00+02:00,2025-05-25,18:19,3,1,4
40,2025-05-25T10:20:00+02:00,2025-05-25,18:20,0,1,1
41,2025-05-25T10:10:00+02:00,2025-05-25,18:10,13,8,21
41,2025-05-25T10:11:00+02:00,2025-05-25,18:11,19,3,22
41,2025-05-25T10:19:00+02:00,2025-05-25,18:19,9,6,15
41,2025-05-25T10:23:00+02:00,2025-05-25,18:23,5,9,14
43,2025-05-25T10:10:00+02:00,2025-05-25,18:10,7,2,9
44,2025-05-25T10:10:00+02:00,2025-05-25,18:10,6,1,7
44,2025-05-25T10:15:00+02:00,2025-05-25,18:15,1,5,6
45,2025-05-25T10:12:00+02:00,2025-05-25,18:12,8,18,26
45,2025-05-25T10:14:00+02:00,2025-05-25,18:14,8,18,26
45,2025-05-25T10:17:00+02:00,2025-05-25,18:17,8,10,18
45,2025-05-25T10:18:00+02:00,2025-05-25,18:18,13,23,36
45,2025-05-25T10:19:00+02:00,2025-05-25,18:19,17,29,46
45,2025-05-25T10:20:00+02:00,2025-05-25,18:20,23,16,39
45,2025-05-25T10:22:00+02:00,2025-05-25,18:22,9,30,39
47,2025-05-25T10:13:00+02:00,2025-05-25,18:13,18,6,24
47,2025-05-25T10:17:00+02:00,2025-05-25,18:17,4,16,20
47,2025-05-25T10:20:00+02:00,2025-05-25,18:20,19,8,27
47,2025-05-25T10:21:00+02:00,2025-05-25,18:21,21,5,26
50,2025-05-25T10:18:00+02:00,2025-05-25,18:18,2,1,3
50,2025-05-25T10:21:00+02:00,2025-05-25,18:21,1,2,3
54,2025-05-25T10:10:00+02:00,2025-05-25,18:10,3,2,5
54,2025-05-25T10:15:00+02:00,2025-05-25,18:15,5,1,6
54,2025-05-25T10:16:00+02:00,2025-05-25,18:16,3,2,5
54,2025-05-25T10:22:00+02:00,2025-05-25,18:22,2,1,3
61,2025-05-25T10:12:00+02:00,2025-05-25,18:12,2,1,3
61,2025-05-25T10:13:00+02:00,2025-05-25,18:13,5,6,11
61,2025-05-25T10:15:00+02:00,2025-05-25,18:15,5,4,9
61,2025-05-25T10:19:00+02:00,2025-05-25,18:19,3,0,3
61,2025-05-25T10:22:00+02:00,2025-05-25,18:22,6,3,9
66,2025-05-25T10:10:00+02:00,2025-05-25,18:10,14,29,43
66,2025-05-25T10:13:00+02:00,2025-05-25,18:13,26,29,55
66,2025-05-25T10:20:00+02:00,2025-05-25,18:20,20,8,28
66,2025-05-25T10:21:00+02:00,2025-05-25,18:21,20,38,58
66,2025-05-25T10:22:00+02:00,2025-05-25,18:22,10,17,27
66,2025-05-25T10:23:00+02:00,2025-05-25,18:23,25,9,34
69,2025-05-25T10:12:00+02:00,2025-05-25,18:12,1,4,5
69,2025-05-25T10:15:00+02:00,2025-05-25,18:15,1,1,2
69,2025-05-25T10:17:00+02:00,2025-05-25,18:17,1,0,1
69,2025-05-25T10:18:00+02:00,2025-05-25,18:18,2,1,3
69,2025-05-25T10:19:00+02:00,2025-05-25,18:19,0,1,1
70,2025-05-25T10:17:00+02:00,2025-05-25,18:17,0,12,12
70,2025-05-25T10:21:00+02:00,2025-05-25,18:21,2,3,5
70,2025-05-25T10:22:00+02:00,2025-05-25,18:22,1,7,8
70,2025-05-25T10:23:00+02:00,2025-05-25,18:23,1,6,7
71,2025-05-25T10:16:00+02:00,2025-05-25,18:16,0,1,1
75,2025-05-25T10:13:00+02:00,2025-05-25,18:13,2,0,2
75,2025-05-25T10:18:00+02:00,2025-05-25,18:18,3,0,3
77,2025-05-25T10:15:00+02:00,2025-05-25,18:15,12,3,15
84,2025-05-25T10:10:00+02:00,2025-05-25,18:10,75,111,186
87,2025-05-25T10:22:00+02:00,2025-05-25,18:22,2,1,3
107,2025-05-25T10:15:00+02:00,2025-05-25,18:15,4,8,12
108,2025-05-25T10:15:00+02:00,2025-05-25,18:15,2,0,2
108,2025-05-25T10:17:00+02:00,2025-05-25,18:17,2,1,3
108,2025-05-25T10:18:00+02:00,2025-05-25,18:18,5,2,7
108,2025-05-25T10:21:00+02:00,2025-05-25,18:21,1,1,2
108,2025-05-25T10:22:00+02:00,2025-05-25,18:22,2,4,6
108,2025-05-25T10:23:00+02:00,2025-05-25,18:23,0,2,2
108,2025-05-25T10:24:00+02:00,2025-05-25,18:24,1,0,1
118,2025-05-25T10:15:00+02:00,2025-05-25,18:15,4,3,7
118,2025-05-25T10:20:00+02:00,2025-05-25,18:20,5,0,5
131,2025-05-25T10:10:00+02:00,2025-05-25,18:10,17,4,21
131,2025-05-25T10:20:00+02:00,2025-05-25,18:20,11,4,15
132,2025-05-25T10:15:00+02:00,2025-05-25,18:15,9,6,15
132,2025-05-25T10:20:00+02:00,2025-05-25,18:20,11,11,22
134,2025-05-25T10:15:00+02:00,2025-05-25,18:15,37,33,70
162,2025-05-25T10:20:00+02:00,2025-05-25,18:20,18,29,47
167,2025-05-25T10:15:00+02:00,2025-05-25,18:15,4,7,11
167,2025-05-25T10:20:00+02:00,2025-05-25,18:20,4,5,9
179,2025-05-25T10:10:00+02:00,2025-05-25,18:10,3,4,7
1,2025-05-25T10:17:00+02:00,2025-05-25,18:17,11,15,26
1,2025-05-25T10:19:00+02:00,2025-05-25,18:19,8,8,16
1,2025-05-25T10:20:00+02:00,2025-05-25,18:20,19,17,36
1,2025-05-25T10:23:00+02:00,2025-05-25,18:23,10,5,15
2,2025-05-25T10:14:00+02:00,2025-05-25,18:14,13,5,18
2,2025-05-25T10:16:00+02:00,2025-05-25,18:16,3,3,6
2,2025-05-25T10:19:00+02:00,2025-05-25,18:19,2,6,8
2,2025-05-25T10:22:00+02:00,2025-05-25,18:22,3,7,10
2,2025-05-25T10:23:00+02:00,2025-05-25,18:23,2,0,2
9,2025-05-25T10:14:00+02:00,2025-05-25,18:14,4,1,5
9,2025-05-25T10:15:00+02:00,2025-05-25,18:15,1,0,1
9,2025-05-25T10:18:00+02:00,2025-05-25,18:18,4,0,4
10,2025-05-25T10:10:00+02:00,2025-05-25,18:10,3,0,3
10,2025-05-25T10:12:00+02:00,2025-05-25,18:12,0,1,1
10,2025-05-25T10:18:00+02:00,2025-05-25,18:18,3,0,3
11,2025-05-25T10:15:00+02:00,2025-05-25,18:15,5,1,6
12,2025-05-25T10:12:00+02:00,2025-05-25,18:12,2,9,11
12,2025-05-25T10:15:00+02:00,2025-05-25,18:15,0,3,3
12,2025-05-25T10:22:00+02:00,2025-05-25,18:22,2,1,3
12,2025-05-25T10:23:00+02:00,2025-05-25,18:23,4,2,6
17,2025-05-25T10:12:00+02:00,2025-05-25,18:12,2,2,4
17,2025-05-25T10:13:00+02:00,2025-05-25,18:13,3,4,7
17,2025-05-25T10:20:00+02:00,2025-05-25,18:20,0,5,5
17,2025-05-25T10:22:00+02:00,2025-05-25,18:22,1,0,1
17,2025-05-25T10:23:00+02:00,2025-05-25,18:23,9,0,9
17,2025-05-25T10:24:00+02:00,2025-05-25,18:24,1,1,2
18,2025-05-25T10:12:00+02:00,2025-05-25,18:12,0,2,2
19,2025-05-25T10:11:00+02:00,2025-05-25,18:11,13,14,27
19,2025-05-25T10:16:00+02:00,2025-05-25,18:16,6,11,17
19,2025-05-25T10:18:00+02:00,2025-05-25,18:18,8,15,23
19,2025-05-25T10:22:00+02:00,2025-05-25,18:22,6,11,17
20,2025-05-25T10:15:00+02:00,2025-05-25,18:15,15,5,20
20,2025-05-25T10:19:00+02:00,2025-05-25,18:19,6,7,13
20,2025-05-25T10:20:00+02:00,2025-05-25,18:20,1,2,3
20,2025-05-25T10:21:00+02:00,2025-05-25,18:21,12,9,21
20,2025-05-25T10:23:00+02:00,2025-05-25,18:23,3,14,17
20,2025-05-25T10:24:00+02:00,2025-05-25,18:24,2,9,11
23,2025-05-25T10:12:00+02:00,2025-05-25,18:12,0,7,7
23,2025-05-25T10:16:00+02:00,2025-05-25,18:16,2,3,5
24,2025-05-25T10:10:00+02:00,2025-05-25,18:10,4,5,9
24,2025-05-25T10:12:00+02:00,2025-05-25,18:12,1,3,4
24,2025-05-25T10:19:00+02:00,2025-05-25,18:19,2,0,2
25,2025-05-25T10:20:00+02:00,2025-05-25,18:20,56,36,92
27,2025-05-25T10:13:00+02:00,2025-05-25,18:13,2,1,3
27,2025-05-25T10:20:00+02:00,2025-05-25,18:20,5,3,8
27,2025-05-25T10:21:00+02:00,2025-05-25,18:21,1,0,1
30,2025-05-25T10:11:00+02:00,2025-05-25,18:11,0,15,15
30,2025-05-25T10:12:00+02:00,2025-05-25,18:12,5,7,12
30,2025-05-25T10:14:00+02:00,2025-05-25,18:14,7,15,22
30,2025-05-25T10:16:00+02:00,2025-05-25,18:16,4,5,9
35,2025-05-25T10:17:00+02:00,2025-05-25,18:17,19,22,41
35,2025-05-25T10:18:00+02:00,2025-05-25,18:18,5,10,15
35,2025-05-25T10:20:00+02:00,2025-05-25,18:20,11,13,24
35,2025-05-25T10:22:00+02:00,2025-05-25,18:22,18,17,35
48,2025-05-25T10:10:00+02:00,2025-05-25,18:10,0,7,7
48,2025-05-25T10:11:00+02:00,2025-05-25,18:11,1,1,2
48,2025-05-25T10:18:00+02:00,2025-05-25,18:18,5,2,7
48,2025-05-25T10:22:00+02:00,2025-05-25,18:22,0,1,1
48,2025-05-25T10:24:00+02:00,2025-05-25,18:24,0,2,2
49,2025-05-25T10:10:00+02:00,2025-05-25,18:10,9,1,10
49,2025-05-25T10:11:00+02:00,2025-05-25,18:11,3,5,8
49,2025-05-25T10:15:00+02:00,2025-05-25,18:15,5,5,10
49,2025-05-25T10:16:00+02:00,2025-05-25,18:16,0,6,6
49,2025-05-25T10:18:00+02:00,2025-05-25,18:18,3,3,6
49,2025-05-25T10:20:00+02:00,2025-05-25,18:20,3,5,8
51,2025-05-25T10:11:00+02:00,2025-05-25,18:11,2,2,4
51,2025-05-25T10:14:00+02:00,2025-05-25,18:14,3,3,6
51,2025-05-25T10:15:00+02:00,2025-05-25,18:15,2,0,2
51,2025-05-25T10:16:00+02:00,2025-05-25,18:16,3,2,5
51,2025-05-25T10:19:00+02:00,2025-05-25,18:19,1,0,1
52,2025-05-25T10:10:00+02:00,2025-05-25,18:10,6,7,13
52,2025-05-25T10:11:00+02:00,2025-05-25,18:11,6,9,15
52,2025-05-25T10:13:00+02:00,2025-05-25,18:13,3,4,7
52,2025-05-25T10:15:00+02:00,2025-05-25,18:15,5,15,20
52,2025-05-25T10:17:00+02:00,2025-05-25,18:17,8,2,10
52,2025-05-25T10:21:00+02:00,2025-05-25,18:21,3,12,15
52,2025-05-25T10:22:00+02:00,2025-05-25,18:22,5,2,7
52,2025-05-25T10:24:00+02:00,2025-05-25,18:24,7,3,10
53,2025-05-25T10:10:00+02:00,2025-05-25,18:10,2,2,4
53,2025-05-25T10:14:00+02:00,2025-05-25,18:14,2,2,4
53,2025-05-25T10:18:00+02:00,2025-05-25,18:18,11,0,11
53,2025-05-25T10:20:00+02:00,2025-05-25,18:20,4,4,8
53,2025-05-25T10:21:00+02:00,2025-05-25,18:21,9,0,9
53,2025-05-25T10:23:00+02:00,2025-05-25,18:23,0,6,6
53,2025-05-25T10:24:00+02:00,2025-05-25,18:24,4,2,6
56,2025-05-25T10:10:00+02:00,2025-05-25,18:10,9,16,25
56,2025-05-25T10:20:00+02:00,2025-05-25,18:20,2,5,7
56,2025-05-25T10:22:00+02:00,2025-05-25,18:22,4,10,14
56,2025-05-25T10:24:00+02:00,2025-05-25,18:24,7,5,12
58,2025-05-25T10:11:00+02:00,2025-05-25,18:11,8,21,29
58,2025-05-25T10:15:00+02:00,2025-05-25,18:15,10,2,12
58,2025-05-25T10:16:00+02:00,2025-05-25,18:16,0,10,10
58,2025-05-25T10:17:00+02:00,2025-05-25,18:17,15,0,15
58,2025-05-25T10:18:00+02:00,2025-05-25,18:18,10,4,14
58,2025-05-25T10:21:00+02:00,2025-05-25,18:21,8,14,22
58,2025-05-25T10:22:00+02:00,2025-05-25,18:22,6,2,8
62,2025-05-25T10:11:00+02:00,2025-05-25,18:11,0,1,1
62,2025-05-25T10:17:00+02:00,2025-05-25,18:17,1,3,4
62,2025-05-25T10:18:00+02:00,2025-05-25,18:18,6,1,7
62,2025-05-25T10:19:00+02:00,2025-05-25,18:19,4,0,4
62,2025-05-25T10:21:00+02:00,2025-05-25,18:21,2,0,2
62,2025-05-25T10:22:00+02:00,2025-05-25,18:22,7,1,8
62,2025-05-25T10:23:00+02:00,2025-05-25,18:23,2,1,3
63,2025-05-25T10:10:00+02:00,2025-05-25,18:10,1,6,7
63,2025-05-25T10:12:00+02:00,2025-05-25,18:12,3,7,10
63,2025-05-25T10:13:00+02:00,2025-05-25,18:13,3,10,13
63,2025-05-25T10:15:00+02:00,2025-05-25,18:15,3,3,6
63,2025-05-25T10:17:00+02:00,2025-05-25,18:17,3,4,7
63,2025-05-25T10:24:00+02:00,2025-05-25,18:24,2,4,6
67,2025-05-25T10:11:00+02:00,2025-05-25,18:11,13,4,17
67,2025-05-25T10:17:00+02:00,2025-05-25,18:17,3,11,14
67,2025-05-25T10:18:00+02:00,2025-05-25,18:18,2,9,11
67,2025-05-25T10:20:00+02:00,2025-05-25,18:20,0,4,4
68,2025-05-25T10:12:00+02:00,2025-05-25,18:12,3,4,7
68,2025-05-25T10:14:00+02:00,2025-05-25,18:14,3,0,3
68,2025-05-25T10:17:00+02:00,2025-05-25,18:17,2,3,5
68,2025-05-25T10:21:00+02:00,2025-05-25,18:21,1,0,1
72,2025-05-25T10:10:00+02:00,2025-05-25,18:10,2,8,10
72,2025-05-25T10:17:00+02:00,2025-05-25,18:17,5,6,11
79,2025-05-25T10:10:00+02:00,2025-05-25,18:10,10,7,17
79,2025-05-25T10:12:00+02:00,2025-05-25,18:12,13,10,23
79,2025-05-25T10:13:00+02:00,2025-05-25,18:13,10,8,18
79,2025-05-25T10:17:00+02:00,2025-05-25,18:17,8,3,11
85,2025-05-25T10:10:00+02:00,2025-05-25,18:10,1,3,4
85,2025-05-25T10:18:00+02:00,2025-05-25,18:18,2,0,2
85,2025-05-25T10:21:00+02:00,2025-05-25,18:21,5,0,5
85,2025-05-25T10:22:00+02:00,2025-05-25,18:22,1,1,2
85,2025-05-25T10:23:00+02:00,2025-05-25,18:23,0,1,1
85,2025-05-25T10:24:00+02:00,2025-05-25,18:24,4,1,5
86,2025-05-25T10:12:00+02:00,2025-05-25,18:12,3,0,3
109,2025-05-25T10:10:00+02:00,2025-05-25,18:10,7,13,20
109,2025-05-25T10:15:00+02:00,2025-05-25,18:15,12,7,19
123,2025-05-25T10:15:00+02:00,2025-05-25,18:15,2,0,2
123,2025-05-25T10:20:00+02:00,2025-05-25,18:20,2,0,2
130,2025-05-25T10:20:00+02:00,2025-05-25,18:20,0,2,2
136,2025-05-25T10:10:00+02:00,2025-05-25,18:10,6,23,29
136,2025-05-25T10:15:00+02:00,2025-05-25,18:15,5,24,29
136,2025-05-25T10:20:00+02:00,2025-05-25,18:20,2,47,49
139,2025-05-25T10:10:00+02:00,2025-05-25,18:10,4,1,5
141,2025-05-25T10:20:00+02:00,2025-05-25,18:20,18,12,30
161,2025-05-25T10:15:00+02:00,2025-05-25,18:15,0,2,2
181,2025-05-25T10:25:00+02:00,2025-05-25,18:25,15,9,24
181,2025-05-25T10:35:00+02:00,2025-05-25,18:35,10,27,37
181,2025-05-25T10:36:00+02:00,2025-05-25,18:36,10,22,32
182,2025-05-25T10:35:00+02:00,2025-05-25,18:35,32,17,49
3,2025-05-25T10:31:00+02:00,2025-05-25,18:31,16,6,22
3,2025-05-25T10:34:00+02:00,2025-05-25,18:34,28,19,47
3,2025-05-25T10:36:00+02:00,2025-05-25,18:36,10,23,33
4,2025-05-25T10:25:00+02:00,2025-05-25,18:25,16,14,30
4,2025-05-25T10:26:00+02:00,2025-05-25,18:26,18,24,42
4,2025-05-25T10:28:00+02:00,2025-05-25,18:28,16,10,26
4,2025-05-25T10:30:00+02:00,2025-05-25,18:30,17,10,27
4,2025-05-25T10:31:00+02:00,2025-05-25,18:31,29,18,47
4,2025-05-25T10:32:00+02:00,2025-05-25,18:32,21,20,41
4,2025-05-25T10:36:00+02:00,2025-05-25,18:36,12,24,36
4,2025-05-25T10:37:00+02:00,2025-05-25,18:37,16,28,44
5,2025-05-25T10:25:00+02:00,2025-05-25,18:25,51,49,100
5,2025-05-25T10:30:00+02:00,2025-05-25,18:30,65,91,156
6,2025-05-25T10:27:00+02:00,2025-05-25,18:27,8,10,18
6,2025-05-25T10:29:00+02:00,2025-05-25,18:29,8,11,19
6,2025-05-25T10:33:00+02:00,2025-05-25,18:33,11,7,18
6,2025-05-25T10:36:00+02:00,2025-05-25,18:36,15,9,24
8,2025-05-25T10:26:00+02:00,2025-05-25,18:26,0,1,1
8,2025-05-25T10:29:00+02:00,2025-05-25,18:29,1,0,1
8,2025-05-25T10:31:00+02:00,2025-05-25,18:31,0,1,1
8,2025-05-25T10:38:00+02:00,2025-05-25,18:38,0,1,1
28,2025-05-25T10:33:00+02:00,2025-05-25,18:33,0,8,8
28,2025-05-25T10:38:00+02:00,2025-05-25,18:38,5,24,29
29,2025-05-25T10:32:00+02:00,2025-05-25,18:32,6,10,16
29,2025-05-25T10:34:00+02:00,2025-05-25,18:34,1,8,9
31,2025-05-25T10:25:00+02:00,2025-05-25,18:25,1,0,1
31,2025-05-25T10:27:00+02:00,2025-05-25,18:27,2,5,7
31,2025-05-25T10:29:00+02:00,2025-05-25,18:29,9,1,10
31,2025-05-25T10:30:00+02:00,2025-05-25,18:30,3,3,6
31,2025-05-25T10:31:00+02:00,2025-05-25,18:31,9,3,12
31,2025-05-25T10:33:00+02:00,2025-05-25,18:33,1,1,2
31,2025-05-25T10:36:00+02:00,2025-05-25,18:36,11,2,13
31,2025-05-25T10:38:00+02:00,2025-05-25,18:38,1,4,5
31,2025-05-25T10:39:00+02:00,2025-05-25,18:39,1,1,2
36,2025-05-25T10:26:00+02:00,2025-05-25,18:26,1,1,2
36,2025-05-25T10:31:00+02:00,2025-05-25,18:31,0,2,2
36,2025-05-25T10:33:00+02:00,2025-05-25,18:33,2,1,3
36,2025-05-25T10:34:00+02:00,2025-05-25,18:34,2,3,5
36,2025-05-25T10:35:00+02:00,2025-05-25,18:35,2,0,2
39,2025-05-25T10:27:00+02:00,2025-05-25,18:27,1,0,1
39,2025-05-25T10:35:00+02:00,2025-05-25,18:35,1,0,1
40,2025-05-25T10:30:00+02:00,2025-05-25,18:30,7,3,10
40,2025-05-25T10:34:00+02:00,2025-05-25,18:34,0,3,3
41,2025-05-25T10:25:00+02:00,2025-05-25,18:25,2,4,6
41,2025-05-25T10:36:00+02:00,2025-05-25,18:36,5,3,8
41,2025-05-25T10:38:00+02:00,2025-05-25,18:38,2,8,10
43,2025-05-25T10:25:00+02:00,2025-05-25,18:25,2,1,3
43,2025-05-25T10:35:00+02:00,2025-05-25,18:35,4,2,6
44,2025-05-25T10:25:00+02:00,2025-05-25,18:25,3,0,3
45,2025-05-25T10:25:00+02:00,2025-05-25,18:25,18,15,33
45,2025-05-25T10:28:00+02:00,2025-05-25,18:28,19,13,32
45,2025-05-25T10:35:00+02:00,2025-05-25,18:35,21,31,52
45,2025-05-25T10:36:00+02:00,2025-05-25,18:36,15,11,26
47,2025-05-25T10:26:00+02:00,2025-05-25,18:26,5,17,22
47,2025-05-25T10:29:00+02:00,2025-05-25,18:29,30,18,48
47,2025-05-25T10:32:00+02:00,2025-05-25,18:32,8,11,19
47,2025-05-25T10:34:00+02:00,2025-05-25,18:34,11,12,23
47,2025-05-25T10:36:00+02:00,2025-05-25,18:36,9,8,17
47,2025-05-25T10:38:00+02:00,2025-05-25,18:38,7,8,15
50,2025-05-25T10:25:00+02:00,2025-05-25,18:25,5,1,6
50,2025-05-25T10:26:00+02:00,2025-05-25,18:26,7,2,9
50,2025-05-25T10:27:00+02:00,2025-05-25,18:27,2,8,10
50,2025-05-25T10:28:00+02:00,2025-05-25,18:28,0,2,2
50,2025-05-25T10:35:00+02:00,2025-05-25,18:35,5,1,6
50,2025-05-25T10:37:00+02:00,2025-05-25,18:37,8,5,13
50,2025-05-25T10:38:00+02:00,2025-05-25,18:38,0,7,7
50,2025-05-25T10:39:00+02:00,2025-05-25,18:39,2,2,4
54,2025-05-25T10:25:00+02:00,2025-05-25,18:25,2,0,2
54,2025-05-25T10:30:00+02:00,2025-05-25,18:30,0,2,2
54,2025-05-25T10:32:00+02:00,2025-05-25,18:32,3,2,5
54,2025-05-25T10:35:00+02:00,2025-05-25,18:35,1,2,3
59,2025-05-25T10:35:00+02:00,2025-05-25,18:35,13,28,41
61,2025-05-25T10:30:00+02:00,2025-05-25,18:30,5,4,9
61,2025-05-25T10:34:00+02:00,2025-05-25,18:34,5,7,12
61,2025-05-25T10:36:00+02:00,2025-05-25,18:36,0,4,4
61,2025-05-25T10:39:00+02:00,2025-05-25,18:39,9,0,9
66,2025-05-25T10:27:00+02:00,2025-05-25,18:27,22,16,38
66,2025-05-25T10:36:00+02:00,2025-05-25,18:36,8,10,18
66,2025-05-25T10:37:00+02:00,2025-05-25,18:37,15,20,35
69,2025-05-25T10:25:00+02:00,2025-05-25,18:25,0,1,1
69,2025-05-25T10:38:00+02:00,2025-05-25,18:38,0,1,1
70,2025-05-25T10:27:00+02:00,2025-05-25,18:27,5,5,10
70,2025-05-25T10:29:00+02:00,2025-05-25,18:29,2,8,10
70,2025-05-25T10:31:00+02:00,2025-05-25,18:31,5,3,8
70,2025-05-25T10:36:00+02:00,2025-05-25,18:36,3,1,4
71,2025-05-25T10:30:00+02:00,2025-05-25,18:30,0,2,2
75,2025-05-25T10:25:00+02:00,2025-05-25,18:25,1,0,1
75,2025-05-25T10:26:00+02:00,2025-05-25,18:26,1,0,1
75,2025-05-25T10:30:00+02:00,2025-05-25,18:30,1,0,1
75,2025-05-25T10:33:00+02:00,2025-05-25,18:33,4,0,4
75,2025-05-25T10:34:00+02:00,2025-05-25,18:34,1,0,1
75,2025-05-25T10:35:00+02:00,2025-05-25,18:35,2,0,2
75,2025-05-25T10:37:00+02:00,2025-05-25,18:37,2,0,2
77,2025-05-25T10:25:00+02:00,2025-05-25,18:25,8,10,18
77,2025-05-25T10:30:00+02:00,2025-05-25,18:30,13,5,18
78,2025-05-25T10:30:00+02:00,2025-05-25,18:30,0,1,1
84,2025-05-25T10:30:00+02:00,2025-05-25,18:30,124,73,197
87,2025-05-25T10:25:00+02:00,2025-05-25,18:25,2,0,2
87,2025-05-25T10:28:00+02:00,2025-05-25,18:28,0,7,7
87,2025-05-25T10:29:00+02:00,2025-05-25,18:29,2,1,3
87,2025-05-25T10:31:00+02:00,2025-05-25,18:31,0,2,2
87,2025-05-25T10:32:00+02:00,2025-05-25,18:32,2,2,4
87,2025-05-25T10:34:00+02:00,2025-05-25,18:34,4,3,7
87,2025-05-25T10:35:00+02:00,2025-05-25,18:35,2,0,2
107,2025-05-25T10:25:00+02:00,2025-05-25,18:25,4,7,11
107,2025-05-25T10:30:00+02:00,2025-05-25,18:30,0,4,4
107,2025-05-25T10:35:00+02:00,2025-05-25,18:35,8,6,14
108,2025-05-25T10:28:00+02:00,2025-05-25,18:28,1,6,7
108,2025-05-25T10:30:00+02:00,2025-05-25,18:30,4,2,6
108,2025-05-25T10:35:00+02:00,2025-05-25,18:35,0,4,4
131,2025-05-25T10:35:00+02:00,2025-05-25,18:35,4,13,17
132,2025-05-25T10:25:00+02:00,2025-05-25,18:25,10,19,29
133,2025-05-25T10:30:00+02:00,2025-05-25,18:30,26,42,68
133,2025-05-25T10:35:00+02:00,2025-05-25,18:35,47,28,75
134,2025-05-25T10:25:00+02:00,2025-05-25,18:25,40,28,68
135,2025-05-25T10:25:00+02:00,2025-05-25,18:25,23,11,34
165,2025-05-25T10:25:00+02:00,2025-05-25,18:25,3,1,4
167,2025-05-25T10:30:00+02:00,2025-05-25,18:30,0,7,7
1,2025-05-25T10:26:00+02:00,2025-05-25,18:26,4,4,8
1,2025-05-25T10:31:00+02:00,2025-05-25,18:31,7,13,20
1,2025-05-25T10:37:00+02:00,2025-05-25,18:37,9,6,15
2,2025-05-25T10:26:00+02:00,2025-05-25,18:26,4,5,9
2,2025-05-25T10:33:00+02:00,2025-05-25,18:33,3,3,6
3,2025-05-25T01:43:00+02:00,2025-05-25,09:43,0,4,4
2,2025-05-25T10:34:00+02:00,2025-05-25,18:34,8,2,10
3,2025-05-25T01:44:00+02:00,2025-05-25,09:44,4,5,9
2,2025-05-25T10:37:00+02:00,2025-05-25,18:37,9,0,9
3,2025-05-25T01:52:00+02:00,2025-05-25,09:52,5,2,7
9,2025-05-25T10:31:00+02:00,2025-05-25,18:31,3,0,3
4,2025-05-25T01:40:00+02:00,2025-05-25,09:40,9,2,11
9,2025-05-25T10:34:00+02:00,2025-05-25,18:34,0,1,1
4,2025-05-25T01:46:00+02:00,2025-05-25,09:46,30,9,39
9,2025-05-25T10:38:00+02:00,2025-05-25,18:38,2,1,3
4,2025-05-25T01:47:00+02:00,2025-05-25,09:47,11,10,21
10,2025-05-25T10:25:00+02:00,2025-05-25,18:25,1,1,2
4,2025-05-25T01:50:00+02:00,2025-05-25,09:50,8,2,10
10,2025-05-25T10:27:00+02:00,2025-05-25,18:27,1,0,1
4,2025-05-25T01:53:00+02:00,2025-05-25,09:53,13,1,14
10,2025-05-25T10:28:00+02:00,2025-05-25,18:28,0,1,1
4,2025-05-25T01:54:00+02:00,2025-05-25,09:54,24,5,29
10,2025-05-25T10:33:00+02:00,2025-05-25,18:33,6,1,7
5,2025-05-25T01:40:00+02:00,2025-05-25,09:40,20,35,55
10,2025-05-25T10:36:00+02:00,2025-05-25,18:36,1,2,3
5,2025-05-25T01:45:00+02:00,2025-05-25,09:45,16,35,51
10,2025-05-25T10:37:00+02:00,2025-05-25,18:37,0,3,3
6,2025-05-25T01:47:00+02:00,2025-05-25,09:47,9,6,15
10,2025-05-25T10:38:00+02:00,2025-05-25,18:38,0,1,1
6,2025-05-25T01:50:00+02:00,2025-05-25,09:50,9,0,9
11,2025-05-25T10:25:00+02:00,2025-05-25,18:25,0,2,2
6,2025-05-25T01:53:00+02:00,2025-05-25,09:53,16,4,20
12,2025-05-25T10:27:00+02:00,2025-05-25,18:27,6,2,8
6,2025-05-25T01:54:00+02:00,2025-05-25,09:54,8,14,22
12,2025-05-25T10:28:00+02:00,2025-05-25,18:28,4,0,4
8,2025-05-25T01:46:00+02:00,2025-05-25,09:46,2,8,10
12,2025-05-25T10:34:00+02:00,2025-05-25,18:34,1,3,4
8,2025-05-25T01:48:00+02:00,2025-05-25,09:48,2,8,10
17,2025-05-25T10:28:00+02:00,2025-05-25,18:28,1,5,6
8,2025-05-25T01:51:00+02:00,2025-05-25,09:51,0,5,5
17,2025-05-25T10:31:00+02:00,2025-05-25,18:31,0,4,4
8,2025-05-25T01:52:00+02:00,2025-05-25,09:52,1,5,6
17,2025-05-25T10:33:00+02:00,2025-05-25,18:33,0,5,5
28,2025-05-25T01:41:00+02:00,2025-05-25,09:41,2,4,6
17,2025-05-25T10:36:00+02:00,2025-05-25,18:36,8,0,8
28,2025-05-25T01:46:00+02:00,2025-05-25,09:46,4,2,6
17,2025-05-25T10:39:00+02:00,2025-05-25,18:39,2,3,5
28,2025-05-25T01:47:00+02:00,2025-05-25,09:47,4,2,6
18,2025-05-25T10:36:00+02:00,2025-05-25,18:36,2,1,3
28,2025-05-25T01:51:00+02:00,2025-05-25,09:51,6,9,15
18,2025-05-25T10:37:00+02:00,2025-05-25,18:37,0,1,1
28,2025-05-25T01:54:00+02:00,2025-05-25,09:54,8,3,11
19,2025-05-25T10:29:00+02:00,2025-05-25,18:29,13,10,23
29,2025-05-25T01:43:00+02:00,2025-05-25,09:43,6,4,10
19,2025-05-25T10:31:00+02:00,2025-05-25,18:31,25,5,30
29,2025-05-25T01:46:00+02:00,2025-05-25,09:46,0,8,8
19,2025-05-25T10:33:00+02:00,2025-05-25,18:33,11,4,15
29,2025-05-25T01:51:00+02:00,2025-05-25,09:51,3,0,3
19,2025-05-25T10:34:00+02:00,2025-05-25,18:34,1,18,19
29,2025-05-25T01:53:00+02:00,2025-05-25,09:53,1,4,5
20,2025-05-25T10:28:00+02:00,2025-05-25,18:28,3,6,9
31,2025-05-25T01:42:00+02:00,2025-05-25,09:42,2,0,2
20,2025-05-25T10:30:00+02:00,2025-05-25,18:30,15,2,17
31,2025-05-25T01:44:00+02:00,2025-05-25,09:44,1,2,3
20,2025-05-25T10:32:00+02:00,2025-05-25,18:32,4,7,11
31,2025-05-25T01:45:00+02:00,2025-05-25,09:45,2,0,2
20,2025-05-25T10:37:00+02:00,2025-05-25,18:37,16,2,18
31,2025-05-25T01:47:00+02:00,2025-05-25,09:47,1,0,1
20,2025-05-25T10:39:00+02:00,2025-05-25,18:39,3,3,6
31,2025-05-25T01:51:00+02:00,2025-05-25,09:51,1,0,1
23,2025-05-25T10:25:00+02:00,2025-05-25,18:25,2,1,3
36,2025-05-25T01:43:00+02:00,2025-05-25,09:43,1,0,1
23,2025-05-25T10:28:00+02:00,2025-05-25,18:28,1,10,11
36,2025-05-25T01:45:00+02:00,2025-05-25,09:45,6,0,6
23,2025-05-25T10:34:00+02:00,2025-05-25,18:34,1,2,3
36,2025-05-25T01:49:00+02:00,2025-05-25,09:49,0,1,1
23,2025-05-25T10:36:00+02:00,2025-05-25,18:36,3,0,3
36,2025-05-25T01:50:00+02:00,2025-05-25,09:50,0,1,1
23,2025-05-25T10:39:00+02:00,2025-05-25,18:39,0,2,2
36,2025-05-25T01:51:00+02:00,2025-05-25,09:51,3,2,5
24,2025-05-25T10:25:00+02:00,2025-05-25,18:25,7,1,8
37,2025-05-25T01:42:00+02:00,2025-05-25,09:42,0,2,2
24,2025-05-25T10:26:00+02:00,2025-05-25,18:26,7,26,33
39,2025-05-25T01:46:00+02:00,2025-05-25,09:46,0,2,2
24,2025-05-25T10:28:00+02:00,2025-05-25,18:28,5,15,20
39,2025-05-25T01:49:00+02:00,2025-05-25,09:49,1,0,1
24,2025-05-25T10:30:00+02:00,2025-05-25,18:30,6,7,13
40,2025-05-25T01:40:00+02:00,2025-05-25,09:40,1,0,1
24,2025-05-25T10:31:00+02:00,2025-05-25,18:31,18,7,25
40,2025-05-25T01:43:00+02:00,2025-05-25,09:43,0,3,3
24,2025-05-25T10:34:00+02:00,2025-05-25,18:34,2,0,2
40,2025-05-25T01:45:00+02:00,2025-05-25,09:45,0,2,2
24,2025-05-25T10:39:00+02:00,2025-05-25,18:39,10,4,14
40,2025-05-25T01:46:00+02:00,2025-05-25,09:46,3,0,3
25,2025-05-25T10:25:00+02:00,2025-05-25,18:25,78,26,104
40,2025-05-25T01:47:00+02:00,2025-05-25,09:47,1,0,1
25,2025-05-25T10:35:00+02:00,2025-05-25,18:35,42,31,73
40,2025-05-25T01:49:00+02:00,2025-05-25,09:49,1,7,8
27,2025-05-25T10:27:00+02:00,2025-05-25,18:27,3,4,7
40,2025-05-25T01:50:00+02:00,2025-05-25,09:50,3,0,3
27,2025-05-25T10:31:00+02:00,2025-05-25,18:31,0,2,2
40,2025-05-25T01:53:00+02:00,2025-05-25,09:53,1,0,1
27,2025-05-25T10:32:00+02:00,2025-05-25,18:32,1,0,1
41,2025-05-25T01:40:00+02:00,2025-05-25,09:40,1,0,1
27,2025-05-25T10:37:00+02:00,2025-05-25,18:37,4,4,8
41,2025-05-25T01:42:00+02:00,2025-05-25,09:42,5,2,7
30,2025-05-25T10:28:00+02:00,2025-05-25,18:28,6,7,13
41,2025-05-25T01:43:00+02:00,2025-05-25,09:43,6,4,10
30,2025-05-25T10:29:00+02:00,2025-05-25,18:29,4,16,20
41,2025-05-25T01:45:00+02:00,2025-05-25,09:45,5,5,10
30,2025-05-25T10:30:00+02:00,2025-05-25,18:30,5,1,6
41,2025-05-25T01:46:00+02:00,2025-05-25,09:46,7,0,7
30,2025-05-25T10:32:00+02:00,2025-05-25,18:32,1,10,11
41,2025-05-25T01:47:00+02:00,2025-05-25,09:47,2,1,3
30,2025-05-25T10:33:00+02:00,2025-05-25,18:33,2,10,12
41,2025-05-25T01:51:00+02:00,2025-05-25,09:51,4,7,11
30,2025-05-25T10:35:00+02:00,2025-05-25,18:35,1,1,2
41,2025-05-25T01:52:00+02:00,2025-05-25,09:52,1,0,1
30,2025-05-25T10:38:00+02:00,2025-05-25,18:38,0,6,6
43,2025-05-25T01:40:00+02:00,2025-05-25,09:40,6,3,9
30,2025-05-25T10:39:00+02:00,2025-05-25,18:39,6,12,18
43,2025-05-25T01:45:00+02:00,2025-05-25,09:45,6,6,12
35,2025-05-25T10:29:00+02:00,2025-05-25,18:29,6,8,14
43,2025-05-25T01:50:00+02:00,2025-05-25,09:50,3,3,6
35,2025-05-25T10:32:00+02:00,2025-05-25,18:32,17,12,29
44,2025-05-25T01:40:00+02:00,2025-05-25,09:40,2,2,4
35,2025-05-25T10:38:00+02:00,2025-05-25,18:38,4,21,25
45,2025-05-25T01:45:00+02:00,2025-05-25,09:45,3,3,6
35,2025-05-25T10:39:00+02:00,2025-05-25,18:39,18,10,28
45,2025-05-25T01:51:00+02:00,2025-05-25,09:51,10,1,11
48,2025-05-25T10:28:00+02:00,2025-05-25,18:28,2,1,3
45,2025-05-25T01:53:00+02:00,2025-05-25,09:53,3,1,4
48,2025-05-25T10:33:00+02:00,2025-05-25,18:33,1,1,2
47,2025-05-25T01:41:00+02:00,2025-05-25,09:41,2,10,12
48,2025-05-25T10:34:00+02:00,2025-05-25,18:34,3,5,8
47,2025-05-25T01:48:00+02:00,2025-05-25,09:48,8,2,10
48,2025-05-25T10:38:00+02:00,2025-05-25,18:38,0,6,6
47,2025-05-25T01:49:00+02:00,2025-05-25,09:49,2,4,6
48,2025-05-25T10:39:00+02:00,2025-05-25,18:39,0,6,6
47,2025-05-25T01:50:00+02:00,2025-05-25,09:50,6,8,14
49,2025-05-25T10:28:00+02:00,2025-05-25,18:28,2,5,7
47,2025-05-25T01:51:00+02:00,2025-05-25,09:51,16,5,21
49,2025-05-25T10:29:00+02:00,2025-05-25,18:29,5,6,11
47,2025-05-25T01:52:00+02:00,2025-05-25,09:52,10,17,27
49,2025-05-25T10:31:00+02:00,2025-05-25,18:31,4,4,8
47,2025-05-25T01:53:00+02:00,2025-05-25,09:53,7,7,14
49,2025-05-25T10:33:00+02:00,2025-05-25,18:33,5,4,9
47,2025-05-25T01:54:00+02:00,2025-05-25,09:54,4,8,12
49,2025-05-25T10:34:00+02:00,2025-05-25,18:34,5,5,10
50,2025-05-25T01:40:00+02:00,2025-05-25,09:40,1,0,1
49,2025-05-25T10:38:00+02:00,2025-05-25,18:38,5,4,9
50,2025-05-25T01:41:00+02:00,2025-05-25,09:41,0,2,2
51,2025-05-25T10:27:00+02:00,2025-05-25,18:27,1,1,2
50,2025-05-25T01:42:00+02:00,2025-05-25,09:42,1,2,3
51,2025-05-25T10:28:00+02:00,2025-05-25,18:28,0,1,1
50,2025-05-25T01:44:00+02:00,2025-05-25,09:44,1,0,1
51,2025-05-25T10:36:00+02:00,2025-05-25,18:36,1,0,1
50,2025-05-25T01:46:00+02:00,2025-05-25,09:46,4,1,5
51,2025-05-25T10:37:00+02:00,2025-05-25,18:37,1,1,2
50,2025-05-25T01:48:00+02:00,2025-05-25,09:48,2,3,5
52,2025-05-25T10:28:00+02:00,2025-05-25,18:28,13,3,16
50,2025-05-25T01:52:00+02:00,2025-05-25,09:52,1,0,1
52,2025-05-25T10:30:00+02:00,2025-05-25,18:30,6,4,10
54,2025-05-25T01:41:00+02:00,2025-05-25,09:41,0,4,4
52,2025-05-25T10:33:00+02:00,2025-05-25,18:33,4,3,7
54,2025-05-25T01:42:00+02:00,2025-05-25,09:42,2,1,3
52,2025-05-25T10:34:00+02:00,2025-05-25,18:34,4,8,12
54,2025-05-25T01:48:00+02:00,2025-05-25,09:48,5,0,5
52,2025-05-25T10:35:00+02:00,2025-05-25,18:35,2,7,9
54,2025-05-25T01:49:00+02:00,2025-05-25,09:49,2,0,2
53,2025-05-25T10:25:00+02:00,2025-05-25,18:25,0,3,3
54,2025-05-25T01:50:00+02:00,2025-05-25,09:50,0,3,3
53,2025-05-25T10:27:00+02:00,2025-05-25,18:27,13,1,14
61,2025-05-25T01:40:00+02:00,2025-05-25,09:40,2,5,7
53,2025-05-25T10:35:00+02:00,2025-05-25,18:35,7,2,9
61,2025-05-25T01:43:00+02:00,2025-05-25,09:43,2,2,4
53,2025-05-25T10:36:00+02:00,2025-05-25,18:36,0,1,1
61,2025-05-25T01:45:00+02:00,2025-05-25,09:45,4,3,7
56,2025-05-25T10:26:00+02:00,2025-05-25,18:26,6,4,10
61,2025-05-25T01:54:00+02:00,2025-05-25,09:54,8,8,16
56,2025-05-25T10:28:00+02:00,2025-05-25,18:28,7,6,13
66,2025-05-25T01:41:00+02:00,2025-05-25,09:41,4,4,8
56,2025-05-25T10:36:00+02:00,2025-05-25,18:36,9,8,17
66,2025-05-25T01:42:00+02:00,2025-05-25,09:42,2,9,11
56,2025-05-25T10:38:00+02:00,2025-05-25,18:38,8,9,17
66,2025-05-25T01:43:00+02:00,2025-05-25,09:43,1,3,4
56,2025-05-25T10:39:00+02:00,2025-05-25,18:39,6,19,25
66,2025-05-25T01:48:00+02:00,2025-05-25,09:48,11,10,21
58,2025-05-25T10:25:00+02:00,2025-05-25,18:25,6,7,13
66,2025-05-25T01:50:00+02:00,2025-05-25,09:50,2,10,12
58,2025-05-25T10:29:00+02:00,2025-05-25,18:29,7,0,7
66,2025-05-25T01:54:00+02:00,2025-05-25,09:54,1,7,8
58,2025-05-25T10:33:00+02:00,2025-05-25,18:33,14,3,17
69,2025-05-25T01:49:00+02:00,2025-05-25,09:49,5,4,9
58,2025-05-25T10:36:00+02:00,2025-05-25,18:36,17,0,17
69,2025-05-25T01:50:00+02:00,2025-05-25,09:50,4,2,6
58,2025-05-25T10:37:00+02:00,2025-05-25,18:37,6,7,13
69,2025-05-25T01:52:00+02:00,2025-05-25,09:52,3,0,3
58,2025-05-25T10:38:00+02:00,2025-05-25,18:38,3,1,4
69,2025-05-25T01:53:00+02:00,2025-05-25,09:53,1,8,9
62,2025-05-25T10:30:00+02:00,2025-05-25,18:30,1,5,6
70,2025-05-25T01:48:00+02:00,2025-05-25,09:48,0,1,1
62,2025-05-25T10:31:00+02:00,2025-05-25,18:31,2,2,4
70,2025-05-25T01:49:00+02:00,2025-05-25,09:49,0,3,3
62,2025-05-25T10:33:00+02:00,2025-05-25,18:33,0,9,9
70,2025-05-25T01:50:00+02:00,2025-05-25,09:50,1,0,1
62,2025-05-25T10:35:00+02:00,2025-05-25,18:35,1,2,3
70,2025-05-25T01:54:00+02:00,2025-05-25,09:54,2,3,5
63,2025-05-25T10:25:00+02:00,2025-05-25,18:25,0,3,3
75,2025-05-25T01:41:00+02:00,2025-05-25,09:41,3,1,4
63,2025-05-25T10:31:00+02:00,2025-05-25,18:31,1,5,6
75,2025-05-25T01:42:00+02:00,2025-05-25,09:42,1,0,1
63,2025-05-25T10:39:00+02:00,2025-05-25,18:39,0,5,5
75,2025-05-25T01:43:00+02:00,2025-05-25,09:43,1,0,1
67,2025-05-25T10:30:00+02:00,2025-05-25,18:30,3,3,6
75,2025-05-25T01:44:00+02:00,2025-05-25,09:44,4,0,4
67,2025-05-25T10:32:00+02:00,2025-05-25,18:32,6,4,10
75,2025-05-25T01:53:00+02:00,2025-05-25,09:53,0,2,2
68,2025-05-25T10:25:00+02:00,2025-05-25,18:25,1,2,3
75,2025-05-25T01:54:00+02:00,2025-05-25,09:54,0,2,2
68,2025-05-25T10:34:00+02:00,2025-05-25,18:34,1,2,3
77,2025-05-25T01:45:00+02:00,2025-05-25,09:45,9,15,24
68,2025-05-25T10:35:00+02:00,2025-05-25,18:35,2,0,2
77,2025-05-25T01:50:00+02:00,2025-05-25,09:50,9,7,16
68,2025-05-25T10:37:00+02:00,2025-05-25,18:37,2,1,3
78,2025-05-25T01:40:00+02:00,2025-05-25,09:40,0,2,2
68,2025-05-25T10:38:00+02:00,2025-05-25,18:38,5,4,9
78,2025-05-25T01:41:00+02:00,2025-05-25,09:41,3,1,4
72,2025-05-25T10:26:00+02:00,2025-05-25,18:26,7,6,13
78,2025-05-25T01:44:00+02:00,2025-05-25,09:44,0,2,2
72,2025-05-25T10:28:00+02:00,2025-05-25,18:28,11,5,16
78,2025-05-25T01:45:00+02:00,2025-05-25,09:45,1,0,1
72,2025-05-25T10:30:00+02:00,2025-05-25,18:30,0,4,4
84,2025-05-25T01:40:00+02:00,2025-05-25,09:40,51,31,82
72,2025-05-25T10:34:00+02:00,2025-05-25,18:34,1,6,7
87,2025-05-25T01:44:00+02:00,2025-05-25,09:44,1,6,7
72,2025-05-25T10:39:00+02:00,2025-05-25,18:39,6,20,26
87,2025-05-25T01:48:00+02:00,2025-05-25,09:48,0,2,2
76,2025-05-25T10:27:00+02:00,2025-05-25,18:27,1,0,1
87,2025-05-25T01:51:00+02:00,2025-05-25,09:51,3,4,7
76,2025-05-25T10:39:00+02:00,2025-05-25,18:39,1,0,1
87,2025-05-25T01:52:00+02:00,2025-05-25,09:52,4,0,4
79,2025-05-25T10:26:00+02:00,2025-05-25,18:26,0,5,5
108,2025-05-25T01:43:00+02:00,2025-05-25,09:43,4,2,6
79,2025-05-25T10:27:00+02:00,2025-05-25,18:27,2,8,10
108,2025-05-25T01:45:00+02:00,2025-05-25,09:45,2,0,2
79,2025-05-25T10:30:00+02:00,2025-05-25,18:30,14,5,19
108,2025-05-25T01:46:00+02:00,2025-05-25,09:46,2,1,3
79,2025-05-25T10:33:00+02:00,2025-05-25,18:33,4,9,13
108,2025-05-25T01:49:00+02:00,2025-05-25,09:49,1,0,1
79,2025-05-25T10:34:00+02:00,2025-05-25,18:34,5,14,19
108,2025-05-25T01:52:00+02:00,2025-05-25,09:52,1,0,1
79,2025-05-25T10:36:00+02:00,2025-05-25,18:36,7,2,9
108,2025-05-25T01:53:00+02:00,2025-05-25,09:53,1,1,2
85,2025-05-25T10:31:00+02:00,2025-05-25,18:31,0,1,1
131,2025-05-25T01:40:00+02:00,2025-05-25,09:40,5,3,8
85,2025-05-25T10:37:00+02:00,2025-05-25,18:37,2,0,2
132,2025-05-25T01:40:00+02:00,2025-05-25,09:40,11,2,13
86,2025-05-25T10:27:00+02:00,2025-05-25,18:27,1,0,1
133,2025-05-25T01:50:00+02:00,2025-05-25,09:50,34,50,84
86,2025-05-25T10:30:00+02:00,2025-05-25,18:30,2,0,2
134,2025-05-25T01:45:00+02:00,2025-05-25,09:45,29,24,53
86,2025-05-25T10:34:00+02:00,2025-05-25,18:34,0,1,1
134,2025-05-25T01:50:00+02:00,2025-05-25,09:50,19,29,48
86,2025-05-25T10:39:00+02:00,2025-05-25,18:39,0,3,3
140,2025-05-25T01:40:00+02:00,2025-05-25,09:40,8,2,10
109,2025-05-25T10:25:00+02:00,2025-05-25,18:25,3,10,13
165,2025-05-25T01:45:00+02:00,2025-05-25,09:45,2,4,6
109,2025-05-25T10:30:00+02:00,2025-05-25,18:30,2,8,10
167,2025-05-25T01:40:00+02:00,2025-05-25,09:40,4,8,12
117,2025-05-25T10:35:00+02:00,2025-05-25,18:35,8,43,51
179,2025-05-25T01:45:00+02:00,2025-05-25,09:45,2,5,7
123,2025-05-25T10:25:00+02:00,2025-05-25,18:25,3,0,3
1,2025-05-25T01:41:00+02:00,2025-05-25,09:41,3,3,6
123,2025-05-25T10:30:00+02:00,2025-05-25,18:30,1,1,2
1,2025-05-25T01:43:00+02:00,2025-05-25,09:43,0,6,6
130,2025-05-25T10:35:00+02:00,2025-05-25,18:35,2,3,5
1,2025-05-25T01:47:00+02:00,2025-05-25,09:47,4,5,9
137,2025-05-25T10:35:00+02:00,2025-05-25,18:35,0,2,2
1,2025-05-25T01:49:00+02:00,2025-05-25,09:49,2,13,15
141,2025-05-25T10:25:00+02:00,2025-05-25,18:25,7,4,11
1,2025-05-25T01:51:00+02:00,2025-05-25,09:51,12,6,18
161,2025-05-25T10:25:00+02:00,2025-05-25,18:25,0,8,8
2,2025-05-25T01:42:00+02:00,2025-05-25,09:42,2,4,6
161,2025-05-25T10:35:00+02:00,2025-05-25,18:35,0,7,7
2,2025-05-25T01:45:00+02:00,2025-05-25,09:45,4,5,9
164,2025-05-25T10:25:00+02:00,2025-05-25,18:25,5,15,20
2,2025-05-25T01:46:00+02:00,2025-05-25,09:46,0,3,3
2,2025-05-25T01:48:00+02:00,2025-05-25,09:48,7,0,7
2,2025-05-25T01:53:00+02:00,2025-05-25,09:53,2,7,9
9,2025-05-25T01:42:00+02:00,2025-05-25,09:42,2,1,3
9,2025-05-25T01:44:00+02:00,2025-05-25,09:44,3,0,3
9,2025-05-25T01:50:00+02:00,2025-05-25,09:50,4,1,5
9,2025-05-25T01:53:00+02:00,2025-05-25,09:53,1,0,1
10,2025-05-25T01:41:00+02:00,2025-05-25,09:41,0,1,1
10,2025-05-25T01:44:00+02:00,2025-05-25,09:44,1,8,9
10,2025-05-25T01:54:00+02:00,2025-05-25,09:54,2,0,2
11,2025-05-25T01:40:00+02:00,2025-05-25,09:40,12,1,13
11,2025-05-25T01:42:00+02:00,2025-05-25,09:42,1,0,1
11,2025-05-25T01:44:00+02:00,2025-05-25,09:44,0,1,1
11,2025-05-25T01:45:00+02:00,2025-05-25,09:45,2,3,5
11,2025-05-25T01:47:00+02:00,2025-05-25,09:47,1,3,4
11,2025-05-25T01:48:00+02:00,2025-05-25,09:48,3,0,3
11,2025-05-25T01:50:00+02:00,2025-05-25,09:50,7,1,8
11,2025-05-25T01:53:00+02:00,2025-05-25,09:53,0,2,2
12,2025-05-25T01:40:00+02:00,2025-05-25,09:40,4,1,5
12,2025-05-25T01:49:00+02:00,2025-05-25,09:49,1,4,5
12,2025-05-25T01:50:00+02:00,2025-05-25,09:50,2,0,2
17,2025-05-25T01:40:00+02:00,2025-05-25,09:40,3,1,4
3,2025-05-25T11:11:00+02:00,2025-05-25,19:11,22,10,32
17,2025-05-25T01:41:00+02:00,2025-05-25,09:41,3,5,8
3,2025-05-25T11:15:00+02:00,2025-05-25,19:15,9,10,19
17,2025-05-25T01:49:00+02:00,2025-05-25,09:49,0,1,1
3,2025-05-25T11:18:00+02:00,2025-05-25,19:18,22,26,48
17,2025-05-25T01:51:00+02:00,2025-05-25,09:51,5,0,5
3,2025-05-25T11:22:00+02:00,2025-05-25,19:22,8,11,19
17,2025-05-25T01:53:00+02:00,2025-05-25,09:53,7,0,7
4,2025-05-25T11:10:00+02:00,2025-05-25,19:10,28,26,54
18,2025-05-25T01:43:00+02:00,2025-05-25,09:43,1,2,3
4,2025-05-25T11:20:00+02:00,2025-05-25,19:20,10,29,39
18,2025-05-25T01:44:00+02:00,2025-05-25,09:44,0,1,1
5,2025-05-25T11:10:00+02:00,2025-05-25,19:10,26,92,118
18,2025-05-25T01:48:00+02:00,2025-05-25,09:48,1,0,1
6,2025-05-25T11:11:00+02:00,2025-05-25,19:11,9,4,13
18,2025-05-25T01:51:00+02:00,2025-05-25,09:51,1,0,1
6,2025-05-25T11:12:00+02:00,2025-05-25,19:12,7,1,8
19,2025-05-25T01:40:00+02:00,2025-05-25,09:40,1,0,1
6,2025-05-25T11:14:00+02:00,2025-05-25,19:14,12,11,23
19,2025-05-25T01:43:00+02:00,2025-05-25,09:43,0,11,11
6,2025-05-25T11:18:00+02:00,2025-05-25,19:18,14,8,22
19,2025-05-25T01:45:00+02:00,2025-05-25,09:45,1,4,5
6,2025-05-25T11:22:00+02:00,2025-05-25,19:22,13,12,25
19,2025-05-25T01:49:00+02:00,2025-05-25,09:49,2,1,3
6,2025-05-25T11:23:00+02:00,2025-05-25,19:23,6,6,12
19,2025-05-25T01:51:00+02:00,2025-05-25,09:51,1,2,3
8,2025-05-25T11:12:00+02:00,2025-05-25,19:12,1,0,1
20,2025-05-25T01:44:00+02:00,2025-05-25,09:44,2,0,2
8,2025-05-25T11:20:00+02:00,2025-05-25,19:20,0,1,1
20,2025-05-25T01:49:00+02:00,2025-05-25,09:49,3,0,3
21,2025-05-25T11:15:00+02:00,2025-05-25,19:15,36,45,81
23,2025-05-25T01:45:00+02:00,2025-05-25,09:45,5,0,5
21,2025-05-25T11:20:00+02:00,2025-05-25,19:20,33,46,79
23,2025-05-25T01:46:00+02:00,2025-05-25,09:46,1,5,6
28,2025-05-25T11:12:00+02:00,2025-05-25,19:12,4,10,14
24,2025-05-25T01:42:00+02:00,2025-05-25,09:42,9,9,18
28,2025-05-25T11:18:00+02:00,2025-05-25,19:18,3,4,7
24,2025-05-25T01:43:00+02:00,2025-05-25,09:43,2,13,15
28,2025-05-25T11:20:00+02:00,2025-05-25,19:20,3,5,8
24,2025-05-25T01:45:00+02:00,2025-05-25,09:45,7,2,9
29,2025-05-25T11:11:00+02:00,2025-05-25,19:11,7,7,14
24,2025-05-25T01:48:00+02:00,2025-05-25,09:48,4,8,12
29,2025-05-25T11:13:00+02:00,2025-05-25,19:13,7,10,17
24,2025-05-25T01:50:00+02:00,2025-05-25,09:50,5,15,20
29,2025-05-25T11:18:00+02:00,2025-05-25,19:18,4,9,13
24,2025-05-25T01:51:00+02:00,2025-05-25,09:51,7,5,12
29,2025-05-25T11:22:00+02:00,2025-05-25,19:22,0,7,7
24,2025-05-25T01:54:00+02:00,2025-05-25,09:54,10,6,16
31,2025-05-25T11:10:00+02:00,2025-05-25,19:10,7,1,8
25,2025-05-25T01:40:00+02:00,2025-05-25,09:40,44,29,73
31,2025-05-25T11:11:00+02:00,2025-05-25,19:11,3,1,4
27,2025-05-25T01:42:00+02:00,2025-05-25,09:42,0,6,6
31,2025-05-25T11:13:00+02:00,2025-05-25,19:13,4,7,11
27,2025-05-25T01:50:00+02:00,2025-05-25,09:50,1,1,2
31,2025-05-25T11:15:00+02:00,2025-05-25,19:15,4,6,10
27,2025-05-25T01:53:00+02:00,2025-05-25,09:53,4,3,7
31,2025-05-25T11:16:00+02:00,2025-05-25,19:16,6,0,6
27,2025-05-25T01:54:00+02:00,2025-05-25,09:54,4,0,4
31,2025-05-25T11:17:00+02:00,2025-05-25,19:17,2,5,7
30,2025-05-25T01:40:00+02:00,2025-05-25,09:40,7,5,12
31,2025-05-25T11:18:00+02:00,2025-05-25,19:18,2,0,2
30,2025-05-25T01:45:00+02:00,2025-05-25,09:45,2,4,6
31,2025-05-25T11:19:00+02:00,2025-05-25,19:19,5,3,8
30,2025-05-25T01:46:00+02:00,2025-05-25,09:46,0,2,2
36,2025-05-25T11:14:00+02:00,2025-05-25,19:14,2,0,2
30,2025-05-25T01:47:00+02:00,2025-05-25,09:47,0,1,1
36,2025-05-25T11:15:00+02:00,2025-05-25,19:15,2,0,2
30,2025-05-25T01:54:00+02:00,2025-05-25,09:54,1,1,2
36,2025-05-25T11:18:00+02:00,2025-05-25,19:18,0,2,2
35,2025-05-25T01:40:00+02:00,2025-05-25,09:40,22,13,35
36,2025-05-25T11:19:00+02:00,2025-05-25,19:19,2,0,2
35,2025-05-25T01:41:00+02:00,2025-05-25,09:41,18,8,26
40,2025-05-25T11:16:00+02:00,2025-05-25,19:16,2,0,2
35,2025-05-25T01:44:00+02:00,2025-05-25,09:44,20,2,22
40,2025-05-25T11:20:00+02:00,2025-05-25,19:20,3,0,3
35,2025-05-25T01:49:00+02:00,2025-05-25,09:49,17,8,25
40,2025-05-25T11:22:00+02:00,2025-05-25,19:22,0,3,3
48,2025-05-25T01:40:00+02:00,2025-05-25,09:40,4,5,9
40,2025-05-25T11:24:00+02:00,2025-05-25,19:24,2,2,4
48,2025-05-25T01:47:00+02:00,2025-05-25,09:47,6,5,11
41,2025-05-25T11:13:00+02:00,2025-05-25,19:13,2,3,5
48,2025-05-25T01:52:00+02:00,2025-05-25,09:52,5,3,8
41,2025-05-25T11:14:00+02:00,2025-05-25,19:14,4,0,4
49,2025-05-25T01:42:00+02:00,2025-05-25,09:42,9,5,14
41,2025-05-25T11:15:00+02:00,2025-05-25,19:15,2,15,17
51,2025-05-25T01:40:00+02:00,2025-05-25,09:40,2,2,4
41,2025-05-25T11:16:00+02:00,2025-05-25,19:16,5,7,12
51,2025-05-25T01:46:00+02:00,2025-05-25,09:46,1,3,4
41,2025-05-25T11:17:00+02:00,2025-05-25,19:17,11,7,18
51,2025-05-25T01:53:00+02:00,2025-05-25,09:53,1,4,5
41,2025-05-25T11:22:00+02:00,2025-05-25,19:22,18,2,20
51,2025-05-25T01:54:00+02:00,2025-05-25,09:54,0,2,2
41,2025-05-25T11:24:00+02:00,2025-05-25,19:24,5,2,7
52,2025-05-25T01:41:00+02:00,2025-05-25,09:41,0,1,1
43,2025-05-25T11:15:00+02:00,2025-05-25,19:15,3,8,11
52,2025-05-25T01:43:00+02:00,2025-05-25,09:43,1,0,1
45,2025-05-25T11:11:00+02:00,2025-05-25,19:11,3,19,22
52,2025-05-25T01:45:00+02:00,2025-05-25,09:45,0,2,2
45,2025-05-25T11:14:00+02:00,2025-05-25,19:14,11,13,24
52,2025-05-25T01:50:00+02:00,2025-05-25,09:50,1,1,2
45,2025-05-25T11:16:00+02:00,2025-05-25,19:16,12,20,32
52,2025-05-25T01:51:00+02:00,2025-05-25,09:51,0,3,3
45,2025-05-25T11:18:00+02:00,2025-05-25,19:18,17,17,34
52,2025-05-25T01:52:00+02:00,2025-05-25,09:52,2,1,3
45,2025-05-25T11:20:00+02:00,2025-05-25,19:20,9,21,30
52,2025-05-25T01:54:00+02:00,2025-05-25,09:54,5,4,9
45,2025-05-25T11:21:00+02:00,2025-05-25,19:21,15,12,27
53,2025-05-25T01:40:00+02:00,2025-05-25,09:40,6,0,6
45,2025-05-25T11:22:00+02:00,2025-05-25,19:22,16,15,31
53,2025-05-25T01:41:00+02:00,2025-05-25,09:41,2,6,8
45,2025-05-25T11:23:00+02:00,2025-05-25,19:23,16,8,24
53,2025-05-25T01:46:00+02:00,2025-05-25,09:46,9,3,12
47,2025-05-25T11:11:00+02:00,2025-05-25,19:11,28,9,37
53,2025-05-25T01:49:00+02:00,2025-05-25,09:49,7,7,14
47,2025-05-25T11:12:00+02:00,2025-05-25,19:12,16,10,26
56,2025-05-25T01:45:00+02:00,2025-05-25,09:45,1,0,1
47,2025-05-25T11:14:00+02:00,2025-05-25,19:14,7,14,21
56,2025-05-25T01:47:00+02:00,2025-05-25,09:47,4,0,4
47,2025-05-25T11:23:00+02:00,2025-05-25,19:23,10,18,28
56,2025-05-25T01:51:00+02:00,2025-05-25,09:51,6,1,7
50,2025-05-25T11:15:00+02:00,2025-05-25,19:15,0,6,6
56,2025-05-25T01:52:00+02:00,2025-05-25,09:52,2,0,2
50,2025-05-25T11:18:00+02:00,2025-05-25,19:18,1,1,2
56,2025-05-25T01:53:00+02:00,2025-05-25,09:53,6,6,12
54,2025-05-25T11:15:00+02:00,2025-05-25,19:15,1,0,1
56,2025-05-25T01:54:00+02:00,2025-05-25,09:54,5,0,5
54,2025-05-25T11:16:00+02:00,2025-05-25,19:16,0,2,2
58,2025-05-25T01:40:00+02:00,2025-05-25,09:40,2,1,3
54,2025-05-25T11:17:00+02:00,2025-05-25,19:17,1,2,3
58,2025-05-25T01:41:00+02:00,2025-05-25,09:41,4,2,6
54,2025-05-25T11:18:00+02:00,2025-05-25,19:18,3,2,5
58,2025-05-25T01:42:00+02:00,2025-05-25,09:42,5,6,11
59,2025-05-25T11:10:00+02:00,2025-05-25,19:10,22,41,63
58,2025-05-25T01:45:00+02:00,2025-05-25,09:45,6,2,8
61,2025-05-25T11:15:00+02:00,2025-05-25,19:15,4,3,7
58,2025-05-25T01:53:00+02:00,2025-05-25,09:53,4,6,10
61,2025-05-25T11:17:00+02:00,2025-05-25,19:17,3,3,6
58,2025-05-25T01:54:00+02:00,2025-05-25,09:54,12,6,18
61,2025-05-25T11:19:00+02:00,2025-05-25,19:19,7,1,8
62,2025-05-25T01:46:00+02:00,2025-05-25,09:46,2,1,3
61,2025-05-25T11:20:00+02:00,2025-05-25,19:20,2,7,9
62,2025-05-25T01:51:00+02:00,2025-05-25,09:51,2,2,4
61,2025-05-25T11:21:00+02:00,2025-05-25,19:21,3,0,3
63,2025-05-25T01:40:00+02:00,2025-05-25,09:40,1,3,4
61,2025-05-25T11:24:00+02:00,2025-05-25,19:24,7,2,9
63,2025-05-25T01:42:00+02:00,2025-05-25,09:42,4,0,4
66,2025-05-25T11:10:00+02:00,2025-05-25,19:10,18,16,34
63,2025-05-25T01:45:00+02:00,2025-05-25,09:45,1,4,5
66,2025-05-25T11:11:00+02:00,2025-05-25,19:11,8,15,23
63,2025-05-25T01:48:00+02:00,2025-05-25,09:48,4,3,7
66,2025-05-25T11:16:00+02:00,2025-05-25,19:16,28,19,47
63,2025-05-25T01:51:00+02:00,2025-05-25,09:51,5,3,8
66,2025-05-25T11:20:00+02:00,2025-05-25,19:20,13,27,40
63,2025-05-25T01:53:00+02:00,2025-05-25,09:53,3,5,8
66,2025-05-25T11:23:00+02:00,2025-05-25,19:23,18,16,34
67,2025-05-25T01:51:00+02:00,2025-05-25,09:51,1,4,5
66,2025-05-25T11:24:00+02:00,2025-05-25,19:24,12,7,19
67,2025-05-25T01:54:00+02:00,2025-05-25,09:54,8,4,12
69,2025-05-25T11:23:00+02:00,2025-05-25,19:23,2,1,3
68,2025-05-25T01:40:00+02:00,2025-05-25,09:40,2,1,3
70,2025-05-25T11:10:00+02:00,2025-05-25,19:10,3,0,3
68,2025-05-25T01:42:00+02:00,2025-05-25,09:42,0,4,4
70,2025-05-25T11:18:00+02:00,2025-05-25,19:18,0,5,5
68,2025-05-25T01:45:00+02:00,2025-05-25,09:45,3,3,6
70,2025-05-25T11:19:00+02:00,2025-05-25,19:19,2,0,2
68,2025-05-25T01:46:00+02:00,2025-05-25,09:46,2,4,6
70,2025-05-25T11:20:00+02:00,2025-05-25,19:20,2,4,6
68,2025-05-25T01:48:00+02:00,2025-05-25,09:48,5,3,8
70,2025-05-25T11:21:00+02:00,2025-05-25,19:21,0,3,3
68,2025-05-25T01:50:00+02:00,2025-05-25,09:50,0,3,3
70,2025-05-25T11:23:00+02:00,2025-05-25,19:23,2,3,5
68,2025-05-25T01:53:00+02:00,2025-05-25,09:53,3,3,6
75,2025-05-25T11:10:00+02:00,2025-05-25,19:10,0,1,1
68,2025-05-25T01:54:00+02:00,2025-05-25,09:54,2,3,5
75,2025-05-25T11:11:00+02:00,2025-05-25,19:11,0,1,1
72,2025-05-25T01:42:00+02:00,2025-05-25,09:42,0,2,2
75,2025-05-25T11:12:00+02:00,2025-05-25,19:12,2,0,2
72,2025-05-25T01:45:00+02:00,2025-05-25,09:45,2,0,2
77,2025-05-25T11:20:00+02:00,2025-05-25,19:20,55,1,56
72,2025-05-25T01:48:00+02:00,2025-05-25,09:48,2,1,3
78,2025-05-25T11:11:00+02:00,2025-05-25,19:11,0,3,3
72,2025-05-25T01:50:00+02:00,2025-05-25,09:50,2,0,2
78,2025-05-25T11:13:00+02:00,2025-05-25,19:13,0,1,1
72,2025-05-25T01:53:00+02:00,2025-05-25,09:53,0,3,3
78,2025-05-25T11:23:00+02:00,2025-05-25,19:23,0,6,6
76,2025-05-25T01:42:00+02:00,2025-05-25,09:42,0,2,2
84,2025-05-25T11:10:00+02:00,2025-05-25,19:10,61,70,131
76,2025-05-25T01:46:00+02:00,2025-05-25,09:46,0,1,1
87,2025-05-25T11:12:00+02:00,2025-05-25,19:12,0,1,1
76,2025-05-25T01:51:00+02:00,2025-05-25,09:51,1,1,2
87,2025-05-25T11:21:00+02:00,2025-05-25,19:21,2,1,3
76,2025-05-25T01:52:00+02:00,2025-05-25,09:52,2,0,2
108,2025-05-25T11:12:00+02:00,2025-05-25,19:12,3,3,6
76,2025-05-25T01:54:00+02:00,2025-05-25,09:54,4,0,4
108,2025-05-25T11:14:00+02:00,2025-05-25,19:14,2,0,2
79,2025-05-25T01:42:00+02:00,2025-05-25,09:42,3,5,8
108,2025-05-25T11:15:00+02:00,2025-05-25,19:15,1,3,4
79,2025-05-25T01:44:00+02:00,2025-05-25,09:44,4,6,10
108,2025-05-25T11:16:00+02:00,2025-05-25,19:16,2,1,3
79,2025-05-25T01:47:00+02:00,2025-05-25,09:47,12,2,14
108,2025-05-25T11:17:00+02:00,2025-05-25,19:17,7,0,7
79,2025-05-25T01:54:00+02:00,2025-05-25,09:54,4,0,4
108,2025-05-25T11:19:00+02:00,2025-05-25,19:19,3,4,7
85,2025-05-25T01:52:00+02:00,2025-05-25,09:52,0,1,1
108,2025-05-25T11:20:00+02:00,2025-05-25,19:20,0,1,1
86,2025-05-25T01:49:00+02:00,2025-05-25,09:49,2,3,5
133,2025-05-25T11:20:00+02:00,2025-05-25,19:20,32,28,60
86,2025-05-25T01:50:00+02:00,2025-05-25,09:50,0,2,2
134,2025-05-25T11:10:00+02:00,2025-05-25,19:10,33,22,55
109,2025-05-25T01:40:00+02:00,2025-05-25,09:40,6,1,7
162,2025-05-25T11:15:00+02:00,2025-05-25,19:15,11,13,24
117,2025-05-25T01:40:00+02:00,2025-05-25,09:40,9,5,14
165,2025-05-25T11:15:00+02:00,2025-05-25,19:15,0,3,3
117,2025-05-25T01:50:00+02:00,2025-05-25,09:50,6,16,22
166,2025-05-25T11:15:00+02:00,2025-05-25,19:15,1,2,3
123,2025-05-25T01:50:00+02:00,2025-05-25,09:50,6,4,10
167,2025-05-25T11:10:00+02:00,2025-05-25,19:10,1,3,4
138,2025-05-25T01:45:00+02:00,2025-05-25,09:45,1,0,1
179,2025-05-25T11:10:00+02:00,2025-05-25,19:10,3,9,12
139,2025-05-25T01:50:00+02:00,2025-05-25,09:50,7,2,9
179,2025-05-25T11:20:00+02:00,2025-05-25,19:20,11,10,21
141,2025-05-25T01:45:00+02:00,2025-05-25,09:45,12,8,20
1,2025-05-25T11:11:00+02:00,2025-05-25,19:11,17,6,23
141,2025-05-25T01:50:00+02:00,2025-05-25,09:50,8,23,31
1,2025-05-25T11:14:00+02:00,2025-05-25,19:14,16,1,17
142,2025-05-25T01:40:00+02:00,2025-05-25,09:40,29,11,40
1,2025-05-25T11:22:00+02:00,2025-05-25,19:22,3,2,5
142,2025-05-25T01:50:00+02:00,2025-05-25,09:50,32,28,60
1,2025-05-25T11:24:00+02:00,2025-05-25,19:24,12,6,18
161,2025-05-25T01:45:00+02:00,2025-05-25,09:45,9,15,24
2,2025-05-25T11:15:00+02:00,2025-05-25,19:15,6,2,8
161,2025-05-25T01:50:00+02:00,2025-05-25,09:50,8,14,22
2,2025-05-25T11:19:00+02:00,2025-05-25,19:19,1,3,4
2,2025-05-25T11:20:00+02:00,2025-05-25,19:20,2,1,3
2,2025-05-25T11:21:00+02:00,2025-05-25,19:21,0,4,4
2,2025-05-25T11:23:00+02:00,2025-05-25,19:23,3,3,6
9,2025-05-25T11:12:00+02:00,2025-05-25,19:12,1,2,3
9,2025-05-25T11:15:00+02:00,2025-05-25,19:15,0,1,1
9,2025-05-25T11:17:00+02:00,2025-05-25,19:17,2,0,2
9,2025-05-25T11:18:00+02:00,2025-05-25,19:18,2,0,2
9,2025-05-25T11:24:00+02:00,2025-05-25,19:24,2,0,2
181,2025-05-25T01:40:00+02:00,2025-05-25,09:40,6,5,11
10,2025-05-25T11:18:00+02:00,2025-05-25,19:18,2,0,2
181,2025-05-25T01:43:00+02:00,2025-05-25,09:43,3,8,11
10,2025-05-25T11:19:00+02:00,2025-05-25,19:19,0,2,2
180,2025-05-25T01:53:00+02:00,2025-05-25,09:53,2,1,3
10,2025-05-25T11:20:00+02:00,2025-05-25,19:20,2,3,5
180,2025-05-25T01:54:00+02:00,2025-05-25,09:54,0,1,1
10,2025-05-25T11:23:00+02:00,2025-05-25,19:23,7,8,15
10,2025-05-25T11:24:00+02:00,2025-05-25,19:24,5,0,5
12,2025-05-25T11:10:00+02:00,2025-05-25,19:10,3,3,6
12,2025-05-25T11:14:00+02:00,2025-05-25,19:14,1,3,4
12,2025-05-25T11:18:00+02:00,2025-05-25,19:18,4,9,13
12,2025-05-25T11:19:00+02:00,2025-05-25,19:19,1,1,2
12,2025-05-25T11:24:00+02:00,2025-05-25,19:24,5,12,17
17,2025-05-25T11:10:00+02:00,2025-05-25,19:10,1,3,4
17,2025-05-25T11:11:00+02:00,2025-05-25,19:11,4,0,4
17,2025-05-25T11:14:00+02:00,2025-05-25,19:14,2,1,3
17,2025-05-25T11:15:00+02:00,2025-05-25,19:15,3,6,9
19,2025-05-25T11:12:00+02:00,2025-05-25,19:12,15,8,23
19,2025-05-25T11:20:00+02:00,2025-05-25,19:20,13,13,26
20,2025-05-25T11:10:00+02:00,2025-05-25,19:10,18,27,45
20,2025-05-25T11:11:00+02:00,2025-05-25,19:11,16,35,51
20,2025-05-25T11:13:00+02:00,2025-05-25,19:13,8,32,40
20,2025-05-25T11:14:00+02:00,2025-05-25,19:14,4,16,20
20,2025-05-25T11:15:00+02:00,2025-05-25,19:15,5,5,10
20,2025-05-25T11:16:00+02:00,2025-05-25,19:16,8,9,17
20,2025-05-25T11:18:00+02:00,2025-05-25,19:18,4,7,11
20,2025-05-25T11:19:00+02:00,2025-05-25,19:19,5,3,8
20,2025-05-25T11:21:00+02:00,2025-05-25,19:21,11,11,22
181,2025-05-25T02:02:00+02:00,2025-05-25,10:02,6,13,19
23,2025-05-25T11:10:00+02:00,2025-05-25,19:10,5,1,6
181,2025-05-25T02:06:00+02:00,2025-05-25,10:06,2,4,6
23,2025-05-25T11:13:00+02:00,2025-05-25,19:13,2,4,6
182,2025-05-25T01:55:00+02:00,2025-05-25,09:55,3,19,22
23,2025-05-25T11:14:00+02:00,2025-05-25,19:14,1,2,3
182,2025-05-25T02:00:00+02:00,2025-05-25,10:00,11,11,22
23,2025-05-25T11:15:00+02:00,2025-05-25,19:15,5,4,9
180,2025-05-25T02:08:00+02:00,2025-05-25,10:08,1,1,2
23,2025-05-25T11:20:00+02:00,2025-05-25,19:20,1,0,1
24,2025-05-25T11:13:00+02:00,2025-05-25,19:13,9,8,17
24,2025-05-25T11:15:00+02:00,2025-05-25,19:15,20,2,22
24,2025-05-25T11:20:00+02:00,2025-05-25,19:20,8,3,11
24,2025-05-25T11:22:00+02:00,2025-05-25,19:22,6,9,15
25,2025-05-25T11:10:00+02:00,2025-05-25,19:10,28,22,50
25,2025-05-25T11:15:00+02:00,2025-05-25,19:15,13,17,30
27,2025-05-25T11:11:00+02:00,2025-05-25,19:11,4,3,7
27,2025-05-25T11:13:00+02:00,2025-05-25,19:13,2,0,2
27,2025-05-25T11:24:00+02:00,2025-05-25,19:24,1,1,2
30,2025-05-25T11:12:00+02:00,2025-05-25,19:12,6,6,12
30,2025-05-25T11:17:00+02:00,2025-05-25,19:17,3,6,9
30,2025-05-25T11:20:00+02:00,2025-05-25,19:20,7,0,7
30,2025-05-25T11:22:00+02:00,2025-05-25,19:22,8,14,22
35,2025-05-25T11:10:00+02:00,2025-05-25,19:10,11,17,28
35,2025-05-25T11:12:00+02:00,2025-05-25,19:12,23,5,28
35,2025-05-25T11:13:00+02:00,2025-05-25,19:13,10,5,15
35,2025-05-25T11:14:00+02:00,2025-05-25,19:14,11,6,17
35,2025-05-25T11:16:00+02:00,2025-05-25,19:16,5,12,17
35,2025-05-25T11:23:00+02:00,2025-05-25,19:23,12,9,21
48,2025-05-25T11:11:00+02:00,2025-05-25,19:11,3,3,6
49,2025-05-25T11:12:00+02:00,2025-05-25,19:12,5,3,8
3,2025-05-25T01:57:00+02:00,2025-05-25,09:57,2,2,4
49,2025-05-25T11:17:00+02:00,2025-05-25,19:17,6,3,9
3,2025-05-25T01:59:00+02:00,2025-05-25,09:59,14,4,18
49,2025-05-25T11:19:00+02:00,2025-05-25,19:19,0,1,1
3,2025-05-25T02:01:00+02:00,2025-05-25,10:01,3,4,7
49,2025-05-25T11:22:00+02:00,2025-05-25,19:22,4,0,4
3,2025-05-25T02:04:00+02:00,2025-05-25,10:04,2,5,7
51,2025-05-25T11:10:00+02:00,2025-05-25,19:10,1,3,4
4,2025-05-25T01:57:00+02:00,2025-05-25,09:57,12,2,14
51,2025-05-25T11:14:00+02:00,2025-05-25,19:14,0,2,2
4,2025-05-25T01:59:00+02:00,2025-05-25,09:59,12,8,20
51,2025-05-25T11:16:00+02:00,2025-05-25,19:16,3,0,3
4,2025-05-25T02:00:00+02:00,2025-05-25,10:00,12,3,15
51,2025-05-25T11:18:00+02:00,2025-05-25,19:18,1,1,2
4,2025-05-25T02:09:00+02:00,2025-05-25,10:09,8,7,15
51,2025-05-25T11:22:00+02:00,2025-05-25,19:22,1,3,4
5,2025-05-25T01:55:00+02:00,2025-05-25,09:55,21,51,72
51,2025-05-25T11:23:00+02:00,2025-05-25,19:23,4,0,4
5,2025-05-25T02:00:00+02:00,2025-05-25,10:00,31,50,81
52,2025-05-25T11:11:00+02:00,2025-05-25,19:11,6,6,12
6,2025-05-25T01:55:00+02:00,2025-05-25,09:55,12,8,20
52,2025-05-25T11:13:00+02:00,2025-05-25,19:13,7,9,16
6,2025-05-25T02:03:00+02:00,2025-05-25,10:03,5,6,11
52,2025-05-25T11:14:00+02:00,2025-05-25,19:14,2,2,4
6,2025-05-25T02:06:00+02:00,2025-05-25,10:06,16,1,17
52,2025-05-25T11:15:00+02:00,2025-05-25,19:15,4,8,12
8,2025-05-25T02:00:00+02:00,2025-05-25,10:00,0,1,1
52,2025-05-25T11:16:00+02:00,2025-05-25,19:16,4,5,9
8,2025-05-25T02:01:00+02:00,2025-05-25,10:01,2,3,5
52,2025-05-25T11:19:00+02:00,2025-05-25,19:19,2,2,4
8,2025-05-25T02:02:00+02:00,2025-05-25,10:02,1,7,8
52,2025-05-25T11:20:00+02:00,2025-05-25,19:20,2,9,11
28,2025-05-25T01:57:00+02:00,2025-05-25,09:57,2,0,2
52,2025-05-25T11:23:00+02:00,2025-05-25,19:23,8,5,13
28,2025-05-25T01:58:00+02:00,2025-05-25,09:58,2,2,4
53,2025-05-25T11:11:00+02:00,2025-05-25,19:11,2,7,9
28,2025-05-25T01:59:00+02:00,2025-05-25,09:59,4,3,7
53,2025-05-25T11:12:00+02:00,2025-05-25,19:12,5,0,5
28,2025-05-25T02:04:00+02:00,2025-05-25,10:04,2,11,13
53,2025-05-25T11:14:00+02:00,2025-05-25,19:14,7,2,9
28,2025-05-25T02:06:00+02:00,2025-05-25,10:06,8,0,8
53,2025-05-25T11:15:00+02:00,2025-05-25,19:15,2,0,2
28,2025-05-25T02:09:00+02:00,2025-05-25,10:09,3,0,3
53,2025-05-25T11:19:00+02:00,2025-05-25,19:19,5,2,7
29,2025-05-25T01:55:00+02:00,2025-05-25,09:55,2,1,3
53,2025-05-25T11:20:00+02:00,2025-05-25,19:20,8,0,8
29,2025-05-25T01:58:00+02:00,2025-05-25,09:58,3,3,6
53,2025-05-25T11:21:00+02:00,2025-05-25,19:21,1,0,1
29,2025-05-25T02:03:00+02:00,2025-05-25,10:03,3,4,7
56,2025-05-25T11:12:00+02:00,2025-05-25,19:12,3,15,18
29,2025-05-25T02:07:00+02:00,2025-05-25,10:07,8,2,10
56,2025-05-25T11:13:00+02:00,2025-05-25,19:13,11,1,12
29,2025-05-25T02:08:00+02:00,2025-05-25,10:08,5,5,10
56,2025-05-25T11:19:00+02:00,2025-05-25,19:19,7,7,14
31,2025-05-25T01:58:00+02:00,2025-05-25,09:58,3,1,4
56,2025-05-25T11:20:00+02:00,2025-05-25,19:20,15,4,19
31,2025-05-25T02:02:00+02:00,2025-05-25,10:02,2,0,2
56,2025-05-25T11:21:00+02:00,2025-05-25,19:21,4,8,12
31,2025-05-25T02:04:00+02:00,2025-05-25,10:04,3,0,3
56,2025-05-25T11:22:00+02:00,2025-05-25,19:22,7,13,20
36,2025-05-25T02:02:00+02:00,2025-05-25,10:02,8,1,9
58,2025-05-25T11:10:00+02:00,2025-05-25,19:10,25,2,27
36,2025-05-25T02:04:00+02:00,2025-05-25,10:04,0,6,6
58,2025-05-25T11:13:00+02:00,2025-05-25,19:13,21,4,25
36,2025-05-25T02:06:00+02:00,2025-05-25,10:06,2,2,4
58,2025-05-25T11:17:00+02:00,2025-05-25,19:17,14,7,21
37,2025-05-25T02:01:00+02:00,2025-05-25,10:01,1,0,1
58,2025-05-25T11:18:00+02:00,2025-05-25,19:18,2,9,11
37,2025-05-25T02:08:00+02:00,2025-05-25,10:08,2,1,3
58,2025-05-25T11:19:00+02:00,2025-05-25,19:19,0,1,1
39,2025-05-25T01:57:00+02:00,2025-05-25,09:57,1,3,4
58,2025-05-25T11:20:00+02:00,2025-05-25,19:20,14,4,18
39,2025-05-25T01:59:00+02:00,2025-05-25,09:59,3,0,3
58,2025-05-25T11:24:00+02:00,2025-05-25,19:24,3,11,14
39,2025-05-25T02:00:00+02:00,2025-05-25,10:00,0,2,2
62,2025-05-25T11:12:00+02:00,2025-05-25,19:12,2,1,3
39,2025-05-25T02:01:00+02:00,2025-05-25,10:01,1,0,1
62,2025-05-25T11:13:00+02:00,2025-05-25,19:13,4,0,4
39,2025-05-25T02:02:00+02:00,2025-05-25,10:02,1,2,3
62,2025-05-25T11:14:00+02:00,2025-05-25,19:14,1,2,3
39,2025-05-25T02:04:00+02:00,2025-05-25,10:04,1,3,4
62,2025-05-25T11:21:00+02:00,2025-05-25,19:21,3,9,12
39,2025-05-25T02:07:00+02:00,2025-05-25,10:07,0,2,2
63,2025-05-25T11:11:00+02:00,2025-05-25,19:11,0,2,2
39,2025-05-25T02:09:00+02:00,2025-05-25,10:09,2,0,2
63,2025-05-25T11:14:00+02:00,2025-05-25,19:14,1,5,6
40,2025-05-25T01:57:00+02:00,2025-05-25,09:57,0,2,2
63,2025-05-25T11:17:00+02:00,2025-05-25,19:17,3,4,7
40,2025-05-25T01:58:00+02:00,2025-05-25,09:58,0,1,1
63,2025-05-25T11:18:00+02:00,2025-05-25,19:18,2,0,2
40,2025-05-25T01:59:00+02:00,2025-05-25,09:59,1,0,1
67,2025-05-25T11:13:00+02:00,2025-05-25,19:13,3,6,9
40,2025-05-25T02:00:00+02:00,2025-05-25,10:00,1,0,1
67,2025-05-25T11:15:00+02:00,2025-05-25,19:15,1,4,5
40,2025-05-25T02:02:00+02:00,2025-05-25,10:02,0,3,3
67,2025-05-25T11:18:00+02:00,2025-05-25,19:18,0,4,4
40,2025-05-25T02:07:00+02:00,2025-05-25,10:07,0,1,1
67,2025-05-25T11:24:00+02:00,2025-05-25,19:24,4,5,9
40,2025-05-25T02:08:00+02:00,2025-05-25,10:08,1,6,7
68,2025-05-25T11:11:00+02:00,2025-05-25,19:11,3,0,3
41,2025-05-25T01:59:00+02:00,2025-05-25,09:59,8,0,8
68,2025-05-25T11:12:00+02:00,2025-05-25,19:12,2,5,7
41,2025-05-25T02:03:00+02:00,2025-05-25,10:03,0,1,1
68,2025-05-25T11:17:00+02:00,2025-05-25,19:17,5,0,5
41,2025-05-25T02:05:00+02:00,2025-05-25,10:05,0,3,3
68,2025-05-25T11:20:00+02:00,2025-05-25,19:20,4,0,4
41,2025-05-25T02:06:00+02:00,2025-05-25,10:06,2,0,2
68,2025-05-25T11:23:00+02:00,2025-05-25,19:23,8,2,10
41,2025-05-25T02:08:00+02:00,2025-05-25,10:08,3,0,3
68,2025-05-25T11:24:00+02:00,2025-05-25,19:24,0,1,1
41,2025-05-25T02:09:00+02:00,2025-05-25,10:09,0,1,1
72,2025-05-25T11:17:00+02:00,2025-05-25,19:17,6,4,10
43,2025-05-25T01:55:00+02:00,2025-05-25,09:55,4,0,4
72,2025-05-25T11:18:00+02:00,2025-05-25,19:18,7,0,7
43,2025-05-25T02:05:00+02:00,2025-05-25,10:05,5,4,9
72,2025-05-25T11:21:00+02:00,2025-05-25,19:21,2,6,8
44,2025-05-25T02:05:00+02:00,2025-05-25,10:05,2,5,7
72,2025-05-25T11:22:00+02:00,2025-05-25,19:22,3,1,4
45,2025-05-25T01:55:00+02:00,2025-05-25,09:55,11,3,14
72,2025-05-25T11:23:00+02:00,2025-05-25,19:23,3,10,13
45,2025-05-25T01:59:00+02:00,2025-05-25,09:59,4,1,5
72,2025-05-25T11:24:00+02:00,2025-05-25,19:24,1,4,5
45,2025-05-25T02:04:00+02:00,2025-05-25,10:04,11,4,15
76,2025-05-25T11:16:00+02:00,2025-05-25,19:16,1,0,1
45,2025-05-25T02:07:00+02:00,2025-05-25,10:07,8,5,13
76,2025-05-25T11:21:00+02:00,2025-05-25,19:21,1,0,1
45,2025-05-25T02:09:00+02:00,2025-05-25,10:09,1,0,1
79,2025-05-25T11:10:00+02:00,2025-05-25,19:10,6,0,6
47,2025-05-25T01:57:00+02:00,2025-05-25,09:57,4,2,6
79,2025-05-25T11:15:00+02:00,2025-05-25,19:15,3,6,9
47,2025-05-25T02:00:00+02:00,2025-05-25,10:00,2,3,5
79,2025-05-25T11:16:00+02:00,2025-05-25,19:16,13,3,16
47,2025-05-25T02:05:00+02:00,2025-05-25,10:05,6,3,9
79,2025-05-25T11:23:00+02:00,2025-05-25,19:23,3,5,8
47,2025-05-25T02:09:00+02:00,2025-05-25,10:09,6,3,9
85,2025-05-25T11:16:00+02:00,2025-05-25,19:16,1,0,1
50,2025-05-25T01:55:00+02:00,2025-05-25,09:55,4,1,5
86,2025-05-25T11:12:00+02:00,2025-05-25,19:12,1,0,1
50,2025-05-25T01:56:00+02:00,2025-05-25,09:56,4,2,6
86,2025-05-25T11:14:00+02:00,2025-05-25,19:14,1,0,1
50,2025-05-25T01:58:00+02:00,2025-05-25,09:58,2,1,3
86,2025-05-25T11:18:00+02:00,2025-05-25,19:18,1,0,1
50,2025-05-25T02:02:00+02:00,2025-05-25,10:02,0,2,2
117,2025-05-25T11:15:00+02:00,2025-05-25,19:15,17,11,28
50,2025-05-25T02:03:00+02:00,2025-05-25,10:03,2,2,4
130,2025-05-25T11:10:00+02:00,2025-05-25,19:10,0,1,1
50,2025-05-25T02:04:00+02:00,2025-05-25,10:04,0,6,6
136,2025-05-25T11:10:00+02:00,2025-05-25,19:10,1,2,3
50,2025-05-25T02:07:00+02:00,2025-05-25,10:07,1,2,3
136,2025-05-25T11:20:00+02:00,2025-05-25,19:20,4,5,9
50,2025-05-25T02:09:00+02:00,2025-05-25,10:09,3,2,5
137,2025-05-25T11:10:00+02:00,2025-05-25,19:10,1,3,4
54,2025-05-25T01:57:00+02:00,2025-05-25,09:57,1,0,1
139,2025-05-25T11:15:00+02:00,2025-05-25,19:15,0,1,1
54,2025-05-25T02:02:00+02:00,2025-05-25,10:02,2,2,4
141,2025-05-25T11:10:00+02:00,2025-05-25,19:10,7,6,13
54,2025-05-25T02:06:00+02:00,2025-05-25,10:06,1,0,1
3,2025-05-25T11:07:00+02:00,2025-05-25,19:07,13,25,38
61,2025-05-25T02:02:00+02:00,2025-05-25,10:02,2,5,7
3,2025-05-25T11:08:00+02:00,2025-05-25,19:08,20,14,34
61,2025-05-25T02:09:00+02:00,2025-05-25,10:09,5,1,6
4,2025-05-25T10:56:00+02:00,2025-05-25,18:56,6,18,24
66,2025-05-25T01:55:00+02:00,2025-05-25,09:55,0,2,2
4,2025-05-25T11:04:00+02:00,2025-05-25,19:04,15,22,37
66,2025-05-25T02:04:00+02:00,2025-05-25,10:04,4,6,10
4,2025-05-25T11:05:00+02:00,2025-05-25,19:05,37,14,51
66,2025-05-25T02:05:00+02:00,2025-05-25,10:05,7,6,13
4,2025-05-25T11:06:00+02:00,2025-05-25,19:06,31,26,57
69,2025-05-25T01:57:00+02:00,2025-05-25,09:57,7,4,11
4,2025-05-25T11:07:00+02:00,2025-05-25,19:07,44,23,67
69,2025-05-25T01:59:00+02:00,2025-05-25,09:59,5,3,8
5,2025-05-25T11:00:00+02:00,2025-05-25,19:00,46,97,143
69,2025-05-25T02:00:00+02:00,2025-05-25,10:00,10,0,10
5,2025-05-25T11:05:00+02:00,2025-05-25,19:05,42,98,140
69,2025-05-25T02:04:00+02:00,2025-05-25,10:04,2,3,5
6,2025-05-25T10:55:00+02:00,2025-05-25,18:55,11,10,21
69,2025-05-25T02:06:00+02:00,2025-05-25,10:06,1,1,2
6,2025-05-25T11:00:00+02:00,2025-05-25,19:00,8,6,14
69,2025-05-25T02:09:00+02:00,2025-05-25,10:09,7,6,13
6,2025-05-25T11:01:00+02:00,2025-05-25,19:01,7,12,19
70,2025-05-25T01:56:00+02:00,2025-05-25,09:56,1,1,2
6,2025-05-25T11:07:00+02:00,2025-05-25,19:07,6,6,12
70,2025-05-25T02:05:00+02:00,2025-05-25,10:05,6,3,9
6,2025-05-25T11:08:00+02:00,2025-05-25,19:08,7,22,29
70,2025-05-25T02:08:00+02:00,2025-05-25,10:08,0,4,4
6,2025-05-25T11:09:00+02:00,2025-05-25,19:09,7,8,15
71,2025-05-25T02:03:00+02:00,2025-05-25,10:03,0,1,1
8,2025-05-25T11:00:00+02:00,2025-05-25,19:00,1,0,1
75,2025-05-25T01:58:00+02:00,2025-05-25,09:58,1,0,1
8,2025-05-25T11:09:00+02:00,2025-05-25,19:09,1,1,2
75,2025-05-25T02:00:00+02:00,2025-05-25,10:00,0,1,1
21,2025-05-25T10:55:00+02:00,2025-05-25,18:55,31,46,77
75,2025-05-25T02:04:00+02:00,2025-05-25,10:04,1,0,1
21,2025-05-25T11:00:00+02:00,2025-05-25,19:00,42,49,91
75,2025-05-25T02:07:00+02:00,2025-05-25,10:07,3,0,3
28,2025-05-25T10:56:00+02:00,2025-05-25,18:56,1,8,9
77,2025-05-25T01:55:00+02:00,2025-05-25,09:55,18,10,28
28,2025-05-25T10:57:00+02:00,2025-05-25,18:57,2,3,5
78,2025-05-25T01:58:00+02:00,2025-05-25,09:58,4,1,5
28,2025-05-25T10:58:00+02:00,2025-05-25,18:58,0,18,18
78,2025-05-25T02:05:00+02:00,2025-05-25,10:05,3,0,3
28,2025-05-25T11:02:00+02:00,2025-05-25,19:02,3,27,30
78,2025-05-25T02:09:00+02:00,2025-05-25,10:09,1,2,3
28,2025-05-25T11:04:00+02:00,2025-05-25,19:04,0,21,21
84,2025-05-25T01:55:00+02:00,2025-05-25,09:55,70,41,111
28,2025-05-25T11:07:00+02:00,2025-05-25,19:07,4,6,10
87,2025-05-25T01:59:00+02:00,2025-05-25,09:59,2,2,4
28,2025-05-25T11:08:00+02:00,2025-05-25,19:08,2,21,23
87,2025-05-25T02:04:00+02:00,2025-05-25,10:04,6,4,10
29,2025-05-25T10:56:00+02:00,2025-05-25,18:56,2,6,8
87,2025-05-25T02:08:00+02:00,2025-05-25,10:08,1,1,2
29,2025-05-25T10:57:00+02:00,2025-05-25,18:57,6,7,13
107,2025-05-25T01:55:00+02:00,2025-05-25,09:55,13,11,24
29,2025-05-25T10:58:00+02:00,2025-05-25,18:58,5,2,7
108,2025-05-25T01:57:00+02:00,2025-05-25,09:57,2,2,4
29,2025-05-25T10:59:00+02:00,2025-05-25,18:59,3,13,16
108,2025-05-25T02:01:00+02:00,2025-05-25,10:01,2,0,2
29,2025-05-25T11:01:00+02:00,2025-05-25,19:01,3,5,8
108,2025-05-25T02:04:00+02:00,2025-05-25,10:04,10,1,11
29,2025-05-25T11:07:00+02:00,2025-05-25,19:07,2,7,9
124,2025-05-25T02:05:00+02:00,2025-05-25,10:05,1,1,2
29,2025-05-25T11:09:00+02:00,2025-05-25,19:09,6,2,8
131,2025-05-25T01:55:00+02:00,2025-05-25,09:55,4,7,11
31,2025-05-25T11:00:00+02:00,2025-05-25,19:00,5,3,8
131,2025-05-25T02:00:00+02:00,2025-05-25,10:00,7,9,16
31,2025-05-25T11:01:00+02:00,2025-05-25,19:01,4,7,11
132,2025-05-25T01:55:00+02:00,2025-05-25,09:55,8,7,15
31,2025-05-25T11:03:00+02:00,2025-05-25,19:03,2,0,2
132,2025-05-25T02:00:00+02:00,2025-05-25,10:00,8,9,17
36,2025-05-25T11:01:00+02:00,2025-05-25,19:01,3,2,5
133,2025-05-25T02:00:00+02:00,2025-05-25,10:00,26,44,70
36,2025-05-25T11:02:00+02:00,2025-05-25,19:02,3,4,7
134,2025-05-25T02:00:00+02:00,2025-05-25,10:00,29,18,47
36,2025-05-25T11:04:00+02:00,2025-05-25,19:04,4,4,8
135,2025-05-25T02:05:00+02:00,2025-05-25,10:05,31,32,63
36,2025-05-25T11:07:00+02:00,2025-05-25,19:07,0,1,1
162,2025-05-25T01:55:00+02:00,2025-05-25,09:55,36,22,58
40,2025-05-25T10:59:00+02:00,2025-05-25,18:59,0,4,4
162,2025-05-25T02:05:00+02:00,2025-05-25,10:05,24,43,67
40,2025-05-25T11:03:00+02:00,2025-05-25,19:03,0,2,2
166,2025-05-25T01:55:00+02:00,2025-05-25,09:55,1,7,8
40,2025-05-25T11:06:00+02:00,2025-05-25,19:06,1,0,1
166,2025-05-25T02:05:00+02:00,2025-05-25,10:05,4,5,9
40,2025-05-25T11:07:00+02:00,2025-05-25,19:07,1,0,1
167,2025-05-25T02:00:00+02:00,2025-05-25,10:00,2,5,7
41,2025-05-25T10:59:00+02:00,2025-05-25,18:59,0,1,1
179,2025-05-25T02:00:00+02:00,2025-05-25,10:00,8,6,14
41,2025-05-25T11:07:00+02:00,2025-05-25,19:07,4,0,4
1,2025-05-25T01:55:00+02:00,2025-05-25,09:55,6,6,12
45,2025-05-25T11:08:00+02:00,2025-05-25,19:08,21,9,30
1,2025-05-25T01:56:00+02:00,2025-05-25,09:56,10,12,22
47,2025-05-25T10:56:00+02:00,2025-05-25,18:56,14,20,34
1,2025-05-25T01:58:00+02:00,2025-05-25,09:58,10,10,20
47,2025-05-25T11:00:00+02:00,2025-05-25,19:00,9,13,22
1,2025-05-25T02:02:00+02:00,2025-05-25,10:02,3,10,13
47,2025-05-25T11:02:00+02:00,2025-05-25,19:02,19,19,38
1,2025-05-25T02:03:00+02:00,2025-05-25,10:03,3,2,5
50,2025-05-25T10:55:00+02:00,2025-05-25,18:55,1,3,4
1,2025-05-25T02:04:00+02:00,2025-05-25,10:04,5,14,19
50,2025-05-25T11:01:00+02:00,2025-05-25,19:01,7,4,11
1,2025-05-25T02:06:00+02:00,2025-05-25,10:06,7,7,14
50,2025-05-25T11:02:00+02:00,2025-05-25,19:02,3,0,3
2,2025-05-25T01:57:00+02:00,2025-05-25,09:57,1,4,5
50,2025-05-25T11:05:00+02:00,2025-05-25,19:05,0,4,4
2,2025-05-25T01:59:00+02:00,2025-05-25,09:59,1,4,5
50,2025-05-25T11:06:00+02:00,2025-05-25,19:06,0,2,2
2,2025-05-25T02:04:00+02:00,2025-05-25,10:04,4,0,4
54,2025-05-25T11:00:00+02:00,2025-05-25,19:00,6,3,9
2,2025-05-25T02:07:00+02:00,2025-05-25,10:07,0,10,10
54,2025-05-25T11:08:00+02:00,2025-05-25,19:08,0,1,1
9,2025-05-25T02:03:00+02:00,2025-05-25,10:03,7,3,10
54,2025-05-25T11:09:00+02:00,2025-05-25,19:09,2,2,4
9,2025-05-25T02:06:00+02:00,2025-05-25,10:06,1,1,2
59,2025-05-25T10:55:00+02:00,2025-05-25,18:55,28,24,52
9,2025-05-25T02:08:00+02:00,2025-05-25,10:08,2,0,2
61,2025-05-25T10:56:00+02:00,2025-05-25,18:56,4,4,8
10,2025-05-25T01:58:00+02:00,2025-05-25,09:58,1,0,1
61,2025-05-25T10:58:00+02:00,2025-05-25,18:58,2,1,3
10,2025-05-25T02:04:00+02:00,2025-05-25,10:04,0,1,1
61,2025-05-25T10:59:00+02:00,2025-05-25,18:59,7,1,8
11,2025-05-25T01:55:00+02:00,2025-05-25,09:55,3,1,4
61,2025-05-25T11:01:00+02:00,2025-05-25,19:01,7,1,8
11,2025-05-25T02:06:00+02:00,2025-05-25,10:06,0,2,2
61,2025-05-25T11:05:00+02:00,2025-05-25,19:05,13,1,14
12,2025-05-25T02:07:00+02:00,2025-05-25,10:07,5,3,8
61,2025-05-25T11:08:00+02:00,2025-05-25,19:08,4,3,7
12,2025-05-25T02:08:00+02:00,2025-05-25,10:08,0,1,1
66,2025-05-25T10:56:00+02:00,2025-05-25,18:56,20,20,40
17,2025-05-25T01:58:00+02:00,2025-05-25,09:58,2,3,5
66,2025-05-25T11:03:00+02:00,2025-05-25,19:03,20,5,25
17,2025-05-25T02:00:00+02:00,2025-05-25,10:00,8,3,11
66,2025-05-25T11:04:00+02:00,2025-05-25,19:04,13,26,39
17,2025-05-25T02:03:00+02:00,2025-05-25,10:03,3,3,6
66,2025-05-25T11:09:00+02:00,2025-05-25,19:09,13,16,29
17,2025-05-25T02:04:00+02:00,2025-05-25,10:04,7,0,7
69,2025-05-25T10:57:00+02:00,2025-05-25,18:57,1,2,3
17,2025-05-25T02:05:00+02:00,2025-05-25,10:05,6,0,6
69,2025-05-25T11:00:00+02:00,2025-05-25,19:00,2,2,4
17,2025-05-25T02:09:00+02:00,2025-05-25,10:09,4,0,4
69,2025-05-25T11:01:00+02:00,2025-05-25,19:01,1,0,1
18,2025-05-25T02:03:00+02:00,2025-05-25,10:03,1,0,1
69,2025-05-25T11:03:00+02:00,2025-05-25,19:03,1,0,1
18,2025-05-25T02:06:00+02:00,2025-05-25,10:06,1,0,1
70,2025-05-25T10:56:00+02:00,2025-05-25,18:56,3,7,10
18,2025-05-25T02:07:00+02:00,2025-05-25,10:07,3,2,5
70,2025-05-25T10:57:00+02:00,2025-05-25,18:57,1,6,7
18,2025-05-25T02:09:00+02:00,2025-05-25,10:09,0,1,1
70,2025-05-25T11:02:00+02:00,2025-05-25,19:02,2,0,2
19,2025-05-25T01:56:00+02:00,2025-05-25,09:56,1,0,1
70,2025-05-25T11:03:00+02:00,2025-05-25,19:03,1,7,8
19,2025-05-25T01:57:00+02:00,2025-05-25,09:57,4,0,4
70,2025-05-25T11:04:00+02:00,2025-05-25,19:04,2,0,2
19,2025-05-25T02:01:00+02:00,2025-05-25,10:01,1,0,1
70,2025-05-25T11:07:00+02:00,2025-05-25,19:07,5,8,13
19,2025-05-25T02:05:00+02:00,2025-05-25,10:05,1,3,4
71,2025-05-25T11:06:00+02:00,2025-05-25,19:06,1,0,1
19,2025-05-25T02:08:00+02:00,2025-05-25,10:08,0,1,1
75,2025-05-25T10:58:00+02:00,2025-05-25,18:58,1,0,1
19,2025-05-25T02:09:00+02:00,2025-05-25,10:09,1,3,4
75,2025-05-25T11:02:00+02:00,2025-05-25,19:02,0,1,1
20,2025-05-25T01:58:00+02:00,2025-05-25,09:58,0,2,2
75,2025-05-25T11:03:00+02:00,2025-05-25,19:03,1,0,1
20,2025-05-25T02:01:00+02:00,2025-05-25,10:01,1,1,2
75,2025-05-25T11:05:00+02:00,2025-05-25,19:05,1,1,2
23,2025-05-25T01:58:00+02:00,2025-05-25,09:58,3,9,12
77,2025-05-25T11:00:00+02:00,2025-05-25,19:00,20,8,28
23,2025-05-25T02:01:00+02:00,2025-05-25,10:01,3,2,5
78,2025-05-25T11:03:00+02:00,2025-05-25,19:03,0,1,1
23,2025-05-25T02:03:00+02:00,2025-05-25,10:03,1,14,15
84,2025-05-25T10:55:00+02:00,2025-05-25,18:55,57,75,132
23,2025-05-25T02:04:00+02:00,2025-05-25,10:04,0,2,2
84,2025-05-25T11:05:00+02:00,2025-05-25,19:05,41,87,128
23,2025-05-25T02:06:00+02:00,2025-05-25,10:06,2,2,4
87,2025-05-25T10:56:00+02:00,2025-05-25,18:56,0,2,2
23,2025-05-25T02:08:00+02:00,2025-05-25,10:08,1,0,1
87,2025-05-25T11:00:00+02:00,2025-05-25,19:00,2,2,4
23,2025-05-25T02:09:00+02:00,2025-05-25,10:09,3,0,3
87,2025-05-25T11:02:00+02:00,2025-05-25,19:02,0,1,1
24,2025-05-25T01:58:00+02:00,2025-05-25,09:58,6,10,16
87,2025-05-25T11:05:00+02:00,2025-05-25,19:05,0,2,2
24,2025-05-25T01:59:00+02:00,2025-05-25,09:59,4,16,20
107,2025-05-25T10:55:00+02:00,2025-05-25,18:55,1,2,3
24,2025-05-25T02:01:00+02:00,2025-05-25,10:01,7,6,13
108,2025-05-25T10:55:00+02:00,2025-05-25,18:55,6,1,7
24,2025-05-25T02:02:00+02:00,2025-05-25,10:02,7,7,14
108,2025-05-25T10:56:00+02:00,2025-05-25,18:56,3,1,4
24,2025-05-25T02:07:00+02:00,2025-05-25,10:07,9,6,15
108,2025-05-25T10:57:00+02:00,2025-05-25,18:57,1,0,1
25,2025-05-25T02:05:00+02:00,2025-05-25,10:05,26,51,77
108,2025-05-25T10:58:00+02:00,2025-05-25,18:58,3,0,3
27,2025-05-25T02:00:00+02:00,2025-05-25,10:00,2,2,4
108,2025-05-25T11:00:00+02:00,2025-05-25,19:00,1,8,9
27,2025-05-25T02:05:00+02:00,2025-05-25,10:05,1,1,2
108,2025-05-25T11:04:00+02:00,2025-05-25,19:04,5,0,5
27,2025-05-25T02:06:00+02:00,2025-05-25,10:06,1,8,9
108,2025-05-25T11:05:00+02:00,2025-05-25,19:05,0,1,1
30,2025-05-25T01:56:00+02:00,2025-05-25,09:56,3,7,10
108,2025-05-25T11:07:00+02:00,2025-05-25,19:07,2,3,5
30,2025-05-25T01:59:00+02:00,2025-05-25,09:59,1,0,1
118,2025-05-25T11:00:00+02:00,2025-05-25,19:00,3,0,3
30,2025-05-25T02:08:00+02:00,2025-05-25,10:08,0,6,6
131,2025-05-25T11:00:00+02:00,2025-05-25,19:00,10,3,13
35,2025-05-25T01:55:00+02:00,2025-05-25,09:55,24,5,29
133,2025-05-25T10:55:00+02:00,2025-05-25,18:55,47,42,89
35,2025-05-25T01:57:00+02:00,2025-05-25,09:57,21,21,42
134,2025-05-25T11:00:00+02:00,2025-05-25,19:00,37,19,56
35,2025-05-25T02:01:00+02:00,2025-05-25,10:01,5,12,17
134,2025-05-25T11:05:00+02:00,2025-05-25,19:05,40,15,55
48,2025-05-25T01:59:00+02:00,2025-05-25,09:59,7,7,14
135,2025-05-25T10:55:00+02:00,2025-05-25,18:55,30,17,47
48,2025-05-25T02:08:00+02:00,2025-05-25,10:08,6,3,9
135,2025-05-25T11:00:00+02:00,2025-05-25,19:00,18,37,55
49,2025-05-25T01:58:00+02:00,2025-05-25,09:58,1,5,6
135,2025-05-25T11:05:00+02:00,2025-05-25,19:05,19,40,59
49,2025-05-25T02:01:00+02:00,2025-05-25,10:01,0,5,5
162,2025-05-25T11:00:00+02:00,2025-05-25,19:00,35,13,48
49,2025-05-25T02:03:00+02:00,2025-05-25,10:03,11,13,24
165,2025-05-25T10:55:00+02:00,2025-05-25,18:55,2,1,3
49,2025-05-25T02:04:00+02:00,2025-05-25,10:04,5,4,9
165,2025-05-25T11:00:00+02:00,2025-05-25,19:00,2,0,2
49,2025-05-25T02:09:00+02:00,2025-05-25,10:09,4,10,14
166,2025-05-25T11:00:00+02:00,2025-05-25,19:00,4,3,7
51,2025-05-25T01:55:00+02:00,2025-05-25,09:55,1,2,3
167,2025-05-25T11:05:00+02:00,2025-05-25,19:05,0,5,5
51,2025-05-25T01:58:00+02:00,2025-05-25,09:58,2,0,2
179,2025-05-25T11:05:00+02:00,2025-05-25,19:05,3,1,4
51,2025-05-25T02:03:00+02:00,2025-05-25,10:03,1,2,3
1,2025-05-25T10:55:00+02:00,2025-05-25,18:55,13,2,15
51,2025-05-25T02:05:00+02:00,2025-05-25,10:05,2,2,4
1,2025-05-25T11:00:00+02:00,2025-05-25,19:00,11,13,24
51,2025-05-25T02:09:00+02:00,2025-05-25,10:09,1,0,1
1,2025-05-25T11:01:00+02:00,2025-05-25,19:01,9,1,10
52,2025-05-25T01:58:00+02:00,2025-05-25,09:58,1,0,1
1,2025-05-25T11:05:00+02:00,2025-05-25,19:05,13,4,17
52,2025-05-25T02:00:00+02:00,2025-05-25,10:00,1,1,2
1,2025-05-25T11:06:00+02:00,2025-05-25,19:06,34,5,39
52,2025-05-25T02:07:00+02:00,2025-05-25,10:07,4,1,5
2,2025-05-25T10:56:00+02:00,2025-05-25,18:56,2,0,2
53,2025-05-25T01:55:00+02:00,2025-05-25,09:55,8,4,12
2,2025-05-25T10:58:00+02:00,2025-05-25,18:58,8,6,14
53,2025-05-25T01:58:00+02:00,2025-05-25,09:58,3,2,5
2,2025-05-25T11:01:00+02:00,2025-05-25,19:01,0,7,7
53,2025-05-25T02:00:00+02:00,2025-05-25,10:00,7,4,11
2,2025-05-25T11:05:00+02:00,2025-05-25,19:05,1,2,3
53,2025-05-25T02:05:00+02:00,2025-05-25,10:05,6,3,9
9,2025-05-25T10:57:00+02:00,2025-05-25,18:57,0,4,4
53,2025-05-25T02:06:00+02:00,2025-05-25,10:06,3,3,6
9,2025-05-25T10:58:00+02:00,2025-05-25,18:58,3,2,5
56,2025-05-25T01:56:00+02:00,2025-05-25,09:56,7,2,9
9,2025-05-25T11:02:00+02:00,2025-05-25,19:02,1,0,1
56,2025-05-25T01:57:00+02:00,2025-05-25,09:57,3,2,5
9,2025-05-25T11:05:00+02:00,2025-05-25,19:05,1,2,3
56,2025-05-25T02:05:00+02:00,2025-05-25,10:05,2,3,5
10,2025-05-25T10:59:00+02:00,2025-05-25,18:59,0,1,1
56,2025-05-25T02:07:00+02:00,2025-05-25,10:07,8,1,9
10,2025-05-25T11:00:00+02:00,2025-05-25,19:00,2,0,2
56,2025-05-25T02:09:00+02:00,2025-05-25,10:09,5,2,7
10,2025-05-25T11:04:00+02:00,2025-05-25,19:04,0,3,3
58,2025-05-25T01:55:00+02:00,2025-05-25,09:55,12,2,14
10,2025-05-25T11:09:00+02:00,2025-05-25,19:09,3,2,5
58,2025-05-25T02:00:00+02:00,2025-05-25,10:00,4,4,8
11,2025-05-25T10:55:00+02:00,2025-05-25,18:55,4,4,8
58,2025-05-25T02:04:00+02:00,2025-05-25,10:04,22,1,23
12,2025-05-25T10:57:00+02:00,2025-05-25,18:57,2,2,4
58,2025-05-25T02:07:00+02:00,2025-05-25,10:07,6,7,13
12,2025-05-25T11:00:00+02:00,2025-05-25,19:00,0,2,2
62,2025-05-25T01:55:00+02:00,2025-05-25,09:55,1,0,1
12,2025-05-25T11:02:00+02:00,2025-05-25,19:02,0,6,6
62,2025-05-25T01:56:00+02:00,2025-05-25,09:56,1,0,1
12,2025-05-25T11:05:00+02:00,2025-05-25,19:05,6,6,12
62,2025-05-25T01:57:00+02:00,2025-05-25,09:57,1,2,3
12,2025-05-25T11:07:00+02:00,2025-05-25,19:07,6,3,9
62,2025-05-25T02:04:00+02:00,2025-05-25,10:04,0,1,1
17,2025-05-25T10:59:00+02:00,2025-05-25,18:59,8,0,8
62,2025-05-25T02:06:00+02:00,2025-05-25,10:06,1,1,2
17,2025-05-25T11:02:00+02:00,2025-05-25,19:02,3,1,4
63,2025-05-25T01:59:00+02:00,2025-05-25,09:59,2,1,3
18,2025-05-25T10:55:00+02:00,2025-05-25,18:55,0,1,1
63,2025-05-25T02:04:00+02:00,2025-05-25,10:04,0,1,1
18,2025-05-25T11:00:00+02:00,2025-05-25,19:00,2,0,2
63,2025-05-25T02:05:00+02:00,2025-05-25,10:05,2,7,9
18,2025-05-25T11:03:00+02:00,2025-05-25,19:03,1,0,1
63,2025-05-25T02:06:00+02:00,2025-05-25,10:06,5,6,11
18,2025-05-25T11:07:00+02:00,2025-05-25,19:07,0,2,2
63,2025-05-25T02:08:00+02:00,2025-05-25,10:08,0,1,1
19,2025-05-25T10:57:00+02:00,2025-05-25,18:57,8,9,17
63,2025-05-25T02:09:00+02:00,2025-05-25,10:09,2,2,4
19,2025-05-25T10:58:00+02:00,2025-05-25,18:58,16,6,22
67,2025-05-25T01:55:00+02:00,2025-05-25,09:55,6,4,10
20,2025-05-25T10:55:00+02:00,2025-05-25,18:55,12,1,13
67,2025-05-25T01:56:00+02:00,2025-05-25,09:56,6,4,10
20,2025-05-25T10:56:00+02:00,2025-05-25,18:56,15,11,26
67,2025-05-25T02:05:00+02:00,2025-05-25,10:05,2,0,2
20,2025-05-25T10:57:00+02:00,2025-05-25,18:57,12,13,25
67,2025-05-25T02:06:00+02:00,2025-05-25,10:06,2,2,4
20,2025-05-25T11:02:00+02:00,2025-05-25,19:02,12,4,16
67,2025-05-25T02:07:00+02:00,2025-05-25,10:07,0,2,2
20,2025-05-25T11:08:00+02:00,2025-05-25,19:08,9,38,47
68,2025-05-25T01:58:00+02:00,2025-05-25,09:58,11,0,11
23,2025-05-25T10:56:00+02:00,2025-05-25,18:56,2,3,5
68,2025-05-25T02:03:00+02:00,2025-05-25,10:03,3,0,3
23,2025-05-25T11:03:00+02:00,2025-05-25,19:03,2,7,9
68,2025-05-25T02:04:00+02:00,2025-05-25,10:04,2,3,5
23,2025-05-25T11:07:00+02:00,2025-05-25,19:07,0,4,4
68,2025-05-25T02:05:00+02:00,2025-05-25,10:05,12,4,16
23,2025-05-25T11:08:00+02:00,2025-05-25,19:08,0,1,1
68,2025-05-25T02:06:00+02:00,2025-05-25,10:06,0,1,1
24,2025-05-25T11:03:00+02:00,2025-05-25,19:03,7,5,12
68,2025-05-25T02:07:00+02:00,2025-05-25,10:07,4,8,12
24,2025-05-25T11:04:00+02:00,2025-05-25,19:04,2,2,4
68,2025-05-25T02:08:00+02:00,2025-05-25,10:08,8,3,11
25,2025-05-25T11:00:00+02:00,2025-05-25,19:00,16,20,36
72,2025-05-25T01:55:00+02:00,2025-05-25,09:55,2,5,7
27,2025-05-25T10:55:00+02:00,2025-05-25,18:55,4,0,4
72,2025-05-25T01:58:00+02:00,2025-05-25,09:58,0,4,4
27,2025-05-25T10:58:00+02:00,2025-05-25,18:58,1,3,4
72,2025-05-25T02:00:00+02:00,2025-05-25,10:00,2,4,6
27,2025-05-25T11:01:00+02:00,2025-05-25,19:01,4,1,5
72,2025-05-25T02:02:00+02:00,2025-05-25,10:02,1,1,2
27,2025-05-25T11:04:00+02:00,2025-05-25,19:04,6,0,6
72,2025-05-25T02:06:00+02:00,2025-05-25,10:06,3,3,6
27,2025-05-25T11:06:00+02:00,2025-05-25,19:06,3,0,3
72,2025-05-25T02:09:00+02:00,2025-05-25,10:09,0,5,5
27,2025-05-25T11:07:00+02:00,2025-05-25,19:07,0,2,2
76,2025-05-25T01:59:00+02:00,2025-05-25,09:59,1,0,1
27,2025-05-25T11:09:00+02:00,2025-05-25,19:09,1,1,2
76,2025-05-25T02:01:00+02:00,2025-05-25,10:01,1,0,1
30,2025-05-25T10:55:00+02:00,2025-05-25,18:55,7,5,12
76,2025-05-25T02:09:00+02:00,2025-05-25,10:09,1,0,1
30,2025-05-25T10:56:00+02:00,2025-05-25,18:56,2,1,3
79,2025-05-25T01:56:00+02:00,2025-05-25,09:56,2,2,4
30,2025-05-25T10:57:00+02:00,2025-05-25,18:57,6,15,21
79,2025-05-25T01:57:00+02:00,2025-05-25,09:57,22,2,24
30,2025-05-25T10:58:00+02:00,2025-05-25,18:58,7,9,16
79,2025-05-25T01:59:00+02:00,2025-05-25,09:59,8,5,13
30,2025-05-25T11:00:00+02:00,2025-05-25,19:00,10,6,16
79,2025-05-25T02:00:00+02:00,2025-05-25,10:00,5,8,13
30,2025-05-25T11:02:00+02:00,2025-05-25,19:02,8,4,12
79,2025-05-25T02:08:00+02:00,2025-05-25,10:08,7,7,14
30,2025-05-25T11:04:00+02:00,2025-05-25,19:04,3,1,4
85,2025-05-25T01:58:00+02:00,2025-05-25,09:58,4,0,4
30,2025-05-25T11:09:00+02:00,2025-05-25,19:09,2,17,19
85,2025-05-25T02:00:00+02:00,2025-05-25,10:00,2,0,2
35,2025-05-25T10:55:00+02:00,2025-05-25,18:55,13,13,26
85,2025-05-25T02:06:00+02:00,2025-05-25,10:06,1,0,1
35,2025-05-25T11:00:00+02:00,2025-05-25,19:00,7,7,14
85,2025-05-25T02:07:00+02:00,2025-05-25,10:07,1,1,2
48,2025-05-25T10:55:00+02:00,2025-05-25,18:55,7,1,8
85,2025-05-25T02:08:00+02:00,2025-05-25,10:08,1,0,1
48,2025-05-25T10:56:00+02:00,2025-05-25,18:56,6,1,7
86,2025-05-25T01:56:00+02:00,2025-05-25,09:56,2,1,3
48,2025-05-25T11:06:00+02:00,2025-05-25,19:06,0,1,1
86,2025-05-25T02:06:00+02:00,2025-05-25,10:06,1,0,1
48,2025-05-25T11:09:00+02:00,2025-05-25,19:09,1,1,2
86,2025-05-25T02:07:00+02:00,2025-05-25,10:07,1,0,1
49,2025-05-25T10:56:00+02:00,2025-05-25,18:56,6,0,6
109,2025-05-25T01:55:00+02:00,2025-05-25,09:55,5,14,19
49,2025-05-25T11:00:00+02:00,2025-05-25,19:00,7,3,10
109,2025-05-25T02:05:00+02:00,2025-05-25,10:05,2,12,14
49,2025-05-25T11:04:00+02:00,2025-05-25,19:04,5,5,10
117,2025-05-25T02:00:00+02:00,2025-05-25,10:00,1,7,8
49,2025-05-25T11:07:00+02:00,2025-05-25,19:07,4,5,9
136,2025-05-25T02:05:00+02:00,2025-05-25,10:05,9,4,13
49,2025-05-25T11:08:00+02:00,2025-05-25,19:08,6,2,8
138,2025-05-25T02:00:00+02:00,2025-05-25,10:00,0,2,2
51,2025-05-25T10:57:00+02:00,2025-05-25,18:57,1,2,3
139,2025-05-25T01:55:00+02:00,2025-05-25,09:55,1,5,6
51,2025-05-25T10:58:00+02:00,2025-05-25,18:58,1,0,1
142,2025-05-25T02:00:00+02:00,2025-05-25,10:00,40,37,77
51,2025-05-25T10:59:00+02:00,2025-05-25,18:59,0,3,3
161,2025-05-25T01:55:00+02:00,2025-05-25,09:55,5,16,21
51,2025-05-25T11:07:00+02:00,2025-05-25,19:07,4,1,5
164,2025-05-25T02:00:00+02:00,2025-05-25,10:00,17,0,17
51,2025-05-25T11:09:00+02:00,2025-05-25,19:09,2,2,4
52,2025-05-25T10:58:00+02:00,2025-05-25,18:58,1,13,14
52,2025-05-25T10:59:00+02:00,2025-05-25,18:59,8,6,14
52,2025-05-25T11:02:00+02:00,2025-05-25,19:02,5,4,9
52,2025-05-25T11:06:00+02:00,2025-05-25,19:06,5,17,22
52,2025-05-25T11:07:00+02:00,2025-05-25,19:07,2,17,19
181,2025-05-25T02:13:00+02:00,2025-05-25,10:13,7,16,23
52,2025-05-25T11:09:00+02:00,2025-05-25,19:09,9,8,17
181,2025-05-25T02:17:00+02:00,2025-05-25,10:17,5,16,21
53,2025-05-25T11:07:00+02:00,2025-05-25,19:07,8,0,8
181,2025-05-25T02:19:00+02:00,2025-05-25,10:19,12,13,25
53,2025-05-25T11:08:00+02:00,2025-05-25,19:08,1,0,1
181,2025-05-25T02:21:00+02:00,2025-05-25,10:21,2,19,21
56,2025-05-25T11:06:00+02:00,2025-05-25,19:06,0,7,7
181,2025-05-25T02:24:00+02:00,2025-05-25,10:24,4,11,15
56,2025-05-25T11:09:00+02:00,2025-05-25,19:09,7,9,16
182,2025-05-25T02:10:00+02:00,2025-05-25,10:10,13,7,20
58,2025-05-25T10:56:00+02:00,2025-05-25,18:56,2,2,4
180,2025-05-25T02:13:00+02:00,2025-05-25,10:13,3,0,3
58,2025-05-25T11:03:00+02:00,2025-05-25,19:03,5,6,11
180,2025-05-25T02:16:00+02:00,2025-05-25,10:16,7,0,7
58,2025-05-25T11:05:00+02:00,2025-05-25,19:05,9,6,15
180,2025-05-25T02:17:00+02:00,2025-05-25,10:17,1,0,1
58,2025-05-25T11:08:00+02:00,2025-05-25,19:08,11,8,19
180,2025-05-25T02:22:00+02:00,2025-05-25,10:22,0,2,2
62,2025-05-25T11:07:00+02:00,2025-05-25,19:07,0,2,2
180,2025-05-25T02:24:00+02:00,2025-05-25,10:24,0,1,1
62,2025-05-25T11:08:00+02:00,2025-05-25,19:08,1,5,6
63,2025-05-25T10:59:00+02:00,2025-05-25,18:59,0,3,3
63,2025-05-25T11:01:00+02:00,2025-05-25,19:01,1,2,3
63,2025-05-25T11:03:00+02:00,2025-05-25,19:03,0,3,3
63,2025-05-25T11:09:00+02:00,2025-05-25,19:09,3,5,8
67,2025-05-25T10:55:00+02:00,2025-05-25,18:55,7,2,9
67,2025-05-25T10:58:00+02:00,2025-05-25,18:58,1,17,18
67,2025-05-25T11:00:00+02:00,2025-05-25,19:00,4,6,10
67,2025-05-25T11:03:00+02:00,2025-05-25,19:03,2,7,9
68,2025-05-25T10:55:00+02:00,2025-05-25,18:55,2,0,2
3,2025-05-25T02:10:00+02:00,2025-05-25,10:10,7,2,9
68,2025-05-25T10:57:00+02:00,2025-05-25,18:57,5,3,8
3,2025-05-25T02:16:00+02:00,2025-05-25,10:16,0,8,8
68,2025-05-25T11:04:00+02:00,2025-05-25,19:04,4,2,6
3,2025-05-25T02:17:00+02:00,2025-05-25,10:17,9,3,12
68,2025-05-25T11:05:00+02:00,2025-05-25,19:05,2,0,2
3,2025-05-25T02:18:00+02:00,2025-05-25,10:18,1,1,2
68,2025-05-25T11:06:00+02:00,2025-05-25,19:06,3,0,3
3,2025-05-25T02:20:00+02:00,2025-05-25,10:20,2,6,8
68,2025-05-25T11:07:00+02:00,2025-05-25,19:07,9,0,9
3,2025-05-25T02:21:00+02:00,2025-05-25,10:21,9,7,16
68,2025-05-25T11:08:00+02:00,2025-05-25,19:08,1,4,5
3,2025-05-25T02:24:00+02:00,2025-05-25,10:24,4,6,10
72,2025-05-25T10:56:00+02:00,2025-05-25,18:56,4,4,8
4,2025-05-25T02:13:00+02:00,2025-05-25,10:13,10,13,23
72,2025-05-25T10:57:00+02:00,2025-05-25,18:57,6,9,15
4,2025-05-25T02:14:00+02:00,2025-05-25,10:14,18,4,22
72,2025-05-25T10:59:00+02:00,2025-05-25,18:59,4,10,14
4,2025-05-25T02:15:00+02:00,2025-05-25,10:15,19,8,27
72,2025-05-25T11:05:00+02:00,2025-05-25,19:05,5,1,6
4,2025-05-25T02:16:00+02:00,2025-05-25,10:16,14,3,17
72,2025-05-25T11:06:00+02:00,2025-05-25,19:06,0,4,4
4,2025-05-25T02:17:00+02:00,2025-05-25,10:17,10,3,13
76,2025-05-25T11:01:00+02:00,2025-05-25,19:01,1,0,1
4,2025-05-25T02:19:00+02:00,2025-05-25,10:19,17,12,29
79,2025-05-25T10:56:00+02:00,2025-05-25,18:56,9,12,21
4,2025-05-25T02:20:00+02:00,2025-05-25,10:20,14,5,19
79,2025-05-25T10:59:00+02:00,2025-05-25,18:59,3,12,15
4,2025-05-25T02:21:00+02:00,2025-05-25,10:21,15,3,18
79,2025-05-25T11:04:00+02:00,2025-05-25,19:04,9,5,14
4,2025-05-25T02:23:00+02:00,2025-05-25,10:23,10,13,23
85,2025-05-25T10:55:00+02:00,2025-05-25,18:55,1,2,3
5,2025-05-25T02:10:00+02:00,2025-05-25,10:10,27,35,62
85,2025-05-25T10:56:00+02:00,2025-05-25,18:56,1,0,1
5,2025-05-25T02:20:00+02:00,2025-05-25,10:20,42,48,90
85,2025-05-25T11:02:00+02:00,2025-05-25,19:02,1,0,1
6,2025-05-25T02:10:00+02:00,2025-05-25,10:10,10,7,17
86,2025-05-25T10:57:00+02:00,2025-05-25,18:57,0,2,2
6,2025-05-25T02:17:00+02:00,2025-05-25,10:17,7,6,13
86,2025-05-25T10:58:00+02:00,2025-05-25,18:58,0,4,4
6,2025-05-25T02:18:00+02:00,2025-05-25,10:18,11,7,18
86,2025-05-25T11:00:00+02:00,2025-05-25,19:00,0,1,1
6,2025-05-25T02:23:00+02:00,2025-05-25,10:23,7,6,13
86,2025-05-25T11:06:00+02:00,2025-05-25,19:06,0,1,1
8,2025-05-25T02:10:00+02:00,2025-05-25,10:10,0,5,5
109,2025-05-25T10:55:00+02:00,2025-05-25,18:55,6,12,18
8,2025-05-25T02:11:00+02:00,2025-05-25,10:11,1,1,2
137,2025-05-25T11:05:00+02:00,2025-05-25,19:05,1,3,4
8,2025-05-25T02:18:00+02:00,2025-05-25,10:18,2,3,5
141,2025-05-25T11:00:00+02:00,2025-05-25,19:00,4,15,19
8,2025-05-25T02:19:00+02:00,2025-05-25,10:19,1,1,2
141,2025-05-25T11:05:00+02:00,2025-05-25,19:05,15,7,22
8,2025-05-25T02:21:00+02:00,2025-05-25,10:21,3,48,51
164,2025-05-25T10:55:00+02:00,2025-05-25,18:55,5,3,8
8,2025-05-25T02:24:00+02:00,2025-05-25,10:24,2,0,2
164,2025-05-25T11:00:00+02:00,2025-05-25,19:00,7,2,9
28,2025-05-25T02:10:00+02:00,2025-05-25,10:10,3,4,7
41,2025-05-25T10:40:00+02:00,2025-05-25,18:40,4,7,11
28,2025-05-25T02:12:00+02:00,2025-05-25,10:12,4,4,8
41,2025-05-25T10:41:00+02:00,2025-05-25,18:41,2,4,6
28,2025-05-25T02:13:00+02:00,2025-05-25,10:13,5,4,9
41,2025-05-25T10:42:00+02:00,2025-05-25,18:42,5,10,15
28,2025-05-25T02:17:00+02:00,2025-05-25,10:17,1,6,7
41,2025-05-25T10:43:00+02:00,2025-05-25,18:43,5,2,7
28,2025-05-25T02:18:00+02:00,2025-05-25,10:18,4,3,7
41,2025-05-25T10:49:00+02:00,2025-05-25,18:49,3,5,8
28,2025-05-25T02:20:00+02:00,2025-05-25,10:20,9,1,10
41,2025-05-25T10:50:00+02:00,2025-05-25,18:50,4,15,19
28,2025-05-25T02:21:00+02:00,2025-05-25,10:21,7,6,13
41,2025-05-25T10:51:00+02:00,2025-05-25,18:51,6,12,18
28,2025-05-25T02:23:00+02:00,2025-05-25,10:23,7,0,7
41,2025-05-25T10:52:00+02:00,2025-05-25,18:52,6,1,7
28,2025-05-25T02:24:00+02:00,2025-05-25,10:24,6,3,9
41,2025-05-25T10:53:00+02:00,2025-05-25,18:53,6,1,7
29,2025-05-25T02:18:00+02:00,2025-05-25,10:18,6,2,8
43,2025-05-25T10:40:00+02:00,2025-05-25,18:40,1,2,3
29,2025-05-25T02:19:00+02:00,2025-05-25,10:19,2,1,3
45,2025-05-25T10:40:00+02:00,2025-05-25,18:40,16,16,32
29,2025-05-25T02:22:00+02:00,2025-05-25,10:22,5,3,8
45,2025-05-25T10:48:00+02:00,2025-05-25,18:48,2,9,11
31,2025-05-25T02:10:00+02:00,2025-05-25,10:10,1,0,1
45,2025-05-25T10:49:00+02:00,2025-05-25,18:49,6,8,14
31,2025-05-25T02:11:00+02:00,2025-05-25,10:11,3,4,7
45,2025-05-25T10:53:00+02:00,2025-05-25,18:53,10,27,37
31,2025-05-25T02:18:00+02:00,2025-05-25,10:18,1,1,2
47,2025-05-25T10:46:00+02:00,2025-05-25,18:46,21,11,32
31,2025-05-25T02:19:00+02:00,2025-05-25,10:19,4,1,5
47,2025-05-25T10:47:00+02:00,2025-05-25,18:47,11,11,22
31,2025-05-25T02:24:00+02:00,2025-05-25,10:24,2,0,2
47,2025-05-25T10:50:00+02:00,2025-05-25,18:50,20,11,31
36,2025-05-25T02:14:00+02:00,2025-05-25,10:14,4,7,11
50,2025-05-25T10:40:00+02:00,2025-05-25,18:40,2,4,6
36,2025-05-25T02:18:00+02:00,2025-05-25,10:18,0,1,1
50,2025-05-25T10:44:00+02:00,2025-05-25,18:44,2,3,5
37,2025-05-25T02:17:00+02:00,2025-05-25,10:17,0,2,2
50,2025-05-25T10:46:00+02:00,2025-05-25,18:46,1,9,10
37,2025-05-25T02:21:00+02:00,2025-05-25,10:21,2,1,3
50,2025-05-25T10:52:00+02:00,2025-05-25,18:52,4,8,12
37,2025-05-25T02:24:00+02:00,2025-05-25,10:24,0,1,1
54,2025-05-25T10:40:00+02:00,2025-05-25,18:40,3,10,13
39,2025-05-25T02:19:00+02:00,2025-05-25,10:19,0,10,10
54,2025-05-25T10:44:00+02:00,2025-05-25,18:44,2,3,5
40,2025-05-25T02:16:00+02:00,2025-05-25,10:16,3,0,3
54,2025-05-25T10:45:00+02:00,2025-05-25,18:45,0,6,6
40,2025-05-25T02:19:00+02:00,2025-05-25,10:19,3,0,3
54,2025-05-25T10:46:00+02:00,2025-05-25,18:46,4,1,5
40,2025-05-25T02:20:00+02:00,2025-05-25,10:20,4,0,4
54,2025-05-25T10:47:00+02:00,2025-05-25,18:47,1,0,1
40,2025-05-25T02:21:00+02:00,2025-05-25,10:21,0,2,2
54,2025-05-25T10:54:00+02:00,2025-05-25,18:54,1,4,5
40,2025-05-25T02:22:00+02:00,2025-05-25,10:22,1,0,1
61,2025-05-25T10:42:00+02:00,2025-05-25,18:42,7,0,7
41,2025-05-25T02:17:00+02:00,2025-05-25,10:17,0,1,1
61,2025-05-25T10:43:00+02:00,2025-05-25,18:43,6,2,8
41,2025-05-25T02:23:00+02:00,2025-05-25,10:23,4,0,4
61,2025-05-25T10:44:00+02:00,2025-05-25,18:44,3,4,7
44,2025-05-25T02:15:00+02:00,2025-05-25,10:15,2,0,2
61,2025-05-25T10:45:00+02:00,2025-05-25,18:45,3,2,5
44,2025-05-25T02:20:00+02:00,2025-05-25,10:20,1,5,6
61,2025-05-25T10:50:00+02:00,2025-05-25,18:50,11,9,20
45,2025-05-25T02:17:00+02:00,2025-05-25,10:17,11,1,12
61,2025-05-25T10:51:00+02:00,2025-05-25,18:51,11,0,11
45,2025-05-25T02:19:00+02:00,2025-05-25,10:19,3,8,11
66,2025-05-25T10:43:00+02:00,2025-05-25,18:43,26,32,58
47,2025-05-25T02:13:00+02:00,2025-05-25,10:13,7,3,10
66,2025-05-25T10:44:00+02:00,2025-05-25,18:44,18,30,48
47,2025-05-25T02:18:00+02:00,2025-05-25,10:18,7,7,14
66,2025-05-25T10:45:00+02:00,2025-05-25,18:45,10,2,12
47,2025-05-25T02:19:00+02:00,2025-05-25,10:19,5,6,11
66,2025-05-25T10:47:00+02:00,2025-05-25,18:47,16,24,40
47,2025-05-25T02:21:00+02:00,2025-05-25,10:21,7,18,25
66,2025-05-25T10:48:00+02:00,2025-05-25,18:48,16,23,39
50,2025-05-25T02:10:00+02:00,2025-05-25,10:10,1,6,7
66,2025-05-25T10:49:00+02:00,2025-05-25,18:49,24,15,39
50,2025-05-25T02:14:00+02:00,2025-05-25,10:14,1,2,3
66,2025-05-25T10:52:00+02:00,2025-05-25,18:52,22,26,48
50,2025-05-25T02:21:00+02:00,2025-05-25,10:21,2,6,8
66,2025-05-25T10:54:00+02:00,2025-05-25,18:54,22,9,31
54,2025-05-25T02:16:00+02:00,2025-05-25,10:16,0,1,1
69,2025-05-25T10:42:00+02:00,2025-05-25,18:42,0,1,1
54,2025-05-25T02:22:00+02:00,2025-05-25,10:22,1,0,1
69,2025-05-25T10:46:00+02:00,2025-05-25,18:46,0,1,1
59,2025-05-25T02:20:00+02:00,2025-05-25,10:20,7,9,16
69,2025-05-25T10:51:00+02:00,2025-05-25,18:51,2,1,3
61,2025-05-25T02:12:00+02:00,2025-05-25,10:12,1,1,2
69,2025-05-25T10:53:00+02:00,2025-05-25,18:53,3,0,3
61,2025-05-25T02:18:00+02:00,2025-05-25,10:18,7,7,14
70,2025-05-25T10:40:00+02:00,2025-05-25,18:40,1,7,8
61,2025-05-25T02:19:00+02:00,2025-05-25,10:19,0,8,8
70,2025-05-25T10:42:00+02:00,2025-05-25,18:42,4,4,8
66,2025-05-25T02:11:00+02:00,2025-05-25,10:11,0,6,6
70,2025-05-25T10:46:00+02:00,2025-05-25,18:46,1,4,5
66,2025-05-25T02:13:00+02:00,2025-05-25,10:13,12,4,16
70,2025-05-25T10:47:00+02:00,2025-05-25,18:47,2,8,10
66,2025-05-25T02:14:00+02:00,2025-05-25,10:14,1,14,15
70,2025-05-25T10:48:00+02:00,2025-05-25,18:48,3,15,18
66,2025-05-25T02:16:00+02:00,2025-05-25,10:16,6,6,12
70,2025-05-25T10:49:00+02:00,2025-05-25,18:49,1,1,2
66,2025-05-25T02:17:00+02:00,2025-05-25,10:17,2,4,6
70,2025-05-25T10:50:00+02:00,2025-05-25,18:50,0,6,6
66,2025-05-25T02:19:00+02:00,2025-05-25,10:19,7,10,17
71,2025-05-25T10:46:00+02:00,2025-05-25,18:46,0,2,2
66,2025-05-25T02:24:00+02:00,2025-05-25,10:24,10,2,12
75,2025-05-25T10:46:00+02:00,2025-05-25,18:46,2,1,3
69,2025-05-25T02:10:00+02:00,2025-05-25,10:10,1,2,3
75,2025-05-25T10:48:00+02:00,2025-05-25,18:48,2,0,2
69,2025-05-25T02:11:00+02:00,2025-05-25,10:11,5,1,6
75,2025-05-25T10:49:00+02:00,2025-05-25,18:49,2,0,2
69,2025-05-25T02:24:00+02:00,2025-05-25,10:24,4,0,4
75,2025-05-25T10:54:00+02:00,2025-05-25,18:54,1,1,2
70,2025-05-25T02:11:00+02:00,2025-05-25,10:11,5,2,7
78,2025-05-25T10:42:00+02:00,2025-05-25,18:42,0,2,2
70,2025-05-25T02:12:00+02:00,2025-05-25,10:12,1,4,5
84,2025-05-25T10:50:00+02:00,2025-05-25,18:50,56,96,152
70,2025-05-25T02:14:00+02:00,2025-05-25,10:14,1,3,4
107,2025-05-25T10:40:00+02:00,2025-05-25,18:40,9,6,15
70,2025-05-25T02:16:00+02:00,2025-05-25,10:16,1,1,2
108,2025-05-25T10:41:00+02:00,2025-05-25,18:41,3,1,4
70,2025-05-25T02:17:00+02:00,2025-05-25,10:17,3,2,5
108,2025-05-25T10:45:00+02:00,2025-05-25,18:45,1,2,3
70,2025-05-25T02:19:00+02:00,2025-05-25,10:19,0,2,2
108,2025-05-25T10:46:00+02:00,2025-05-25,18:46,0,1,1
70,2025-05-25T02:22:00+02:00,2025-05-25,10:22,0,1,1
108,2025-05-25T10:49:00+02:00,2025-05-25,18:49,6,3,9
70,2025-05-25T02:24:00+02:00,2025-05-25,10:24,3,1,4
108,2025-05-25T10:53:00+02:00,2025-05-25,18:53,0,4,4
75,2025-05-25T02:10:00+02:00,2025-05-25,10:10,0,2,2
134,2025-05-25T10:45:00+02:00,2025-05-25,18:45,50,10,60
75,2025-05-25T02:14:00+02:00,2025-05-25,10:14,2,1,3
135,2025-05-25T10:45:00+02:00,2025-05-25,18:45,31,30,61
75,2025-05-25T02:18:00+02:00,2025-05-25,10:18,1,1,2
135,2025-05-25T10:50:00+02:00,2025-05-25,18:50,14,15,29
75,2025-05-25T02:23:00+02:00,2025-05-25,10:23,1,5,6
166,2025-05-25T10:40:00+02:00,2025-05-25,18:40,3,1,4
75,2025-05-25T02:24:00+02:00,2025-05-25,10:24,4,0,4
179,2025-05-25T10:45:00+02:00,2025-05-25,18:45,4,7,11
77,2025-05-25T02:10:00+02:00,2025-05-25,10:10,11,46,57
1,2025-05-25T10:40:00+02:00,2025-05-25,18:40,15,6,21
78,2025-05-25T02:14:00+02:00,2025-05-25,10:14,1,0,1
1,2025-05-25T10:41:00+02:00,2025-05-25,18:41,18,10,28
78,2025-05-25T02:16:00+02:00,2025-05-25,10:16,0,6,6
1,2025-05-25T10:43:00+02:00,2025-05-25,18:43,20,9,29
78,2025-05-25T02:21:00+02:00,2025-05-25,10:21,0,3,3
1,2025-05-25T10:44:00+02:00,2025-05-25,18:44,9,6,15
84,2025-05-25T02:20:00+02:00,2025-05-25,10:20,58,28,86
1,2025-05-25T10:45:00+02:00,2025-05-25,18:45,8,6,14
87,2025-05-25T02:16:00+02:00,2025-05-25,10:16,3,0,3
1,2025-05-25T10:48:00+02:00,2025-05-25,18:48,11,3,14
87,2025-05-25T02:17:00+02:00,2025-05-25,10:17,2,6,8
1,2025-05-25T10:49:00+02:00,2025-05-25,18:49,27,7,34
87,2025-05-25T02:18:00+02:00,2025-05-25,10:18,0,2,2
1,2025-05-25T10:51:00+02:00,2025-05-25,18:51,7,10,17
87,2025-05-25T02:23:00+02:00,2025-05-25,10:23,0,2,2
2,2025-05-25T10:46:00+02:00,2025-05-25,18:46,3,7,10
87,2025-05-25T02:24:00+02:00,2025-05-25,10:24,0,1,1
2,2025-05-25T10:52:00+02:00,2025-05-25,18:52,5,5,10
108,2025-05-25T02:13:00+02:00,2025-05-25,10:13,4,2,6
2,2025-05-25T10:53:00+02:00,2025-05-25,18:53,11,5,16
108,2025-05-25T02:16:00+02:00,2025-05-25,10:16,0,2,2
2,2025-05-25T10:54:00+02:00,2025-05-25,18:54,4,8,12
108,2025-05-25T02:17:00+02:00,2025-05-25,10:17,2,6,8
9,2025-05-25T10:46:00+02:00,2025-05-25,18:46,0,1,1
108,2025-05-25T02:20:00+02:00,2025-05-25,10:20,0,1,1
9,2025-05-25T10:53:00+02:00,2025-05-25,18:53,5,1,6
108,2025-05-25T02:22:00+02:00,2025-05-25,10:22,1,1,2
10,2025-05-25T10:40:00+02:00,2025-05-25,18:40,4,0,4
108,2025-05-25T02:24:00+02:00,2025-05-25,10:24,2,3,5
10,2025-05-25T10:46:00+02:00,2025-05-25,18:46,2,0,2
118,2025-05-25T02:10:00+02:00,2025-05-25,10:10,0,3,3
10,2025-05-25T10:52:00+02:00,2025-05-25,18:52,0,2,2
118,2025-05-25T02:20:00+02:00,2025-05-25,10:20,0,4,4
10,2025-05-25T10:54:00+02:00,2025-05-25,18:54,4,0,4
131,2025-05-25T02:15:00+02:00,2025-05-25,10:15,2,8,10
11,2025-05-25T10:45:00+02:00,2025-05-25,18:45,3,2,5
134,2025-05-25T02:15:00+02:00,2025-05-25,10:15,34,35,69
11,2025-05-25T10:50:00+02:00,2025-05-25,18:50,4,2,6
135,2025-05-25T02:10:00+02:00,2025-05-25,10:10,34,26,60
12,2025-05-25T10:40:00+02:00,2025-05-25,18:40,5,0,5
140,2025-05-25T02:10:00+02:00,2025-05-25,10:10,13,9,22
12,2025-05-25T10:45:00+02:00,2025-05-25,18:45,5,4,9
140,2025-05-25T02:15:00+02:00,2025-05-25,10:15,13,11,24
12,2025-05-25T10:48:00+02:00,2025-05-25,18:48,0,6,6
162,2025-05-25T02:10:00+02:00,2025-05-25,10:10,34,54,88
12,2025-05-25T10:49:00+02:00,2025-05-25,18:49,1,6,7
162,2025-05-25T02:20:00+02:00,2025-05-25,10:20,40,35,75
12,2025-05-25T10:51:00+02:00,2025-05-25,18:51,1,1,2
165,2025-05-25T02:10:00+02:00,2025-05-25,10:10,3,0,3
17,2025-05-25T10:40:00+02:00,2025-05-25,18:40,3,3,6
165,2025-05-25T02:15:00+02:00,2025-05-25,10:15,0,4,4
17,2025-05-25T10:44:00+02:00,2025-05-25,18:44,1,1,2
165,2025-05-25T02:20:00+02:00,2025-05-25,10:20,2,6,8
17,2025-05-25T10:49:00+02:00,2025-05-25,18:49,2,3,5
166,2025-05-25T02:10:00+02:00,2025-05-25,10:10,3,1,4
17,2025-05-25T10:51:00+02:00,2025-05-25,18:51,1,4,5
166,2025-05-25T02:15:00+02:00,2025-05-25,10:15,10,10,20
17,2025-05-25T10:53:00+02:00,2025-05-25,18:53,1,2,3
167,2025-05-25T02:15:00+02:00,2025-05-25,10:15,1,2,3
18,2025-05-25T10:48:00+02:00,2025-05-25,18:48,0,1,1
179,2025-05-25T02:15:00+02:00,2025-05-25,10:15,5,3,8
19,2025-05-25T10:42:00+02:00,2025-05-25,18:42,15,1,16
179,2025-05-25T02:20:00+02:00,2025-05-25,10:20,9,3,12
19,2025-05-25T10:43:00+02:00,2025-05-25,18:43,9,6,15
1,2025-05-25T02:14:00+02:00,2025-05-25,10:14,7,8,15
19,2025-05-25T10:49:00+02:00,2025-05-25,18:49,12,14,26
1,2025-05-25T02:16:00+02:00,2025-05-25,10:16,6,3,9
19,2025-05-25T10:50:00+02:00,2025-05-25,18:50,10,9,19
1,2025-05-25T02:19:00+02:00,2025-05-25,10:19,0,5,5
19,2025-05-25T10:52:00+02:00,2025-05-25,18:52,25,6,31
1,2025-05-25T02:21:00+02:00,2025-05-25,10:21,9,9,18
19,2025-05-25T10:53:00+02:00,2025-05-25,18:53,10,7,17
1,2025-05-25T02:23:00+02:00,2025-05-25,10:23,3,6,9
20,2025-05-25T10:51:00+02:00,2025-05-25,18:51,0,11,11
2,2025-05-25T02:10:00+02:00,2025-05-25,10:10,2,5,7
23,2025-05-25T10:40:00+02:00,2025-05-25,18:40,3,1,4
2,2025-05-25T02:12:00+02:00,2025-05-25,10:12,0,6,6
23,2025-05-25T10:41:00+02:00,2025-05-25,18:41,0,3,3
2,2025-05-25T02:19:00+02:00,2025-05-25,10:19,3,0,3
23,2025-05-25T10:44:00+02:00,2025-05-25,18:44,0,5,5
2,2025-05-25T02:23:00+02:00,2025-05-25,10:23,7,5,12
23,2025-05-25T10:51:00+02:00,2025-05-25,18:51,5,3,8
9,2025-05-25T02:16:00+02:00,2025-05-25,10:16,0,3,3
24,2025-05-25T10:41:00+02:00,2025-05-25,18:41,2,6,8
9,2025-05-25T02:22:00+02:00,2025-05-25,10:22,0,1,1
24,2025-05-25T10:42:00+02:00,2025-05-25,18:42,8,4,12
10,2025-05-25T02:15:00+02:00,2025-05-25,10:15,0,1,1
24,2025-05-25T10:43:00+02:00,2025-05-25,18:43,4,22,26
11,2025-05-25T02:15:00+02:00,2025-05-25,10:15,6,1,7
24,2025-05-25T10:44:00+02:00,2025-05-25,18:44,4,33,37
11,2025-05-25T02:17:00+02:00,2025-05-25,10:17,0,2,2
24,2025-05-25T10:46:00+02:00,2025-05-25,18:46,5,11,16
11,2025-05-25T02:20:00+02:00,2025-05-25,10:20,1,4,5
24,2025-05-25T10:48:00+02:00,2025-05-25,18:48,11,1,12
12,2025-05-25T02:11:00+02:00,2025-05-25,10:11,2,1,3
24,2025-05-25T10:49:00+02:00,2025-05-25,18:49,3,18,21
12,2025-05-25T02:12:00+02:00,2025-05-25,10:12,2,7,9
24,2025-05-25T10:50:00+02:00,2025-05-25,18:50,16,38,54
12,2025-05-25T02:14:00+02:00,2025-05-25,10:14,2,1,3
24,2025-05-25T10:53:00+02:00,2025-05-25,18:53,4,4,8
12,2025-05-25T02:15:00+02:00,2025-05-25,10:15,2,5,7
25,2025-05-25T10:50:00+02:00,2025-05-25,18:50,25,48,73
12,2025-05-25T02:17:00+02:00,2025-05-25,10:17,3,4,7
27,2025-05-25T10:41:00+02:00,2025-05-25,18:41,3,0,3
12,2025-05-25T02:21:00+02:00,2025-05-25,10:21,2,3,5
27,2025-05-25T10:49:00+02:00,2025-05-25,18:49,6,1,7
17,2025-05-25T02:19:00+02:00,2025-05-25,10:19,2,0,2
27,2025-05-25T10:50:00+02:00,2025-05-25,18:50,4,2,6
19,2025-05-25T02:10:00+02:00,2025-05-25,10:10,0,5,5
27,2025-05-25T10:53:00+02:00,2025-05-25,18:53,2,3,5
19,2025-05-25T02:11:00+02:00,2025-05-25,10:11,0,3,3
30,2025-05-25T10:41:00+02:00,2025-05-25,18:41,8,4,12
19,2025-05-25T02:12:00+02:00,2025-05-25,10:12,0,4,4
30,2025-05-25T10:50:00+02:00,2025-05-25,18:50,0,10,10
19,2025-05-25T02:16:00+02:00,2025-05-25,10:16,4,2,6
30,2025-05-25T10:51:00+02:00,2025-05-25,18:51,6,8,14
19,2025-05-25T02:18:00+02:00,2025-05-25,10:18,1,1,2
30,2025-05-25T10:53:00+02:00,2025-05-25,18:53,6,3,9
19,2025-05-25T02:22:00+02:00,2025-05-25,10:22,4,5,9
35,2025-05-25T10:46:00+02:00,2025-05-25,18:46,7,22,29
19,2025-05-25T02:24:00+02:00,2025-05-25,10:24,3,3,6
35,2025-05-25T10:47:00+02:00,2025-05-25,18:47,12,20,32
20,2025-05-25T02:11:00+02:00,2025-05-25,10:11,1,1,2
35,2025-05-25T10:49:00+02:00,2025-05-25,18:49,6,8,14
20,2025-05-25T02:15:00+02:00,2025-05-25,10:15,0,1,1
35,2025-05-25T10:51:00+02:00,2025-05-25,18:51,23,13,36
20,2025-05-25T02:17:00+02:00,2025-05-25,10:17,4,2,6
35,2025-05-25T10:52:00+02:00,2025-05-25,18:52,8,17,25
20,2025-05-25T02:20:00+02:00,2025-05-25,10:20,2,2,4
35,2025-05-25T10:54:00+02:00,2025-05-25,18:54,21,13,34
23,2025-05-25T02:11:00+02:00,2025-05-25,10:11,1,0,1
46,2025-05-25T10:50:00+02:00,2025-05-25,18:50,2,0,2
23,2025-05-25T02:13:00+02:00,2025-05-25,10:13,6,1,7
48,2025-05-25T10:48:00+02:00,2025-05-25,18:48,3,2,5
23,2025-05-25T02:15:00+02:00,2025-05-25,10:15,2,6,8
48,2025-05-25T10:49:00+02:00,2025-05-25,18:49,1,0,1
23,2025-05-25T02:16:00+02:00,2025-05-25,10:16,3,3,6
48,2025-05-25T10:51:00+02:00,2025-05-25,18:51,5,3,8
23,2025-05-25T02:20:00+02:00,2025-05-25,10:20,1,9,10
49,2025-05-25T10:40:00+02:00,2025-05-25,18:40,3,6,9
23,2025-05-25T02:22:00+02:00,2025-05-25,10:22,8,9,17
49,2025-05-25T10:43:00+02:00,2025-05-25,18:43,6,2,8
23,2025-05-25T02:24:00+02:00,2025-05-25,10:24,3,0,3
49,2025-05-25T10:44:00+02:00,2025-05-25,18:44,6,4,10
24,2025-05-25T02:10:00+02:00,2025-05-25,10:10,4,3,7
49,2025-05-25T10:47:00+02:00,2025-05-25,18:47,2,3,5
24,2025-05-25T02:16:00+02:00,2025-05-25,10:16,14,10,24
49,2025-05-25T10:48:00+02:00,2025-05-25,18:48,3,4,7
24,2025-05-25T02:21:00+02:00,2025-05-25,10:21,6,25,31
49,2025-05-25T10:49:00+02:00,2025-05-25,18:49,7,1,8
24,2025-05-25T02:22:00+02:00,2025-05-25,10:22,4,3,7
49,2025-05-25T10:52:00+02:00,2025-05-25,18:52,2,3,5
27,2025-05-25T02:20:00+02:00,2025-05-25,10:20,5,5,10
49,2025-05-25T10:54:00+02:00,2025-05-25,18:54,4,10,14
30,2025-05-25T02:14:00+02:00,2025-05-25,10:14,0,1,1
51,2025-05-25T10:45:00+02:00,2025-05-25,18:45,1,1,2
30,2025-05-25T02:15:00+02:00,2025-05-25,10:15,1,5,6
51,2025-05-25T10:50:00+02:00,2025-05-25,18:50,3,1,4
30,2025-05-25T02:22:00+02:00,2025-05-25,10:22,3,4,7
51,2025-05-25T10:52:00+02:00,2025-05-25,18:52,2,1,3
30,2025-05-25T02:23:00+02:00,2025-05-25,10:23,5,1,6
52,2025-05-25T10:41:00+02:00,2025-05-25,18:41,5,5,10
30,2025-05-25T02:24:00+02:00,2025-05-25,10:24,0,5,5
52,2025-05-25T10:54:00+02:00,2025-05-25,18:54,2,4,6
35,2025-05-25T02:16:00+02:00,2025-05-25,10:16,14,9,23
53,2025-05-25T10:40:00+02:00,2025-05-25,18:40,4,4,8
35,2025-05-25T02:18:00+02:00,2025-05-25,10:18,36,6,42
53,2025-05-25T10:41:00+02:00,2025-05-25,18:41,3,0,3
35,2025-05-25T02:20:00+02:00,2025-05-25,10:20,13,16,29
53,2025-05-25T10:46:00+02:00,2025-05-25,18:46,1,4,5
46,2025-05-25T02:15:00+02:00,2025-05-25,10:15,1,0,1
56,2025-05-25T10:40:00+02:00,2025-05-25,18:40,12,6,18
48,2025-05-25T02:10:00+02:00,2025-05-25,10:10,5,9,14
56,2025-05-25T10:41:00+02:00,2025-05-25,18:41,18,5,23
48,2025-05-25T02:13:00+02:00,2025-05-25,10:13,2,3,5
56,2025-05-25T10:43:00+02:00,2025-05-25,18:43,7,8,15
48,2025-05-25T02:14:00+02:00,2025-05-25,10:14,7,3,10
56,2025-05-25T10:45:00+02:00,2025-05-25,18:45,6,13,19
48,2025-05-25T02:20:00+02:00,2025-05-25,10:20,4,1,5
56,2025-05-25T10:47:00+02:00,2025-05-25,18:47,3,5,8
48,2025-05-25T02:24:00+02:00,2025-05-25,10:24,7,0,7
58,2025-05-25T10:41:00+02:00,2025-05-25,18:41,1,15,16
49,2025-05-25T02:12:00+02:00,2025-05-25,10:12,8,4,12
58,2025-05-25T10:43:00+02:00,2025-05-25,18:43,2,6,8
49,2025-05-25T02:13:00+02:00,2025-05-25,10:13,4,8,12
58,2025-05-25T10:46:00+02:00,2025-05-25,18:46,6,4,10
49,2025-05-25T02:15:00+02:00,2025-05-25,10:15,3,7,10
58,2025-05-25T10:47:00+02:00,2025-05-25,18:47,22,4,26
49,2025-05-25T02:16:00+02:00,2025-05-25,10:16,6,11,17
58,2025-05-25T10:50:00+02:00,2025-05-25,18:50,8,1,9
51,2025-05-25T02:18:00+02:00,2025-05-25,10:18,2,0,2
62,2025-05-25T10:43:00+02:00,2025-05-25,18:43,3,3,6
51,2025-05-25T02:23:00+02:00,2025-05-25,10:23,0,4,4
62,2025-05-25T10:46:00+02:00,2025-05-25,18:46,4,0,4
52,2025-05-25T02:12:00+02:00,2025-05-25,10:12,3,0,3
62,2025-05-25T10:49:00+02:00,2025-05-25,18:49,4,3,7
52,2025-05-25T02:16:00+02:00,2025-05-25,10:16,1,0,1
62,2025-05-25T10:51:00+02:00,2025-05-25,18:51,1,0,1
52,2025-05-25T02:20:00+02:00,2025-05-25,10:20,1,0,1
62,2025-05-25T10:52:00+02:00,2025-05-25,18:52,2,1,3
52,2025-05-25T02:23:00+02:00,2025-05-25,10:23,1,1,2
62,2025-05-25T10:54:00+02:00,2025-05-25,18:54,3,3,6
53,2025-05-25T02:11:00+02:00,2025-05-25,10:11,13,2,15
63,2025-05-25T10:43:00+02:00,2025-05-25,18:43,0,1,1
53,2025-05-25T02:16:00+02:00,2025-05-25,10:16,3,2,5
63,2025-05-25T10:46:00+02:00,2025-05-25,18:46,0,6,6
53,2025-05-25T02:17:00+02:00,2025-05-25,10:17,8,2,10
63,2025-05-25T10:48:00+02:00,2025-05-25,18:48,0,3,3
53,2025-05-25T02:19:00+02:00,2025-05-25,10:19,11,1,12
63,2025-05-25T10:49:00+02:00,2025-05-25,18:49,1,6,7
53,2025-05-25T02:21:00+02:00,2025-05-25,10:21,12,6,18
67,2025-05-25T10:43:00+02:00,2025-05-25,18:43,6,7,13
53,2025-05-25T02:24:00+02:00,2025-05-25,10:24,7,4,11
67,2025-05-25T10:44:00+02:00,2025-05-25,18:44,3,5,8
56,2025-05-25T02:15:00+02:00,2025-05-25,10:15,8,3,11
67,2025-05-25T10:53:00+02:00,2025-05-25,18:53,6,15,21
56,2025-05-25T02:18:00+02:00,2025-05-25,10:18,5,2,7
67,2025-05-25T10:54:00+02:00,2025-05-25,18:54,4,6,10
58,2025-05-25T02:10:00+02:00,2025-05-25,10:10,10,5,15
68,2025-05-25T10:50:00+02:00,2025-05-25,18:50,9,3,12
58,2025-05-25T02:14:00+02:00,2025-05-25,10:14,6,11,17
72,2025-05-25T10:40:00+02:00,2025-05-25,18:40,6,17,23
58,2025-05-25T02:18:00+02:00,2025-05-25,10:18,12,0,12
72,2025-05-25T10:42:00+02:00,2025-05-25,18:42,2,6,8
58,2025-05-25T02:21:00+02:00,2025-05-25,10:21,16,4,20
72,2025-05-25T10:43:00+02:00,2025-05-25,18:43,1,7,8
58,2025-05-25T02:23:00+02:00,2025-05-25,10:23,9,1,10
72,2025-05-25T10:45:00+02:00,2025-05-25,18:45,3,8,11
62,2025-05-25T02:20:00+02:00,2025-05-25,10:20,1,2,3
72,2025-05-25T10:47:00+02:00,2025-05-25,18:47,4,12,16
62,2025-05-25T02:23:00+02:00,2025-05-25,10:23,0,1,1
72,2025-05-25T10:52:00+02:00,2025-05-25,18:52,8,16,24
63,2025-05-25T02:14:00+02:00,2025-05-25,10:14,1,1,2
72,2025-05-25T10:54:00+02:00,2025-05-25,18:54,7,11,18
63,2025-05-25T02:15:00+02:00,2025-05-25,10:15,4,5,9
76,2025-05-25T10:41:00+02:00,2025-05-25,18:41,1,0,1
63,2025-05-25T02:17:00+02:00,2025-05-25,10:17,2,4,6
76,2025-05-25T10:50:00+02:00,2025-05-25,18:50,0,6,6
63,2025-05-25T02:18:00+02:00,2025-05-25,10:18,1,5,6
79,2025-05-25T10:41:00+02:00,2025-05-25,18:41,4,10,14
67,2025-05-25T02:12:00+02:00,2025-05-25,10:12,9,3,12
79,2025-05-25T10:43:00+02:00,2025-05-25,18:43,5,2,7
67,2025-05-25T02:14:00+02:00,2025-05-25,10:14,9,4,13
79,2025-05-25T10:45:00+02:00,2025-05-25,18:45,8,11,19
67,2025-05-25T02:16:00+02:00,2025-05-25,10:16,3,9,12
79,2025-05-25T10:48:00+02:00,2025-05-25,18:48,13,2,15
67,2025-05-25T02:19:00+02:00,2025-05-25,10:19,6,4,10
79,2025-05-25T10:49:00+02:00,2025-05-25,18:49,5,7,12
67,2025-05-25T02:21:00+02:00,2025-05-25,10:21,4,1,5
79,2025-05-25T10:53:00+02:00,2025-05-25,18:53,6,25,31
67,2025-05-25T02:23:00+02:00,2025-05-25,10:23,1,10,11
85,2025-05-25T10:50:00+02:00,2025-05-25,18:50,1,1,2
67,2025-05-25T02:24:00+02:00,2025-05-25,10:24,1,12,13
86,2025-05-25T10:45:00+02:00,2025-05-25,18:45,3,0,3
68,2025-05-25T02:10:00+02:00,2025-05-25,10:10,7,3,10
86,2025-05-25T10:46:00+02:00,2025-05-25,18:46,0,1,1
68,2025-05-25T02:12:00+02:00,2025-05-25,10:12,7,11,18
86,2025-05-25T10:47:00+02:00,2025-05-25,18:47,2,5,7
68,2025-05-25T02:22:00+02:00,2025-05-25,10:22,4,1,5
86,2025-05-25T10:49:00+02:00,2025-05-25,18:49,3,1,4
72,2025-05-25T02:11:00+02:00,2025-05-25,10:11,2,2,4
86,2025-05-25T10:52:00+02:00,2025-05-25,18:52,1,1,2
72,2025-05-25T02:14:00+02:00,2025-05-25,10:14,2,0,2
86,2025-05-25T10:54:00+02:00,2025-05-25,18:54,5,1,6
72,2025-05-25T02:15:00+02:00,2025-05-25,10:15,0,5,5
109,2025-05-25T10:50:00+02:00,2025-05-25,18:50,6,4,10
72,2025-05-25T02:18:00+02:00,2025-05-25,10:18,3,4,7
130,2025-05-25T10:40:00+02:00,2025-05-25,18:40,4,0,4
72,2025-05-25T02:20:00+02:00,2025-05-25,10:20,0,4,4
136,2025-05-25T10:40:00+02:00,2025-05-25,18:40,1,22,23
72,2025-05-25T02:21:00+02:00,2025-05-25,10:21,1,0,1
136,2025-05-25T10:45:00+02:00,2025-05-25,18:45,0,22,22
72,2025-05-25T02:23:00+02:00,2025-05-25,10:23,0,9,9
141,2025-05-25T10:40:00+02:00,2025-05-25,18:40,5,22,27
76,2025-05-25T02:15:00+02:00,2025-05-25,10:15,1,0,1
142,2025-05-25T10:50:00+02:00,2025-05-25,18:50,11,1,12
76,2025-05-25T02:16:00+02:00,2025-05-25,10:16,0,1,1
164,2025-05-25T10:45:00+02:00,2025-05-25,18:45,12,4,16
76,2025-05-25T02:23:00+02:00,2025-05-25,10:23,2,0,2
3,2025-05-25T10:41:00+02:00,2025-05-25,18:41,14,9,23
79,2025-05-25T02:11:00+02:00,2025-05-25,10:11,2,0,2
3,2025-05-25T10:42:00+02:00,2025-05-25,18:42,8,10,18
79,2025-05-25T02:16:00+02:00,2025-05-25,10:16,0,1,1
3,2025-05-25T10:43:00+02:00,2025-05-25,18:43,10,9,19
79,2025-05-25T02:20:00+02:00,2025-05-25,10:20,7,6,13
3,2025-05-25T10:45:00+02:00,2025-05-25,18:45,15,19,34
79,2025-05-25T02:21:00+02:00,2025-05-25,10:21,4,4,8
3,2025-05-25T10:52:00+02:00,2025-05-25,18:52,10,16,26
85,2025-05-25T02:11:00+02:00,2025-05-25,10:11,1,1,2
3,2025-05-25T10:54:00+02:00,2025-05-25,18:54,15,28,43
85,2025-05-25T02:12:00+02:00,2025-05-25,10:12,1,0,1
4,2025-05-25T10:43:00+02:00,2025-05-25,18:43,11,24,35
85,2025-05-25T02:18:00+02:00,2025-05-25,10:18,2,0,2
4,2025-05-25T10:48:00+02:00,2025-05-25,18:48,20,21,41
85,2025-05-25T02:19:00+02:00,2025-05-25,10:19,1,0,1
4,2025-05-25T10:52:00+02:00,2025-05-25,18:52,16,13,29
86,2025-05-25T02:16:00+02:00,2025-05-25,10:16,0,4,4
4,2025-05-25T10:53:00+02:00,2025-05-25,18:53,10,17,27
86,2025-05-25T02:17:00+02:00,2025-05-25,10:17,0,4,4
5,2025-05-25T10:50:00+02:00,2025-05-25,18:50,53,108,161
86,2025-05-25T02:18:00+02:00,2025-05-25,10:18,1,0,1
6,2025-05-25T10:40:00+02:00,2025-05-25,18:40,13,18,31
86,2025-05-25T02:19:00+02:00,2025-05-25,10:19,0,1,1
6,2025-05-25T10:42:00+02:00,2025-05-25,18:42,8,9,17
86,2025-05-25T02:22:00+02:00,2025-05-25,10:22,0,1,1
6,2025-05-25T10:43:00+02:00,2025-05-25,18:43,8,20,28
86,2025-05-25T02:24:00+02:00,2025-05-25,10:24,5,1,6
6,2025-05-25T10:44:00+02:00,2025-05-25,18:44,12,15,27
130,2025-05-25T02:10:00+02:00,2025-05-25,10:10,5,8,13
6,2025-05-25T10:45:00+02:00,2025-05-25,18:45,11,5,16
130,2025-05-25T02:15:00+02:00,2025-05-25,10:15,0,8,8
6,2025-05-25T10:50:00+02:00,2025-05-25,18:50,12,7,19
138,2025-05-25T02:15:00+02:00,2025-05-25,10:15,1,1,2
6,2025-05-25T10:51:00+02:00,2025-05-25,18:51,8,3,11
139,2025-05-25T02:10:00+02:00,2025-05-25,10:10,0,1,1
6,2025-05-25T10:54:00+02:00,2025-05-25,18:54,23,6,29
139,2025-05-25T02:15:00+02:00,2025-05-25,10:15,2,0,2
8,2025-05-25T10:44:00+02:00,2025-05-25,18:44,0,1,1
141,2025-05-25T02:15:00+02:00,2025-05-25,10:15,9,22,31
28,2025-05-25T10:41:00+02:00,2025-05-25,18:41,3,7,10
161,2025-05-25T02:20:00+02:00,2025-05-25,10:20,15,14,29
28,2025-05-25T10:43:00+02:00,2025-05-25,18:43,1,17,18
164,2025-05-25T02:10:00+02:00,2025-05-25,10:10,15,0,15
28,2025-05-25T10:53:00+02:00,2025-05-25,18:53,5,12,17
164,2025-05-25T02:15:00+02:00,2025-05-25,10:15,9,1,10
28,2025-05-25T10:54:00+02:00,2025-05-25,18:54,1,14,15
29,2025-05-25T10:40:00+02:00,2025-05-25,18:40,3,5,8
29,2025-05-25T10:44:00+02:00,2025-05-25,18:44,10,10,20
29,2025-05-25T10:46:00+02:00,2025-05-25,18:46,1,5,6
29,2025-05-25T10:48:00+02:00,2025-05-25,18:48,12,3,15
29,2025-05-25T10:52:00+02:00,2025-05-25,18:52,0,6,6
29,2025-05-25T10:53:00+02:00,2025-05-25,18:53,3,8,11
29,2025-05-25T10:54:00+02:00,2025-05-25,18:54,4,3,7
31,2025-05-25T10:40:00+02:00,2025-05-25,18:40,2,8,10
31,2025-05-25T10:42:00+02:00,2025-05-25,18:42,0,3,3
31,2025-05-25T10:51:00+02:00,2025-05-25,18:51,1,6,7
31,2025-05-25T10:52:00+02:00,2025-05-25,18:52,2,3,5
31,2025-05-25T10:54:00+02:00,2025-05-25,18:54,10,5,15
36,2025-05-25T10:42:00+02:00,2025-05-25,18:42,6,4,10
36,2025-05-25T10:44:00+02:00,2025-05-25,18:44,1,0,1
36,2025-05-25T10:52:00+02:00,2025-05-25,18:52,0,3,3
36,2025-05-25T10:54:00+02:00,2025-05-25,18:54,0,1,1
39,2025-05-25T10:46:00+02:00,2025-05-25,18:46,0,2,2
39,2025-05-25T10:50:00+02:00,2025-05-25,18:50,2,0,2
39,2025-05-25T10:52:00+02:00,2025-05-25,18:52,1,0,1
39,2025-05-25T10:53:00+02:00,2025-05-25,18:53,4,0,4
40,2025-05-25T10:41:00+02:00,2025-05-25,18:41,0,1,1
40,2025-05-25T10:42:00+02:00,2025-05-25,18:42,0,2,2
40,2025-05-25T10:44:00+02:00,2025-05-25,18:44,1,3,4
40,2025-05-25T10:45:00+02:00,2025-05-25,18:45,0,2,2
40,2025-05-25T10:50:00+02:00,2025-05-25,18:50,0,1,1
40,2025-05-25T10:54:00+02:00,2025-05-25,18:54,2,2,4
181,2025-05-25T10:42:00+02:00,2025-05-25,18:42,15,12,27
181,2025-05-25T10:43:00+02:00,2025-05-25,18:43,17,13,30
181,2025-05-25T10:48:00+02:00,2025-05-25,18:48,6,18,24
181,2025-05-25T10:49:00+02:00,2025-05-25,18:49,9,8,17
181,2025-05-25T10:50:00+02:00,2025-05-25,18:50,7,23,30
181,2025-05-25T10:51:00+02:00,2025-05-25,18:51,15,9,24
181,2025-05-25T10:52:00+02:00,2025-05-25,18:52,17,11,28
181,2025-05-25T10:53:00+02:00,2025-05-25,18:53,14,20,34
182,2025-05-25T10:50:00+02:00,2025-05-25,18:50,24,26,50
181,2025-05-25T10:55:00+02:00,2025-05-25,18:55,9,24,33
181,2025-05-25T11:00:00+02:00,2025-05-25,19:00,8,16,24
181,2025-05-25T11:02:00+02:00,2025-05-25,19:02,15,14,29
181,2025-05-25T11:03:00+02:00,2025-05-25,19:03,8,17,25
181,2025-05-25T11:04:00+02:00,2025-05-25,19:04,11,10,21
181,2025-05-25T11:08:00+02:00,2025-05-25,19:08,18,10,28
182,2025-05-25T11:05:00+02:00,2025-05-25,19:05,22,19,41
180,2025-05-25T11:05:00+02:00,2025-05-25,19:05,0,3,3
181,2025-05-25T11:10:00+02:00,2025-05-25,19:10,16,9,25
181,2025-05-25T11:14:00+02:00,2025-05-25,19:14,19,13,32
181,2025-05-25T11:15:00+02:00,2025-05-25,19:15,16,8,24
181,2025-05-25T11:17:00+02:00,2025-05-25,19:17,14,24,38
181,2025-05-25T11:24:00+02:00,2025-05-25,19:24,13,22,35
180,2025-05-25T11:21:00+02:00,2025-05-25,19:21,0,1,1
3,2025-05-25T02:40:00+02:00,2025-05-25,10:40,7,7,14
3,2025-05-25T02:41:00+02:00,2025-05-25,10:41,1,9,10
3,2025-05-25T02:42:00+02:00,2025-05-25,10:42,7,4,11
3,2025-05-25T02:45:00+02:00,2025-05-25,10:45,8,10,18
3,2025-05-25T02:46:00+02:00,2025-05-25,10:46,12,5,17
3,2025-05-25T02:49:00+02:00,2025-05-25,10:49,8,3,11
3,2025-05-25T02:52:00+02:00,2025-05-25,10:52,11,19,30
3,2025-05-25T02:53:00+02:00,2025-05-25,10:53,3,8,11
4,2025-05-25T02:40:00+02:00,2025-05-25,10:40,5,10,15
4,2025-05-25T02:44:00+02:00,2025-05-25,10:44,8,3,11
4,2025-05-25T02:46:00+02:00,2025-05-25,10:46,26,12,38
4,2025-05-25T02:47:00+02:00,2025-05-25,10:47,15,8,23
4,2025-05-25T02:50:00+02:00,2025-05-25,10:50,18,14,32
4,2025-05-25T02:51:00+02:00,2025-05-25,10:51,22,9,31
6,2025-05-25T02:46:00+02:00,2025-05-25,10:46,11,4,15
6,2025-05-25T02:47:00+02:00,2025-05-25,10:47,6,9,15
6,2025-05-25T02:54:00+02:00,2025-05-25,10:54,17,9,26
8,2025-05-25T02:40:00+02:00,2025-05-25,10:40,1,2,3
8,2025-05-25T02:42:00+02:00,2025-05-25,10:42,1,6,7
8,2025-05-25T02:46:00+02:00,2025-05-25,10:46,6,5,11
8,2025-05-25T02:49:00+02:00,2025-05-25,10:49,5,5,10
8,2025-05-25T02:53:00+02:00,2025-05-25,10:53,2,1,3
28,2025-05-25T02:44:00+02:00,2025-05-25,10:44,13,8,21
29,2025-05-25T02:44:00+02:00,2025-05-25,10:44,1,6,7
29,2025-05-25T02:45:00+02:00,2025-05-25,10:45,5,6,11
29,2025-05-25T02:50:00+02:00,2025-05-25,10:50,7,7,14
29,2025-05-25T02:52:00+02:00,2025-05-25,10:52,6,11,17
29,2025-05-25T02:53:00+02:00,2025-05-25,10:53,8,6,14
29,2025-05-25T02:54:00+02:00,2025-05-25,10:54,7,4,11
31,2025-05-25T02:40:00+02:00,2025-05-25,10:40,2,1,3
31,2025-05-25T02:45:00+02:00,2025-05-25,10:45,2,4,6
31,2025-05-25T02:47:00+02:00,2025-05-25,10:47,2,1,3
31,2025-05-25T02:49:00+02:00,2025-05-25,10:49,1,1,2
31,2025-05-25T02:50:00+02:00,2025-05-25,10:50,1,0,1
36,2025-05-25T02:42:00+02:00,2025-05-25,10:42,0,5,5
36,2025-05-25T02:43:00+02:00,2025-05-25,10:43,1,12,13
36,2025-05-25T02:44:00+02:00,2025-05-25,10:44,5,1,6
36,2025-05-25T02:49:00+02:00,2025-05-25,10:49,0,2,2
36,2025-05-25T02:51:00+02:00,2025-05-25,10:51,1,0,1
39,2025-05-25T02:41:00+02:00,2025-05-25,10:41,3,2,5
39,2025-05-25T02:46:00+02:00,2025-05-25,10:46,0,5,5
39,2025-05-25T02:51:00+02:00,2025-05-25,10:51,1,0,1
39,2025-05-25T02:54:00+02:00,2025-05-25,10:54,1,0,1
40,2025-05-25T02:41:00+02:00,2025-05-25,10:41,5,2,7
40,2025-05-25T02:44:00+02:00,2025-05-25,10:44,0,3,3
40,2025-05-25T02:49:00+02:00,2025-05-25,10:49,4,4,8
40,2025-05-25T02:51:00+02:00,2025-05-25,10:51,5,1,6
40,2025-05-25T02:52:00+02:00,2025-05-25,10:52,1,3,4
41,2025-05-25T02:41:00+02:00,2025-05-25,10:41,7,5,12
41,2025-05-25T02:42:00+02:00,2025-05-25,10:42,5,3,8
41,2025-05-25T02:48:00+02:00,2025-05-25,10:48,4,5,9
41,2025-05-25T02:50:00+02:00,2025-05-25,10:50,5,4,9
41,2025-05-25T02:54:00+02:00,2025-05-25,10:54,1,2,3
43,2025-05-25T02:50:00+02:00,2025-05-25,10:50,2,7,9
45,2025-05-25T02:42:00+02:00,2025-05-25,10:42,8,0,8
45,2025-05-25T02:44:00+02:00,2025-05-25,10:44,10,4,14
45,2025-05-25T02:48:00+02:00,2025-05-25,10:48,12,3,15
45,2025-05-25T02:49:00+02:00,2025-05-25,10:49,3,3,6
45,2025-05-25T02:50:00+02:00,2025-05-25,10:50,11,2,13
45,2025-05-25T02:52:00+02:00,2025-05-25,10:52,12,7,19
45,2025-05-25T02:53:00+02:00,2025-05-25,10:53,8,4,12
47,2025-05-25T02:40:00+02:00,2025-05-25,10:40,6,22,28
47,2025-05-25T02:45:00+02:00,2025-05-25,10:45,12,12,24
47,2025-05-25T02:46:00+02:00,2025-05-25,10:46,8,11,19
47,2025-05-25T02:47:00+02:00,2025-05-25,10:47,4,9,13
47,2025-05-25T02:49:00+02:00,2025-05-25,10:49,18,13,31
47,2025-05-25T02:52:00+02:00,2025-05-25,10:52,13,15,28
47,2025-05-25T02:54:00+02:00,2025-05-25,10:54,16,21,37
50,2025-05-25T02:40:00+02:00,2025-05-25,10:40,1,3,4
50,2025-05-25T02:48:00+02:00,2025-05-25,10:48,2,3,5
50,2025-05-25T02:49:00+02:00,2025-05-25,10:49,2,2,4
50,2025-05-25T02:50:00+02:00,2025-05-25,10:50,0,3,3
50,2025-05-25T02:51:00+02:00,2025-05-25,10:51,1,7,8
50,2025-05-25T02:53:00+02:00,2025-05-25,10:53,3,3,6
50,2025-05-25T02:54:00+02:00,2025-05-25,10:54,4,5,9
54,2025-05-25T02:46:00+02:00,2025-05-25,10:46,0,1,1
54,2025-05-25T02:53:00+02:00,2025-05-25,10:53,3,0,3
61,2025-05-25T02:44:00+02:00,2025-05-25,10:44,2,13,15
61,2025-05-25T02:49:00+02:00,2025-05-25,10:49,6,6,12
61,2025-05-25T02:52:00+02:00,2025-05-25,10:52,6,9,15
61,2025-05-25T02:53:00+02:00,2025-05-25,10:53,7,7,14
61,2025-05-25T02:54:00+02:00,2025-05-25,10:54,7,2,9
66,2025-05-25T02:44:00+02:00,2025-05-25,10:44,10,11,21
66,2025-05-25T02:46:00+02:00,2025-05-25,10:46,10,13,23
66,2025-05-25T02:48:00+02:00,2025-05-25,10:48,8,9,17
66,2025-05-25T02:49:00+02:00,2025-05-25,10:49,7,4,11
66,2025-05-25T02:51:00+02:00,2025-05-25,10:51,3,18,21
69,2025-05-25T02:40:00+02:00,2025-05-25,10:40,4,0,4
69,2025-05-25T02:41:00+02:00,2025-05-25,10:41,13,4,17
69,2025-05-25T02:42:00+02:00,2025-05-25,10:42,1,5,6
69,2025-05-25T02:47:00+02:00,2025-05-25,10:47,3,0,3
69,2025-05-25T02:50:00+02:00,2025-05-25,10:50,1,7,8
69,2025-05-25T02:52:00+02:00,2025-05-25,10:52,2,4,6
69,2025-05-25T02:54:00+02:00,2025-05-25,10:54,4,2,6
70,2025-05-25T02:40:00+02:00,2025-05-25,10:40,1,0,1
70,2025-05-25T02:42:00+02:00,2025-05-25,10:42,1,1,2
70,2025-05-25T02:44:00+02:00,2025-05-25,10:44,3,2,5
70,2025-05-25T02:45:00+02:00,2025-05-25,10:45,7,1,8
70,2025-05-25T02:46:00+02:00,2025-05-25,10:46,3,2,5
75,2025-05-25T02:47:00+02:00,2025-05-25,10:47,1,0,1
75,2025-05-25T02:49:00+02:00,2025-05-25,10:49,1,2,3
75,2025-05-25T02:50:00+02:00,2025-05-25,10:50,1,0,1
75,2025-05-25T02:52:00+02:00,2025-05-25,10:52,3,2,5
75,2025-05-25T02:54:00+02:00,2025-05-25,10:54,0,3,3
77,2025-05-25T02:50:00+02:00,2025-05-25,10:50,8,21,29
78,2025-05-25T02:40:00+02:00,2025-05-25,10:40,1,4,5
78,2025-05-25T02:46:00+02:00,2025-05-25,10:46,0,1,1
78,2025-05-25T02:50:00+02:00,2025-05-25,10:50,2,1,3
78,2025-05-25T02:51:00+02:00,2025-05-25,10:51,1,0,1
78,2025-05-25T02:52:00+02:00,2025-05-25,10:52,3,3,6
84,2025-05-25T02:45:00+02:00,2025-05-25,10:45,83,51,134
84,2025-05-25T02:50:00+02:00,2025-05-25,10:50,67,45,112
87,2025-05-25T02:42:00+02:00,2025-05-25,10:42,1,0,1
87,2025-05-25T02:43:00+02:00,2025-05-25,10:43,0,2,2
87,2025-05-25T02:53:00+02:00,2025-05-25,10:53,3,1,4
87,2025-05-25T02:54:00+02:00,2025-05-25,10:54,2,1,3
108,2025-05-25T02:44:00+02:00,2025-05-25,10:44,4,0,4
108,2025-05-25T02:46:00+02:00,2025-05-25,10:46,1,3,4
108,2025-05-25T02:50:00+02:00,2025-05-25,10:50,2,0,2
108,2025-05-25T02:51:00+02:00,2025-05-25,10:51,1,1,2
134,2025-05-25T02:40:00+02:00,2025-05-25,10:40,19,45,64
134,2025-05-25T02:45:00+02:00,2025-05-25,10:45,27,29,56
134,2025-05-25T02:50:00+02:00,2025-05-25,10:50,41,23,64
135,2025-05-25T02:45:00+02:00,2025-05-25,10:45,34,20,54
140,2025-05-25T02:40:00+02:00,2025-05-25,10:40,11,1,12
140,2025-05-25T02:45:00+02:00,2025-05-25,10:45,10,12,22
162,2025-05-25T02:40:00+02:00,2025-05-25,10:40,28,45,73
165,2025-05-25T02:50:00+02:00,2025-05-25,10:50,2,1,3
166,2025-05-25T02:45:00+02:00,2025-05-25,10:45,2,4,6
166,2025-05-25T02:50:00+02:00,2025-05-25,10:50,6,5,11
167,2025-05-25T02:40:00+02:00,2025-05-25,10:40,3,5,8
167,2025-05-25T02:50:00+02:00,2025-05-25,10:50,8,2,10
179,2025-05-25T02:50:00+02:00,2025-05-25,10:50,2,7,9
1,2025-05-25T02:42:00+02:00,2025-05-25,10:42,13,13,26
1,2025-05-25T02:43:00+02:00,2025-05-25,10:43,15,7,22
1,2025-05-25T02:44:00+02:00,2025-05-25,10:44,4,7,11
1,2025-05-25T02:45:00+02:00,2025-05-25,10:45,23,4,27
1,2025-05-25T02:46:00+02:00,2025-05-25,10:46,13,25,38
1,2025-05-25T02:50:00+02:00,2025-05-25,10:50,20,11,31
1,2025-05-25T02:53:00+02:00,2025-05-25,10:53,8,8,16
2,2025-05-25T02:41:00+02:00,2025-05-25,10:41,3,4,7
2,2025-05-25T02:42:00+02:00,2025-05-25,10:42,2,6,8
2,2025-05-25T02:51:00+02:00,2025-05-25,10:51,5,13,18
9,2025-05-25T02:42:00+02:00,2025-05-25,10:42,0,1,1
9,2025-05-25T02:44:00+02:00,2025-05-25,10:44,4,5,9
9,2025-05-25T02:46:00+02:00,2025-05-25,10:46,5,2,7
9,2025-05-25T02:49:00+02:00,2025-05-25,10:49,2,1,3
9,2025-05-25T02:50:00+02:00,2025-05-25,10:50,1,0,1
9,2025-05-25T02:51:00+02:00,2025-05-25,10:51,0,2,2
10,2025-05-25T02:42:00+02:00,2025-05-25,10:42,1,1,2
10,2025-05-25T02:51:00+02:00,2025-05-25,10:51,1,0,1
10,2025-05-25T02:54:00+02:00,2025-05-25,10:54,2,6,8
11,2025-05-25T02:43:00+02:00,2025-05-25,10:43,2,0,2
11,2025-05-25T02:51:00+02:00,2025-05-25,10:51,0,3,3
12,2025-05-25T02:45:00+02:00,2025-05-25,10:45,0,1,1
12,2025-05-25T02:48:00+02:00,2025-05-25,10:48,2,2,4
12,2025-05-25T02:49:00+02:00,2025-05-25,10:49,5,2,7
12,2025-05-25T02:50:00+02:00,2025-05-25,10:50,7,1,8
12,2025-05-25T02:51:00+02:00,2025-05-25,10:51,1,10,11
12,2025-05-25T02:54:00+02:00,2025-05-25,10:54,1,3,4
17,2025-05-25T02:40:00+02:00,2025-05-25,10:40,1,1,2
17,2025-05-25T02:43:00+02:00,2025-05-25,10:43,1,1,2
17,2025-05-25T02:44:00+02:00,2025-05-25,10:44,1,4,5
17,2025-05-25T02:50:00+02:00,2025-05-25,10:50,1,0,1
17,2025-05-25T02:51:00+02:00,2025-05-25,10:51,4,1,5
18,2025-05-25T02:44:00+02:00,2025-05-25,10:44,1,2,3
18,2025-05-25T02:45:00+02:00,2025-05-25,10:45,0,9,9
18,2025-05-25T02:46:00+02:00,2025-05-25,10:46,1,1,2
18,2025-05-25T02:47:00+02:00,2025-05-25,10:47,1,4,5
19,2025-05-25T02:42:00+02:00,2025-05-25,10:42,3,5,8
19,2025-05-25T02:44:00+02:00,2025-05-25,10:44,8,2,10
19,2025-05-25T02:47:00+02:00,2025-05-25,10:47,2,0,2
19,2025-05-25T02:49:00+02:00,2025-05-25,10:49,4,0,4
19,2025-05-25T02:50:00+02:00,2025-05-25,10:50,1,4,5
20,2025-05-25T02:42:00+02:00,2025-05-25,10:42,1,0,1
20,2025-05-25T02:47:00+02:00,2025-05-25,10:47,0,3,3
20,2025-05-25T02:49:00+02:00,2025-05-25,10:49,5,0,5
20,2025-05-25T02:52:00+02:00,2025-05-25,10:52,0,2,2
20,2025-05-25T02:53:00+02:00,2025-05-25,10:53,5,2,7
23,2025-05-25T02:42:00+02:00,2025-05-25,10:42,1,5,6
23,2025-05-25T02:44:00+02:00,2025-05-25,10:44,2,8,10
23,2025-05-25T02:46:00+02:00,2025-05-25,10:46,1,3,4
23,2025-05-25T02:47:00+02:00,2025-05-25,10:47,3,5,8
23,2025-05-25T02:49:00+02:00,2025-05-25,10:49,5,2,7
23,2025-05-25T02:52:00+02:00,2025-05-25,10:52,6,2,8
23,2025-05-25T02:53:00+02:00,2025-05-25,10:53,1,1,2
23,2025-05-25T02:54:00+02:00,2025-05-25,10:54,8,3,11
24,2025-05-25T02:42:00+02:00,2025-05-25,10:42,8,1,9
24,2025-05-25T02:44:00+02:00,2025-05-25,10:44,9,6,15
24,2025-05-25T02:50:00+02:00,2025-05-25,10:50,7,3,10
25,2025-05-25T02:50:00+02:00,2025-05-25,10:50,53,77,130
27,2025-05-25T02:41:00+02:00,2025-05-25,10:41,4,3,7
27,2025-05-25T02:47:00+02:00,2025-05-25,10:47,5,0,5
27,2025-05-25T02:48:00+02:00,2025-05-25,10:48,2,7,9
27,2025-05-25T02:49:00+02:00,2025-05-25,10:49,12,0,12
27,2025-05-25T02:51:00+02:00,2025-05-25,10:51,2,5,7
30,2025-05-25T02:45:00+02:00,2025-05-25,10:45,2,2,4
30,2025-05-25T02:51:00+02:00,2025-05-25,10:51,0,7,7
30,2025-05-25T02:52:00+02:00,2025-05-25,10:52,1,4,5
30,2025-05-25T02:54:00+02:00,2025-05-25,10:54,1,3,4
35,2025-05-25T02:45:00+02:00,2025-05-25,10:45,14,14,28
35,2025-05-25T02:46:00+02:00,2025-05-25,10:46,9,20,29
35,2025-05-25T02:48:00+02:00,2025-05-25,10:48,10,16,26
35,2025-05-25T02:49:00+02:00,2025-05-25,10:49,36,10,46
35,2025-05-25T02:50:00+02:00,2025-05-25,10:50,18,16,34
46,2025-05-25T02:40:00+02:00,2025-05-25,10:40,4,1,5
48,2025-05-25T02:40:00+02:00,2025-05-25,10:40,8,3,11
48,2025-05-25T02:45:00+02:00,2025-05-25,10:45,12,6,18
48,2025-05-25T02:46:00+02:00,2025-05-25,10:46,10,6,16
48,2025-05-25T02:48:00+02:00,2025-05-25,10:48,9,5,14
48,2025-05-25T02:49:00+02:00,2025-05-25,10:49,7,5,12
49,2025-05-25T02:44:00+02:00,2025-05-25,10:44,10,10,20
49,2025-05-25T02:45:00+02:00,2025-05-25,10:45,1,4,5
49,2025-05-25T02:48:00+02:00,2025-05-25,10:48,5,6,11
49,2025-05-25T02:49:00+02:00,2025-05-25,10:49,7,5,12
49,2025-05-25T02:52:00+02:00,2025-05-25,10:52,4,3,7
51,2025-05-25T02:52:00+02:00,2025-05-25,10:52,2,2,4
52,2025-05-25T02:42:00+02:00,2025-05-25,10:42,2,1,3
52,2025-05-25T02:43:00+02:00,2025-05-25,10:43,1,8,9
52,2025-05-25T02:46:00+02:00,2025-05-25,10:46,1,4,5
52,2025-05-25T02:48:00+02:00,2025-05-25,10:48,1,6,7
52,2025-05-25T02:50:00+02:00,2025-05-25,10:50,5,0,5
52,2025-05-25T02:51:00+02:00,2025-05-25,10:51,1,2,3
53,2025-05-25T02:47:00+02:00,2025-05-25,10:47,6,5,11
53,2025-05-25T02:53:00+02:00,2025-05-25,10:53,8,4,12
56,2025-05-25T02:42:00+02:00,2025-05-25,10:42,3,1,4
56,2025-05-25T02:47:00+02:00,2025-05-25,10:47,4,4,8
56,2025-05-25T02:50:00+02:00,2025-05-25,10:50,7,5,12
56,2025-05-25T02:53:00+02:00,2025-05-25,10:53,2,5,7
58,2025-05-25T02:40:00+02:00,2025-05-25,10:40,8,4,12
58,2025-05-25T02:41:00+02:00,2025-05-25,10:41,10,2,12
58,2025-05-25T02:44:00+02:00,2025-05-25,10:44,18,2,20
58,2025-05-25T02:52:00+02:00,2025-05-25,10:52,16,6,22
58,2025-05-25T02:53:00+02:00,2025-05-25,10:53,11,2,13
62,2025-05-25T02:41:00+02:00,2025-05-25,10:41,2,4,6
62,2025-05-25T02:42:00+02:00,2025-05-25,10:42,4,1,5
62,2025-05-25T02:43:00+02:00,2025-05-25,10:43,4,0,4
62,2025-05-25T02:46:00+02:00,2025-05-25,10:46,0,2,2
62,2025-05-25T02:51:00+02:00,2025-05-25,10:51,1,4,5
63,2025-05-25T02:41:00+02:00,2025-05-25,10:41,3,1,4
63,2025-05-25T02:48:00+02:00,2025-05-25,10:48,2,4,6
67,2025-05-25T02:41:00+02:00,2025-05-25,10:41,8,10,18
67,2025-05-25T02:43:00+02:00,2025-05-25,10:43,4,4,8
67,2025-05-25T02:44:00+02:00,2025-05-25,10:44,4,12,16
67,2025-05-25T02:45:00+02:00,2025-05-25,10:45,5,2,7
67,2025-05-25T02:46:00+02:00,2025-05-25,10:46,1,2,3
67,2025-05-25T02:49:00+02:00,2025-05-25,10:49,4,2,6
68,2025-05-25T02:40:00+02:00,2025-05-25,10:40,5,3,8
68,2025-05-25T02:42:00+02:00,2025-05-25,10:42,3,3,6
68,2025-05-25T02:45:00+02:00,2025-05-25,10:45,4,6,10
68,2025-05-25T02:48:00+02:00,2025-05-25,10:48,4,8,12
68,2025-05-25T02:53:00+02:00,2025-05-25,10:53,4,7,11
72,2025-05-25T02:41:00+02:00,2025-05-25,10:41,5,8,13
72,2025-05-25T02:42:00+02:00,2025-05-25,10:42,2,3,5
72,2025-05-25T02:46:00+02:00,2025-05-25,10:46,2,2,4
72,2025-05-25T02:47:00+02:00,2025-05-25,10:47,0,2,2
72,2025-05-25T02:50:00+02:00,2025-05-25,10:50,8,0,8
72,2025-05-25T02:52:00+02:00,2025-05-25,10:52,1,8,9
72,2025-05-25T02:54:00+02:00,2025-05-25,10:54,5,5,10
76,2025-05-25T02:41:00+02:00,2025-05-25,10:41,1,0,1
76,2025-05-25T02:44:00+02:00,2025-05-25,10:44,2,3,5
76,2025-05-25T02:48:00+02:00,2025-05-25,10:48,0,3,3
79,2025-05-25T02:42:00+02:00,2025-05-25,10:42,5,5,10
85,2025-05-25T02:40:00+02:00,2025-05-25,10:40,0,2,2
85,2025-05-25T02:45:00+02:00,2025-05-25,10:45,10,5,15
85,2025-05-25T02:46:00+02:00,2025-05-25,10:46,3,0,3
85,2025-05-25T02:48:00+02:00,2025-05-25,10:48,2,3,5
85,2025-05-25T02:50:00+02:00,2025-05-25,10:50,1,4,5
85,2025-05-25T02:54:00+02:00,2025-05-25,10:54,2,0,2
86,2025-05-25T02:40:00+02:00,2025-05-25,10:40,1,2,3
86,2025-05-25T02:46:00+02:00,2025-05-25,10:46,1,0,1
86,2025-05-25T02:47:00+02:00,2025-05-25,10:47,2,3,5
86,2025-05-25T02:49:00+02:00,2025-05-25,10:49,0,1,1
86,2025-05-25T02:50:00+02:00,2025-05-25,10:50,1,0,1
109,2025-05-25T02:45:00+02:00,2025-05-25,10:45,10,3,13
117,2025-05-25T02:45:00+02:00,2025-05-25,10:45,18,18,36
117,2025-05-25T02:50:00+02:00,2025-05-25,10:50,10,13,23
123,2025-05-25T02:40:00+02:00,2025-05-25,10:40,6,0,6
130,2025-05-25T02:45:00+02:00,2025-05-25,10:45,2,3,5
136,2025-05-25T02:45:00+02:00,2025-05-25,10:45,13,14,27
137,2025-05-25T02:40:00+02:00,2025-05-25,10:40,0,2,2
139,2025-05-25T02:45:00+02:00,2025-05-25,10:45,4,1,5
139,2025-05-25T02:50:00+02:00,2025-05-25,10:50,0,11,11
141,2025-05-25T02:40:00+02:00,2025-05-25,10:40,15,10,25
142,2025-05-25T02:40:00+02:00,2025-05-25,10:40,46,34,80
164,2025-05-25T02:40:00+02:00,2025-05-25,10:40,25,2,27
3,2025-05-25T02:28:00+02:00,2025-05-25,10:28,5,8,13
3,2025-05-25T02:31:00+02:00,2025-05-25,10:31,2,4,6
3,2025-05-25T02:32:00+02:00,2025-05-25,10:32,7,7,14
3,2025-05-25T02:33:00+02:00,2025-05-25,10:33,4,4,8
3,2025-05-25T02:35:00+02:00,2025-05-25,10:35,9,7,16
3,2025-05-25T02:37:00+02:00,2025-05-25,10:37,11,5,16
4,2025-05-25T02:31:00+02:00,2025-05-25,10:31,19,15,34
4,2025-05-25T02:34:00+02:00,2025-05-25,10:34,12,8,20
4,2025-05-25T02:38:00+02:00,2025-05-25,10:38,19,4,23
5,2025-05-25T02:25:00+02:00,2025-05-25,10:25,26,43,69
5,2025-05-25T02:30:00+02:00,2025-05-25,10:30,24,64,88
6,2025-05-25T02:29:00+02:00,2025-05-25,10:29,10,3,13
6,2025-05-25T02:30:00+02:00,2025-05-25,10:30,6,6,12
6,2025-05-25T02:32:00+02:00,2025-05-25,10:32,12,3,15
6,2025-05-25T02:35:00+02:00,2025-05-25,10:35,6,11,17
6,2025-05-25T02:37:00+02:00,2025-05-25,10:37,11,8,19
8,2025-05-25T02:25:00+02:00,2025-05-25,10:25,2,7,9
8,2025-05-25T02:26:00+02:00,2025-05-25,10:26,7,2,9
8,2025-05-25T02:30:00+02:00,2025-05-25,10:30,4,9,13
8,2025-05-25T02:32:00+02:00,2025-05-25,10:32,6,20,26
8,2025-05-25T02:34:00+02:00,2025-05-25,10:34,4,5,9
28,2025-05-25T02:26:00+02:00,2025-05-25,10:26,3,1,4
28,2025-05-25T02:27:00+02:00,2025-05-25,10:27,6,6,12
28,2025-05-25T02:29:00+02:00,2025-05-25,10:29,4,1,5
28,2025-05-25T02:33:00+02:00,2025-05-25,10:33,9,5,14
28,2025-05-25T02:36:00+02:00,2025-05-25,10:36,7,4,11
28,2025-05-25T02:38:00+02:00,2025-05-25,10:38,8,7,15
28,2025-05-25T02:39:00+02:00,2025-05-25,10:39,8,6,14
29,2025-05-25T02:28:00+02:00,2025-05-25,10:28,2,0,2
29,2025-05-25T02:29:00+02:00,2025-05-25,10:29,3,5,8
29,2025-05-25T02:36:00+02:00,2025-05-25,10:36,2,8,10
31,2025-05-25T02:25:00+02:00,2025-05-25,10:25,0,2,2
31,2025-05-25T02:28:00+02:00,2025-05-25,10:28,4,2,6
31,2025-05-25T02:33:00+02:00,2025-05-25,10:33,1,0,1
31,2025-05-25T02:37:00+02:00,2025-05-25,10:37,2,1,3
36,2025-05-25T02:25:00+02:00,2025-05-25,10:25,3,0,3
36,2025-05-25T02:26:00+02:00,2025-05-25,10:26,7,2,9
36,2025-05-25T02:29:00+02:00,2025-05-25,10:29,0,1,1
36,2025-05-25T02:30:00+02:00,2025-05-25,10:30,1,0,1
37,2025-05-25T02:31:00+02:00,2025-05-25,10:31,5,3,8
37,2025-05-25T02:39:00+02:00,2025-05-25,10:39,0,2,2
39,2025-05-25T02:25:00+02:00,2025-05-25,10:25,0,2,2
39,2025-05-25T02:26:00+02:00,2025-05-25,10:26,0,1,1
39,2025-05-25T02:34:00+02:00,2025-05-25,10:34,2,0,2
40,2025-05-25T02:26:00+02:00,2025-05-25,10:26,3,2,5
40,2025-05-25T02:27:00+02:00,2025-05-25,10:27,2,0,2
40,2025-05-25T02:29:00+02:00,2025-05-25,10:29,1,2,3
40,2025-05-25T02:38:00+02:00,2025-05-25,10:38,0,1,1
41,2025-05-25T02:30:00+02:00,2025-05-25,10:30,3,0,3
41,2025-05-25T02:37:00+02:00,2025-05-25,10:37,2,0,2
44,2025-05-25T02:35:00+02:00,2025-05-25,10:35,2,3,5
45,2025-05-25T02:25:00+02:00,2025-05-25,10:25,4,10,14
45,2025-05-25T02:26:00+02:00,2025-05-25,10:26,6,1,7
45,2025-05-25T02:35:00+02:00,2025-05-25,10:35,7,9,16
45,2025-05-25T02:39:00+02:00,2025-05-25,10:39,5,5,10
47,2025-05-25T02:25:00+02:00,2025-05-25,10:25,10,2,12
47,2025-05-25T02:27:00+02:00,2025-05-25,10:27,6,10,16
47,2025-05-25T02:28:00+02:00,2025-05-25,10:28,4,4,8
47,2025-05-25T02:30:00+02:00,2025-05-25,10:30,19,12,31
47,2025-05-25T02:35:00+02:00,2025-05-25,10:35,17,11,28
47,2025-05-25T02:36:00+02:00,2025-05-25,10:36,2,7,9
47,2025-05-25T02:37:00+02:00,2025-05-25,10:37,7,8,15
50,2025-05-25T02:26:00+02:00,2025-05-25,10:26,1,0,1
50,2025-05-25T02:30:00+02:00,2025-05-25,10:30,3,1,4
50,2025-05-25T02:31:00+02:00,2025-05-25,10:31,3,2,5
50,2025-05-25T02:33:00+02:00,2025-05-25,10:33,0,2,2
50,2025-05-25T02:34:00+02:00,2025-05-25,10:34,3,1,4
50,2025-05-25T02:37:00+02:00,2025-05-25,10:37,2,2,4
50,2025-05-25T02:38:00+02:00,2025-05-25,10:38,1,2,3
50,2025-05-25T02:39:00+02:00,2025-05-25,10:39,3,2,5
54,2025-05-25T02:30:00+02:00,2025-05-25,10:30,1,0,1
54,2025-05-25T02:33:00+02:00,2025-05-25,10:33,1,2,3
54,2025-05-25T02:35:00+02:00,2025-05-25,10:35,1,2,3
59,2025-05-25T02:25:00+02:00,2025-05-25,10:25,11,10,21
59,2025-05-25T02:35:00+02:00,2025-05-25,10:35,12,10,22
61,2025-05-25T02:31:00+02:00,2025-05-25,10:31,7,3,10
61,2025-05-25T02:34:00+02:00,2025-05-25,10:34,2,1,3
61,2025-05-25T02:36:00+02:00,2025-05-25,10:36,0,3,3
61,2025-05-25T02:38:00+02:00,2025-05-25,10:38,9,3,12
66,2025-05-25T02:35:00+02:00,2025-05-25,10:35,3,10,13
69,2025-05-25T02:25:00+02:00,2025-05-25,10:25,6,1,7
69,2025-05-25T02:27:00+02:00,2025-05-25,10:27,2,1,3
69,2025-05-25T02:32:00+02:00,2025-05-25,10:32,7,5,12
69,2025-05-25T02:34:00+02:00,2025-05-25,10:34,5,0,5
69,2025-05-25T02:35:00+02:00,2025-05-25,10:35,5,0,5
69,2025-05-25T02:38:00+02:00,2025-05-25,10:38,4,1,5
70,2025-05-25T02:28:00+02:00,2025-05-25,10:28,0,7,7
70,2025-05-25T02:29:00+02:00,2025-05-25,10:29,1,1,2
70,2025-05-25T02:31:00+02:00,2025-05-25,10:31,0,1,1
70,2025-05-25T02:34:00+02:00,2025-05-25,10:34,2,1,3
70,2025-05-25T02:39:00+02:00,2025-05-25,10:39,0,2,2
75,2025-05-25T02:27:00+02:00,2025-05-25,10:27,2,1,3
75,2025-05-25T02:29:00+02:00,2025-05-25,10:29,0,3,3
75,2025-05-25T02:30:00+02:00,2025-05-25,10:30,0,1,1
75,2025-05-25T02:32:00+02:00,2025-05-25,10:32,1,1,2
75,2025-05-25T02:38:00+02:00,2025-05-25,10:38,3,0,3
78,2025-05-25T02:29:00+02:00,2025-05-25,10:29,2,1,3
78,2025-05-25T02:30:00+02:00,2025-05-25,10:30,0,2,2
78,2025-05-25T02:35:00+02:00,2025-05-25,10:35,0,2,2
78,2025-05-25T02:37:00+02:00,2025-05-25,10:37,0,3,3
84,2025-05-25T02:30:00+02:00,2025-05-25,10:30,54,50,104
87,2025-05-25T02:26:00+02:00,2025-05-25,10:26,1,1,2
87,2025-05-25T02:35:00+02:00,2025-05-25,10:35,1,2,3
87,2025-05-25T02:38:00+02:00,2025-05-25,10:38,1,2,3
87,2025-05-25T02:39:00+02:00,2025-05-25,10:39,3,0,3
108,2025-05-25T02:26:00+02:00,2025-05-25,10:26,1,0,1
108,2025-05-25T02:29:00+02:00,2025-05-25,10:29,2,4,6
3,2025-05-25T09:26:00+02:00,2025-05-25,17:26,15,23,38
108,2025-05-25T02:30:00+02:00,2025-05-25,10:30,1,1,2
3,2025-05-25T09:27:00+02:00,2025-05-25,17:27,5,17,22
108,2025-05-25T02:38:00+02:00,2025-05-25,10:38,5,3,8
3,2025-05-25T09:28:00+02:00,2025-05-25,17:28,11,19,30
132,2025-05-25T02:30:00+02:00,2025-05-25,10:30,14,3,17
3,2025-05-25T09:31:00+02:00,2025-05-25,17:31,15,17,32
132,2025-05-25T02:35:00+02:00,2025-05-25,10:35,21,10,31
3,2025-05-25T09:34:00+02:00,2025-05-25,17:34,13,34,47
133,2025-05-25T02:30:00+02:00,2025-05-25,10:30,41,36,77
3,2025-05-25T09:35:00+02:00,2025-05-25,17:35,16,23,39
133,2025-05-25T02:35:00+02:00,2025-05-25,10:35,25,25,50
3,2025-05-25T09:37:00+02:00,2025-05-25,17:37,28,20,48
134,2025-05-25T02:25:00+02:00,2025-05-25,10:25,21,30,51
4,2025-05-25T09:26:00+02:00,2025-05-25,17:26,19,19,38
135,2025-05-25T02:25:00+02:00,2025-05-25,10:25,28,29,57
4,2025-05-25T09:27:00+02:00,2025-05-25,17:27,26,24,50
140,2025-05-25T02:35:00+02:00,2025-05-25,10:35,12,4,16
4,2025-05-25T09:28:00+02:00,2025-05-25,17:28,43,47,90
162,2025-05-25T02:35:00+02:00,2025-05-25,10:35,29,35,64
4,2025-05-25T09:29:00+02:00,2025-05-25,17:29,28,31,59
165,2025-05-25T02:35:00+02:00,2025-05-25,10:35,3,8,11
4,2025-05-25T09:32:00+02:00,2025-05-25,17:32,15,29,44
166,2025-05-25T02:30:00+02:00,2025-05-25,10:30,3,13,16
4,2025-05-25T09:33:00+02:00,2025-05-25,17:33,22,37,59
166,2025-05-25T02:35:00+02:00,2025-05-25,10:35,7,6,13
4,2025-05-25T09:35:00+02:00,2025-05-25,17:35,20,15,35
167,2025-05-25T02:25:00+02:00,2025-05-25,10:25,5,5,10
4,2025-05-25T09:38:00+02:00,2025-05-25,17:38,31,30,61
167,2025-05-25T02:30:00+02:00,2025-05-25,10:30,1,7,8
4,2025-05-25T09:39:00+02:00,2025-05-25,17:39,19,23,42
179,2025-05-25T02:30:00+02:00,2025-05-25,10:30,3,0,3
6,2025-05-25T09:25:00+02:00,2025-05-25,17:25,7,10,17
1,2025-05-25T02:26:00+02:00,2025-05-25,10:26,6,9,15
6,2025-05-25T09:27:00+02:00,2025-05-25,17:27,24,14,38
1,2025-05-25T02:27:00+02:00,2025-05-25,10:27,6,7,13
6,2025-05-25T09:30:00+02:00,2025-05-25,17:30,17,11,28
1,2025-05-25T02:31:00+02:00,2025-05-25,10:31,6,19,25
6,2025-05-25T09:31:00+02:00,2025-05-25,17:31,14,24,38
1,2025-05-25T02:32:00+02:00,2025-05-25,10:32,8,9,17
6,2025-05-25T09:32:00+02:00,2025-05-25,17:32,9,6,15
1,2025-05-25T02:35:00+02:00,2025-05-25,10:35,5,12,17
6,2025-05-25T09:34:00+02:00,2025-05-25,17:34,11,4,15
1,2025-05-25T02:38:00+02:00,2025-05-25,10:38,11,13,24
6,2025-05-25T09:35:00+02:00,2025-05-25,17:35,17,17,34
1,2025-05-25T02:39:00+02:00,2025-05-25,10:39,6,15,21
6,2025-05-25T09:36:00+02:00,2025-05-25,17:36,6,9,15
2,2025-05-25T02:28:00+02:00,2025-05-25,10:28,5,3,8
8,2025-05-25T09:31:00+02:00,2025-05-25,17:31,7,1,8
2,2025-05-25T02:30:00+02:00,2025-05-25,10:30,4,4,8
8,2025-05-25T09:36:00+02:00,2025-05-25,17:36,1,2,3
2,2025-05-25T02:32:00+02:00,2025-05-25,10:32,6,4,10
8,2025-05-25T09:38:00+02:00,2025-05-25,17:38,1,1,2
2,2025-05-25T02:33:00+02:00,2025-05-25,10:33,4,2,6
8,2025-05-25T09:39:00+02:00,2025-05-25,17:39,2,1,3
2,2025-05-25T02:34:00+02:00,2025-05-25,10:34,10,7,17
28,2025-05-25T09:26:00+02:00,2025-05-25,17:26,8,10,18
2,2025-05-25T02:36:00+02:00,2025-05-25,10:36,19,3,22
28,2025-05-25T09:27:00+02:00,2025-05-25,17:27,6,11,17
2,2025-05-25T02:39:00+02:00,2025-05-25,10:39,12,11,23
28,2025-05-25T09:31:00+02:00,2025-05-25,17:31,4,15,19
9,2025-05-25T02:25:00+02:00,2025-05-25,10:25,0,2,2
28,2025-05-25T09:33:00+02:00,2025-05-25,17:33,5,2,7
9,2025-05-25T02:30:00+02:00,2025-05-25,10:30,2,1,3
28,2025-05-25T09:37:00+02:00,2025-05-25,17:37,2,5,7
9,2025-05-25T02:38:00+02:00,2025-05-25,10:38,2,0,2
28,2025-05-25T09:38:00+02:00,2025-05-25,17:38,0,7,7
9,2025-05-25T02:39:00+02:00,2025-05-25,10:39,0,1,1
29,2025-05-25T09:34:00+02:00,2025-05-25,17:34,6,8,14
11,2025-05-25T02:31:00+02:00,2025-05-25,10:31,2,0,2
29,2025-05-25T09:35:00+02:00,2025-05-25,17:35,15,11,26
11,2025-05-25T02:34:00+02:00,2025-05-25,10:34,0,1,1
29,2025-05-25T09:39:00+02:00,2025-05-25,17:39,5,2,7
11,2025-05-25T02:36:00+02:00,2025-05-25,10:36,1,0,1
31,2025-05-25T09:26:00+02:00,2025-05-25,17:26,2,5,7
11,2025-05-25T02:38:00+02:00,2025-05-25,10:38,0,3,3
31,2025-05-25T09:28:00+02:00,2025-05-25,17:28,3,1,4
12,2025-05-25T02:25:00+02:00,2025-05-25,10:25,1,2,3
31,2025-05-25T09:34:00+02:00,2025-05-25,17:34,0,2,2
12,2025-05-25T02:26:00+02:00,2025-05-25,10:26,2,0,2
31,2025-05-25T09:36:00+02:00,2025-05-25,17:36,5,5,10
12,2025-05-25T02:27:00+02:00,2025-05-25,10:27,1,3,4
31,2025-05-25T09:38:00+02:00,2025-05-25,17:38,4,0,4
12,2025-05-25T02:28:00+02:00,2025-05-25,10:28,1,2,3
36,2025-05-25T09:26:00+02:00,2025-05-25,17:26,0,1,1
12,2025-05-25T02:33:00+02:00,2025-05-25,10:33,0,2,2
36,2025-05-25T09:28:00+02:00,2025-05-25,17:28,1,0,1
12,2025-05-25T02:36:00+02:00,2025-05-25,10:36,1,2,3
36,2025-05-25T09:30:00+02:00,2025-05-25,17:30,0,1,1
12,2025-05-25T02:37:00+02:00,2025-05-25,10:37,4,5,9
36,2025-05-25T09:32:00+02:00,2025-05-25,17:32,4,1,5
17,2025-05-25T02:26:00+02:00,2025-05-25,10:26,0,2,2
36,2025-05-25T09:34:00+02:00,2025-05-25,17:34,2,0,2
17,2025-05-25T02:27:00+02:00,2025-05-25,10:27,3,0,3
36,2025-05-25T09:35:00+02:00,2025-05-25,17:35,3,1,4
17,2025-05-25T02:30:00+02:00,2025-05-25,10:30,4,1,5
36,2025-05-25T09:36:00+02:00,2025-05-25,17:36,2,0,2
17,2025-05-25T02:31:00+02:00,2025-05-25,10:31,8,0,8
36,2025-05-25T09:38:00+02:00,2025-05-25,17:38,2,1,3
17,2025-05-25T02:32:00+02:00,2025-05-25,10:32,4,3,7
39,2025-05-25T09:29:00+02:00,2025-05-25,17:29,0,1,1
17,2025-05-25T02:33:00+02:00,2025-05-25,10:33,8,6,14
39,2025-05-25T09:33:00+02:00,2025-05-25,17:33,1,0,1
18,2025-05-25T02:30:00+02:00,2025-05-25,10:30,1,0,1
40,2025-05-25T09:33:00+02:00,2025-05-25,17:33,0,1,1
18,2025-05-25T02:32:00+02:00,2025-05-25,10:32,2,2,4
40,2025-05-25T09:34:00+02:00,2025-05-25,17:34,1,4,5
19,2025-05-25T02:26:00+02:00,2025-05-25,10:26,1,1,2
40,2025-05-25T09:38:00+02:00,2025-05-25,17:38,4,0,4
19,2025-05-25T02:27:00+02:00,2025-05-25,10:27,3,2,5
41,2025-05-25T09:25:00+02:00,2025-05-25,17:25,4,1,5
19,2025-05-25T02:28:00+02:00,2025-05-25,10:28,6,1,7
41,2025-05-25T09:27:00+02:00,2025-05-25,17:27,7,9,16
19,2025-05-25T02:31:00+02:00,2025-05-25,10:31,3,3,6
41,2025-05-25T09:33:00+02:00,2025-05-25,17:33,9,1,10
19,2025-05-25T02:32:00+02:00,2025-05-25,10:32,0,2,2
41,2025-05-25T09:35:00+02:00,2025-05-25,17:35,2,6,8
19,2025-05-25T02:33:00+02:00,2025-05-25,10:33,1,5,6
41,2025-05-25T09:39:00+02:00,2025-05-25,17:39,17,8,25
19,2025-05-25T02:34:00+02:00,2025-05-25,10:34,4,1,5
45,2025-05-25T09:26:00+02:00,2025-05-25,17:26,21,32,53
19,2025-05-25T02:36:00+02:00,2025-05-25,10:36,1,6,7
45,2025-05-25T09:34:00+02:00,2025-05-25,17:34,18,16,34
19,2025-05-25T02:39:00+02:00,2025-05-25,10:39,5,1,6
45,2025-05-25T09:37:00+02:00,2025-05-25,17:37,23,12,35
20,2025-05-25T02:38:00+02:00,2025-05-25,10:38,2,0,2
45,2025-05-25T09:39:00+02:00,2025-05-25,17:39,8,21,29
20,2025-05-25T02:39:00+02:00,2025-05-25,10:39,0,1,1
47,2025-05-25T09:27:00+02:00,2025-05-25,17:27,22,12,34
23,2025-05-25T02:27:00+02:00,2025-05-25,10:27,1,0,1
47,2025-05-25T09:33:00+02:00,2025-05-25,17:33,15,12,27
23,2025-05-25T02:31:00+02:00,2025-05-25,10:31,1,3,4
47,2025-05-25T09:36:00+02:00,2025-05-25,17:36,27,13,40
23,2025-05-25T02:33:00+02:00,2025-05-25,10:33,1,1,2
47,2025-05-25T09:37:00+02:00,2025-05-25,17:37,10,16,26
23,2025-05-25T02:39:00+02:00,2025-05-25,10:39,5,0,5
50,2025-05-25T09:26:00+02:00,2025-05-25,17:26,8,0,8
24,2025-05-25T02:26:00+02:00,2025-05-25,10:26,9,0,9
50,2025-05-25T09:31:00+02:00,2025-05-25,17:31,4,5,9
24,2025-05-25T02:29:00+02:00,2025-05-25,10:29,4,6,10
50,2025-05-25T09:35:00+02:00,2025-05-25,17:35,1,4,5
24,2025-05-25T02:31:00+02:00,2025-05-25,10:31,14,15,29
50,2025-05-25T09:36:00+02:00,2025-05-25,17:36,2,1,3
24,2025-05-25T02:34:00+02:00,2025-05-25,10:34,4,5,9
50,2025-05-25T09:37:00+02:00,2025-05-25,17:37,1,1,2
25,2025-05-25T02:25:00+02:00,2025-05-25,10:25,49,71,120
50,2025-05-25T09:39:00+02:00,2025-05-25,17:39,9,4,13
25,2025-05-25T02:35:00+02:00,2025-05-25,10:35,53,72,125
54,2025-05-25T09:29:00+02:00,2025-05-25,17:29,1,3,4
27,2025-05-25T02:27:00+02:00,2025-05-25,10:27,6,1,7
54,2025-05-25T09:31:00+02:00,2025-05-25,17:31,1,2,3
27,2025-05-25T02:35:00+02:00,2025-05-25,10:35,2,7,9
54,2025-05-25T09:35:00+02:00,2025-05-25,17:35,1,2,3
27,2025-05-25T02:39:00+02:00,2025-05-25,10:39,4,9,13
54,2025-05-25T09:36:00+02:00,2025-05-25,17:36,1,3,4
30,2025-05-25T02:27:00+02:00,2025-05-25,10:27,1,1,2
54,2025-05-25T09:37:00+02:00,2025-05-25,17:37,4,3,7
30,2025-05-25T02:28:00+02:00,2025-05-25,10:28,2,3,5
54,2025-05-25T09:38:00+02:00,2025-05-25,17:38,1,2,3
30,2025-05-25T02:30:00+02:00,2025-05-25,10:30,1,1,2
54,2025-05-25T09:39:00+02:00,2025-05-25,17:39,2,4,6
30,2025-05-25T02:32:00+02:00,2025-05-25,10:32,0,1,1
59,2025-05-25T09:30:00+02:00,2025-05-25,17:30,14,31,45
30,2025-05-25T02:34:00+02:00,2025-05-25,10:34,0,3,3
59,2025-05-25T09:35:00+02:00,2025-05-25,17:35,19,29,48
30,2025-05-25T02:35:00+02:00,2025-05-25,10:35,3,2,5
61,2025-05-25T09:25:00+02:00,2025-05-25,17:25,6,12,18
30,2025-05-25T02:36:00+02:00,2025-05-25,10:36,0,3,3
61,2025-05-25T09:27:00+02:00,2025-05-25,17:27,7,9,16
35,2025-05-25T02:25:00+02:00,2025-05-25,10:25,24,12,36
61,2025-05-25T09:28:00+02:00,2025-05-25,17:28,8,9,17
35,2025-05-25T02:28:00+02:00,2025-05-25,10:28,15,7,22
66,2025-05-25T09:27:00+02:00,2025-05-25,17:27,19,24,43
35,2025-05-25T02:31:00+02:00,2025-05-25,10:31,21,7,28
66,2025-05-25T09:28:00+02:00,2025-05-25,17:28,15,40,55
35,2025-05-25T02:32:00+02:00,2025-05-25,10:32,40,9,49
66,2025-05-25T09:29:00+02:00,2025-05-25,17:29,22,12,34
35,2025-05-25T02:33:00+02:00,2025-05-25,10:33,21,13,34
66,2025-05-25T09:32:00+02:00,2025-05-25,17:32,26,28,54
48,2025-05-25T02:26:00+02:00,2025-05-25,10:26,6,11,17
66,2025-05-25T09:33:00+02:00,2025-05-25,17:33,35,37,72
48,2025-05-25T02:30:00+02:00,2025-05-25,10:30,6,0,6
66,2025-05-25T09:38:00+02:00,2025-05-25,17:38,15,17,32
48,2025-05-25T02:33:00+02:00,2025-05-25,10:33,5,4,9
70,2025-05-25T09:26:00+02:00,2025-05-25,17:26,7,3,10
48,2025-05-25T02:35:00+02:00,2025-05-25,10:35,6,14,20
70,2025-05-25T09:30:00+02:00,2025-05-25,17:30,7,2,9
49,2025-05-25T02:30:00+02:00,2025-05-25,10:30,9,2,11
70,2025-05-25T09:32:00+02:00,2025-05-25,17:32,3,0,3
49,2025-05-25T02:31:00+02:00,2025-05-25,10:31,3,5,8
70,2025-05-25T09:37:00+02:00,2025-05-25,17:37,2,1,3
49,2025-05-25T02:35:00+02:00,2025-05-25,10:35,7,3,10
71,2025-05-25T09:26:00+02:00,2025-05-25,17:26,1,0,1
49,2025-05-25T02:39:00+02:00,2025-05-25,10:39,8,11,19
75,2025-05-25T09:29:00+02:00,2025-05-25,17:29,0,2,2
51,2025-05-25T02:27:00+02:00,2025-05-25,10:27,1,0,1
75,2025-05-25T09:33:00+02:00,2025-05-25,17:33,1,0,1
51,2025-05-25T02:31:00+02:00,2025-05-25,10:31,3,0,3
78,2025-05-25T09:31:00+02:00,2025-05-25,17:31,1,0,1
51,2025-05-25T02:33:00+02:00,2025-05-25,10:33,1,5,6
84,2025-05-25T09:25:00+02:00,2025-05-25,17:25,70,121,191
51,2025-05-25T02:36:00+02:00,2025-05-25,10:36,1,4,5
84,2025-05-25T09:30:00+02:00,2025-05-25,17:30,63,95,158
51,2025-05-25T02:38:00+02:00,2025-05-25,10:38,4,0,4
87,2025-05-25T09:27:00+02:00,2025-05-25,17:27,1,1,2
52,2025-05-25T02:25:00+02:00,2025-05-25,10:25,1,3,4
87,2025-05-25T09:34:00+02:00,2025-05-25,17:34,0,6,6
52,2025-05-25T02:26:00+02:00,2025-05-25,10:26,2,1,3
87,2025-05-25T09:36:00+02:00,2025-05-25,17:36,2,1,3
52,2025-05-25T02:27:00+02:00,2025-05-25,10:27,1,5,6
87,2025-05-25T09:37:00+02:00,2025-05-25,17:37,1,0,1
52,2025-05-25T02:28:00+02:00,2025-05-25,10:28,2,1,3
87,2025-05-25T09:39:00+02:00,2025-05-25,17:39,2,2,4
52,2025-05-25T02:31:00+02:00,2025-05-25,10:31,1,5,6
107,2025-05-25T09:35:00+02:00,2025-05-25,17:35,5,18,23
52,2025-05-25T02:33:00+02:00,2025-05-25,10:33,2,6,8
108,2025-05-25T09:26:00+02:00,2025-05-25,17:26,1,0,1
52,2025-05-25T02:35:00+02:00,2025-05-25,10:35,1,0,1
108,2025-05-25T09:27:00+02:00,2025-05-25,17:27,0,1,1
52,2025-05-25T02:36:00+02:00,2025-05-25,10:36,2,2,4
108,2025-05-25T09:31:00+02:00,2025-05-25,17:31,2,2,4
52,2025-05-25T02:38:00+02:00,2025-05-25,10:38,8,0,8
108,2025-05-25T09:35:00+02:00,2025-05-25,17:35,2,5,7
53,2025-05-25T02:26:00+02:00,2025-05-25,10:26,5,2,7
108,2025-05-25T09:36:00+02:00,2025-05-25,17:36,2,4,6
53,2025-05-25T02:28:00+02:00,2025-05-25,10:28,4,1,5
108,2025-05-25T09:37:00+02:00,2025-05-25,17:37,2,3,5
53,2025-05-25T02:29:00+02:00,2025-05-25,10:29,4,4,8
108,2025-05-25T09:38:00+02:00,2025-05-25,17:38,1,4,5
53,2025-05-25T02:33:00+02:00,2025-05-25,10:33,2,4,6
118,2025-05-25T09:25:00+02:00,2025-05-25,17:25,4,0,4
53,2025-05-25T02:35:00+02:00,2025-05-25,10:35,9,3,12
131,2025-05-25T09:35:00+02:00,2025-05-25,17:35,8,3,11
53,2025-05-25T02:38:00+02:00,2025-05-25,10:38,11,3,14
132,2025-05-25T09:25:00+02:00,2025-05-25,17:25,18,15,33
56,2025-05-25T02:26:00+02:00,2025-05-25,10:26,4,4,8
132,2025-05-25T09:30:00+02:00,2025-05-25,17:30,9,6,15
56,2025-05-25T02:32:00+02:00,2025-05-25,10:32,7,3,10
133,2025-05-25T09:25:00+02:00,2025-05-25,17:25,31,31,62
56,2025-05-25T02:33:00+02:00,2025-05-25,10:33,8,7,15
133,2025-05-25T09:30:00+02:00,2025-05-25,17:30,37,55,92
56,2025-05-25T02:36:00+02:00,2025-05-25,10:36,3,5,8
134,2025-05-25T09:25:00+02:00,2025-05-25,17:25,51,35,86
58,2025-05-25T02:27:00+02:00,2025-05-25,10:27,6,2,8
134,2025-05-25T09:30:00+02:00,2025-05-25,17:30,32,32,64
58,2025-05-25T02:29:00+02:00,2025-05-25,10:29,10,1,11
134,2025-05-25T09:35:00+02:00,2025-05-25,17:35,34,36,70
58,2025-05-25T02:34:00+02:00,2025-05-25,10:34,16,0,16
135,2025-05-25T09:30:00+02:00,2025-05-25,17:30,12,27,39
58,2025-05-25T02:38:00+02:00,2025-05-25,10:38,14,4,18
140,2025-05-25T09:30:00+02:00,2025-05-25,17:30,1,0,1
58,2025-05-25T02:39:00+02:00,2025-05-25,10:39,13,6,19
162,2025-05-25T09:25:00+02:00,2025-05-25,17:25,11,5,16
62,2025-05-25T02:25:00+02:00,2025-05-25,10:25,1,3,4
165,2025-05-25T09:30:00+02:00,2025-05-25,17:30,4,3,7
62,2025-05-25T02:29:00+02:00,2025-05-25,10:29,3,1,4
167,2025-05-25T09:35:00+02:00,2025-05-25,17:35,0,2,2
62,2025-05-25T02:32:00+02:00,2025-05-25,10:32,2,0,2
179,2025-05-25T09:25:00+02:00,2025-05-25,17:25,7,4,11
62,2025-05-25T02:35:00+02:00,2025-05-25,10:35,1,0,1
1,2025-05-25T09:27:00+02:00,2025-05-25,17:27,19,11,30
62,2025-05-25T02:39:00+02:00,2025-05-25,10:39,2,0,2
1,2025-05-25T09:30:00+02:00,2025-05-25,17:30,14,13,27
63,2025-05-25T02:25:00+02:00,2025-05-25,10:25,1,6,7
1,2025-05-25T09:34:00+02:00,2025-05-25,17:34,14,8,22
63,2025-05-25T02:30:00+02:00,2025-05-25,10:30,2,6,8
1,2025-05-25T09:35:00+02:00,2025-05-25,17:35,10,15,25
63,2025-05-25T02:34:00+02:00,2025-05-25,10:34,2,0,2
1,2025-05-25T09:37:00+02:00,2025-05-25,17:37,22,21,43
63,2025-05-25T02:35:00+02:00,2025-05-25,10:35,3,3,6
1,2025-05-25T09:39:00+02:00,2025-05-25,17:39,31,14,45
63,2025-05-25T02:37:00+02:00,2025-05-25,10:37,2,6,8
2,2025-05-25T09:28:00+02:00,2025-05-25,17:28,9,3,12
67,2025-05-25T02:28:00+02:00,2025-05-25,10:28,10,11,21
2,2025-05-25T09:31:00+02:00,2025-05-25,17:31,4,9,13
67,2025-05-25T02:29:00+02:00,2025-05-25,10:29,4,5,9
2,2025-05-25T09:32:00+02:00,2025-05-25,17:32,3,4,7
67,2025-05-25T02:30:00+02:00,2025-05-25,10:30,7,4,11
2,2025-05-25T09:34:00+02:00,2025-05-25,17:34,10,2,12
67,2025-05-25T02:38:00+02:00,2025-05-25,10:38,8,4,12
2,2025-05-25T09:36:00+02:00,2025-05-25,17:36,8,2,10
68,2025-05-25T02:28:00+02:00,2025-05-25,10:28,2,3,5
2,2025-05-25T09:37:00+02:00,2025-05-25,17:37,7,3,10
68,2025-05-25T02:29:00+02:00,2025-05-25,10:29,4,4,8
2,2025-05-25T09:38:00+02:00,2025-05-25,17:38,8,0,8
68,2025-05-25T02:36:00+02:00,2025-05-25,10:36,2,12,14
2,2025-05-25T09:39:00+02:00,2025-05-25,17:39,5,3,8
68,2025-05-25T02:37:00+02:00,2025-05-25,10:37,2,2,4
10,2025-05-25T09:36:00+02:00,2025-05-25,17:36,2,1,3
68,2025-05-25T02:39:00+02:00,2025-05-25,10:39,6,1,7
11,2025-05-25T09:25:00+02:00,2025-05-25,17:25,4,7,11
72,2025-05-25T02:25:00+02:00,2025-05-25,10:25,3,5,8
11,2025-05-25T09:35:00+02:00,2025-05-25,17:35,1,2,3
72,2025-05-25T02:27:00+02:00,2025-05-25,10:27,2,0,2
12,2025-05-25T09:26:00+02:00,2025-05-25,17:26,1,3,4
72,2025-05-25T02:32:00+02:00,2025-05-25,10:32,3,5,8
12,2025-05-25T09:30:00+02:00,2025-05-25,17:30,3,2,5
72,2025-05-25T02:37:00+02:00,2025-05-25,10:37,2,2,4
12,2025-05-25T09:31:00+02:00,2025-05-25,17:31,1,5,6
72,2025-05-25T02:38:00+02:00,2025-05-25,10:38,3,2,5
12,2025-05-25T09:32:00+02:00,2025-05-25,17:32,5,2,7
76,2025-05-25T02:25:00+02:00,2025-05-25,10:25,1,2,3
12,2025-05-25T09:34:00+02:00,2025-05-25,17:34,6,2,8
76,2025-05-25T02:29:00+02:00,2025-05-25,10:29,0,1,1
12,2025-05-25T09:37:00+02:00,2025-05-25,17:37,1,2,3
76,2025-05-25T02:36:00+02:00,2025-05-25,10:36,2,0,2
12,2025-05-25T09:38:00+02:00,2025-05-25,17:38,5,3,8
76,2025-05-25T02:38:00+02:00,2025-05-25,10:38,4,2,6
17,2025-05-25T09:27:00+02:00,2025-05-25,17:27,5,2,7
79,2025-05-25T02:34:00+02:00,2025-05-25,10:34,8,2,10
17,2025-05-25T09:28:00+02:00,2025-05-25,17:28,1,1,2
85,2025-05-25T02:32:00+02:00,2025-05-25,10:32,1,0,1
17,2025-05-25T09:30:00+02:00,2025-05-25,17:30,3,3,6
85,2025-05-25T02:35:00+02:00,2025-05-25,10:35,3,2,5
17,2025-05-25T09:32:00+02:00,2025-05-25,17:32,11,1,12
85,2025-05-25T02:36:00+02:00,2025-05-25,10:36,1,5,6
17,2025-05-25T09:33:00+02:00,2025-05-25,17:33,4,0,4
85,2025-05-25T02:39:00+02:00,2025-05-25,10:39,0,1,1
17,2025-05-25T09:38:00+02:00,2025-05-25,17:38,3,0,3
86,2025-05-25T02:31:00+02:00,2025-05-25,10:31,4,0,4
18,2025-05-25T09:36:00+02:00,2025-05-25,17:36,1,2,3
86,2025-05-25T02:36:00+02:00,2025-05-25,10:36,0,2,2
19,2025-05-25T09:25:00+02:00,2025-05-25,17:25,35,8,43
109,2025-05-25T02:25:00+02:00,2025-05-25,10:25,3,5,8
19,2025-05-25T09:27:00+02:00,2025-05-25,17:27,3,1,4
109,2025-05-25T02:35:00+02:00,2025-05-25,10:35,7,7,14
19,2025-05-25T09:31:00+02:00,2025-05-25,17:31,11,4,15
123,2025-05-25T02:30:00+02:00,2025-05-25,10:30,1,0,1
19,2025-05-25T09:33:00+02:00,2025-05-25,17:33,12,4,16
123,2025-05-25T02:35:00+02:00,2025-05-25,10:35,2,0,2
19,2025-05-25T09:35:00+02:00,2025-05-25,17:35,12,6,18
130,2025-05-25T02:25:00+02:00,2025-05-25,10:25,0,4,4
19,2025-05-25T09:36:00+02:00,2025-05-25,17:36,20,1,21
136,2025-05-25T02:35:00+02:00,2025-05-25,10:35,12,9,21
19,2025-05-25T09:37:00+02:00,2025-05-25,17:37,14,4,18
139,2025-05-25T02:30:00+02:00,2025-05-25,10:30,4,4,8
19,2025-05-25T09:38:00+02:00,2025-05-25,17:38,3,6,9
161,2025-05-25T02:30:00+02:00,2025-05-25,10:30,11,16,27
20,2025-05-25T09:26:00+02:00,2025-05-25,17:26,11,11,22
164,2025-05-25T02:25:00+02:00,2025-05-25,10:25,7,4,11
20,2025-05-25T09:27:00+02:00,2025-05-25,17:27,8,6,14
164,2025-05-25T02:35:00+02:00,2025-05-25,10:35,17,5,22
20,2025-05-25T09:29:00+02:00,2025-05-25,17:29,4,6,10
20,2025-05-25T09:33:00+02:00,2025-05-25,17:33,10,8,18
20,2025-05-25T09:34:00+02:00,2025-05-25,17:34,11,4,15
20,2025-05-25T09:37:00+02:00,2025-05-25,17:37,5,6,11
23,2025-05-25T09:25:00+02:00,2025-05-25,17:25,3,0,3
23,2025-05-25T09:29:00+02:00,2025-05-25,17:29,5,0,5
23,2025-05-25T09:33:00+02:00,2025-05-25,17:33,2,9,11
23,2025-05-25T09:35:00+02:00,2025-05-25,17:35,33,2,35
23,2025-05-25T09:37:00+02:00,2025-05-25,17:37,2,2,4
23,2025-05-25T09:39:00+02:00,2025-05-25,17:39,3,0,3
24,2025-05-25T09:27:00+02:00,2025-05-25,17:27,8,17,25
24,2025-05-25T09:30:00+02:00,2025-05-25,17:30,7,13,20
24,2025-05-25T09:39:00+02:00,2025-05-25,17:39,4,9,13
25,2025-05-25T09:25:00+02:00,2025-05-25,17:25,54,44,98
25,2025-05-25T09:30:00+02:00,2025-05-25,17:30,87,22,109
27,2025-05-25T09:31:00+02:00,2025-05-25,17:31,1,1,2
27,2025-05-25T09:36:00+02:00,2025-05-25,17:36,3,0,3
27,2025-05-25T09:37:00+02:00,2025-05-25,17:37,2,2,4
30,2025-05-25T09:25:00+02:00,2025-05-25,17:25,6,1,7
30,2025-05-25T09:26:00+02:00,2025-05-25,17:26,8,5,13
30,2025-05-25T09:28:00+02:00,2025-05-25,17:28,1,4,5
30,2025-05-25T09:29:00+02:00,2025-05-25,17:29,3,9,12
30,2025-05-25T09:31:00+02:00,2025-05-25,17:31,1,10,11
30,2025-05-25T09:35:00+02:00,2025-05-25,17:35,8,3,11
30,2025-05-25T09:36:00+02:00,2025-05-25,17:36,12,12,24
30,2025-05-25T09:37:00+02:00,2025-05-25,17:37,1,12,13
30,2025-05-25T09:38:00+02:00,2025-05-25,17:38,16,18,34
35,2025-05-25T09:27:00+02:00,2025-05-25,17:27,22,19,41
35,2025-05-25T09:28:00+02:00,2025-05-25,17:28,17,20,37
35,2025-05-25T09:32:00+02:00,2025-05-25,17:32,19,32,51
35,2025-05-25T09:33:00+02:00,2025-05-25,17:33,15,18,33
35,2025-05-25T09:35:00+02:00,2025-05-25,17:35,18,10,28
35,2025-05-25T09:36:00+02:00,2025-05-25,17:36,10,6,16
35,2025-05-25T09:37:00+02:00,2025-05-25,17:37,12,4,16
35,2025-05-25T09:38:00+02:00,2025-05-25,17:38,14,19,33
46,2025-05-25T09:25:00+02:00,2025-05-25,17:25,2,7,9
48,2025-05-25T09:25:00+02:00,2025-05-25,17:25,1,6,7
48,2025-05-25T09:27:00+02:00,2025-05-25,17:27,9,7,16
48,2025-05-25T09:28:00+02:00,2025-05-25,17:28,7,1,8
48,2025-05-25T09:29:00+02:00,2025-05-25,17:29,3,4,7
48,2025-05-25T09:33:00+02:00,2025-05-25,17:33,5,6,11
48,2025-05-25T09:38:00+02:00,2025-05-25,17:38,1,0,1
49,2025-05-25T09:28:00+02:00,2025-05-25,17:28,7,4,11
49,2025-05-25T09:30:00+02:00,2025-05-25,17:30,0,1,1
49,2025-05-25T09:35:00+02:00,2025-05-25,17:35,1,6,7
49,2025-05-25T09:36:00+02:00,2025-05-25,17:36,4,2,6
51,2025-05-25T09:31:00+02:00,2025-05-25,17:31,2,3,5
51,2025-05-25T09:33:00+02:00,2025-05-25,17:33,6,2,8
51,2025-05-25T09:36:00+02:00,2025-05-25,17:36,3,0,3
52,2025-05-25T09:25:00+02:00,2025-05-25,17:25,5,1,6
52,2025-05-25T09:32:00+02:00,2025-05-25,17:32,1,4,5
52,2025-05-25T09:38:00+02:00,2025-05-25,17:38,2,7,9
53,2025-05-25T09:29:00+02:00,2025-05-25,17:29,3,5,8
53,2025-05-25T09:33:00+02:00,2025-05-25,17:33,11,2,13
53,2025-05-25T09:37:00+02:00,2025-05-25,17:37,0,6,6
56,2025-05-25T09:29:00+02:00,2025-05-25,17:29,12,14,26
56,2025-05-25T09:30:00+02:00,2025-05-25,17:30,5,15,20
56,2025-05-25T09:35:00+02:00,2025-05-25,17:35,2,12,14
56,2025-05-25T09:36:00+02:00,2025-05-25,17:36,2,5,7
58,2025-05-25T09:26:00+02:00,2025-05-25,17:26,6,2,8
58,2025-05-25T09:29:00+02:00,2025-05-25,17:29,0,15,15
58,2025-05-25T09:37:00+02:00,2025-05-25,17:37,9,5,14
62,2025-05-25T09:25:00+02:00,2025-05-25,17:25,4,3,7
62,2025-05-25T09:34:00+02:00,2025-05-25,17:34,0,3,3
63,2025-05-25T09:26:00+02:00,2025-05-25,17:26,6,4,10
67,2025-05-25T09:39:00+02:00,2025-05-25,17:39,9,4,13
68,2025-05-25T09:26:00+02:00,2025-05-25,17:26,3,5,8
68,2025-05-25T09:28:00+02:00,2025-05-25,17:28,6,6,12
68,2025-05-25T09:33:00+02:00,2025-05-25,17:33,1,4,5
68,2025-05-25T09:36:00+02:00,2025-05-25,17:36,2,1,3
68,2025-05-25T09:37:00+02:00,2025-05-25,17:37,2,3,5
68,2025-05-25T09:39:00+02:00,2025-05-25,17:39,2,2,4
72,2025-05-25T09:26:00+02:00,2025-05-25,17:26,2,2,4
72,2025-05-25T09:27:00+02:00,2025-05-25,17:27,9,17,26
72,2025-05-25T09:30:00+02:00,2025-05-25,17:30,5,13,18
72,2025-05-25T09:31:00+02:00,2025-05-25,17:31,2,17,19
72,2025-05-25T09:33:00+02:00,2025-05-25,17:33,1,7,8
72,2025-05-25T09:34:00+02:00,2025-05-25,17:34,2,11,13
72,2025-05-25T09:36:00+02:00,2025-05-25,17:36,5,2,7
72,2025-05-25T09:39:00+02:00,2025-05-25,17:39,6,5,11
76,2025-05-25T09:26:00+02:00,2025-05-25,17:26,0,1,1
76,2025-05-25T09:28:00+02:00,2025-05-25,17:28,0,2,2
76,2025-05-25T09:30:00+02:00,2025-05-25,17:30,3,1,4
76,2025-05-25T09:32:00+02:00,2025-05-25,17:32,1,0,1
76,2025-05-25T09:37:00+02:00,2025-05-25,17:37,0,2,2
79,2025-05-25T09:26:00+02:00,2025-05-25,17:26,15,4,19
79,2025-05-25T09:27:00+02:00,2025-05-25,17:27,12,16,28
79,2025-05-25T09:28:00+02:00,2025-05-25,17:28,16,6,22
79,2025-05-25T09:33:00+02:00,2025-05-25,17:33,7,7,14
79,2025-05-25T09:35:00+02:00,2025-05-25,17:35,5,3,8
79,2025-05-25T09:37:00+02:00,2025-05-25,17:37,14,3,17
85,2025-05-25T09:26:00+02:00,2025-05-25,17:26,0,2,2
85,2025-05-25T09:28:00+02:00,2025-05-25,17:28,0,2,2
85,2025-05-25T09:29:00+02:00,2025-05-25,17:29,2,2,4
85,2025-05-25T09:36:00+02:00,2025-05-25,17:36,1,1,2
85,2025-05-25T09:37:00+02:00,2025-05-25,17:37,3,0,3
85,2025-05-25T09:38:00+02:00,2025-05-25,17:38,0,1,1
86,2025-05-25T09:26:00+02:00,2025-05-25,17:26,3,4,7
86,2025-05-25T09:27:00+02:00,2025-05-25,17:27,2,0,2
86,2025-05-25T09:30:00+02:00,2025-05-25,17:30,0,1,1
86,2025-05-25T09:35:00+02:00,2025-05-25,17:35,0,2,2
109,2025-05-25T09:35:00+02:00,2025-05-25,17:35,2,9,11
117,2025-05-25T09:30:00+02:00,2025-05-25,17:30,12,23,35
130,2025-05-25T09:25:00+02:00,2025-05-25,17:25,1,4,5
130,2025-05-25T09:30:00+02:00,2025-05-25,17:30,6,4,10
136,2025-05-25T09:35:00+02:00,2025-05-25,17:35,31,14,45
139,2025-05-25T09:25:00+02:00,2025-05-25,17:25,1,3,4
161,2025-05-25T09:25:00+02:00,2025-05-25,17:25,36,12,48
161,2025-05-25T09:30:00+02:00,2025-05-25,17:30,57,8,65
161,2025-05-25T09:35:00+02:00,2025-05-25,17:35,27,8,35
164,2025-05-25T09:25:00+02:00,2025-05-25,17:25,10,16,26
181,2025-05-25T09:41:00+02:00,2025-05-25,17:41,27,17,44
181,2025-05-25T09:42:00+02:00,2025-05-25,17:42,9,9,18
181,2025-05-25T09:43:00+02:00,2025-05-25,17:43,10,8,18
181,2025-05-25T09:46:00+02:00,2025-05-25,17:46,20,7,27
180,2025-05-25T09:44:00+02:00,2025-05-25,17:44,0,1,1
180,2025-05-25T09:45:00+02:00,2025-05-25,17:45,0,1,1
3,2025-05-25T09:40:00+02:00,2025-05-25,17:40,23,27,50
3,2025-05-25T09:42:00+02:00,2025-05-25,17:42,18,9,27
3,2025-05-25T09:44:00+02:00,2025-05-25,17:44,23,5,28
3,2025-05-25T09:46:00+02:00,2025-05-25,17:46,31,24,55
3,2025-05-25T09:47:00+02:00,2025-05-25,17:47,8,20,28
3,2025-05-25T09:53:00+02:00,2025-05-25,17:53,20,13,33
4,2025-05-25T09:40:00+02:00,2025-05-25,17:40,22,39,61
4,2025-05-25T09:41:00+02:00,2025-05-25,17:41,32,25,57
4,2025-05-25T09:47:00+02:00,2025-05-25,17:47,18,26,44
4,2025-05-25T09:48:00+02:00,2025-05-25,17:48,31,21,52
4,2025-05-25T09:50:00+02:00,2025-05-25,17:50,27,10,37
4,2025-05-25T09:52:00+02:00,2025-05-25,17:52,15,23,38
5,2025-05-25T09:50:00+02:00,2025-05-25,17:50,50,91,141
6,2025-05-25T09:41:00+02:00,2025-05-25,17:41,10,11,21
6,2025-05-25T09:42:00+02:00,2025-05-25,17:42,17,25,42
6,2025-05-25T09:43:00+02:00,2025-05-25,17:43,14,8,22
8,2025-05-25T09:48:00+02:00,2025-05-25,17:48,1,0,1
8,2025-05-25T09:49:00+02:00,2025-05-25,17:49,1,0,1
8,2025-05-25T09:54:00+02:00,2025-05-25,17:54,1,1,2
28,2025-05-25T09:42:00+02:00,2025-05-25,17:42,8,4,12
28,2025-05-25T09:43:00+02:00,2025-05-25,17:43,4,10,14
28,2025-05-25T09:49:00+02:00,2025-05-25,17:49,5,5,10
28,2025-05-25T09:50:00+02:00,2025-05-25,17:50,2,18,20
29,2025-05-25T09:40:00+02:00,2025-05-25,17:40,10,3,13
29,2025-05-25T09:41:00+02:00,2025-05-25,17:41,14,7,21
29,2025-05-25T09:43:00+02:00,2025-05-25,17:43,10,8,18
29,2025-05-25T09:44:00+02:00,2025-05-25,17:44,15,4,19
29,2025-05-25T09:45:00+02:00,2025-05-25,17:45,10,2,12
29,2025-05-25T09:48:00+02:00,2025-05-25,17:48,13,9,22
29,2025-05-25T09:51:00+02:00,2025-05-25,17:51,7,9,16
29,2025-05-25T09:52:00+02:00,2025-05-25,17:52,17,5,22
31,2025-05-25T09:43:00+02:00,2025-05-25,17:43,1,4,5
31,2025-05-25T09:44:00+02:00,2025-05-25,17:44,1,2,3
31,2025-05-25T09:46:00+02:00,2025-05-25,17:46,3,3,6
31,2025-05-25T09:48:00+02:00,2025-05-25,17:48,2,3,5
31,2025-05-25T09:49:00+02:00,2025-05-25,17:49,6,8,14
31,2025-05-25T09:50:00+02:00,2025-05-25,17:50,2,6,8
31,2025-05-25T09:52:00+02:00,2025-05-25,17:52,2,4,6
36,2025-05-25T09:47:00+02:00,2025-05-25,17:47,2,1,3
36,2025-05-25T09:48:00+02:00,2025-05-25,17:48,0,2,2
36,2025-05-25T09:50:00+02:00,2025-05-25,17:50,2,1,3
36,2025-05-25T09:54:00+02:00,2025-05-25,17:54,0,4,4
39,2025-05-25T09:50:00+02:00,2025-05-25,17:50,0,1,1
39,2025-05-25T09:53:00+02:00,2025-05-25,17:53,0,1,1
39,2025-05-25T09:54:00+02:00,2025-05-25,17:54,1,0,1
40,2025-05-25T09:41:00+02:00,2025-05-25,17:41,2,3,5
40,2025-05-25T09:42:00+02:00,2025-05-25,17:42,2,0,2
40,2025-05-25T09:48:00+02:00,2025-05-25,17:48,4,0,4
40,2025-05-25T09:49:00+02:00,2025-05-25,17:49,1,0,1
40,2025-05-25T09:51:00+02:00,2025-05-25,17:51,1,3,4
40,2025-05-25T09:52:00+02:00,2025-05-25,17:52,0,2,2
41,2025-05-25T09:44:00+02:00,2025-05-25,17:44,3,0,3
41,2025-05-25T09:46:00+02:00,2025-05-25,17:46,7,6,13
41,2025-05-25T09:50:00+02:00,2025-05-25,17:50,6,12,18
41,2025-05-25T09:52:00+02:00,2025-05-25,17:52,2,2,4
41,2025-05-25T09:53:00+02:00,2025-05-25,17:53,17,4,21
43,2025-05-25T09:45:00+02:00,2025-05-25,17:45,2,1,3
44,2025-05-25T09:40:00+02:00,2025-05-25,17:40,5,1,6
45,2025-05-25T09:45:00+02:00,2025-05-25,17:45,11,17,28
45,2025-05-25T09:48:00+02:00,2025-05-25,17:48,11,13,24
47,2025-05-25T09:40:00+02:00,2025-05-25,17:40,15,18,33
47,2025-05-25T09:41:00+02:00,2025-05-25,17:41,5,19,24
47,2025-05-25T09:47:00+02:00,2025-05-25,17:47,24,16,40
47,2025-05-25T09:52:00+02:00,2025-05-25,17:52,18,9,27
47,2025-05-25T09:53:00+02:00,2025-05-25,17:53,24,26,50
47,2025-05-25T09:54:00+02:00,2025-05-25,17:54,23,7,30
50,2025-05-25T09:53:00+02:00,2025-05-25,17:53,4,4,8
50,2025-05-25T09:54:00+02:00,2025-05-25,17:54,1,4,5
54,2025-05-25T09:40:00+02:00,2025-05-25,17:40,3,0,3
54,2025-05-25T09:43:00+02:00,2025-05-25,17:43,2,2,4
54,2025-05-25T09:46:00+02:00,2025-05-25,17:46,3,6,9
54,2025-05-25T09:49:00+02:00,2025-05-25,17:49,5,1,6
54,2025-05-25T09:51:00+02:00,2025-05-25,17:51,2,1,3
59,2025-05-25T09:40:00+02:00,2025-05-25,17:40,23,28,51
59,2025-05-25T09:45:00+02:00,2025-05-25,17:45,13,24,37
59,2025-05-25T09:50:00+02:00,2025-05-25,17:50,26,29,55
61,2025-05-25T09:41:00+02:00,2025-05-25,17:41,12,3,15
61,2025-05-25T09:42:00+02:00,2025-05-25,17:42,6,10,16
61,2025-05-25T09:43:00+02:00,2025-05-25,17:43,2,3,5
61,2025-05-25T09:48:00+02:00,2025-05-25,17:48,4,4,8
61,2025-05-25T09:50:00+02:00,2025-05-25,17:50,3,8,11
61,2025-05-25T09:53:00+02:00,2025-05-25,17:53,7,6,13
66,2025-05-25T09:44:00+02:00,2025-05-25,17:44,13,13,26
66,2025-05-25T09:47:00+02:00,2025-05-25,17:47,14,18,32
66,2025-05-25T09:51:00+02:00,2025-05-25,17:51,16,37,53
66,2025-05-25T09:52:00+02:00,2025-05-25,17:52,22,10,32
69,2025-05-25T09:42:00+02:00,2025-05-25,17:42,1,3,4
69,2025-05-25T09:44:00+02:00,2025-05-25,17:44,1,1,2
69,2025-05-25T09:47:00+02:00,2025-05-25,17:47,1,1,2
69,2025-05-25T09:48:00+02:00,2025-05-25,17:48,2,2,4
69,2025-05-25T09:52:00+02:00,2025-05-25,17:52,1,0,1
70,2025-05-25T09:42:00+02:00,2025-05-25,17:42,6,1,7
70,2025-05-25T09:44:00+02:00,2025-05-25,17:44,0,7,7
70,2025-05-25T09:49:00+02:00,2025-05-25,17:49,3,0,3
75,2025-05-25T09:40:00+02:00,2025-05-25,17:40,3,0,3
75,2025-05-25T09:51:00+02:00,2025-05-25,17:51,0,2,2
77,2025-05-25T09:40:00+02:00,2025-05-25,17:40,8,16,24
77,2025-05-25T09:50:00+02:00,2025-05-25,17:50,18,10,28
78,2025-05-25T09:51:00+02:00,2025-05-25,17:51,1,0,1
84,2025-05-25T09:40:00+02:00,2025-05-25,17:40,77,102,179
87,2025-05-25T09:40:00+02:00,2025-05-25,17:40,0,3,3
87,2025-05-25T09:41:00+02:00,2025-05-25,17:41,4,2,6
87,2025-05-25T09:43:00+02:00,2025-05-25,17:43,2,2,4
87,2025-05-25T09:44:00+02:00,2025-05-25,17:44,3,1,4
87,2025-05-25T09:50:00+02:00,2025-05-25,17:50,1,0,1
87,2025-05-25T09:53:00+02:00,2025-05-25,17:53,1,0,1
108,2025-05-25T09:41:00+02:00,2025-05-25,17:41,5,5,10
108,2025-05-25T09:42:00+02:00,2025-05-25,17:42,4,0,4
108,2025-05-25T09:43:00+02:00,2025-05-25,17:43,2,7,9
108,2025-05-25T09:46:00+02:00,2025-05-25,17:46,6,2,8
108,2025-05-25T09:49:00+02:00,2025-05-25,17:49,2,6,8
108,2025-05-25T09:50:00+02:00,2025-05-25,17:50,2,0,2
108,2025-05-25T09:52:00+02:00,2025-05-25,17:52,3,0,3
108,2025-05-25T09:54:00+02:00,2025-05-25,17:54,1,8,9
133,2025-05-25T09:40:00+02:00,2025-05-25,17:40,35,49,84
135,2025-05-25T09:40:00+02:00,2025-05-25,17:40,33,23,56
162,2025-05-25T09:40:00+02:00,2025-05-25,17:40,15,22,37
166,2025-05-25T09:45:00+02:00,2025-05-25,17:45,6,1,7
166,2025-05-25T09:50:00+02:00,2025-05-25,17:50,0,4,4
1,2025-05-25T09:41:00+02:00,2025-05-25,17:41,9,13,22
1,2025-05-25T09:43:00+02:00,2025-05-25,17:43,15,9,24
1,2025-05-25T09:45:00+02:00,2025-05-25,17:45,17,14,31
1,2025-05-25T09:46:00+02:00,2025-05-25,17:46,11,11,22
1,2025-05-25T09:50:00+02:00,2025-05-25,17:50,18,13,31
1,2025-05-25T09:53:00+02:00,2025-05-25,17:53,15,15,30
2,2025-05-25T09:41:00+02:00,2025-05-25,17:41,7,2,9
2,2025-05-25T09:42:00+02:00,2025-05-25,17:42,5,3,8
2,2025-05-25T09:47:00+02:00,2025-05-25,17:47,2,10,12
2,2025-05-25T09:49:00+02:00,2025-05-25,17:49,6,6,12
2,2025-05-25T09:54:00+02:00,2025-05-25,17:54,5,4,9
9,2025-05-25T09:40:00+02:00,2025-05-25,17:40,8,0,8
9,2025-05-25T09:42:00+02:00,2025-05-25,17:42,0,2,2
9,2025-05-25T09:50:00+02:00,2025-05-25,17:50,1,1,2
10,2025-05-25T09:43:00+02:00,2025-05-25,17:43,4,0,4
10,2025-05-25T09:45:00+02:00,2025-05-25,17:45,2,0,2
10,2025-05-25T09:51:00+02:00,2025-05-25,17:51,0,1,1
12,2025-05-25T09:42:00+02:00,2025-05-25,17:42,5,1,6
12,2025-05-25T09:53:00+02:00,2025-05-25,17:53,9,0,9
17,2025-05-25T09:46:00+02:00,2025-05-25,17:46,0,1,1
17,2025-05-25T09:48:00+02:00,2025-05-25,17:48,4,1,5
17,2025-05-25T09:49:00+02:00,2025-05-25,17:49,1,1,2
17,2025-05-25T09:53:00+02:00,2025-05-25,17:53,4,2,6
18,2025-05-25T09:41:00+02:00,2025-05-25,17:41,0,1,1
18,2025-05-25T09:48:00+02:00,2025-05-25,17:48,1,0,1
19,2025-05-25T09:41:00+02:00,2025-05-25,17:41,14,15,29
19,2025-05-25T09:42:00+02:00,2025-05-25,17:42,7,6,13
19,2025-05-25T09:44:00+02:00,2025-05-25,17:44,5,13,18
19,2025-05-25T09:49:00+02:00,2025-05-25,17:49,2,16,18
19,2025-05-25T09:50:00+02:00,2025-05-25,17:50,9,7,16
19,2025-05-25T09:52:00+02:00,2025-05-25,17:52,23,15,38
19,2025-05-25T09:53:00+02:00,2025-05-25,17:53,8,11,19
19,2025-05-25T09:54:00+02:00,2025-05-25,17:54,10,5,15
20,2025-05-25T09:40:00+02:00,2025-05-25,17:40,6,20,26
20,2025-05-25T09:42:00+02:00,2025-05-25,17:42,11,20,31
20,2025-05-25T09:43:00+02:00,2025-05-25,17:43,3,39,42
20,2025-05-25T09:44:00+02:00,2025-05-25,17:44,4,14,18
20,2025-05-25T09:45:00+02:00,2025-05-25,17:45,8,17,25
20,2025-05-25T09:50:00+02:00,2025-05-25,17:50,2,7,9
20,2025-05-25T09:51:00+02:00,2025-05-25,17:51,12,7,19
20,2025-05-25T09:54:00+02:00,2025-05-25,17:54,8,9,17
23,2025-05-25T09:43:00+02:00,2025-05-25,17:43,3,0,3
23,2025-05-25T09:47:00+02:00,2025-05-25,17:47,2,4,6
23,2025-05-25T09:48:00+02:00,2025-05-25,17:48,0,1,1
23,2025-05-25T09:50:00+02:00,2025-05-25,17:50,2,4,6
23,2025-05-25T09:53:00+02:00,2025-05-25,17:53,5,6,11
24,2025-05-25T09:40:00+02:00,2025-05-25,17:40,18,3,21
24,2025-05-25T09:41:00+02:00,2025-05-25,17:41,4,10,14
24,2025-05-25T09:44:00+02:00,2025-05-25,17:44,4,1,5
24,2025-05-25T09:47:00+02:00,2025-05-25,17:47,3,24,27
25,2025-05-25T09:40:00+02:00,2025-05-25,17:40,87,19,106
27,2025-05-25T09:44:00+02:00,2025-05-25,17:44,2,0,2
27,2025-05-25T09:51:00+02:00,2025-05-25,17:51,1,1,2
27,2025-05-25T09:52:00+02:00,2025-05-25,17:52,1,1,2
27,2025-05-25T09:53:00+02:00,2025-05-25,17:53,1,2,3
30,2025-05-25T09:41:00+02:00,2025-05-25,17:41,9,13,22
30,2025-05-25T09:42:00+02:00,2025-05-25,17:42,0,11,11
30,2025-05-25T09:46:00+02:00,2025-05-25,17:46,4,5,9
30,2025-05-25T09:51:00+02:00,2025-05-25,17:51,7,14,21
30,2025-05-25T09:52:00+02:00,2025-05-25,17:52,1,8,9
35,2025-05-25T09:45:00+02:00,2025-05-25,17:45,15,17,32
35,2025-05-25T09:48:00+02:00,2025-05-25,17:48,10,13,23
35,2025-05-25T09:52:00+02:00,2025-05-25,17:52,12,15,27
35,2025-05-25T09:54:00+02:00,2025-05-25,17:54,11,22,33
46,2025-05-25T09:40:00+02:00,2025-05-25,17:40,0,1,1
48,2025-05-25T09:43:00+02:00,2025-05-25,17:43,2,3,5
48,2025-05-25T09:46:00+02:00,2025-05-25,17:46,4,1,5
48,2025-05-25T09:49:00+02:00,2025-05-25,17:49,2,0,2
48,2025-05-25T09:50:00+02:00,2025-05-25,17:50,1,0,1
49,2025-05-25T09:44:00+02:00,2025-05-25,17:44,2,3,5
49,2025-05-25T09:45:00+02:00,2025-05-25,17:45,3,1,4
49,2025-05-25T09:49:00+02:00,2025-05-25,17:49,2,0,2
49,2025-05-25T09:50:00+02:00,2025-05-25,17:50,0,4,4
49,2025-05-25T09:53:00+02:00,2025-05-25,17:53,1,2,3
51,2025-05-25T09:41:00+02:00,2025-05-25,17:41,0,2,2
51,2025-05-25T09:46:00+02:00,2025-05-25,17:46,0,1,1
52,2025-05-25T09:42:00+02:00,2025-05-25,17:42,3,8,11
52,2025-05-25T09:43:00+02:00,2025-05-25,17:43,6,6,12
52,2025-05-25T09:47:00+02:00,2025-05-25,17:47,13,1,14
53,2025-05-25T09:41:00+02:00,2025-05-25,17:41,6,3,9
53,2025-05-25T09:42:00+02:00,2025-05-25,17:42,7,3,10
53,2025-05-25T09:45:00+02:00,2025-05-25,17:45,5,4,9
53,2025-05-25T09:47:00+02:00,2025-05-25,17:47,10,7,17
53,2025-05-25T09:49:00+02:00,2025-05-25,17:49,8,3,11
53,2025-05-25T09:53:00+02:00,2025-05-25,17:53,4,1,5
56,2025-05-25T09:40:00+02:00,2025-05-25,17:40,10,11,21
56,2025-05-25T09:41:00+02:00,2025-05-25,17:41,7,20,27
56,2025-05-25T09:46:00+02:00,2025-05-25,17:46,9,10,19
56,2025-05-25T09:53:00+02:00,2025-05-25,17:53,18,6,24
56,2025-05-25T09:54:00+02:00,2025-05-25,17:54,8,8,16
58,2025-05-25T09:41:00+02:00,2025-05-25,17:41,1,0,1
58,2025-05-25T09:44:00+02:00,2025-05-25,17:44,6,3,9
58,2025-05-25T09:46:00+02:00,2025-05-25,17:46,5,3,8
58,2025-05-25T09:47:00+02:00,2025-05-25,17:47,16,9,25
58,2025-05-25T09:48:00+02:00,2025-05-25,17:48,6,9,15
58,2025-05-25T09:49:00+02:00,2025-05-25,17:49,7,10,17
58,2025-05-25T09:50:00+02:00,2025-05-25,17:50,6,0,6
58,2025-05-25T09:54:00+02:00,2025-05-25,17:54,2,5,7
62,2025-05-25T09:42:00+02:00,2025-05-25,17:42,4,1,5
62,2025-05-25T09:49:00+02:00,2025-05-25,17:49,2,4,6
62,2025-05-25T09:50:00+02:00,2025-05-25,17:50,4,1,5
67,2025-05-25T09:41:00+02:00,2025-05-25,17:41,5,8,13
67,2025-05-25T09:43:00+02:00,2025-05-25,17:43,9,3,12
67,2025-05-25T09:44:00+02:00,2025-05-25,17:44,0,6,6
67,2025-05-25T09:45:00+02:00,2025-05-25,17:45,4,10,14
67,2025-05-25T09:46:00+02:00,2025-05-25,17:46,4,4,8
67,2025-05-25T09:51:00+02:00,2025-05-25,17:51,6,6,12
67,2025-05-25T09:52:00+02:00,2025-05-25,17:52,4,2,6
67,2025-05-25T09:54:00+02:00,2025-05-25,17:54,4,8,12
68,2025-05-25T09:42:00+02:00,2025-05-25,17:42,1,5,6
68,2025-05-25T09:43:00+02:00,2025-05-25,17:43,8,1,9
68,2025-05-25T09:45:00+02:00,2025-05-25,17:45,2,2,4
68,2025-05-25T09:47:00+02:00,2025-05-25,17:47,2,2,4
68,2025-05-25T09:51:00+02:00,2025-05-25,17:51,6,4,10
68,2025-05-25T09:52:00+02:00,2025-05-25,17:52,1,3,4
72,2025-05-25T09:40:00+02:00,2025-05-25,17:40,1,9,10
72,2025-05-25T09:41:00+02:00,2025-05-25,17:41,0,5,5
72,2025-05-25T09:42:00+02:00,2025-05-25,17:42,4,3,7
72,2025-05-25T09:47:00+02:00,2025-05-25,17:47,7,2,9
72,2025-05-25T09:48:00+02:00,2025-05-25,17:48,1,2,3
72,2025-05-25T09:51:00+02:00,2025-05-25,17:51,2,12,14
72,2025-05-25T09:54:00+02:00,2025-05-25,17:54,6,11,17
76,2025-05-25T09:40:00+02:00,2025-05-25,17:40,1,1,2
76,2025-05-25T09:42:00+02:00,2025-05-25,17:42,0,1,1
76,2025-05-25T09:43:00+02:00,2025-05-25,17:43,0,1,1
76,2025-05-25T09:45:00+02:00,2025-05-25,17:45,0,1,1
76,2025-05-25T09:50:00+02:00,2025-05-25,17:50,0,2,2
79,2025-05-25T09:45:00+02:00,2025-05-25,17:45,6,4,10
79,2025-05-25T09:48:00+02:00,2025-05-25,17:48,13,2,15
79,2025-05-25T09:52:00+02:00,2025-05-25,17:52,14,10,24
79,2025-05-25T09:53:00+02:00,2025-05-25,17:53,1,4,5
86,2025-05-25T09:40:00+02:00,2025-05-25,17:40,2,1,3
86,2025-05-25T09:42:00+02:00,2025-05-25,17:42,0,1,1
86,2025-05-25T09:47:00+02:00,2025-05-25,17:47,0,2,2
86,2025-05-25T09:54:00+02:00,2025-05-25,17:54,0,1,1
109,2025-05-25T09:50:00+02:00,2025-05-25,17:50,4,11,15
117,2025-05-25T09:40:00+02:00,2025-05-25,17:40,37,11,48
117,2025-05-25T09:45:00+02:00,2025-05-25,17:45,25,40,65
123,2025-05-25T09:40:00+02:00,2025-05-25,17:40,1,0,1
130,2025-05-25T09:40:00+02:00,2025-05-25,17:40,1,3,4
130,2025-05-25T09:45:00+02:00,2025-05-25,17:45,0,1,1
136,2025-05-25T09:45:00+02:00,2025-05-25,17:45,11,14,25
136,2025-05-25T09:50:00+02:00,2025-05-25,17:50,13,12,25
141,2025-05-25T09:40:00+02:00,2025-05-25,17:40,9,4,13
161,2025-05-25T09:50:00+02:00,2025-05-25,17:50,1,0,1
164,2025-05-25T09:40:00+02:00,2025-05-25,17:40,11,10,21
164,2025-05-25T09:50:00+02:00,2025-05-25,17:50,5,11,16
181,2025-05-25T09:55:00+02:00,2025-05-25,17:55,17,10,27
181,2025-05-25T09:57:00+02:00,2025-05-25,17:57,3,19,22
181,2025-05-25T09:58:00+02:00,2025-05-25,17:58,13,29,42
181,2025-05-25T10:00:00+02:00,2025-05-25,18:00,17,18,35
181,2025-05-25T10:02:00+02:00,2025-05-25,18:02,3,21,24
181,2025-05-25T10:03:00+02:00,2025-05-25,18:03,9,16,25
181,2025-05-25T10:07:00+02:00,2025-05-25,18:07,7,24,31
181,2025-05-25T10:08:00+02:00,2025-05-25,18:08,15,15,30
181,2025-05-25T10:09:00+02:00,2025-05-25,18:09,11,24,35
182,2025-05-25T10:00:00+02:00,2025-05-25,18:00,30,17,47
182,2025-05-25T10:05:00+02:00,2025-05-25,18:05,24,22,46
181,2025-05-25T02:29:00+02:00,2025-05-25,10:29,2,14,16
181,2025-05-25T02:30:00+02:00,2025-05-25,10:30,8,7,15
181,2025-05-25T02:33:00+02:00,2025-05-25,10:33,7,13,20
181,2025-05-25T02:34:00+02:00,2025-05-25,10:34,12,11,23
181,2025-05-25T02:37:00+02:00,2025-05-25,10:37,7,7,14
181,2025-05-25T02:39:00+02:00,2025-05-25,10:39,11,6,17
182,2025-05-25T02:30:00+02:00,2025-05-25,10:30,12,8,20
180,2025-05-25T02:29:00+02:00,2025-05-25,10:29,1,0,1
180,2025-05-25T02:33:00+02:00,2025-05-25,10:33,1,0,1
180,2025-05-25T02:37:00+02:00,2025-05-25,10:37,1,0,1
181,2025-05-25T02:41:00+02:00,2025-05-25,10:41,1,9,10
181,2025-05-25T02:42:00+02:00,2025-05-25,10:42,8,16,24
181,2025-05-25T02:49:00+02:00,2025-05-25,10:49,7,6,13
182,2025-05-25T02:40:00+02:00,2025-05-25,10:40,21,9,30
182,2025-05-25T02:45:00+02:00,2025-05-25,10:45,8,5,13
180,2025-05-25T02:45:00+02:00,2025-05-25,10:45,0,2,2
180,2025-05-25T02:52:00+02:00,2025-05-25,10:52,2,0,2
181,2025-05-25T02:55:00+02:00,2025-05-25,10:55,9,18,27
181,2025-05-25T02:56:00+02:00,2025-05-25,10:56,4,10,14
181,2025-05-25T02:58:00+02:00,2025-05-25,10:58,6,13,19
181,2025-05-25T03:01:00+02:00,2025-05-25,11:01,10,11,21
181,2025-05-25T03:04:00+02:00,2025-05-25,11:04,3,6,9
181,2025-05-25T03:06:00+02:00,2025-05-25,11:06,12,7,19
182,2025-05-25T03:00:00+02:00,2025-05-25,11:00,12,7,19
180,2025-05-25T02:55:00+02:00,2025-05-25,10:55,0,1,1
180,2025-05-25T02:59:00+02:00,2025-05-25,10:59,5,0,5
180,2025-05-25T03:05:00+02:00,2025-05-25,11:05,0,1,1
3,2025-05-25T02:55:00+02:00,2025-05-25,10:55,10,4,14
3,2025-05-25T02:56:00+02:00,2025-05-25,10:56,2,7,9
3,2025-05-25T03:00:00+02:00,2025-05-25,11:00,11,4,15
3,2025-05-25T03:05:00+02:00,2025-05-25,11:05,3,12,15
4,2025-05-25T02:55:00+02:00,2025-05-25,10:55,10,16,26
4,2025-05-25T02:56:00+02:00,2025-05-25,10:56,21,8,29
4,2025-05-25T03:01:00+02:00,2025-05-25,11:01,11,19,30
4,2025-05-25T03:02:00+02:00,2025-05-25,11:02,16,14,30
4,2025-05-25T03:03:00+02:00,2025-05-25,11:03,26,15,41
4,2025-05-25T03:04:00+02:00,2025-05-25,11:04,9,12,21
4,2025-05-25T03:05:00+02:00,2025-05-25,11:05,16,8,24
4,2025-05-25T03:06:00+02:00,2025-05-25,11:06,14,9,23
4,2025-05-25T03:07:00+02:00,2025-05-25,11:07,18,4,22
6,2025-05-25T02:56:00+02:00,2025-05-25,10:56,7,8,15
6,2025-05-25T03:05:00+02:00,2025-05-25,11:05,10,12,22
6,2025-05-25T03:07:00+02:00,2025-05-25,11:07,6,13,19
8,2025-05-25T02:56:00+02:00,2025-05-25,10:56,2,8,10
8,2025-05-25T02:57:00+02:00,2025-05-25,10:57,0,13,13
8,2025-05-25T03:01:00+02:00,2025-05-25,11:01,4,3,7
8,2025-05-25T03:02:00+02:00,2025-05-25,11:02,9,5,14
8,2025-05-25T03:03:00+02:00,2025-05-25,11:03,1,1,2
8,2025-05-25T03:06:00+02:00,2025-05-25,11:06,0,3,3
8,2025-05-25T03:07:00+02:00,2025-05-25,11:07,3,5,8
8,2025-05-25T03:09:00+02:00,2025-05-25,11:09,6,2,8
28,2025-05-25T02:55:00+02:00,2025-05-25,10:55,6,6,12
28,2025-05-25T03:00:00+02:00,2025-05-25,11:00,2,4,6
29,2025-05-25T02:58:00+02:00,2025-05-25,10:58,11,4,15
29,2025-05-25T03:05:00+02:00,2025-05-25,11:05,9,9,18
31,2025-05-25T02:56:00+02:00,2025-05-25,10:56,1,2,3
31,2025-05-25T03:00:00+02:00,2025-05-25,11:00,1,3,4
31,2025-05-25T03:01:00+02:00,2025-05-25,11:01,0,3,3
31,2025-05-25T03:02:00+02:00,2025-05-25,11:02,1,3,4
31,2025-05-25T03:05:00+02:00,2025-05-25,11:05,4,1,5
31,2025-05-25T03:09:00+02:00,2025-05-25,11:09,1,3,4
36,2025-05-25T02:55:00+02:00,2025-05-25,10:55,0,1,1
36,2025-05-25T02:56:00+02:00,2025-05-25,10:56,0,1,1
36,2025-05-25T02:58:00+02:00,2025-05-25,10:58,0,4,4
36,2025-05-25T03:00:00+02:00,2025-05-25,11:00,3,0,3
36,2025-05-25T03:03:00+02:00,2025-05-25,11:03,2,0,2
36,2025-05-25T03:04:00+02:00,2025-05-25,11:04,3,1,4
36,2025-05-25T03:05:00+02:00,2025-05-25,11:05,1,1,2
36,2025-05-25T03:06:00+02:00,2025-05-25,11:06,1,3,4
36,2025-05-25T03:07:00+02:00,2025-05-25,11:07,2,1,3
36,2025-05-25T03:09:00+02:00,2025-05-25,11:09,1,2,3
37,2025-05-25T02:55:00+02:00,2025-05-25,10:55,3,5,8
37,2025-05-25T02:57:00+02:00,2025-05-25,10:57,1,0,1
37,2025-05-25T03:06:00+02:00,2025-05-25,11:06,2,1,3
39,2025-05-25T03:06:00+02:00,2025-05-25,11:06,0,1,1
40,2025-05-25T03:01:00+02:00,2025-05-25,11:01,3,5,8
40,2025-05-25T03:03:00+02:00,2025-05-25,11:03,2,3,5
40,2025-05-25T03:09:00+02:00,2025-05-25,11:09,7,1,8
41,2025-05-25T02:55:00+02:00,2025-05-25,10:55,4,0,4
41,2025-05-25T02:57:00+02:00,2025-05-25,10:57,0,7,7
41,2025-05-25T02:58:00+02:00,2025-05-25,10:58,0,1,1
41,2025-05-25T03:01:00+02:00,2025-05-25,11:01,0,4,4
41,2025-05-25T03:02:00+02:00,2025-05-25,11:02,2,6,8
41,2025-05-25T03:05:00+02:00,2025-05-25,11:05,2,11,13
41,2025-05-25T03:08:00+02:00,2025-05-25,11:08,2,7,9
41,2025-05-25T03:09:00+02:00,2025-05-25,11:09,4,4,8
43,2025-05-25T03:00:00+02:00,2025-05-25,11:00,7,6,13
44,2025-05-25T03:00:00+02:00,2025-05-25,11:00,3,5,8
45,2025-05-25T03:01:00+02:00,2025-05-25,11:01,4,12,16
45,2025-05-25T03:02:00+02:00,2025-05-25,11:02,11,6,17
45,2025-05-25T03:04:00+02:00,2025-05-25,11:04,6,11,17
47,2025-05-25T02:55:00+02:00,2025-05-25,10:55,10,14,24
47,2025-05-25T02:56:00+02:00,2025-05-25,10:56,33,2,35
47,2025-05-25T03:06:00+02:00,2025-05-25,11:06,16,12,28
47,2025-05-25T03:07:00+02:00,2025-05-25,11:07,11,11,22
50,2025-05-25T02:57:00+02:00,2025-05-25,10:57,0,5,5
50,2025-05-25T02:58:00+02:00,2025-05-25,10:58,3,0,3
50,2025-05-25T03:09:00+02:00,2025-05-25,11:09,0,5,5
54,2025-05-25T02:55:00+02:00,2025-05-25,10:55,7,2,9
54,2025-05-25T03:00:00+02:00,2025-05-25,11:00,5,1,6
59,2025-05-25T02:55:00+02:00,2025-05-25,10:55,12,27,39
61,2025-05-25T02:55:00+02:00,2025-05-25,10:55,5,4,9
61,2025-05-25T02:57:00+02:00,2025-05-25,10:57,3,12,15
61,2025-05-25T03:09:00+02:00,2025-05-25,11:09,5,3,8
66,2025-05-25T02:55:00+02:00,2025-05-25,10:55,6,8,14
66,2025-05-25T02:58:00+02:00,2025-05-25,10:58,17,7,24
66,2025-05-25T02:59:00+02:00,2025-05-25,10:59,11,10,21
66,2025-05-25T03:08:00+02:00,2025-05-25,11:08,9,23,32
69,2025-05-25T02:56:00+02:00,2025-05-25,10:56,3,4,7
69,2025-05-25T02:58:00+02:00,2025-05-25,10:58,7,7,14
69,2025-05-25T03:00:00+02:00,2025-05-25,11:00,6,6,12
69,2025-05-25T03:01:00+02:00,2025-05-25,11:01,8,0,8
69,2025-05-25T03:06:00+02:00,2025-05-25,11:06,4,4,8
69,2025-05-25T03:07:00+02:00,2025-05-25,11:07,7,2,9
69,2025-05-25T03:09:00+02:00,2025-05-25,11:09,2,1,3
70,2025-05-25T02:58:00+02:00,2025-05-25,10:58,1,0,1
70,2025-05-25T03:00:00+02:00,2025-05-25,11:00,1,1,2
70,2025-05-25T03:09:00+02:00,2025-05-25,11:09,0,2,2
71,2025-05-25T02:58:00+02:00,2025-05-25,10:58,1,1,2
75,2025-05-25T02:56:00+02:00,2025-05-25,10:56,1,5,6
75,2025-05-25T03:08:00+02:00,2025-05-25,11:08,0,2,2
75,2025-05-25T03:09:00+02:00,2025-05-25,11:09,0,1,1
77,2025-05-25T03:00:00+02:00,2025-05-25,11:00,14,9,23
78,2025-05-25T03:04:00+02:00,2025-05-25,11:04,3,3,6
78,2025-05-25T03:05:00+02:00,2025-05-25,11:05,3,2,5
84,2025-05-25T02:55:00+02:00,2025-05-25,10:55,82,48,130
87,2025-05-25T02:55:00+02:00,2025-05-25,10:55,1,2,3
87,2025-05-25T02:59:00+02:00,2025-05-25,10:59,0,1,1
87,2025-05-25T03:03:00+02:00,2025-05-25,11:03,2,1,3
87,2025-05-25T03:04:00+02:00,2025-05-25,11:04,0,1,1
87,2025-05-25T03:06:00+02:00,2025-05-25,11:06,2,2,4
87,2025-05-25T03:07:00+02:00,2025-05-25,11:07,0,4,4
107,2025-05-25T03:00:00+02:00,2025-05-25,11:00,1,4,5
107,2025-05-25T03:05:00+02:00,2025-05-25,11:05,4,4,8
108,2025-05-25T02:57:00+02:00,2025-05-25,10:57,6,4,10
108,2025-05-25T03:03:00+02:00,2025-05-25,11:03,2,2,4
108,2025-05-25T03:05:00+02:00,2025-05-25,11:05,2,1,3
108,2025-05-25T03:06:00+02:00,2025-05-25,11:06,2,3,5
108,2025-05-25T03:08:00+02:00,2025-05-25,11:08,6,1,7
118,2025-05-25T02:55:00+02:00,2025-05-25,10:55,3,0,3
118,2025-05-25T03:05:00+02:00,2025-05-25,11:05,0,5,5
124,2025-05-25T02:55:00+02:00,2025-05-25,10:55,0,1,1
132,2025-05-25T03:05:00+02:00,2025-05-25,11:05,8,4,12
133,2025-05-25T03:00:00+02:00,2025-05-25,11:00,48,30,78
134,2025-05-25T02:55:00+02:00,2025-05-25,10:55,20,26,46
135,2025-05-25T03:05:00+02:00,2025-05-25,11:05,38,33,71
165,2025-05-25T02:55:00+02:00,2025-05-25,10:55,3,2,5
165,2025-05-25T03:00:00+02:00,2025-05-25,11:00,3,4,7
167,2025-05-25T02:55:00+02:00,2025-05-25,10:55,5,9,14
1,2025-05-25T02:59:00+02:00,2025-05-25,10:59,20,16,36
1,2025-05-25T03:00:00+02:00,2025-05-25,11:00,5,12,17
1,2025-05-25T03:03:00+02:00,2025-05-25,11:03,16,3,19
1,2025-05-25T03:04:00+02:00,2025-05-25,11:04,7,10,17
1,2025-05-25T03:06:00+02:00,2025-05-25,11:06,12,25,37
2,2025-05-25T02:55:00+02:00,2025-05-25,10:55,1,7,8
2,2025-05-25T03:01:00+02:00,2025-05-25,11:01,7,3,10
2,2025-05-25T03:02:00+02:00,2025-05-25,11:02,5,8,13
2,2025-05-25T03:03:00+02:00,2025-05-25,11:03,2,7,9
2,2025-05-25T03:05:00+02:00,2025-05-25,11:05,6,11,17
2,2025-05-25T03:06:00+02:00,2025-05-25,11:06,8,4,12
2,2025-05-25T03:08:00+02:00,2025-05-25,11:08,3,10,13
9,2025-05-25T03:02:00+02:00,2025-05-25,11:02,2,0,2
9,2025-05-25T03:06:00+02:00,2025-05-25,11:06,0,4,4
11,2025-05-25T02:55:00+02:00,2025-05-25,10:55,7,5,12
11,2025-05-25T02:57:00+02:00,2025-05-25,10:57,1,0,1
11,2025-05-25T02:58:00+02:00,2025-05-25,10:58,0,1,1
11,2025-05-25T03:01:00+02:00,2025-05-25,11:01,2,0,2
12,2025-05-25T02:56:00+02:00,2025-05-25,10:56,2,6,8
12,2025-05-25T03:04:00+02:00,2025-05-25,11:04,1,3,4
12,2025-05-25T03:07:00+02:00,2025-05-25,11:07,3,0,3
17,2025-05-25T02:57:00+02:00,2025-05-25,10:57,3,5,8
17,2025-05-25T02:59:00+02:00,2025-05-25,10:59,0,3,3
17,2025-05-25T03:02:00+02:00,2025-05-25,11:02,2,2,4
17,2025-05-25T03:04:00+02:00,2025-05-25,11:04,3,2,5
17,2025-05-25T03:06:00+02:00,2025-05-25,11:06,4,2,6
17,2025-05-25T03:07:00+02:00,2025-05-25,11:07,2,1,3
18,2025-05-25T02:57:00+02:00,2025-05-25,10:57,1,1,2
18,2025-05-25T03:01:00+02:00,2025-05-25,11:01,3,0,3
18,2025-05-25T03:03:00+02:00,2025-05-25,11:03,0,2,2
18,2025-05-25T03:04:00+02:00,2025-05-25,11:04,0,3,3
18,2025-05-25T03:08:00+02:00,2025-05-25,11:08,3,1,4
19,2025-05-25T02:57:00+02:00,2025-05-25,10:57,3,2,5
19,2025-05-25T03:01:00+02:00,2025-05-25,11:01,6,2,8
19,2025-05-25T03:02:00+02:00,2025-05-25,11:02,3,0,3
19,2025-05-25T03:06:00+02:00,2025-05-25,11:06,7,7,14
20,2025-05-25T02:56:00+02:00,2025-05-25,10:56,3,1,4
20,2025-05-25T03:03:00+02:00,2025-05-25,11:03,6,3,9
20,2025-05-25T03:04:00+02:00,2025-05-25,11:04,4,1,5
20,2025-05-25T03:05:00+02:00,2025-05-25,11:05,6,0,6
20,2025-05-25T03:07:00+02:00,2025-05-25,11:07,1,0,1
23,2025-05-25T02:56:00+02:00,2025-05-25,10:56,3,9,12
23,2025-05-25T03:00:00+02:00,2025-05-25,11:00,0,2,2
23,2025-05-25T03:02:00+02:00,2025-05-25,11:02,1,1,2
23,2025-05-25T03:07:00+02:00,2025-05-25,11:07,4,5,9
24,2025-05-25T02:55:00+02:00,2025-05-25,10:55,3,2,5
24,2025-05-25T02:58:00+02:00,2025-05-25,10:58,1,9,10
24,2025-05-25T02:59:00+02:00,2025-05-25,10:59,14,10,24
24,2025-05-25T03:03:00+02:00,2025-05-25,11:03,5,9,14
24,2025-05-25T03:08:00+02:00,2025-05-25,11:08,9,5,14
25,2025-05-25T02:55:00+02:00,2025-05-25,10:55,28,77,105
25,2025-05-25T03:00:00+02:00,2025-05-25,11:00,33,93,126
27,2025-05-25T02:58:00+02:00,2025-05-25,10:58,3,2,5
27,2025-05-25T02:59:00+02:00,2025-05-25,10:59,3,4,7
27,2025-05-25T03:06:00+02:00,2025-05-25,11:06,0,3,3
30,2025-05-25T02:55:00+02:00,2025-05-25,10:55,1,2,3
30,2025-05-25T02:56:00+02:00,2025-05-25,10:56,8,5,13
30,2025-05-25T02:57:00+02:00,2025-05-25,10:57,1,3,4
30,2025-05-25T02:58:00+02:00,2025-05-25,10:58,1,5,6
30,2025-05-25T03:00:00+02:00,2025-05-25,11:00,0,1,1
30,2025-05-25T03:07:00+02:00,2025-05-25,11:07,1,5,6
35,2025-05-25T02:55:00+02:00,2025-05-25,10:55,21,12,33
35,2025-05-25T03:02:00+02:00,2025-05-25,11:02,28,7,35
35,2025-05-25T03:03:00+02:00,2025-05-25,11:03,30,15,45
35,2025-05-25T03:05:00+02:00,2025-05-25,11:05,8,20,28
35,2025-05-25T03:09:00+02:00,2025-05-25,11:09,31,22,53
46,2025-05-25T02:55:00+02:00,2025-05-25,10:55,11,4,15
46,2025-05-25T03:05:00+02:00,2025-05-25,11:05,2,3,5
48,2025-05-25T02:57:00+02:00,2025-05-25,10:57,7,10,17
48,2025-05-25T02:58:00+02:00,2025-05-25,10:58,10,1,11
48,2025-05-25T02:59:00+02:00,2025-05-25,10:59,11,3,14
48,2025-05-25T03:00:00+02:00,2025-05-25,11:00,4,4,8
48,2025-05-25T03:02:00+02:00,2025-05-25,11:02,11,2,13
48,2025-05-25T03:03:00+02:00,2025-05-25,11:03,9,3,12
48,2025-05-25T03:05:00+02:00,2025-05-25,11:05,13,2,15
49,2025-05-25T02:59:00+02:00,2025-05-25,10:59,11,9,20
49,2025-05-25T03:00:00+02:00,2025-05-25,11:00,8,4,12
49,2025-05-25T03:03:00+02:00,2025-05-25,11:03,2,10,12
49,2025-05-25T03:05:00+02:00,2025-05-25,11:05,4,7,11
49,2025-05-25T03:07:00+02:00,2025-05-25,11:07,1,10,11
49,2025-05-25T03:08:00+02:00,2025-05-25,11:08,9,3,12
49,2025-05-25T03:09:00+02:00,2025-05-25,11:09,7,13,20
51,2025-05-25T02:55:00+02:00,2025-05-25,10:55,1,1,2
51,2025-05-25T02:56:00+02:00,2025-05-25,10:56,3,5,8
51,2025-05-25T02:58:00+02:00,2025-05-25,10:58,0,5,5
51,2025-05-25T03:01:00+02:00,2025-05-25,11:01,4,3,7
51,2025-05-25T03:03:00+02:00,2025-05-25,11:03,2,4,6
51,2025-05-25T03:08:00+02:00,2025-05-25,11:08,3,4,7
51,2025-05-25T03:09:00+02:00,2025-05-25,11:09,2,0,2
52,2025-05-25T02:58:00+02:00,2025-05-25,10:58,5,4,9
52,2025-05-25T03:05:00+02:00,2025-05-25,11:05,7,2,9
52,2025-05-25T03:08:00+02:00,2025-05-25,11:08,7,4,11
53,2025-05-25T02:55:00+02:00,2025-05-25,10:55,0,13,13
53,2025-05-25T02:57:00+02:00,2025-05-25,10:57,16,6,22
53,2025-05-25T02:58:00+02:00,2025-05-25,10:58,17,8,25
53,2025-05-25T03:01:00+02:00,2025-05-25,11:01,5,6,11
53,2025-05-25T03:02:00+02:00,2025-05-25,11:02,6,11,17
53,2025-05-25T03:03:00+02:00,2025-05-25,11:03,14,5,19
53,2025-05-25T03:04:00+02:00,2025-05-25,11:04,2,4,6
53,2025-05-25T03:06:00+02:00,2025-05-25,11:06,12,5,17
53,2025-05-25T03:07:00+02:00,2025-05-25,11:07,9,8,17
53,2025-05-25T03:09:00+02:00,2025-05-25,11:09,13,8,21
56,2025-05-25T02:57:00+02:00,2025-05-25,10:57,8,4,12
56,2025-05-25T02:59:00+02:00,2025-05-25,10:59,5,3,8
56,2025-05-25T03:05:00+02:00,2025-05-25,11:05,10,4,14
56,2025-05-25T03:06:00+02:00,2025-05-25,11:06,4,0,4
56,2025-05-25T03:08:00+02:00,2025-05-25,11:08,0,2,2
58,2025-05-25T02:56:00+02:00,2025-05-25,10:56,15,2,17
58,2025-05-25T02:58:00+02:00,2025-05-25,10:58,3,1,4
58,2025-05-25T03:01:00+02:00,2025-05-25,11:01,18,1,19
58,2025-05-25T03:03:00+02:00,2025-05-25,11:03,2,5,7
58,2025-05-25T03:08:00+02:00,2025-05-25,11:08,14,1,15
62,2025-05-25T03:02:00+02:00,2025-05-25,11:02,9,0,9
62,2025-05-25T03:03:00+02:00,2025-05-25,11:03,1,3,4
63,2025-05-25T02:57:00+02:00,2025-05-25,10:57,3,1,4
63,2025-05-25T02:59:00+02:00,2025-05-25,10:59,1,6,7
63,2025-05-25T03:02:00+02:00,2025-05-25,11:02,7,3,10
63,2025-05-25T03:09:00+02:00,2025-05-25,11:09,1,9,10
67,2025-05-25T03:01:00+02:00,2025-05-25,11:01,3,16,19
67,2025-05-25T03:03:00+02:00,2025-05-25,11:03,13,2,15
67,2025-05-25T03:07:00+02:00,2025-05-25,11:07,2,12,14
68,2025-05-25T02:55:00+02:00,2025-05-25,10:55,5,2,7
68,2025-05-25T02:57:00+02:00,2025-05-25,10:57,4,4,8
68,2025-05-25T02:58:00+02:00,2025-05-25,10:58,5,13,18
68,2025-05-25T02:59:00+02:00,2025-05-25,10:59,3,8,11
72,2025-05-25T02:57:00+02:00,2025-05-25,10:57,3,12,15
72,2025-05-25T03:01:00+02:00,2025-05-25,11:01,1,2,3
72,2025-05-25T03:09:00+02:00,2025-05-25,11:09,2,2,4
76,2025-05-25T03:00:00+02:00,2025-05-25,11:00,0,2,2
76,2025-05-25T03:02:00+02:00,2025-05-25,11:02,2,2,4
76,2025-05-25T03:03:00+02:00,2025-05-25,11:03,3,1,4
76,2025-05-25T03:04:00+02:00,2025-05-25,11:04,4,0,4
76,2025-05-25T03:09:00+02:00,2025-05-25,11:09,0,1,1
79,2025-05-25T03:01:00+02:00,2025-05-25,11:01,3,6,9
79,2025-05-25T03:02:00+02:00,2025-05-25,11:02,8,11,19
79,2025-05-25T03:05:00+02:00,2025-05-25,11:05,5,5,10
79,2025-05-25T03:09:00+02:00,2025-05-25,11:09,13,8,21
85,2025-05-25T02:55:00+02:00,2025-05-25,10:55,1,3,4
85,2025-05-25T02:59:00+02:00,2025-05-25,10:59,6,0,6
85,2025-05-25T03:02:00+02:00,2025-05-25,11:02,0,1,1
85,2025-05-25T03:03:00+02:00,2025-05-25,11:03,5,3,8
85,2025-05-25T03:04:00+02:00,2025-05-25,11:04,1,1,2
85,2025-05-25T03:08:00+02:00,2025-05-25,11:08,2,0,2
86,2025-05-25T02:56:00+02:00,2025-05-25,10:56,1,0,1
86,2025-05-25T02:59:00+02:00,2025-05-25,10:59,1,0,1
86,2025-05-25T03:02:00+02:00,2025-05-25,11:02,0,2,2
86,2025-05-25T03:03:00+02:00,2025-05-25,11:03,0,2,2
86,2025-05-25T03:04:00+02:00,2025-05-25,11:04,0,4,4
86,2025-05-25T03:09:00+02:00,2025-05-25,11:09,1,2,3
109,2025-05-25T03:00:00+02:00,2025-05-25,11:00,3,4,7
109,2025-05-25T03:05:00+02:00,2025-05-25,11:05,8,5,13
117,2025-05-25T02:55:00+02:00,2025-05-25,10:55,14,15,29
123,2025-05-25T03:05:00+02:00,2025-05-25,11:05,5,2,7
130,2025-05-25T03:00:00+02:00,2025-05-25,11:00,4,0,4
137,2025-05-25T02:55:00+02:00,2025-05-25,10:55,1,1,2
138,2025-05-25T03:05:00+02:00,2025-05-25,11:05,0,1,1
141,2025-05-25T02:55:00+02:00,2025-05-25,10:55,10,18,28
141,2025-05-25T03:00:00+02:00,2025-05-25,11:00,11,12,23
141,2025-05-25T03:05:00+02:00,2025-05-25,11:05,11,15,26
142,2025-05-25T03:00:00+02:00,2025-05-25,11:00,36,29,65
142,2025-05-25T03:05:00+02:00,2025-05-25,11:05,46,41,87
3,2025-05-25T03:12:00+02:00,2025-05-25,11:12,9,8,17
3,2025-05-25T03:14:00+02:00,2025-05-25,11:14,3,2,5
3,2025-05-25T03:19:00+02:00,2025-05-25,11:19,12,16,28
3,2025-05-25T03:20:00+02:00,2025-05-25,11:20,1,6,7
3,2025-05-25T03:21:00+02:00,2025-05-25,11:21,14,5,19
3,2025-05-25T03:22:00+02:00,2025-05-25,11:22,7,5,12
4,2025-05-25T03:13:00+02:00,2025-05-25,11:13,19,7,26
4,2025-05-25T03:15:00+02:00,2025-05-25,11:15,30,13,43
4,2025-05-25T03:16:00+02:00,2025-05-25,11:16,15,12,27
4,2025-05-25T03:17:00+02:00,2025-05-25,11:17,29,9,38
4,2025-05-25T03:19:00+02:00,2025-05-25,11:19,23,18,41
4,2025-05-25T03:22:00+02:00,2025-05-25,11:22,24,27,51
5,2025-05-25T03:10:00+02:00,2025-05-25,11:10,51,48,99
6,2025-05-25T03:15:00+02:00,2025-05-25,11:15,6,15,21
6,2025-05-25T03:21:00+02:00,2025-05-25,11:21,11,9,20
6,2025-05-25T03:22:00+02:00,2025-05-25,11:22,11,10,21
8,2025-05-25T03:15:00+02:00,2025-05-25,11:15,2,8,10
8,2025-05-25T03:18:00+02:00,2025-05-25,11:18,1,5,6
8,2025-05-25T03:23:00+02:00,2025-05-25,11:23,2,3,5
28,2025-05-25T03:16:00+02:00,2025-05-25,11:16,6,6,12
28,2025-05-25T03:19:00+02:00,2025-05-25,11:19,10,7,17
29,2025-05-25T03:12:00+02:00,2025-05-25,11:12,7,4,11
29,2025-05-25T03:13:00+02:00,2025-05-25,11:13,3,3,6
29,2025-05-25T03:14:00+02:00,2025-05-25,11:14,2,14,16
29,2025-05-25T03:15:00+02:00,2025-05-25,11:15,8,3,11
29,2025-05-25T03:17:00+02:00,2025-05-25,11:17,3,12,15
29,2025-05-25T03:18:00+02:00,2025-05-25,11:18,9,9,18
29,2025-05-25T03:19:00+02:00,2025-05-25,11:19,9,6,15
29,2025-05-25T03:20:00+02:00,2025-05-25,11:20,11,1,12
31,2025-05-25T03:13:00+02:00,2025-05-25,11:13,4,0,4
31,2025-05-25T03:18:00+02:00,2025-05-25,11:18,0,2,2
31,2025-05-25T03:21:00+02:00,2025-05-25,11:21,1,2,3
36,2025-05-25T03:10:00+02:00,2025-05-25,11:10,1,0,1
36,2025-05-25T03:11:00+02:00,2025-05-25,11:11,1,0,1
36,2025-05-25T03:12:00+02:00,2025-05-25,11:12,5,5,10
36,2025-05-25T03:14:00+02:00,2025-05-25,11:14,2,1,3
36,2025-05-25T03:17:00+02:00,2025-05-25,11:17,2,0,2
36,2025-05-25T03:18:00+02:00,2025-05-25,11:18,1,2,3
36,2025-05-25T03:22:00+02:00,2025-05-25,11:22,0,2,2
37,2025-05-25T03:11:00+02:00,2025-05-25,11:11,2,0,2
37,2025-05-25T03:15:00+02:00,2025-05-25,11:15,10,0,10
37,2025-05-25T03:16:00+02:00,2025-05-25,11:16,2,0,2
37,2025-05-25T03:17:00+02:00,2025-05-25,11:17,2,1,3
37,2025-05-25T03:19:00+02:00,2025-05-25,11:19,0,3,3
37,2025-05-25T03:20:00+02:00,2025-05-25,11:20,0,2,2
37,2025-05-25T03:21:00+02:00,2025-05-25,11:21,1,0,1
37,2025-05-25T03:23:00+02:00,2025-05-25,11:23,2,0,2
39,2025-05-25T03:17:00+02:00,2025-05-25,11:17,0,1,1
39,2025-05-25T03:20:00+02:00,2025-05-25,11:20,2,0,2
39,2025-05-25T03:22:00+02:00,2025-05-25,11:22,3,1,4
40,2025-05-25T03:17:00+02:00,2025-05-25,11:17,0,2,2
40,2025-05-25T03:19:00+02:00,2025-05-25,11:19,3,0,3
40,2025-05-25T03:20:00+02:00,2025-05-25,11:20,4,0,4
40,2025-05-25T03:21:00+02:00,2025-05-25,11:21,3,2,5
41,2025-05-25T03:10:00+02:00,2025-05-25,11:10,11,5,16
41,2025-05-25T03:11:00+02:00,2025-05-25,11:11,9,2,11
41,2025-05-25T03:12:00+02:00,2025-05-25,11:12,2,1,3
41,2025-05-25T03:13:00+02:00,2025-05-25,11:13,0,1,1
41,2025-05-25T03:19:00+02:00,2025-05-25,11:19,3,0,3
41,2025-05-25T03:23:00+02:00,2025-05-25,11:23,1,2,3
43,2025-05-25T03:15:00+02:00,2025-05-25,11:15,4,5,9
43,2025-05-25T03:20:00+02:00,2025-05-25,11:20,5,1,6
44,2025-05-25T03:15:00+02:00,2025-05-25,11:15,6,2,8
45,2025-05-25T03:14:00+02:00,2025-05-25,11:14,19,9,28
45,2025-05-25T03:15:00+02:00,2025-05-25,11:15,8,4,12
45,2025-05-25T03:17:00+02:00,2025-05-25,11:17,15,14,29
45,2025-05-25T03:18:00+02:00,2025-05-25,11:18,17,11,28
45,2025-05-25T03:20:00+02:00,2025-05-25,11:20,10,2,12
45,2025-05-25T03:22:00+02:00,2025-05-25,11:22,9,9,18
47,2025-05-25T03:16:00+02:00,2025-05-25,11:16,10,5,15
47,2025-05-25T03:18:00+02:00,2025-05-25,11:18,21,8,29
47,2025-05-25T03:19:00+02:00,2025-05-25,11:19,10,8,18
47,2025-05-25T03:21:00+02:00,2025-05-25,11:21,6,7,13
47,2025-05-25T03:23:00+02:00,2025-05-25,11:23,11,11,22
50,2025-05-25T03:11:00+02:00,2025-05-25,11:11,4,1,5
50,2025-05-25T03:12:00+02:00,2025-05-25,11:12,4,4,8
50,2025-05-25T03:15:00+02:00,2025-05-25,11:15,2,5,7
50,2025-05-25T03:18:00+02:00,2025-05-25,11:18,0,3,3
50,2025-05-25T03:19:00+02:00,2025-05-25,11:19,1,5,6
54,2025-05-25T03:10:00+02:00,2025-05-25,11:10,0,2,2
54,2025-05-25T03:17:00+02:00,2025-05-25,11:17,2,3,5
54,2025-05-25T03:21:00+02:00,2025-05-25,11:21,2,0,2
54,2025-05-25T03:23:00+02:00,2025-05-25,11:23,2,5,7
59,2025-05-25T03:10:00+02:00,2025-05-25,11:10,18,19,37
59,2025-05-25T03:15:00+02:00,2025-05-25,11:15,8,20,28
3,2025-05-25T11:26:00+02:00,2025-05-25,19:26,27,16,43
61,2025-05-25T03:10:00+02:00,2025-05-25,11:10,2,2,4
3,2025-05-25T11:27:00+02:00,2025-05-25,19:27,7,15,22
61,2025-05-25T03:11:00+02:00,2025-05-25,11:11,2,9,11
3,2025-05-25T11:29:00+02:00,2025-05-25,19:29,6,18,24
61,2025-05-25T03:18:00+02:00,2025-05-25,11:18,4,5,9
3,2025-05-25T11:32:00+02:00,2025-05-25,19:32,18,31,49
61,2025-05-25T03:22:00+02:00,2025-05-25,11:22,1,13,14
3,2025-05-25T11:34:00+02:00,2025-05-25,19:34,18,6,24
66,2025-05-25T03:14:00+02:00,2025-05-25,11:14,15,17,32
4,2025-05-25T11:25:00+02:00,2025-05-25,19:25,19,19,38
66,2025-05-25T03:23:00+02:00,2025-05-25,11:23,17,6,23
4,2025-05-25T11:26:00+02:00,2025-05-25,19:26,16,22,38
69,2025-05-25T03:13:00+02:00,2025-05-25,11:13,4,3,7
4,2025-05-25T11:28:00+02:00,2025-05-25,19:28,11,25,36
69,2025-05-25T03:15:00+02:00,2025-05-25,11:15,5,4,9
4,2025-05-25T11:29:00+02:00,2025-05-25,19:29,18,26,44
69,2025-05-25T03:22:00+02:00,2025-05-25,11:22,3,4,7
4,2025-05-25T11:30:00+02:00,2025-05-25,19:30,6,12,18
69,2025-05-25T03:23:00+02:00,2025-05-25,11:23,8,2,10
4,2025-05-25T11:31:00+02:00,2025-05-25,19:31,29,26,55
70,2025-05-25T03:21:00+02:00,2025-05-25,11:21,2,1,3
4,2025-05-25T11:32:00+02:00,2025-05-25,19:32,29,7,36
75,2025-05-25T03:13:00+02:00,2025-05-25,11:13,2,0,2
4,2025-05-25T11:37:00+02:00,2025-05-25,19:37,15,8,23
75,2025-05-25T03:18:00+02:00,2025-05-25,11:18,5,0,5
6,2025-05-25T11:25:00+02:00,2025-05-25,19:25,3,14,17
75,2025-05-25T03:21:00+02:00,2025-05-25,11:21,2,4,6
6,2025-05-25T11:27:00+02:00,2025-05-25,19:27,11,14,25
75,2025-05-25T03:23:00+02:00,2025-05-25,11:23,1,0,1
6,2025-05-25T11:30:00+02:00,2025-05-25,19:30,11,3,14
77,2025-05-25T03:15:00+02:00,2025-05-25,11:15,26,13,39
6,2025-05-25T11:34:00+02:00,2025-05-25,19:34,6,3,9
77,2025-05-25T03:20:00+02:00,2025-05-25,11:20,7,9,16
8,2025-05-25T11:27:00+02:00,2025-05-25,19:27,0,1,1
78,2025-05-25T03:10:00+02:00,2025-05-25,11:10,0,1,1
8,2025-05-25T11:28:00+02:00,2025-05-25,19:28,0,1,1
78,2025-05-25T03:16:00+02:00,2025-05-25,11:16,4,0,4
8,2025-05-25T11:33:00+02:00,2025-05-25,19:33,1,0,1
78,2025-05-25T03:18:00+02:00,2025-05-25,11:18,3,2,5
21,2025-05-25T11:30:00+02:00,2025-05-25,19:30,10,9,19
78,2025-05-25T03:20:00+02:00,2025-05-25,11:20,2,0,2
28,2025-05-25T11:27:00+02:00,2025-05-25,19:27,2,0,2
87,2025-05-25T03:10:00+02:00,2025-05-25,11:10,1,1,2
28,2025-05-25T11:31:00+02:00,2025-05-25,19:31,1,7,8
87,2025-05-25T03:11:00+02:00,2025-05-25,11:11,4,4,8
28,2025-05-25T11:35:00+02:00,2025-05-25,19:35,1,2,3
87,2025-05-25T03:12:00+02:00,2025-05-25,11:12,2,0,2
28,2025-05-25T11:36:00+02:00,2025-05-25,19:36,0,1,1
87,2025-05-25T03:13:00+02:00,2025-05-25,11:13,5,3,8
28,2025-05-25T11:37:00+02:00,2025-05-25,19:37,2,0,2
87,2025-05-25T03:14:00+02:00,2025-05-25,11:14,2,0,2
29,2025-05-25T11:26:00+02:00,2025-05-25,19:26,1,8,9
87,2025-05-25T03:15:00+02:00,2025-05-25,11:15,4,0,4
29,2025-05-25T11:28:00+02:00,2025-05-25,19:28,2,6,8
87,2025-05-25T03:17:00+02:00,2025-05-25,11:17,1,2,3
29,2025-05-25T11:29:00+02:00,2025-05-25,19:29,3,7,10
87,2025-05-25T03:18:00+02:00,2025-05-25,11:18,2,2,4
29,2025-05-25T11:31:00+02:00,2025-05-25,19:31,0,5,5
87,2025-05-25T03:19:00+02:00,2025-05-25,11:19,4,6,10
29,2025-05-25T11:36:00+02:00,2025-05-25,19:36,6,5,11
87,2025-05-25T03:22:00+02:00,2025-05-25,11:22,3,0,3
29,2025-05-25T11:37:00+02:00,2025-05-25,19:37,1,4,5
87,2025-05-25T03:24:00+02:00,2025-05-25,11:24,1,0,1
31,2025-05-25T11:26:00+02:00,2025-05-25,19:26,3,3,6
108,2025-05-25T03:10:00+02:00,2025-05-25,11:10,0,4,4
31,2025-05-25T11:27:00+02:00,2025-05-25,19:27,3,9,12
108,2025-05-25T03:22:00+02:00,2025-05-25,11:22,1,2,3
31,2025-05-25T11:28:00+02:00,2025-05-25,19:28,14,0,14
131,2025-05-25T03:10:00+02:00,2025-05-25,11:10,10,14,24
31,2025-05-25T11:29:00+02:00,2025-05-25,19:29,5,6,11
133,2025-05-25T03:20:00+02:00,2025-05-25,11:20,24,46,70
31,2025-05-25T11:38:00+02:00,2025-05-25,19:38,4,8,12
140,2025-05-25T03:20:00+02:00,2025-05-25,11:20,15,1,16
31,2025-05-25T11:39:00+02:00,2025-05-25,19:39,4,0,4
165,2025-05-25T03:10:00+02:00,2025-05-25,11:10,2,3,5
36,2025-05-25T11:29:00+02:00,2025-05-25,19:29,0,1,1
167,2025-05-25T03:20:00+02:00,2025-05-25,11:20,2,8,10
36,2025-05-25T11:30:00+02:00,2025-05-25,19:30,0,2,2
179,2025-05-25T03:15:00+02:00,2025-05-25,11:15,3,5,8
36,2025-05-25T11:32:00+02:00,2025-05-25,19:32,4,2,6
179,2025-05-25T03:20:00+02:00,2025-05-25,11:20,5,8,13
39,2025-05-25T11:35:00+02:00,2025-05-25,19:35,2,0,2
1,2025-05-25T03:19:00+02:00,2025-05-25,11:19,14,10,24
40,2025-05-25T11:26:00+02:00,2025-05-25,19:26,2,0,2
1,2025-05-25T03:21:00+02:00,2025-05-25,11:21,15,10,25
40,2025-05-25T11:29:00+02:00,2025-05-25,19:29,2,2,4
1,2025-05-25T03:22:00+02:00,2025-05-25,11:22,10,18,28
40,2025-05-25T11:32:00+02:00,2025-05-25,19:32,2,1,3
1,2025-05-25T03:24:00+02:00,2025-05-25,11:24,13,17,30
40,2025-05-25T11:35:00+02:00,2025-05-25,19:35,3,0,3
2,2025-05-25T03:10:00+02:00,2025-05-25,11:10,1,4,5
41,2025-05-25T11:27:00+02:00,2025-05-25,19:27,4,0,4
2,2025-05-25T03:12:00+02:00,2025-05-25,11:12,6,8,14
41,2025-05-25T11:28:00+02:00,2025-05-25,19:28,7,4,11
2,2025-05-25T03:13:00+02:00,2025-05-25,11:13,10,4,14
41,2025-05-25T11:31:00+02:00,2025-05-25,19:31,5,4,9
2,2025-05-25T03:18:00+02:00,2025-05-25,11:18,8,8,16
41,2025-05-25T11:34:00+02:00,2025-05-25,19:34,1,10,11
2,2025-05-25T03:21:00+02:00,2025-05-25,11:21,11,10,21
41,2025-05-25T11:38:00+02:00,2025-05-25,19:38,2,3,5
2,2025-05-25T03:22:00+02:00,2025-05-25,11:22,8,8,16
44,2025-05-25T11:25:00+02:00,2025-05-25,19:25,1,9,10
2,2025-05-25T03:23:00+02:00,2025-05-25,11:23,5,11,16
45,2025-05-25T11:26:00+02:00,2025-05-25,19:26,3,11,14
9,2025-05-25T03:11:00+02:00,2025-05-25,11:11,1,0,1
45,2025-05-25T11:27:00+02:00,2025-05-25,19:27,14,14,28
9,2025-05-25T03:17:00+02:00,2025-05-25,11:17,0,1,1
45,2025-05-25T11:29:00+02:00,2025-05-25,19:29,3,13,16
9,2025-05-25T03:18:00+02:00,2025-05-25,11:18,2,0,2
45,2025-05-25T11:36:00+02:00,2025-05-25,19:36,8,16,24
9,2025-05-25T03:21:00+02:00,2025-05-25,11:21,0,3,3
45,2025-05-25T11:37:00+02:00,2025-05-25,19:37,7,12,19
9,2025-05-25T03:22:00+02:00,2025-05-25,11:22,1,1,2
45,2025-05-25T11:38:00+02:00,2025-05-25,19:38,14,10,24
10,2025-05-25T03:10:00+02:00,2025-05-25,11:10,1,2,3
47,2025-05-25T11:25:00+02:00,2025-05-25,19:25,2,5,7
10,2025-05-25T03:12:00+02:00,2025-05-25,11:12,0,4,4
47,2025-05-25T11:33:00+02:00,2025-05-25,19:33,26,11,37
10,2025-05-25T03:14:00+02:00,2025-05-25,11:14,2,0,2
47,2025-05-25T11:35:00+02:00,2025-05-25,19:35,8,8,16
10,2025-05-25T03:18:00+02:00,2025-05-25,11:18,0,1,1
47,2025-05-25T11:36:00+02:00,2025-05-25,19:36,12,13,25
10,2025-05-25T03:19:00+02:00,2025-05-25,11:19,2,0,2
47,2025-05-25T11:38:00+02:00,2025-05-25,19:38,10,11,21
10,2025-05-25T03:20:00+02:00,2025-05-25,11:20,1,0,1
50,2025-05-25T11:25:00+02:00,2025-05-25,19:25,3,4,7
11,2025-05-25T03:15:00+02:00,2025-05-25,11:15,4,1,5
50,2025-05-25T11:29:00+02:00,2025-05-25,19:29,2,2,4
11,2025-05-25T03:16:00+02:00,2025-05-25,11:16,3,2,5
50,2025-05-25T11:35:00+02:00,2025-05-25,19:35,10,0,10
11,2025-05-25T03:20:00+02:00,2025-05-25,11:20,4,5,9
50,2025-05-25T11:39:00+02:00,2025-05-25,19:39,4,3,7
11,2025-05-25T03:22:00+02:00,2025-05-25,11:22,3,0,3
54,2025-05-25T11:26:00+02:00,2025-05-25,19:26,1,0,1
11,2025-05-25T03:23:00+02:00,2025-05-25,11:23,0,2,2
54,2025-05-25T11:27:00+02:00,2025-05-25,19:27,2,3,5
11,2025-05-25T03:24:00+02:00,2025-05-25,11:24,2,4,6
54,2025-05-25T11:28:00+02:00,2025-05-25,19:28,4,0,4
12,2025-05-25T03:11:00+02:00,2025-05-25,11:11,3,11,14
54,2025-05-25T11:30:00+02:00,2025-05-25,19:30,3,3,6
12,2025-05-25T03:12:00+02:00,2025-05-25,11:12,7,2,9
54,2025-05-25T11:34:00+02:00,2025-05-25,19:34,1,3,4
12,2025-05-25T03:13:00+02:00,2025-05-25,11:13,8,4,12
54,2025-05-25T11:36:00+02:00,2025-05-25,19:36,2,3,5
12,2025-05-25T03:15:00+02:00,2025-05-25,11:15,2,8,10
54,2025-05-25T11:37:00+02:00,2025-05-25,19:37,3,3,6
12,2025-05-25T03:17:00+02:00,2025-05-25,11:17,4,3,7
59,2025-05-25T11:35:00+02:00,2025-05-25,19:35,9,4,13
12,2025-05-25T03:18:00+02:00,2025-05-25,11:18,7,3,10
61,2025-05-25T11:26:00+02:00,2025-05-25,19:26,5,3,8
17,2025-05-25T03:12:00+02:00,2025-05-25,11:12,0,1,1
61,2025-05-25T11:27:00+02:00,2025-05-25,19:27,9,1,10
17,2025-05-25T03:13:00+02:00,2025-05-25,11:13,17,3,20
61,2025-05-25T11:29:00+02:00,2025-05-25,19:29,2,3,5
17,2025-05-25T03:15:00+02:00,2025-05-25,11:15,4,1,5
61,2025-05-25T11:35:00+02:00,2025-05-25,19:35,10,0,10
17,2025-05-25T03:21:00+02:00,2025-05-25,11:21,2,1,3
61,2025-05-25T11:39:00+02:00,2025-05-25,19:39,4,5,9
18,2025-05-25T03:13:00+02:00,2025-05-25,11:13,2,0,2
66,2025-05-25T11:27:00+02:00,2025-05-25,19:27,20,10,30
18,2025-05-25T03:15:00+02:00,2025-05-25,11:15,1,0,1
66,2025-05-25T11:28:00+02:00,2025-05-25,19:28,20,15,35
18,2025-05-25T03:21:00+02:00,2025-05-25,11:21,0,1,1
66,2025-05-25T11:30:00+02:00,2025-05-25,19:30,21,13,34
18,2025-05-25T03:23:00+02:00,2025-05-25,11:23,0,5,5
66,2025-05-25T11:32:00+02:00,2025-05-25,19:32,22,14,36
19,2025-05-25T03:10:00+02:00,2025-05-25,11:10,2,5,7
66,2025-05-25T11:33:00+02:00,2025-05-25,19:33,22,8,30
19,2025-05-25T03:12:00+02:00,2025-05-25,11:12,3,1,4
66,2025-05-25T11:38:00+02:00,2025-05-25,19:38,10,13,23
19,2025-05-25T03:16:00+02:00,2025-05-25,11:16,4,1,5
69,2025-05-25T11:30:00+02:00,2025-05-25,19:30,1,0,1
19,2025-05-25T03:17:00+02:00,2025-05-25,11:17,9,10,19
69,2025-05-25T11:32:00+02:00,2025-05-25,19:32,1,1,2
19,2025-05-25T03:18:00+02:00,2025-05-25,11:18,2,4,6
69,2025-05-25T11:36:00+02:00,2025-05-25,19:36,1,0,1
19,2025-05-25T03:19:00+02:00,2025-05-25,11:19,2,6,8
70,2025-05-25T11:28:00+02:00,2025-05-25,19:28,3,2,5
19,2025-05-25T03:20:00+02:00,2025-05-25,11:20,3,3,6
70,2025-05-25T11:35:00+02:00,2025-05-25,19:35,0,1,1
19,2025-05-25T03:21:00+02:00,2025-05-25,11:21,5,3,8
70,2025-05-25T11:39:00+02:00,2025-05-25,19:39,1,1,2
19,2025-05-25T03:24:00+02:00,2025-05-25,11:24,7,3,10
71,2025-05-25T11:27:00+02:00,2025-05-25,19:27,0,1,1
20,2025-05-25T03:11:00+02:00,2025-05-25,11:11,4,4,8
71,2025-05-25T11:36:00+02:00,2025-05-25,19:36,0,1,1
20,2025-05-25T03:18:00+02:00,2025-05-25,11:18,4,1,5
75,2025-05-25T11:27:00+02:00,2025-05-25,19:27,2,0,2
20,2025-05-25T03:23:00+02:00,2025-05-25,11:23,3,4,7
75,2025-05-25T11:39:00+02:00,2025-05-25,19:39,1,0,1
20,2025-05-25T03:24:00+02:00,2025-05-25,11:24,6,4,10
77,2025-05-25T11:35:00+02:00,2025-05-25,19:35,25,6,31
23,2025-05-25T03:15:00+02:00,2025-05-25,11:15,5,0,5
84,2025-05-25T11:35:00+02:00,2025-05-25,19:35,57,40,97
23,2025-05-25T03:16:00+02:00,2025-05-25,11:16,2,2,4
107,2025-05-25T11:25:00+02:00,2025-05-25,19:25,10,18,28
23,2025-05-25T03:18:00+02:00,2025-05-25,11:18,7,1,8
108,2025-05-25T11:29:00+02:00,2025-05-25,19:29,2,0,2
24,2025-05-25T03:10:00+02:00,2025-05-25,11:10,3,8,11
108,2025-05-25T11:33:00+02:00,2025-05-25,19:33,1,10,11
24,2025-05-25T03:20:00+02:00,2025-05-25,11:20,4,3,7
108,2025-05-25T11:35:00+02:00,2025-05-25,19:35,0,3,3
25,2025-05-25T03:15:00+02:00,2025-05-25,11:15,43,70,113
108,2025-05-25T11:39:00+02:00,2025-05-25,19:39,1,6,7
27,2025-05-25T03:13:00+02:00,2025-05-25,11:13,3,2,5
118,2025-05-25T11:25:00+02:00,2025-05-25,19:25,2,0,2
27,2025-05-25T03:16:00+02:00,2025-05-25,11:16,11,8,19
118,2025-05-25T11:30:00+02:00,2025-05-25,19:30,6,0,6
27,2025-05-25T03:18:00+02:00,2025-05-25,11:18,0,10,10
131,2025-05-25T11:30:00+02:00,2025-05-25,19:30,6,10,16
30,2025-05-25T03:10:00+02:00,2025-05-25,11:10,0,4,4
134,2025-05-25T11:25:00+02:00,2025-05-25,19:25,43,26,69
30,2025-05-25T03:11:00+02:00,2025-05-25,11:11,3,1,4
134,2025-05-25T11:35:00+02:00,2025-05-25,19:35,36,15,51
30,2025-05-25T03:16:00+02:00,2025-05-25,11:16,1,9,10
135,2025-05-25T11:30:00+02:00,2025-05-25,19:30,13,78,91
30,2025-05-25T03:17:00+02:00,2025-05-25,11:17,2,6,8
135,2025-05-25T11:35:00+02:00,2025-05-25,19:35,23,53,76
30,2025-05-25T03:20:00+02:00,2025-05-25,11:20,1,4,5
162,2025-05-25T11:25:00+02:00,2025-05-25,19:25,22,9,31
30,2025-05-25T03:21:00+02:00,2025-05-25,11:21,1,1,2
162,2025-05-25T11:35:00+02:00,2025-05-25,19:35,11,8,19
30,2025-05-25T03:22:00+02:00,2025-05-25,11:22,1,4,5
166,2025-05-25T11:35:00+02:00,2025-05-25,19:35,1,1,2
30,2025-05-25T03:23:00+02:00,2025-05-25,11:23,3,6,9
167,2025-05-25T11:35:00+02:00,2025-05-25,19:35,0,2,2
30,2025-05-25T03:24:00+02:00,2025-05-25,11:24,2,9,11
179,2025-05-25T11:35:00+02:00,2025-05-25,19:35,11,9,20
35,2025-05-25T03:12:00+02:00,2025-05-25,11:12,10,12,22
1,2025-05-25T11:26:00+02:00,2025-05-25,19:26,17,1,18
35,2025-05-25T03:13:00+02:00,2025-05-25,11:13,16,7,23
1,2025-05-25T11:28:00+02:00,2025-05-25,19:28,5,7,12
35,2025-05-25T03:14:00+02:00,2025-05-25,11:14,11,13,24
1,2025-05-25T11:33:00+02:00,2025-05-25,19:33,11,2,13
46,2025-05-25T03:10:00+02:00,2025-05-25,11:10,5,4,9
2,2025-05-25T11:27:00+02:00,2025-05-25,19:27,3,2,5
48,2025-05-25T03:11:00+02:00,2025-05-25,11:11,18,15,33
2,2025-05-25T11:33:00+02:00,2025-05-25,19:33,2,2,4
48,2025-05-25T03:14:00+02:00,2025-05-25,11:14,1,7,8
2,2025-05-25T11:35:00+02:00,2025-05-25,19:35,2,6,8
48,2025-05-25T03:16:00+02:00,2025-05-25,11:16,6,5,11
9,2025-05-25T11:28:00+02:00,2025-05-25,19:28,3,0,3
48,2025-05-25T03:19:00+02:00,2025-05-25,11:19,13,12,25
9,2025-05-25T11:29:00+02:00,2025-05-25,19:29,2,0,2
48,2025-05-25T03:22:00+02:00,2025-05-25,11:22,7,15,22
9,2025-05-25T11:33:00+02:00,2025-05-25,19:33,1,0,1
48,2025-05-25T03:23:00+02:00,2025-05-25,11:23,8,5,13
9,2025-05-25T11:39:00+02:00,2025-05-25,19:39,1,1,2
48,2025-05-25T03:24:00+02:00,2025-05-25,11:24,6,2,8
10,2025-05-25T11:26:00+02:00,2025-05-25,19:26,6,2,8
49,2025-05-25T03:11:00+02:00,2025-05-25,11:11,5,7,12
10,2025-05-25T11:28:00+02:00,2025-05-25,19:28,2,1,3
49,2025-05-25T03:13:00+02:00,2025-05-25,11:13,12,9,21
10,2025-05-25T11:37:00+02:00,2025-05-25,19:37,0,5,5
49,2025-05-25T03:16:00+02:00,2025-05-25,11:16,2,11,13
11,2025-05-25T11:25:00+02:00,2025-05-25,19:25,5,4,9
49,2025-05-25T03:18:00+02:00,2025-05-25,11:18,7,6,13
11,2025-05-25T11:35:00+02:00,2025-05-25,19:35,0,13,13
51,2025-05-25T03:12:00+02:00,2025-05-25,11:12,1,1,2
12,2025-05-25T11:25:00+02:00,2025-05-25,19:25,1,17,18
51,2025-05-25T03:20:00+02:00,2025-05-25,11:20,12,3,15
12,2025-05-25T11:26:00+02:00,2025-05-25,19:26,5,12,17
52,2025-05-25T03:17:00+02:00,2025-05-25,11:17,3,3,6
12,2025-05-25T11:32:00+02:00,2025-05-25,19:32,7,22,29
52,2025-05-25T03:20:00+02:00,2025-05-25,11:20,2,4,6
12,2025-05-25T11:37:00+02:00,2025-05-25,19:37,4,7,11
52,2025-05-25T03:23:00+02:00,2025-05-25,11:23,9,3,12
17,2025-05-25T11:26:00+02:00,2025-05-25,19:26,1,2,3
52,2025-05-25T03:24:00+02:00,2025-05-25,11:24,1,2,3
18,2025-05-25T11:27:00+02:00,2025-05-25,19:27,0,1,1
53,2025-05-25T03:13:00+02:00,2025-05-25,11:13,19,4,23
19,2025-05-25T11:25:00+02:00,2025-05-25,19:25,6,10,16
53,2025-05-25T03:16:00+02:00,2025-05-25,11:16,8,8,16
19,2025-05-25T11:31:00+02:00,2025-05-25,19:31,5,8,13
53,2025-05-25T03:17:00+02:00,2025-05-25,11:17,2,4,6
19,2025-05-25T11:35:00+02:00,2025-05-25,19:35,4,9,13
53,2025-05-25T03:18:00+02:00,2025-05-25,11:18,5,7,12
19,2025-05-25T11:39:00+02:00,2025-05-25,19:39,5,11,16
53,2025-05-25T03:19:00+02:00,2025-05-25,11:19,13,7,20
20,2025-05-25T11:25:00+02:00,2025-05-25,19:25,3,3,6
56,2025-05-25T03:19:00+02:00,2025-05-25,11:19,6,3,9
20,2025-05-25T11:26:00+02:00,2025-05-25,19:26,2,6,8
56,2025-05-25T03:21:00+02:00,2025-05-25,11:21,1,3,4
20,2025-05-25T11:31:00+02:00,2025-05-25,19:31,11,9,20
56,2025-05-25T03:23:00+02:00,2025-05-25,11:23,6,2,8
20,2025-05-25T11:33:00+02:00,2025-05-25,19:33,6,14,20
58,2025-05-25T03:11:00+02:00,2025-05-25,11:11,9,1,10
23,2025-05-25T11:27:00+02:00,2025-05-25,19:27,2,6,8
58,2025-05-25T03:14:00+02:00,2025-05-25,11:14,29,2,31
23,2025-05-25T11:33:00+02:00,2025-05-25,19:33,1,3,4
58,2025-05-25T03:16:00+02:00,2025-05-25,11:16,13,3,16
23,2025-05-25T11:36:00+02:00,2025-05-25,19:36,0,8,8
58,2025-05-25T03:22:00+02:00,2025-05-25,11:22,8,3,11
24,2025-05-25T11:28:00+02:00,2025-05-25,19:28,30,12,42
58,2025-05-25T03:23:00+02:00,2025-05-25,11:23,7,13,20
24,2025-05-25T11:31:00+02:00,2025-05-25,19:31,11,5,16
62,2025-05-25T03:11:00+02:00,2025-05-25,11:11,2,2,4
24,2025-05-25T11:32:00+02:00,2025-05-25,19:32,6,9,15
62,2025-05-25T03:12:00+02:00,2025-05-25,11:12,0,1,1
24,2025-05-25T11:33:00+02:00,2025-05-25,19:33,20,2,22
62,2025-05-25T03:17:00+02:00,2025-05-25,11:17,2,0,2
24,2025-05-25T11:38:00+02:00,2025-05-25,19:38,5,14,19
62,2025-05-25T03:21:00+02:00,2025-05-25,11:21,3,4,7
27,2025-05-25T11:32:00+02:00,2025-05-25,19:32,2,0,2
62,2025-05-25T03:23:00+02:00,2025-05-25,11:23,0,1,1
27,2025-05-25T11:39:00+02:00,2025-05-25,19:39,4,0,4
63,2025-05-25T03:13:00+02:00,2025-05-25,11:13,1,2,3
30,2025-05-25T11:27:00+02:00,2025-05-25,19:27,11,12,23
63,2025-05-25T03:15:00+02:00,2025-05-25,11:15,2,4,6
30,2025-05-25T11:28:00+02:00,2025-05-25,19:28,2,9,11
63,2025-05-25T03:17:00+02:00,2025-05-25,11:17,2,2,4
30,2025-05-25T11:37:00+02:00,2025-05-25,19:37,3,3,6
63,2025-05-25T03:18:00+02:00,2025-05-25,11:18,0,8,8
30,2025-05-25T11:38:00+02:00,2025-05-25,19:38,5,1,6
63,2025-05-25T03:21:00+02:00,2025-05-25,11:21,3,4,7
35,2025-05-25T11:25:00+02:00,2025-05-25,19:25,7,15,22
63,2025-05-25T03:22:00+02:00,2025-05-25,11:22,3,3,6
35,2025-05-25T11:28:00+02:00,2025-05-25,19:28,8,8,16
63,2025-05-25T03:23:00+02:00,2025-05-25,11:23,0,3,3
35,2025-05-25T11:35:00+02:00,2025-05-25,19:35,5,9,14
67,2025-05-25T03:14:00+02:00,2025-05-25,11:14,2,9,11
35,2025-05-25T11:36:00+02:00,2025-05-25,19:36,10,7,17
67,2025-05-25T03:17:00+02:00,2025-05-25,11:17,6,8,14
35,2025-05-25T11:39:00+02:00,2025-05-25,19:39,4,4,8
67,2025-05-25T03:18:00+02:00,2025-05-25,11:18,2,19,21
46,2025-05-25T11:30:00+02:00,2025-05-25,19:30,0,1,1
68,2025-05-25T03:10:00+02:00,2025-05-25,11:10,8,4,12
48,2025-05-25T11:25:00+02:00,2025-05-25,19:25,0,11,11
68,2025-05-25T03:14:00+02:00,2025-05-25,11:14,10,3,13
48,2025-05-25T11:29:00+02:00,2025-05-25,19:29,3,3,6
68,2025-05-25T03:18:00+02:00,2025-05-25,11:18,5,4,9
48,2025-05-25T11:30:00+02:00,2025-05-25,19:30,2,0,2
68,2025-05-25T03:21:00+02:00,2025-05-25,11:21,4,5,9
48,2025-05-25T11:31:00+02:00,2025-05-25,19:31,5,6,11
68,2025-05-25T03:23:00+02:00,2025-05-25,11:23,5,3,8
48,2025-05-25T11:36:00+02:00,2025-05-25,19:36,0,2,2
72,2025-05-25T03:10:00+02:00,2025-05-25,11:10,0,2,2
49,2025-05-25T11:27:00+02:00,2025-05-25,19:27,1,2,3
72,2025-05-25T03:13:00+02:00,2025-05-25,11:13,3,1,4
49,2025-05-25T11:32:00+02:00,2025-05-25,19:32,7,5,12
72,2025-05-25T03:14:00+02:00,2025-05-25,11:14,3,5,8
49,2025-05-25T11:34:00+02:00,2025-05-25,19:34,1,5,6
72,2025-05-25T03:24:00+02:00,2025-05-25,11:24,9,14,23
49,2025-05-25T11:36:00+02:00,2025-05-25,19:36,7,2,9
76,2025-05-25T03:13:00+02:00,2025-05-25,11:13,3,0,3
49,2025-05-25T11:38:00+02:00,2025-05-25,19:38,1,0,1
76,2025-05-25T03:14:00+02:00,2025-05-25,11:14,0,2,2
51,2025-05-25T11:30:00+02:00,2025-05-25,19:30,0,1,1
76,2025-05-25T03:19:00+02:00,2025-05-25,11:19,2,1,3
51,2025-05-25T11:32:00+02:00,2025-05-25,19:32,3,2,5
76,2025-05-25T03:23:00+02:00,2025-05-25,11:23,2,1,3
51,2025-05-25T11:33:00+02:00,2025-05-25,19:33,1,1,2
79,2025-05-25T03:10:00+02:00,2025-05-25,11:10,10,6,16
51,2025-05-25T11:34:00+02:00,2025-05-25,19:34,2,4,6
79,2025-05-25T03:11:00+02:00,2025-05-25,11:11,4,10,14
52,2025-05-25T11:25:00+02:00,2025-05-25,19:25,8,4,12
79,2025-05-25T03:12:00+02:00,2025-05-25,11:12,5,6,11
52,2025-05-25T11:26:00+02:00,2025-05-25,19:26,11,5,16
79,2025-05-25T03:14:00+02:00,2025-05-25,11:14,9,9,18
52,2025-05-25T11:30:00+02:00,2025-05-25,19:30,4,4,8
79,2025-05-25T03:15:00+02:00,2025-05-25,11:15,6,8,14
52,2025-05-25T11:32:00+02:00,2025-05-25,19:32,7,1,8
79,2025-05-25T03:17:00+02:00,2025-05-25,11:17,24,8,32
52,2025-05-25T11:35:00+02:00,2025-05-25,19:35,3,0,3
79,2025-05-25T03:18:00+02:00,2025-05-25,11:18,13,1,14
52,2025-05-25T11:36:00+02:00,2025-05-25,19:36,6,4,10
79,2025-05-25T03:21:00+02:00,2025-05-25,11:21,8,7,15
52,2025-05-25T11:38:00+02:00,2025-05-25,19:38,7,7,14
85,2025-05-25T03:14:00+02:00,2025-05-25,11:14,3,2,5
52,2025-05-25T11:39:00+02:00,2025-05-25,19:39,7,1,8
85,2025-05-25T03:15:00+02:00,2025-05-25,11:15,4,1,5
53,2025-05-25T11:27:00+02:00,2025-05-25,19:27,1,2,3
85,2025-05-25T03:23:00+02:00,2025-05-25,11:23,1,1,2
53,2025-05-25T11:32:00+02:00,2025-05-25,19:32,0,1,1
86,2025-05-25T03:10:00+02:00,2025-05-25,11:10,1,1,2
56,2025-05-25T11:28:00+02:00,2025-05-25,19:28,12,16,28
86,2025-05-25T03:12:00+02:00,2025-05-25,11:12,2,2,4
56,2025-05-25T11:31:00+02:00,2025-05-25,19:31,5,7,12
86,2025-05-25T03:13:00+02:00,2025-05-25,11:13,1,0,1
56,2025-05-25T11:33:00+02:00,2025-05-25,19:33,3,14,17
86,2025-05-25T03:17:00+02:00,2025-05-25,11:17,2,0,2
56,2025-05-25T11:36:00+02:00,2025-05-25,19:36,4,9,13
86,2025-05-25T03:21:00+02:00,2025-05-25,11:21,1,4,5
56,2025-05-25T11:37:00+02:00,2025-05-25,19:37,9,0,9
109,2025-05-25T03:10:00+02:00,2025-05-25,11:10,0,5,5
58,2025-05-25T11:28:00+02:00,2025-05-25,19:28,47,0,47
109,2025-05-25T03:15:00+02:00,2025-05-25,11:15,5,12,17
58,2025-05-25T11:35:00+02:00,2025-05-25,19:35,20,2,22
117,2025-05-25T03:10:00+02:00,2025-05-25,11:10,9,11,20
58,2025-05-25T11:38:00+02:00,2025-05-25,19:38,15,2,17
117,2025-05-25T03:20:00+02:00,2025-05-25,11:20,7,17,24
62,2025-05-25T11:28:00+02:00,2025-05-25,19:28,0,4,4
130,2025-05-25T03:10:00+02:00,2025-05-25,11:10,2,3,5
62,2025-05-25T11:32:00+02:00,2025-05-25,19:32,2,0,2
137,2025-05-25T03:10:00+02:00,2025-05-25,11:10,0,4,4
62,2025-05-25T11:37:00+02:00,2025-05-25,19:37,1,1,2
138,2025-05-25T03:10:00+02:00,2025-05-25,11:10,3,0,3
62,2025-05-25T11:39:00+02:00,2025-05-25,19:39,3,3,6
138,2025-05-25T03:20:00+02:00,2025-05-25,11:20,2,1,3
63,2025-05-25T11:26:00+02:00,2025-05-25,19:26,0,7,7
141,2025-05-25T03:10:00+02:00,2025-05-25,11:10,21,15,36
63,2025-05-25T11:27:00+02:00,2025-05-25,19:27,0,1,1
141,2025-05-25T03:20:00+02:00,2025-05-25,11:20,9,13,22
63,2025-05-25T11:30:00+02:00,2025-05-25,19:30,1,3,4
142,2025-05-25T03:20:00+02:00,2025-05-25,11:20,51,45,96
63,2025-05-25T11:33:00+02:00,2025-05-25,19:33,0,2,2
161,2025-05-25T03:10:00+02:00,2025-05-25,11:10,21,16,37
63,2025-05-25T11:35:00+02:00,2025-05-25,19:35,0,7,7
161,2025-05-25T03:20:00+02:00,2025-05-25,11:20,15,29,44
63,2025-05-25T11:36:00+02:00,2025-05-25,19:36,1,1,2
67,2025-05-25T11:25:00+02:00,2025-05-25,19:25,6,5,11
67,2025-05-25T11:31:00+02:00,2025-05-25,19:31,1,6,7
67,2025-05-25T11:35:00+02:00,2025-05-25,19:35,0,6,6
67,2025-05-25T11:37:00+02:00,2025-05-25,19:37,4,7,11
67,2025-05-25T11:39:00+02:00,2025-05-25,19:39,2,10,12
68,2025-05-25T11:29:00+02:00,2025-05-25,19:29,2,1,3
181,2025-05-25T03:12:00+02:00,2025-05-25,11:12,7,12,19
68,2025-05-25T11:33:00+02:00,2025-05-25,19:33,0,5,5
181,2025-05-25T03:15:00+02:00,2025-05-25,11:15,7,7,14
68,2025-05-25T11:38:00+02:00,2025-05-25,19:38,5,3,8
181,2025-05-25T03:19:00+02:00,2025-05-25,11:19,13,8,21
68,2025-05-25T11:39:00+02:00,2025-05-25,19:39,1,1,2
181,2025-05-25T03:21:00+02:00,2025-05-25,11:21,12,5,17
72,2025-05-25T11:28:00+02:00,2025-05-25,19:28,2,4,6
181,2025-05-25T03:22:00+02:00,2025-05-25,11:22,7,6,13
76,2025-05-25T11:31:00+02:00,2025-05-25,19:31,0,5,5
182,2025-05-25T03:20:00+02:00,2025-05-25,11:20,12,7,19
76,2025-05-25T11:39:00+02:00,2025-05-25,19:39,0,2,2
180,2025-05-25T03:18:00+02:00,2025-05-25,11:18,2,0,2
79,2025-05-25T11:27:00+02:00,2025-05-25,19:27,5,8,13
79,2025-05-25T11:28:00+02:00,2025-05-25,19:28,7,3,10
79,2025-05-25T11:30:00+02:00,2025-05-25,19:30,7,12,19
79,2025-05-25T11:33:00+02:00,2025-05-25,19:33,5,8,13
79,2025-05-25T11:38:00+02:00,2025-05-25,19:38,1,6,7
79,2025-05-25T11:39:00+02:00,2025-05-25,19:39,5,5,10
85,2025-05-25T11:35:00+02:00,2025-05-25,19:35,3,0,3
85,2025-05-25T11:36:00+02:00,2025-05-25,19:36,0,1,1
85,2025-05-25T11:38:00+02:00,2025-05-25,19:38,2,0,2
86,2025-05-25T11:26:00+02:00,2025-05-25,19:26,1,2,3
86,2025-05-25T11:27:00+02:00,2025-05-25,19:27,0,3,3
86,2025-05-25T11:30:00+02:00,2025-05-25,19:30,2,0,2
86,2025-05-25T11:32:00+02:00,2025-05-25,19:32,1,0,1
86,2025-05-25T11:33:00+02:00,2025-05-25,19:33,0,2,2
109,2025-05-25T11:30:00+02:00,2025-05-25,19:30,8,7,15
136,2025-05-25T11:25:00+02:00,2025-05-25,19:25,6,3,9
136,2025-05-25T11:35:00+02:00,2025-05-25,19:35,0,1,1
142,2025-05-25T11:25:00+02:00,2025-05-25,19:25,11,0,11
142,2025-05-25T11:30:00+02:00,2025-05-25,19:30,2,3,5
161,2025-05-25T11:30:00+02:00,2025-05-25,19:30,0,1,1
3,2025-05-25T03:27:00+02:00,2025-05-25,11:27,9,13,22
3,2025-05-25T03:29:00+02:00,2025-05-25,11:29,5,0,5
3,2025-05-25T03:34:00+02:00,2025-05-25,11:34,6,21,27
3,2025-05-25T03:35:00+02:00,2025-05-25,11:35,6,15,21
3,2025-05-25T03:36:00+02:00,2025-05-25,11:36,5,12,17
3,2025-05-25T03:38:00+02:00,2025-05-25,11:38,9,6,15
4,2025-05-25T03:28:00+02:00,2025-05-25,11:28,29,16,45
181,2025-05-25T11:25:00+02:00,2025-05-25,19:25,27,15,42
4,2025-05-25T03:29:00+02:00,2025-05-25,11:29,14,9,23
181,2025-05-25T11:33:00+02:00,2025-05-25,19:33,11,13,24
4,2025-05-25T03:31:00+02:00,2025-05-25,11:31,12,9,21
181,2025-05-25T11:39:00+02:00,2025-05-25,19:39,13,12,25
4,2025-05-25T03:34:00+02:00,2025-05-25,11:34,16,19,35
182,2025-05-25T11:25:00+02:00,2025-05-25,19:25,24,13,37
4,2025-05-25T03:37:00+02:00,2025-05-25,11:37,27,11,38
182,2025-05-25T11:35:00+02:00,2025-05-25,19:35,29,16,45
4,2025-05-25T03:38:00+02:00,2025-05-25,11:38,21,21,42
180,2025-05-25T11:27:00+02:00,2025-05-25,19:27,1,0,1
6,2025-05-25T03:26:00+02:00,2025-05-25,11:26,16,6,22
180,2025-05-25T11:39:00+02:00,2025-05-25,19:39,1,0,1
6,2025-05-25T03:30:00+02:00,2025-05-25,11:30,7,15,22
6,2025-05-25T03:33:00+02:00,2025-05-25,11:33,8,8,16
8,2025-05-25T03:26:00+02:00,2025-05-25,11:26,7,4,11
8,2025-05-25T03:31:00+02:00,2025-05-25,11:31,3,9,12
8,2025-05-25T03:32:00+02:00,2025-05-25,11:32,1,1,2
3,2025-05-25T08:27:00+02:00,2025-05-25,16:27,16,7,23
8,2025-05-25T03:33:00+02:00,2025-05-25,11:33,5,5,10
3,2025-05-25T08:29:00+02:00,2025-05-25,16:29,28,9,37
8,2025-05-25T03:34:00+02:00,2025-05-25,11:34,2,6,8
3,2025-05-25T08:33:00+02:00,2025-05-25,16:33,14,24,38
8,2025-05-25T03:38:00+02:00,2025-05-25,11:38,4,5,9
3,2025-05-25T08:35:00+02:00,2025-05-25,16:35,30,27,57
8,2025-05-25T03:39:00+02:00,2025-05-25,11:39,4,5,9
4,2025-05-25T08:28:00+02:00,2025-05-25,16:28,24,28,52
28,2025-05-25T03:25:00+02:00,2025-05-25,11:25,9,9,18
4,2025-05-25T08:29:00+02:00,2025-05-25,16:29,44,32,76
28,2025-05-25T03:27:00+02:00,2025-05-25,11:27,5,5,10
4,2025-05-25T08:34:00+02:00,2025-05-25,16:34,35,20,55
28,2025-05-25T03:28:00+02:00,2025-05-25,11:28,18,1,19
6,2025-05-25T08:25:00+02:00,2025-05-25,16:25,18,16,34
28,2025-05-25T03:29:00+02:00,2025-05-25,11:29,6,0,6
6,2025-05-25T08:27:00+02:00,2025-05-25,16:27,9,9,18
28,2025-05-25T03:30:00+02:00,2025-05-25,11:30,2,5,7
6,2025-05-25T08:28:00+02:00,2025-05-25,16:28,22,23,45
28,2025-05-25T03:31:00+02:00,2025-05-25,11:31,9,4,13
6,2025-05-25T08:29:00+02:00,2025-05-25,16:29,7,18,25
28,2025-05-25T03:33:00+02:00,2025-05-25,11:33,10,5,15
6,2025-05-25T08:31:00+02:00,2025-05-25,16:31,25,3,28
28,2025-05-25T03:36:00+02:00,2025-05-25,11:36,5,6,11
6,2025-05-25T08:32:00+02:00,2025-05-25,16:32,18,14,32
28,2025-05-25T03:38:00+02:00,2025-05-25,11:38,6,11,17
6,2025-05-25T08:33:00+02:00,2025-05-25,16:33,18,8,26
28,2025-05-25T03:39:00+02:00,2025-05-25,11:39,18,6,24
8,2025-05-25T08:32:00+02:00,2025-05-25,16:32,3,10,13
29,2025-05-25T03:30:00+02:00,2025-05-25,11:30,4,9,13
8,2025-05-25T08:34:00+02:00,2025-05-25,16:34,0,4,4
29,2025-05-25T03:31:00+02:00,2025-05-25,11:31,3,6,9
8,2025-05-25T08:38:00+02:00,2025-05-25,16:38,4,1,5
29,2025-05-25T03:32:00+02:00,2025-05-25,11:32,8,10,18
28,2025-05-25T08:28:00+02:00,2025-05-25,16:28,10,13,23
29,2025-05-25T03:34:00+02:00,2025-05-25,11:34,2,4,6
28,2025-05-25T08:32:00+02:00,2025-05-25,16:32,12,7,19
29,2025-05-25T03:35:00+02:00,2025-05-25,11:35,8,9,17
28,2025-05-25T08:35:00+02:00,2025-05-25,16:35,10,9,19
29,2025-05-25T03:39:00+02:00,2025-05-25,11:39,5,7,12
28,2025-05-25T08:36:00+02:00,2025-05-25,16:36,12,4,16
31,2025-05-25T03:27:00+02:00,2025-05-25,11:27,2,4,6
28,2025-05-25T08:37:00+02:00,2025-05-25,16:37,9,11,20
31,2025-05-25T03:30:00+02:00,2025-05-25,11:30,0,3,3
28,2025-05-25T08:38:00+02:00,2025-05-25,16:38,10,11,21
31,2025-05-25T03:36:00+02:00,2025-05-25,11:36,0,2,2
29,2025-05-25T08:31:00+02:00,2025-05-25,16:31,9,7,16
31,2025-05-25T03:39:00+02:00,2025-05-25,11:39,4,5,9
29,2025-05-25T08:33:00+02:00,2025-05-25,16:33,9,11,20
36,2025-05-25T03:30:00+02:00,2025-05-25,11:30,2,3,5
29,2025-05-25T08:35:00+02:00,2025-05-25,16:35,11,3,14
36,2025-05-25T03:33:00+02:00,2025-05-25,11:33,2,7,9
29,2025-05-25T08:38:00+02:00,2025-05-25,16:38,14,12,26
36,2025-05-25T03:35:00+02:00,2025-05-25,11:35,3,1,4
31,2025-05-25T08:31:00+02:00,2025-05-25,16:31,3,3,6
36,2025-05-25T03:36:00+02:00,2025-05-25,11:36,5,0,5
31,2025-05-25T08:32:00+02:00,2025-05-25,16:32,9,4,13
36,2025-05-25T03:39:00+02:00,2025-05-25,11:39,2,1,3
31,2025-05-25T08:34:00+02:00,2025-05-25,16:34,4,3,7
37,2025-05-25T03:26:00+02:00,2025-05-25,11:26,5,0,5
31,2025-05-25T08:36:00+02:00,2025-05-25,16:36,0,2,2
37,2025-05-25T03:30:00+02:00,2025-05-25,11:30,0,3,3
31,2025-05-25T08:38:00+02:00,2025-05-25,16:38,11,8,19
37,2025-05-25T03:32:00+02:00,2025-05-25,11:32,0,1,1
31,2025-05-25T08:39:00+02:00,2025-05-25,16:39,6,3,9
37,2025-05-25T03:33:00+02:00,2025-05-25,11:33,1,0,1
36,2025-05-25T08:26:00+02:00,2025-05-25,16:26,0,2,2
39,2025-05-25T03:25:00+02:00,2025-05-25,11:25,1,0,1
36,2025-05-25T08:27:00+02:00,2025-05-25,16:27,6,0,6
39,2025-05-25T03:36:00+02:00,2025-05-25,11:36,2,1,3
36,2025-05-25T08:28:00+02:00,2025-05-25,16:28,0,3,3
40,2025-05-25T03:29:00+02:00,2025-05-25,11:29,4,3,7
36,2025-05-25T08:29:00+02:00,2025-05-25,16:29,1,6,7
41,2025-05-25T03:37:00+02:00,2025-05-25,11:37,6,3,9
36,2025-05-25T08:32:00+02:00,2025-05-25,16:32,2,3,5
44,2025-05-25T03:30:00+02:00,2025-05-25,11:30,5,2,7
36,2025-05-25T08:35:00+02:00,2025-05-25,16:35,4,2,6
45,2025-05-25T03:27:00+02:00,2025-05-25,11:27,13,12,25
36,2025-05-25T08:36:00+02:00,2025-05-25,16:36,2,3,5
45,2025-05-25T03:28:00+02:00,2025-05-25,11:28,11,7,18
39,2025-05-25T08:28:00+02:00,2025-05-25,16:28,1,1,2
45,2025-05-25T03:30:00+02:00,2025-05-25,11:30,16,10,26
39,2025-05-25T08:29:00+02:00,2025-05-25,16:29,1,2,3
45,2025-05-25T03:32:00+02:00,2025-05-25,11:32,15,12,27
40,2025-05-25T08:27:00+02:00,2025-05-25,16:27,0,1,1
45,2025-05-25T03:37:00+02:00,2025-05-25,11:37,6,6,12
40,2025-05-25T08:31:00+02:00,2025-05-25,16:31,1,2,3
47,2025-05-25T03:25:00+02:00,2025-05-25,11:25,13,8,21
40,2025-05-25T08:32:00+02:00,2025-05-25,16:32,7,2,9
47,2025-05-25T03:28:00+02:00,2025-05-25,11:28,13,10,23
40,2025-05-25T08:34:00+02:00,2025-05-25,16:34,5,0,5
47,2025-05-25T03:30:00+02:00,2025-05-25,11:30,11,15,26
40,2025-05-25T08:39:00+02:00,2025-05-25,16:39,2,0,2
47,2025-05-25T03:35:00+02:00,2025-05-25,11:35,11,3,14
41,2025-05-25T08:28:00+02:00,2025-05-25,16:28,24,11,35
47,2025-05-25T03:38:00+02:00,2025-05-25,11:38,5,15,20
41,2025-05-25T08:36:00+02:00,2025-05-25,16:36,9,10,19
47,2025-05-25T03:39:00+02:00,2025-05-25,11:39,13,14,27
41,2025-05-25T08:39:00+02:00,2025-05-25,16:39,1,1,2
50,2025-05-25T03:29:00+02:00,2025-05-25,11:29,3,5,8
43,2025-05-25T08:25:00+02:00,2025-05-25,16:25,8,11,19
50,2025-05-25T03:30:00+02:00,2025-05-25,11:30,8,2,10
44,2025-05-25T08:25:00+02:00,2025-05-25,16:25,5,7,12
50,2025-05-25T03:31:00+02:00,2025-05-25,11:31,1,7,8
45,2025-05-25T08:29:00+02:00,2025-05-25,16:29,32,17,49
50,2025-05-25T03:32:00+02:00,2025-05-25,11:32,3,0,3
45,2025-05-25T08:33:00+02:00,2025-05-25,16:33,16,11,27
50,2025-05-25T03:33:00+02:00,2025-05-25,11:33,12,5,17
45,2025-05-25T08:35:00+02:00,2025-05-25,16:35,30,22,52
50,2025-05-25T03:36:00+02:00,2025-05-25,11:36,2,5,7
45,2025-05-25T08:36:00+02:00,2025-05-25,16:36,18,14,32
54,2025-05-25T03:30:00+02:00,2025-05-25,11:30,2,0,2
45,2025-05-25T08:39:00+02:00,2025-05-25,16:39,22,14,36
54,2025-05-25T03:35:00+02:00,2025-05-25,11:35,3,2,5
47,2025-05-25T08:26:00+02:00,2025-05-25,16:26,33,22,55
59,2025-05-25T03:25:00+02:00,2025-05-25,11:25,7,16,23
47,2025-05-25T08:27:00+02:00,2025-05-25,16:27,31,11,42
61,2025-05-25T03:25:00+02:00,2025-05-25,11:25,1,3,4
47,2025-05-25T08:28:00+02:00,2025-05-25,16:28,19,29,48
61,2025-05-25T03:29:00+02:00,2025-05-25,11:29,5,8,13
47,2025-05-25T08:32:00+02:00,2025-05-25,16:32,19,27,46
61,2025-05-25T03:31:00+02:00,2025-05-25,11:31,0,11,11
47,2025-05-25T08:36:00+02:00,2025-05-25,16:36,20,10,30
61,2025-05-25T03:32:00+02:00,2025-05-25,11:32,5,5,10
47,2025-05-25T08:38:00+02:00,2025-05-25,16:38,22,19,41
66,2025-05-25T03:27:00+02:00,2025-05-25,11:27,7,13,20
50,2025-05-25T08:25:00+02:00,2025-05-25,16:25,5,0,5
66,2025-05-25T03:31:00+02:00,2025-05-25,11:31,8,9,17
50,2025-05-25T08:26:00+02:00,2025-05-25,16:26,5,1,6
66,2025-05-25T03:33:00+02:00,2025-05-25,11:33,10,12,22
50,2025-05-25T08:31:00+02:00,2025-05-25,16:31,4,3,7
66,2025-05-25T03:34:00+02:00,2025-05-25,11:34,8,6,14
50,2025-05-25T08:34:00+02:00,2025-05-25,16:34,3,3,6
66,2025-05-25T03:35:00+02:00,2025-05-25,11:35,8,20,28
50,2025-05-25T08:37:00+02:00,2025-05-25,16:37,5,1,6
66,2025-05-25T03:37:00+02:00,2025-05-25,11:37,17,11,28
50,2025-05-25T08:39:00+02:00,2025-05-25,16:39,5,6,11
66,2025-05-25T03:38:00+02:00,2025-05-25,11:38,8,19,27
54,2025-05-25T08:27:00+02:00,2025-05-25,16:27,0,2,2
66,2025-05-25T03:39:00+02:00,2025-05-25,11:39,14,17,31
54,2025-05-25T08:30:00+02:00,2025-05-25,16:30,2,0,2
69,2025-05-25T03:26:00+02:00,2025-05-25,11:26,7,1,8
54,2025-05-25T08:34:00+02:00,2025-05-25,16:34,3,0,3
69,2025-05-25T03:30:00+02:00,2025-05-25,11:30,6,6,12
54,2025-05-25T08:36:00+02:00,2025-05-25,16:36,2,3,5
69,2025-05-25T03:32:00+02:00,2025-05-25,11:32,5,1,6
54,2025-05-25T08:37:00+02:00,2025-05-25,16:37,3,1,4
69,2025-05-25T03:39:00+02:00,2025-05-25,11:39,1,5,6
54,2025-05-25T08:38:00+02:00,2025-05-25,16:38,4,3,7
70,2025-05-25T03:26:00+02:00,2025-05-25,11:26,0,1,1
54,2025-05-25T08:39:00+02:00,2025-05-25,16:39,0,3,3
70,2025-05-25T03:39:00+02:00,2025-05-25,11:39,1,1,2
61,2025-05-25T08:27:00+02:00,2025-05-25,16:27,8,10,18
71,2025-05-25T03:35:00+02:00,2025-05-25,11:35,1,0,1
61,2025-05-25T08:33:00+02:00,2025-05-25,16:33,5,6,11
75,2025-05-25T03:25:00+02:00,2025-05-25,11:25,0,1,1
61,2025-05-25T08:34:00+02:00,2025-05-25,16:34,21,10,31
75,2025-05-25T03:33:00+02:00,2025-05-25,11:33,5,0,5
61,2025-05-25T08:36:00+02:00,2025-05-25,16:36,11,5,16
75,2025-05-25T03:38:00+02:00,2025-05-25,11:38,3,0,3
61,2025-05-25T08:39:00+02:00,2025-05-25,16:39,10,5,15
75,2025-05-25T03:39:00+02:00,2025-05-25,11:39,0,2,2
66,2025-05-25T08:26:00+02:00,2025-05-25,16:26,21,20,41
77,2025-05-25T03:25:00+02:00,2025-05-25,11:25,19,10,29
66,2025-05-25T08:36:00+02:00,2025-05-25,16:36,19,16,35
77,2025-05-25T03:30:00+02:00,2025-05-25,11:30,18,15,33
69,2025-05-25T08:25:00+02:00,2025-05-25,16:25,6,2,8
78,2025-05-25T03:28:00+02:00,2025-05-25,11:28,0,4,4
69,2025-05-25T08:26:00+02:00,2025-05-25,16:26,1,1,2
78,2025-05-25T03:29:00+02:00,2025-05-25,11:29,2,3,5
69,2025-05-25T08:28:00+02:00,2025-05-25,16:28,2,0,2
78,2025-05-25T03:34:00+02:00,2025-05-25,11:34,0,2,2
69,2025-05-25T08:29:00+02:00,2025-05-25,16:29,6,0,6
84,2025-05-25T03:25:00+02:00,2025-05-25,11:25,126,55,181
69,2025-05-25T08:36:00+02:00,2025-05-25,16:36,8,4,12
84,2025-05-25T03:35:00+02:00,2025-05-25,11:35,61,85,146
70,2025-05-25T08:27:00+02:00,2025-05-25,16:27,6,5,11
87,2025-05-25T03:28:00+02:00,2025-05-25,11:28,3,1,4
70,2025-05-25T08:30:00+02:00,2025-05-25,16:30,3,3,6
87,2025-05-25T03:31:00+02:00,2025-05-25,11:31,6,3,9
70,2025-05-25T08:35:00+02:00,2025-05-25,16:35,4,3,7
87,2025-05-25T03:32:00+02:00,2025-05-25,11:32,3,0,3
70,2025-05-25T08:37:00+02:00,2025-05-25,16:37,1,3,4
107,2025-05-25T03:25:00+02:00,2025-05-25,11:25,5,7,12
71,2025-05-25T08:35:00+02:00,2025-05-25,16:35,0,1,1
108,2025-05-25T03:28:00+02:00,2025-05-25,11:28,1,1,2
71,2025-05-25T08:38:00+02:00,2025-05-25,16:38,1,0,1
108,2025-05-25T03:37:00+02:00,2025-05-25,11:37,0,2,2
75,2025-05-25T08:25:00+02:00,2025-05-25,16:25,0,1,1
118,2025-05-25T03:25:00+02:00,2025-05-25,11:25,3,0,3
75,2025-05-25T08:29:00+02:00,2025-05-25,16:29,0,3,3
118,2025-05-25T03:30:00+02:00,2025-05-25,11:30,1,4,5
75,2025-05-25T08:31:00+02:00,2025-05-25,16:31,0,3,3
124,2025-05-25T03:30:00+02:00,2025-05-25,11:30,0,1,1
75,2025-05-25T08:33:00+02:00,2025-05-25,16:33,1,3,4
131,2025-05-25T03:30:00+02:00,2025-05-25,11:30,6,2,8
75,2025-05-25T08:34:00+02:00,2025-05-25,16:34,2,2,4
132,2025-05-25T03:35:00+02:00,2025-05-25,11:35,23,11,34
75,2025-05-25T08:35:00+02:00,2025-05-25,16:35,1,0,1
133,2025-05-25T03:25:00+02:00,2025-05-25,11:25,32,52,84
75,2025-05-25T08:39:00+02:00,2025-05-25,16:39,3,2,5
134,2025-05-25T03:30:00+02:00,2025-05-25,11:30,48,22,70
77,2025-05-25T08:35:00+02:00,2025-05-25,16:35,21,15,36
140,2025-05-25T03:25:00+02:00,2025-05-25,11:25,8,8,16
78,2025-05-25T08:25:00+02:00,2025-05-25,16:25,0,3,3
140,2025-05-25T03:35:00+02:00,2025-05-25,11:35,18,11,29
78,2025-05-25T08:29:00+02:00,2025-05-25,16:29,1,0,1
162,2025-05-25T03:25:00+02:00,2025-05-25,11:25,35,45,80
78,2025-05-25T08:30:00+02:00,2025-05-25,16:30,2,5,7
165,2025-05-25T03:25:00+02:00,2025-05-25,11:25,0,5,5
78,2025-05-25T08:32:00+02:00,2025-05-25,16:32,1,3,4
166,2025-05-25T03:35:00+02:00,2025-05-25,11:35,3,4,7
78,2025-05-25T08:35:00+02:00,2025-05-25,16:35,0,1,1
179,2025-05-25T03:30:00+02:00,2025-05-25,11:30,4,4,8
78,2025-05-25T08:36:00+02:00,2025-05-25,16:36,0,1,1
179,2025-05-25T03:35:00+02:00,2025-05-25,11:35,4,1,5
84,2025-05-25T08:25:00+02:00,2025-05-25,16:25,86,111,197
1,2025-05-25T03:27:00+02:00,2025-05-25,11:27,8,17,25
84,2025-05-25T08:30:00+02:00,2025-05-25,16:30,116,116,232
1,2025-05-25T03:29:00+02:00,2025-05-25,11:29,27,14,41
87,2025-05-25T08:26:00+02:00,2025-05-25,16:26,0,1,1
1,2025-05-25T03:39:00+02:00,2025-05-25,11:39,45,13,58
87,2025-05-25T08:28:00+02:00,2025-05-25,16:28,1,4,5
2,2025-05-25T03:26:00+02:00,2025-05-25,11:26,10,2,12
87,2025-05-25T08:30:00+02:00,2025-05-25,16:30,0,2,2
2,2025-05-25T03:27:00+02:00,2025-05-25,11:27,11,10,21
87,2025-05-25T08:32:00+02:00,2025-05-25,16:32,9,1,10
2,2025-05-25T03:28:00+02:00,2025-05-25,11:28,11,7,18
87,2025-05-25T08:38:00+02:00,2025-05-25,16:38,1,3,4
2,2025-05-25T03:29:00+02:00,2025-05-25,11:29,7,13,20
87,2025-05-25T08:39:00+02:00,2025-05-25,16:39,1,1,2
2,2025-05-25T03:32:00+02:00,2025-05-25,11:32,19,5,24
107,2025-05-25T08:30:00+02:00,2025-05-25,16:30,10,5,15
2,2025-05-25T03:33:00+02:00,2025-05-25,11:33,11,9,20
107,2025-05-25T08:35:00+02:00,2025-05-25,16:35,9,10,19
2,2025-05-25T03:36:00+02:00,2025-05-25,11:36,7,0,7
108,2025-05-25T08:25:00+02:00,2025-05-25,16:25,0,1,1
2,2025-05-25T03:39:00+02:00,2025-05-25,11:39,12,17,29
108,2025-05-25T08:30:00+02:00,2025-05-25,16:30,0,6,6
9,2025-05-25T03:29:00+02:00,2025-05-25,11:29,1,0,1
108,2025-05-25T08:32:00+02:00,2025-05-25,16:32,1,0,1
9,2025-05-25T03:31:00+02:00,2025-05-25,11:31,1,1,2
108,2025-05-25T08:33:00+02:00,2025-05-25,16:33,2,0,2
9,2025-05-25T03:36:00+02:00,2025-05-25,11:36,1,1,2
108,2025-05-25T08:38:00+02:00,2025-05-25,16:38,2,1,3
9,2025-05-25T03:37:00+02:00,2025-05-25,11:37,0,2,2
108,2025-05-25T08:39:00+02:00,2025-05-25,16:39,4,2,6
9,2025-05-25T03:39:00+02:00,2025-05-25,11:39,0,2,2
118,2025-05-25T08:25:00+02:00,2025-05-25,16:25,2,4,6
10,2025-05-25T03:31:00+02:00,2025-05-25,11:31,0,2,2
118,2025-05-25T08:30:00+02:00,2025-05-25,16:30,2,3,5
11,2025-05-25T03:28:00+02:00,2025-05-25,11:28,0,4,4
124,2025-05-25T08:35:00+02:00,2025-05-25,16:35,1,0,1
11,2025-05-25T03:31:00+02:00,2025-05-25,11:31,3,3,6
132,2025-05-25T08:35:00+02:00,2025-05-25,16:35,10,22,32
11,2025-05-25T03:35:00+02:00,2025-05-25,11:35,4,0,4
134,2025-05-25T08:25:00+02:00,2025-05-25,16:25,33,18,51
12,2025-05-25T03:30:00+02:00,2025-05-25,11:30,1,9,10
134,2025-05-25T08:30:00+02:00,2025-05-25,16:30,47,30,77
12,2025-05-25T03:36:00+02:00,2025-05-25,11:36,2,0,2
162,2025-05-25T08:30:00+02:00,2025-05-25,16:30,30,31,61
17,2025-05-25T03:25:00+02:00,2025-05-25,11:25,3,3,6
165,2025-05-25T08:25:00+02:00,2025-05-25,16:25,3,12,15
17,2025-05-25T03:28:00+02:00,2025-05-25,11:28,6,3,9
165,2025-05-25T08:35:00+02:00,2025-05-25,16:35,1,2,3
17,2025-05-25T03:31:00+02:00,2025-05-25,11:31,1,0,1
1,2025-05-25T08:26:00+02:00,2025-05-25,16:26,22,19,41
17,2025-05-25T03:34:00+02:00,2025-05-25,11:34,4,1,5
1,2025-05-25T08:27:00+02:00,2025-05-25,16:27,21,21,42
17,2025-05-25T03:37:00+02:00,2025-05-25,11:37,4,2,6
1,2025-05-25T08:29:00+02:00,2025-05-25,16:29,9,33,42
17,2025-05-25T03:38:00+02:00,2025-05-25,11:38,0,7,7
1,2025-05-25T08:31:00+02:00,2025-05-25,16:31,16,22,38
17,2025-05-25T03:39:00+02:00,2025-05-25,11:39,10,3,13
1,2025-05-25T08:35:00+02:00,2025-05-25,16:35,26,8,34
18,2025-05-25T03:31:00+02:00,2025-05-25,11:31,0,1,1
1,2025-05-25T08:38:00+02:00,2025-05-25,16:38,23,21,44
18,2025-05-25T03:32:00+02:00,2025-05-25,11:32,2,2,4
2,2025-05-25T08:29:00+02:00,2025-05-25,16:29,5,9,14
18,2025-05-25T03:33:00+02:00,2025-05-25,11:33,1,0,1
2,2025-05-25T08:30:00+02:00,2025-05-25,16:30,6,8,14
18,2025-05-25T03:35:00+02:00,2025-05-25,11:35,1,0,1
2,2025-05-25T08:32:00+02:00,2025-05-25,16:32,11,15,26
18,2025-05-25T03:36:00+02:00,2025-05-25,11:36,0,1,1
2,2025-05-25T08:33:00+02:00,2025-05-25,16:33,7,16,23
18,2025-05-25T03:38:00+02:00,2025-05-25,11:38,1,0,1
2,2025-05-25T08:34:00+02:00,2025-05-25,16:34,6,15,21
19,2025-05-25T03:26:00+02:00,2025-05-25,11:26,6,12,18
9,2025-05-25T08:26:00+02:00,2025-05-25,16:26,2,0,2
19,2025-05-25T03:27:00+02:00,2025-05-25,11:27,2,1,3
9,2025-05-25T08:29:00+02:00,2025-05-25,16:29,4,0,4
19,2025-05-25T03:29:00+02:00,2025-05-25,11:29,1,3,4
9,2025-05-25T08:30:00+02:00,2025-05-25,16:30,3,2,5
19,2025-05-25T03:33:00+02:00,2025-05-25,11:33,8,5,13
9,2025-05-25T08:31:00+02:00,2025-05-25,16:31,0,7,7
19,2025-05-25T03:38:00+02:00,2025-05-25,11:38,16,1,17
9,2025-05-25T08:36:00+02:00,2025-05-25,16:36,5,2,7
20,2025-05-25T03:31:00+02:00,2025-05-25,11:31,6,1,7
9,2025-05-25T08:38:00+02:00,2025-05-25,16:38,0,1,1
20,2025-05-25T03:38:00+02:00,2025-05-25,11:38,6,3,9
10,2025-05-25T08:27:00+02:00,2025-05-25,16:27,0,1,1
20,2025-05-25T03:39:00+02:00,2025-05-25,11:39,0,3,3
10,2025-05-25T08:39:00+02:00,2025-05-25,16:39,3,0,3
23,2025-05-25T03:26:00+02:00,2025-05-25,11:26,1,0,1
11,2025-05-25T08:31:00+02:00,2025-05-25,16:31,1,2,3
23,2025-05-25T03:27:00+02:00,2025-05-25,11:27,2,0,2
11,2025-05-25T08:34:00+02:00,2025-05-25,16:34,5,6,11
23,2025-05-25T03:30:00+02:00,2025-05-25,11:30,2,2,4
11,2025-05-25T08:36:00+02:00,2025-05-25,16:36,5,1,6
23,2025-05-25T03:31:00+02:00,2025-05-25,11:31,0,5,5
11,2025-05-25T08:39:00+02:00,2025-05-25,16:39,0,1,1
23,2025-05-25T03:32:00+02:00,2025-05-25,11:32,4,2,6
12,2025-05-25T08:26:00+02:00,2025-05-25,16:26,3,5,8
23,2025-05-25T03:34:00+02:00,2025-05-25,11:34,0,2,2
12,2025-05-25T08:27:00+02:00,2025-05-25,16:27,10,3,13
23,2025-05-25T03:35:00+02:00,2025-05-25,11:35,4,0,4
12,2025-05-25T08:29:00+02:00,2025-05-25,16:29,7,7,14
23,2025-05-25T03:38:00+02:00,2025-05-25,11:38,2,0,2
17,2025-05-25T08:33:00+02:00,2025-05-25,16:33,0,1,1
24,2025-05-25T03:31:00+02:00,2025-05-25,11:31,5,15,20
17,2025-05-25T08:38:00+02:00,2025-05-25,16:38,4,0,4
24,2025-05-25T03:33:00+02:00,2025-05-25,11:33,2,10,12
17,2025-05-25T08:39:00+02:00,2025-05-25,16:39,0,4,4
25,2025-05-25T03:25:00+02:00,2025-05-25,11:25,49,108,157
18,2025-05-25T08:27:00+02:00,2025-05-25,16:27,2,0,2
27,2025-05-25T03:30:00+02:00,2025-05-25,11:30,3,3,6
18,2025-05-25T08:39:00+02:00,2025-05-25,16:39,0,1,1
27,2025-05-25T03:32:00+02:00,2025-05-25,11:32,7,3,10
19,2025-05-25T08:26:00+02:00,2025-05-25,16:26,8,12,20
30,2025-05-25T03:31:00+02:00,2025-05-25,11:31,1,3,4
19,2025-05-25T08:27:00+02:00,2025-05-25,16:27,3,9,12
30,2025-05-25T03:35:00+02:00,2025-05-25,11:35,1,8,9
19,2025-05-25T08:34:00+02:00,2025-05-25,16:34,6,9,15
35,2025-05-25T03:27:00+02:00,2025-05-25,11:27,23,19,42
19,2025-05-25T08:35:00+02:00,2025-05-25,16:35,7,4,11
35,2025-05-25T03:30:00+02:00,2025-05-25,11:30,19,8,27
19,2025-05-25T08:36:00+02:00,2025-05-25,16:36,11,14,25
35,2025-05-25T03:32:00+02:00,2025-05-25,11:32,17,18,35
19,2025-05-25T08:38:00+02:00,2025-05-25,16:38,5,11,16
35,2025-05-25T03:36:00+02:00,2025-05-25,11:36,6,13,19
20,2025-05-25T08:26:00+02:00,2025-05-25,16:26,5,4,9
48,2025-05-25T03:26:00+02:00,2025-05-25,11:26,7,8,15
20,2025-05-25T08:31:00+02:00,2025-05-25,16:31,5,7,12
48,2025-05-25T03:29:00+02:00,2025-05-25,11:29,8,10,18
20,2025-05-25T08:33:00+02:00,2025-05-25,16:33,3,10,13
48,2025-05-25T03:32:00+02:00,2025-05-25,11:32,10,6,16
20,2025-05-25T08:34:00+02:00,2025-05-25,16:34,6,5,11
48,2025-05-25T03:33:00+02:00,2025-05-25,11:33,4,6,10
23,2025-05-25T08:26:00+02:00,2025-05-25,16:26,1,11,12
48,2025-05-25T03:34:00+02:00,2025-05-25,11:34,10,6,16
23,2025-05-25T08:28:00+02:00,2025-05-25,16:28,0,1,1
48,2025-05-25T03:35:00+02:00,2025-05-25,11:35,9,6,15
23,2025-05-25T08:31:00+02:00,2025-05-25,16:31,3,0,3
48,2025-05-25T03:36:00+02:00,2025-05-25,11:36,8,3,11
23,2025-05-25T08:32:00+02:00,2025-05-25,16:32,2,0,2
48,2025-05-25T03:37:00+02:00,2025-05-25,11:37,11,5,16
23,2025-05-25T08:35:00+02:00,2025-05-25,16:35,0,4,4
48,2025-05-25T03:39:00+02:00,2025-05-25,11:39,6,16,22
23,2025-05-25T08:36:00+02:00,2025-05-25,16:36,3,5,8
49,2025-05-25T03:33:00+02:00,2025-05-25,11:33,8,8,16
23,2025-05-25T08:37:00+02:00,2025-05-25,16:37,1,6,7
49,2025-05-25T03:34:00+02:00,2025-05-25,11:34,2,9,11
23,2025-05-25T08:38:00+02:00,2025-05-25,16:38,0,11,11
49,2025-05-25T03:35:00+02:00,2025-05-25,11:35,4,9,13
24,2025-05-25T08:25:00+02:00,2025-05-25,16:25,2,28,30
49,2025-05-25T03:37:00+02:00,2025-05-25,11:37,8,2,10
24,2025-05-25T08:27:00+02:00,2025-05-25,16:27,18,16,34
49,2025-05-25T03:39:00+02:00,2025-05-25,11:39,7,4,11
24,2025-05-25T08:31:00+02:00,2025-05-25,16:31,4,9,13
51,2025-05-25T03:26:00+02:00,2025-05-25,11:26,1,9,10
24,2025-05-25T08:32:00+02:00,2025-05-25,16:32,10,26,36
51,2025-05-25T03:28:00+02:00,2025-05-25,11:28,1,1,2
24,2025-05-25T08:34:00+02:00,2025-05-25,16:34,4,21,25
51,2025-05-25T03:29:00+02:00,2025-05-25,11:29,6,3,9
24,2025-05-25T08:36:00+02:00,2025-05-25,16:36,1,20,21
51,2025-05-25T03:30:00+02:00,2025-05-25,11:30,6,1,7
25,2025-05-25T08:25:00+02:00,2025-05-25,16:25,109,53,162
51,2025-05-25T03:31:00+02:00,2025-05-25,11:31,4,0,4
27,2025-05-25T08:29:00+02:00,2025-05-25,16:29,0,3,3
51,2025-05-25T03:32:00+02:00,2025-05-25,11:32,1,1,2
27,2025-05-25T08:30:00+02:00,2025-05-25,16:30,3,0,3
51,2025-05-25T03:33:00+02:00,2025-05-25,11:33,2,1,3
27,2025-05-25T08:31:00+02:00,2025-05-25,16:31,1,2,3
51,2025-05-25T03:36:00+02:00,2025-05-25,11:36,8,2,10
27,2025-05-25T08:39:00+02:00,2025-05-25,16:39,8,0,8
51,2025-05-25T03:37:00+02:00,2025-05-25,11:37,1,5,6
30,2025-05-25T08:26:00+02:00,2025-05-25,16:26,3,5,8
51,2025-05-25T03:38:00+02:00,2025-05-25,11:38,4,2,6
30,2025-05-25T08:29:00+02:00,2025-05-25,16:29,2,18,20
52,2025-05-25T03:25:00+02:00,2025-05-25,11:25,4,0,4
30,2025-05-25T08:30:00+02:00,2025-05-25,16:30,2,12,14
52,2025-05-25T03:28:00+02:00,2025-05-25,11:28,3,1,4
30,2025-05-25T08:33:00+02:00,2025-05-25,16:33,5,9,14
52,2025-05-25T03:35:00+02:00,2025-05-25,11:35,4,8,12
30,2025-05-25T08:34:00+02:00,2025-05-25,16:34,5,5,10
52,2025-05-25T03:39:00+02:00,2025-05-25,11:39,2,0,2
30,2025-05-25T08:37:00+02:00,2025-05-25,16:37,8,5,13
53,2025-05-25T03:26:00+02:00,2025-05-25,11:26,10,8,18
30,2025-05-25T08:38:00+02:00,2025-05-25,16:38,0,4,4
53,2025-05-25T03:28:00+02:00,2025-05-25,11:28,13,4,17
35,2025-05-25T08:25:00+02:00,2025-05-25,16:25,22,31,53
53,2025-05-25T03:33:00+02:00,2025-05-25,11:33,17,0,17
35,2025-05-25T08:26:00+02:00,2025-05-25,16:26,18,25,43
53,2025-05-25T03:34:00+02:00,2025-05-25,11:34,15,3,18
35,2025-05-25T08:29:00+02:00,2025-05-25,16:29,32,17,49
53,2025-05-25T03:35:00+02:00,2025-05-25,11:35,15,8,23
35,2025-05-25T08:32:00+02:00,2025-05-25,16:32,23,16,39
53,2025-05-25T03:37:00+02:00,2025-05-25,11:37,11,12,23
46,2025-05-25T08:30:00+02:00,2025-05-25,16:30,5,7,12
53,2025-05-25T03:39:00+02:00,2025-05-25,11:39,5,3,8
46,2025-05-25T08:35:00+02:00,2025-05-25,16:35,9,7,16
56,2025-05-25T03:25:00+02:00,2025-05-25,11:25,15,3,18
48,2025-05-25T08:28:00+02:00,2025-05-25,16:28,10,3,13
56,2025-05-25T03:33:00+02:00,2025-05-25,11:33,10,8,18
48,2025-05-25T08:30:00+02:00,2025-05-25,16:30,8,5,13
56,2025-05-25T03:36:00+02:00,2025-05-25,11:36,8,2,10
48,2025-05-25T08:32:00+02:00,2025-05-25,16:32,9,3,12
58,2025-05-25T03:27:00+02:00,2025-05-25,11:27,21,10,31
49,2025-05-25T08:27:00+02:00,2025-05-25,16:27,9,7,16
58,2025-05-25T03:28:00+02:00,2025-05-25,11:28,6,2,8
49,2025-05-25T08:34:00+02:00,2025-05-25,16:34,2,2,4
58,2025-05-25T03:31:00+02:00,2025-05-25,11:31,3,3,6
49,2025-05-25T08:36:00+02:00,2025-05-25,16:36,4,2,6
58,2025-05-25T03:34:00+02:00,2025-05-25,11:34,18,5,23
51,2025-05-25T08:25:00+02:00,2025-05-25,16:25,1,3,4
58,2025-05-25T03:36:00+02:00,2025-05-25,11:36,12,5,17
51,2025-05-25T08:27:00+02:00,2025-05-25,16:27,11,0,11
58,2025-05-25T03:37:00+02:00,2025-05-25,11:37,3,2,5
51,2025-05-25T08:30:00+02:00,2025-05-25,16:30,1,0,1
62,2025-05-25T03:26:00+02:00,2025-05-25,11:26,3,5,8
51,2025-05-25T08:31:00+02:00,2025-05-25,16:31,2,8,10
62,2025-05-25T03:27:00+02:00,2025-05-25,11:27,3,0,3
51,2025-05-25T08:34:00+02:00,2025-05-25,16:34,7,0,7
62,2025-05-25T03:30:00+02:00,2025-05-25,11:30,11,3,14
51,2025-05-25T08:36:00+02:00,2025-05-25,16:36,4,0,4
62,2025-05-25T03:31:00+02:00,2025-05-25,11:31,5,4,9
52,2025-05-25T08:28:00+02:00,2025-05-25,16:28,7,7,14
62,2025-05-25T03:32:00+02:00,2025-05-25,11:32,1,3,4
52,2025-05-25T08:33:00+02:00,2025-05-25,16:33,9,7,16
62,2025-05-25T03:33:00+02:00,2025-05-25,11:33,2,0,2
52,2025-05-25T08:35:00+02:00,2025-05-25,16:35,4,3,7
62,2025-05-25T03:34:00+02:00,2025-05-25,11:34,0,1,1
52,2025-05-25T08:38:00+02:00,2025-05-25,16:38,6,7,13
62,2025-05-25T03:38:00+02:00,2025-05-25,11:38,2,0,2
53,2025-05-25T08:26:00+02:00,2025-05-25,16:26,4,4,8
62,2025-05-25T03:39:00+02:00,2025-05-25,11:39,0,5,5
53,2025-05-25T08:28:00+02:00,2025-05-25,16:28,2,6,8
63,2025-05-25T03:30:00+02:00,2025-05-25,11:30,0,4,4
53,2025-05-25T08:29:00+02:00,2025-05-25,16:29,6,10,16
63,2025-05-25T03:33:00+02:00,2025-05-25,11:33,12,6,18
53,2025-05-25T08:31:00+02:00,2025-05-25,16:31,11,6,17
63,2025-05-25T03:34:00+02:00,2025-05-25,11:34,1,4,5
53,2025-05-25T08:33:00+02:00,2025-05-25,16:33,6,3,9
67,2025-05-25T03:26:00+02:00,2025-05-25,11:26,3,11,14
53,2025-05-25T08:35:00+02:00,2025-05-25,16:35,10,8,18
67,2025-05-25T03:32:00+02:00,2025-05-25,11:32,7,9,16
53,2025-05-25T08:36:00+02:00,2025-05-25,16:36,9,2,11
67,2025-05-25T03:33:00+02:00,2025-05-25,11:33,5,5,10
53,2025-05-25T08:37:00+02:00,2025-05-25,16:37,5,2,7
67,2025-05-25T03:36:00+02:00,2025-05-25,11:36,7,9,16
53,2025-05-25T08:38:00+02:00,2025-05-25,16:38,3,5,8
68,2025-05-25T03:28:00+02:00,2025-05-25,11:28,8,3,11
53,2025-05-25T08:39:00+02:00,2025-05-25,16:39,17,6,23
68,2025-05-25T03:37:00+02:00,2025-05-25,11:37,6,4,10
56,2025-05-25T08:25:00+02:00,2025-05-25,16:25,1,12,13
72,2025-05-25T03:29:00+02:00,2025-05-25,11:29,10,9,19
56,2025-05-25T08:27:00+02:00,2025-05-25,16:27,9,5,14
72,2025-05-25T03:34:00+02:00,2025-05-25,11:34,11,2,13
56,2025-05-25T08:32:00+02:00,2025-05-25,16:32,16,4,20
72,2025-05-25T03:39:00+02:00,2025-05-25,11:39,1,4,5
56,2025-05-25T08:33:00+02:00,2025-05-25,16:33,6,10,16
76,2025-05-25T03:25:00+02:00,2025-05-25,11:25,1,2,3
56,2025-05-25T08:34:00+02:00,2025-05-25,16:34,5,2,7
76,2025-05-25T03:26:00+02:00,2025-05-25,11:26,0,2,2
56,2025-05-25T08:39:00+02:00,2025-05-25,16:39,5,4,9
76,2025-05-25T03:28:00+02:00,2025-05-25,11:28,2,0,2
58,2025-05-25T08:25:00+02:00,2025-05-25,16:25,6,10,16
76,2025-05-25T03:33:00+02:00,2025-05-25,11:33,1,1,2
58,2025-05-25T08:28:00+02:00,2025-05-25,16:28,4,10,14
76,2025-05-25T03:39:00+02:00,2025-05-25,11:39,1,0,1
58,2025-05-25T08:33:00+02:00,2025-05-25,16:33,3,15,18
79,2025-05-25T03:28:00+02:00,2025-05-25,11:28,11,6,17
58,2025-05-25T08:35:00+02:00,2025-05-25,16:35,7,8,15
79,2025-05-25T03:32:00+02:00,2025-05-25,11:32,8,18,26
58,2025-05-25T08:36:00+02:00,2025-05-25,16:36,24,12,36
79,2025-05-25T03:37:00+02:00,2025-05-25,11:37,11,7,18
62,2025-05-25T08:28:00+02:00,2025-05-25,16:28,3,1,4
79,2025-05-25T03:39:00+02:00,2025-05-25,11:39,14,2,16
62,2025-05-25T08:30:00+02:00,2025-05-25,16:30,6,5,11
85,2025-05-25T03:25:00+02:00,2025-05-25,11:25,6,0,6
62,2025-05-25T08:35:00+02:00,2025-05-25,16:35,4,5,9
85,2025-05-25T03:31:00+02:00,2025-05-25,11:31,0,1,1
63,2025-05-25T08:25:00+02:00,2025-05-25,16:25,12,13,25
85,2025-05-25T03:34:00+02:00,2025-05-25,11:34,1,8,9
63,2025-05-25T08:30:00+02:00,2025-05-25,16:30,11,6,17
85,2025-05-25T03:37:00+02:00,2025-05-25,11:37,0,4,4
63,2025-05-25T08:36:00+02:00,2025-05-25,16:36,7,5,12
85,2025-05-25T03:38:00+02:00,2025-05-25,11:38,10,1,11
67,2025-05-25T08:29:00+02:00,2025-05-25,16:29,11,8,19
86,2025-05-25T03:29:00+02:00,2025-05-25,11:29,0,3,3
67,2025-05-25T08:30:00+02:00,2025-05-25,16:30,4,6,10
86,2025-05-25T03:32:00+02:00,2025-05-25,11:32,1,0,1
67,2025-05-25T08:31:00+02:00,2025-05-25,16:31,8,5,13
86,2025-05-25T03:38:00+02:00,2025-05-25,11:38,2,0,2
67,2025-05-25T08:33:00+02:00,2025-05-25,16:33,8,18,26
109,2025-05-25T03:35:00+02:00,2025-05-25,11:35,13,4,17
67,2025-05-25T08:34:00+02:00,2025-05-25,16:34,1,4,5
123,2025-05-25T03:30:00+02:00,2025-05-25,11:30,7,1,8
68,2025-05-25T08:25:00+02:00,2025-05-25,16:25,22,3,25
130,2025-05-25T03:25:00+02:00,2025-05-25,11:25,4,7,11
68,2025-05-25T08:26:00+02:00,2025-05-25,16:26,10,3,13
130,2025-05-25T03:35:00+02:00,2025-05-25,11:35,2,2,4
68,2025-05-25T08:27:00+02:00,2025-05-25,16:27,7,1,8
136,2025-05-25T03:30:00+02:00,2025-05-25,11:30,17,4,21
68,2025-05-25T08:28:00+02:00,2025-05-25,16:28,1,5,6
136,2025-05-25T03:35:00+02:00,2025-05-25,11:35,15,10,25
68,2025-05-25T08:29:00+02:00,2025-05-25,16:29,6,3,9
137,2025-05-25T03:25:00+02:00,2025-05-25,11:25,1,1,2
68,2025-05-25T08:32:00+02:00,2025-05-25,16:32,2,5,7
137,2025-05-25T03:30:00+02:00,2025-05-25,11:30,0,1,1
68,2025-05-25T08:33:00+02:00,2025-05-25,16:33,6,7,13
141,2025-05-25T03:30:00+02:00,2025-05-25,11:30,6,13,19
68,2025-05-25T08:36:00+02:00,2025-05-25,16:36,1,5,6
161,2025-05-25T03:25:00+02:00,2025-05-25,11:25,31,16,47
68,2025-05-25T08:37:00+02:00,2025-05-25,16:37,4,3,7
161,2025-05-25T03:35:00+02:00,2025-05-25,11:35,21,17,38
68,2025-05-25T08:38:00+02:00,2025-05-25,16:38,4,3,7
164,2025-05-25T03:25:00+02:00,2025-05-25,11:25,8,7,15
72,2025-05-25T08:35:00+02:00,2025-05-25,16:35,6,11,17
72,2025-05-25T08:38:00+02:00,2025-05-25,16:38,6,7,13
76,2025-05-25T08:29:00+02:00,2025-05-25,16:29,0,5,5
76,2025-05-25T08:33:00+02:00,2025-05-25,16:33,2,0,2
76,2025-05-25T08:34:00+02:00,2025-05-25,16:34,2,0,2
79,2025-05-25T08:27:00+02:00,2025-05-25,16:27,32,13,45
79,2025-05-25T08:32:00+02:00,2025-05-25,16:32,7,16,23
79,2025-05-25T08:34:00+02:00,2025-05-25,16:34,6,19,25
181,2025-05-25T03:26:00+02:00,2025-05-25,11:26,12,9,21
79,2025-05-25T08:35:00+02:00,2025-05-25,16:35,0,3,3
181,2025-05-25T03:29:00+02:00,2025-05-25,11:29,5,6,11
79,2025-05-25T08:37:00+02:00,2025-05-25,16:37,6,3,9
181,2025-05-25T03:31:00+02:00,2025-05-25,11:31,9,14,23
79,2025-05-25T08:39:00+02:00,2025-05-25,16:39,7,10,17
181,2025-05-25T03:33:00+02:00,2025-05-25,11:33,3,18,21
85,2025-05-25T08:34:00+02:00,2025-05-25,16:34,2,0,2
181,2025-05-25T03:38:00+02:00,2025-05-25,11:38,13,13,26
85,2025-05-25T08:35:00+02:00,2025-05-25,16:35,0,2,2
182,2025-05-25T03:35:00+02:00,2025-05-25,11:35,8,5,13
86,2025-05-25T08:27:00+02:00,2025-05-25,16:27,0,1,1
180,2025-05-25T03:31:00+02:00,2025-05-25,11:31,0,3,3
109,2025-05-25T08:35:00+02:00,2025-05-25,16:35,3,12,15
180,2025-05-25T03:34:00+02:00,2025-05-25,11:34,2,1,3
117,2025-05-25T08:30:00+02:00,2025-05-25,16:30,14,18,32
180,2025-05-25T03:36:00+02:00,2025-05-25,11:36,2,0,2
130,2025-05-25T08:30:00+02:00,2025-05-25,16:30,10,1,11
180,2025-05-25T03:37:00+02:00,2025-05-25,11:37,2,0,2
136,2025-05-25T08:25:00+02:00,2025-05-25,16:25,12,10,22
180,2025-05-25T03:38:00+02:00,2025-05-25,11:38,1,0,1
137,2025-05-25T08:25:00+02:00,2025-05-25,16:25,1,0,1
137,2025-05-25T08:30:00+02:00,2025-05-25,16:30,1,11,12
139,2025-05-25T08:25:00+02:00,2025-05-25,16:25,2,5,7
139,2025-05-25T08:35:00+02:00,2025-05-25,16:35,6,1,7
161,2025-05-25T08:25:00+02:00,2025-05-25,16:25,25,31,56
161,2025-05-25T08:35:00+02:00,2025-05-25,16:35,17,20,37
164,2025-05-25T08:30:00+02:00,2025-05-25,16:30,3,8,11
164,2025-05-25T08:35:00+02:00,2025-05-25,16:35,9,13,22
181,2025-05-25T08:43:00+02:00,2025-05-25,16:43,17,11,28
181,2025-05-25T08:45:00+02:00,2025-05-25,16:45,8,15,23
181,2025-05-25T08:47:00+02:00,2025-05-25,16:47,17,19,36
181,2025-05-25T08:48:00+02:00,2025-05-25,16:48,24,20,44
181,2025-05-25T08:52:00+02:00,2025-05-25,16:52,23,15,38
180,2025-05-25T08:44:00+02:00,2025-05-25,16:44,2,1,3
180,2025-05-25T08:45:00+02:00,2025-05-25,16:45,1,0,1
180,2025-05-25T08:49:00+02:00,2025-05-25,16:49,0,1,1
3,2025-05-25T08:41:00+02:00,2025-05-25,16:41,28,26,54
3,2025-05-25T08:45:00+02:00,2025-05-25,16:45,7,19,26
3,2025-05-25T08:48:00+02:00,2025-05-25,16:48,5,13,18
3,2025-05-25T08:50:00+02:00,2025-05-25,16:50,22,18,40
4,2025-05-25T08:40:00+02:00,2025-05-25,16:40,33,42,75
4,2025-05-25T08:43:00+02:00,2025-05-25,16:43,27,19,46
4,2025-05-25T08:46:00+02:00,2025-05-25,16:46,25,20,45
4,2025-05-25T08:53:00+02:00,2025-05-25,16:53,27,27,54
5,2025-05-25T08:40:00+02:00,2025-05-25,16:40,72,60,132
5,2025-05-25T08:45:00+02:00,2025-05-25,16:45,104,93,197
5,2025-05-25T08:50:00+02:00,2025-05-25,16:50,117,89,206
6,2025-05-25T08:42:00+02:00,2025-05-25,16:42,13,12,25
6,2025-05-25T08:46:00+02:00,2025-05-25,16:46,13,8,21
6,2025-05-25T08:50:00+02:00,2025-05-25,16:50,9,14,23
6,2025-05-25T08:51:00+02:00,2025-05-25,16:51,21,27,48
8,2025-05-25T08:45:00+02:00,2025-05-25,16:45,13,6,19
8,2025-05-25T08:46:00+02:00,2025-05-25,16:46,2,2,4
8,2025-05-25T08:52:00+02:00,2025-05-25,16:52,2,3,5
8,2025-05-25T08:54:00+02:00,2025-05-25,16:54,7,6,13
28,2025-05-25T08:41:00+02:00,2025-05-25,16:41,6,18,24
28,2025-05-25T08:42:00+02:00,2025-05-25,16:42,3,11,14
28,2025-05-25T08:45:00+02:00,2025-05-25,16:45,11,14,25
28,2025-05-25T08:46:00+02:00,2025-05-25,16:46,2,18,20
28,2025-05-25T08:48:00+02:00,2025-05-25,16:48,3,9,12
28,2025-05-25T08:49:00+02:00,2025-05-25,16:49,5,20,25
28,2025-05-25T08:51:00+02:00,2025-05-25,16:51,5,28,33
28,2025-05-25T08:52:00+02:00,2025-05-25,16:52,10,15,25
28,2025-05-25T08:54:00+02:00,2025-05-25,16:54,8,12,20
29,2025-05-25T08:43:00+02:00,2025-05-25,16:43,5,13,18
29,2025-05-25T08:44:00+02:00,2025-05-25,16:44,18,9,27
29,2025-05-25T08:45:00+02:00,2025-05-25,16:45,11,7,18
29,2025-05-25T08:51:00+02:00,2025-05-25,16:51,17,14,31
31,2025-05-25T08:40:00+02:00,2025-05-25,16:40,3,0,3
31,2025-05-25T08:42:00+02:00,2025-05-25,16:42,7,6,13
31,2025-05-25T08:43:00+02:00,2025-05-25,16:43,1,0,1
31,2025-05-25T08:47:00+02:00,2025-05-25,16:47,2,1,3
31,2025-05-25T08:48:00+02:00,2025-05-25,16:48,7,2,9
31,2025-05-25T08:50:00+02:00,2025-05-25,16:50,6,0,6
31,2025-05-25T08:51:00+02:00,2025-05-25,16:51,4,1,5
31,2025-05-25T08:52:00+02:00,2025-05-25,16:52,4,11,15
36,2025-05-25T08:48:00+02:00,2025-05-25,16:48,0,1,1
36,2025-05-25T08:53:00+02:00,2025-05-25,16:53,1,0,1
39,2025-05-25T08:40:00+02:00,2025-05-25,16:40,0,1,1
39,2025-05-25T08:41:00+02:00,2025-05-25,16:41,0,2,2
39,2025-05-25T08:45:00+02:00,2025-05-25,16:45,0,1,1
39,2025-05-25T08:47:00+02:00,2025-05-25,16:47,3,0,3
39,2025-05-25T08:49:00+02:00,2025-05-25,16:49,1,0,1
39,2025-05-25T08:54:00+02:00,2025-05-25,16:54,1,0,1
40,2025-05-25T08:41:00+02:00,2025-05-25,16:41,1,6,7
40,2025-05-25T08:42:00+02:00,2025-05-25,16:42,2,2,4
40,2025-05-25T08:47:00+02:00,2025-05-25,16:47,0,5,5
40,2025-05-25T08:49:00+02:00,2025-05-25,16:49,0,2,2
40,2025-05-25T08:52:00+02:00,2025-05-25,16:52,1,1,2
40,2025-05-25T08:54:00+02:00,2025-05-25,16:54,3,0,3
41,2025-05-25T08:42:00+02:00,2025-05-25,16:42,9,4,13
41,2025-05-25T08:45:00+02:00,2025-05-25,16:45,20,5,25
41,2025-05-25T08:52:00+02:00,2025-05-25,16:52,4,0,4
41,2025-05-25T08:53:00+02:00,2025-05-25,16:53,4,4,8
45,2025-05-25T08:44:00+02:00,2025-05-25,16:44,9,14,23
45,2025-05-25T08:48:00+02:00,2025-05-25,16:48,17,15,32
45,2025-05-25T08:49:00+02:00,2025-05-25,16:49,31,13,44
47,2025-05-25T08:42:00+02:00,2025-05-25,16:42,14,15,29
47,2025-05-25T08:43:00+02:00,2025-05-25,16:43,33,31,64
47,2025-05-25T08:46:00+02:00,2025-05-25,16:46,28,22,50
47,2025-05-25T08:48:00+02:00,2025-05-25,16:48,7,0,7
50,2025-05-25T08:46:00+02:00,2025-05-25,16:46,1,2,3
50,2025-05-25T08:47:00+02:00,2025-05-25,16:47,3,3,6
50,2025-05-25T08:49:00+02:00,2025-05-25,16:49,2,4,6
50,2025-05-25T08:54:00+02:00,2025-05-25,16:54,0,1,1
54,2025-05-25T08:45:00+02:00,2025-05-25,16:45,3,1,4
54,2025-05-25T08:48:00+02:00,2025-05-25,16:48,0,3,3
59,2025-05-25T08:45:00+02:00,2025-05-25,16:45,29,34,63
61,2025-05-25T08:43:00+02:00,2025-05-25,16:43,13,7,20
61,2025-05-25T08:44:00+02:00,2025-05-25,16:44,8,4,12
61,2025-05-25T08:45:00+02:00,2025-05-25,16:45,7,10,17
61,2025-05-25T08:47:00+02:00,2025-05-25,16:47,6,10,16
61,2025-05-25T08:51:00+02:00,2025-05-25,16:51,15,8,23
66,2025-05-25T08:40:00+02:00,2025-05-25,16:40,25,20,45
66,2025-05-25T08:45:00+02:00,2025-05-25,16:45,25,20,45
66,2025-05-25T08:46:00+02:00,2025-05-25,16:46,20,26,46
66,2025-05-25T08:48:00+02:00,2025-05-25,16:48,16,43,59
66,2025-05-25T08:52:00+02:00,2025-05-25,16:52,30,28,58
69,2025-05-25T08:41:00+02:00,2025-05-25,16:41,4,3,7
69,2025-05-25T08:42:00+02:00,2025-05-25,16:42,0,1,1
69,2025-05-25T08:44:00+02:00,2025-05-25,16:44,2,0,2
69,2025-05-25T08:47:00+02:00,2025-05-25,16:47,1,3,4
69,2025-05-25T08:50:00+02:00,2025-05-25,16:50,7,1,8
69,2025-05-25T08:52:00+02:00,2025-05-25,16:52,0,1,1
70,2025-05-25T08:40:00+02:00,2025-05-25,16:40,3,2,5
70,2025-05-25T08:43:00+02:00,2025-05-25,16:43,3,2,5
70,2025-05-25T08:45:00+02:00,2025-05-25,16:45,2,2,4
70,2025-05-25T08:47:00+02:00,2025-05-25,16:47,2,1,3
70,2025-05-25T08:50:00+02:00,2025-05-25,16:50,2,2,4
70,2025-05-25T08:54:00+02:00,2025-05-25,16:54,3,0,3
75,2025-05-25T08:54:00+02:00,2025-05-25,16:54,0,1,1
78,2025-05-25T08:40:00+02:00,2025-05-25,16:40,1,0,1
78,2025-05-25T08:41:00+02:00,2025-05-25,16:41,1,1,2
78,2025-05-25T08:42:00+02:00,2025-05-25,16:42,1,0,1
78,2025-05-25T08:44:00+02:00,2025-05-25,16:44,2,1,3
78,2025-05-25T08:48:00+02:00,2025-05-25,16:48,0,3,3
78,2025-05-25T08:51:00+02:00,2025-05-25,16:51,6,1,7
84,2025-05-25T08:45:00+02:00,2025-05-25,16:45,59,118,177
87,2025-05-25T08:42:00+02:00,2025-05-25,16:42,0,2,2
87,2025-05-25T08:47:00+02:00,2025-05-25,16:47,2,0,2
87,2025-05-25T08:49:00+02:00,2025-05-25,16:49,0,1,1
87,2025-05-25T08:52:00+02:00,2025-05-25,16:52,3,0,3
87,2025-05-25T08:53:00+02:00,2025-05-25,16:53,2,1,3
87,2025-05-25T08:54:00+02:00,2025-05-25,16:54,2,0,2
107,2025-05-25T08:45:00+02:00,2025-05-25,16:45,8,6,14
108,2025-05-25T08:40:00+02:00,2025-05-25,16:40,5,1,6
108,2025-05-25T08:43:00+02:00,2025-05-25,16:43,2,5,7
108,2025-05-25T08:48:00+02:00,2025-05-25,16:48,6,1,7
108,2025-05-25T08:52:00+02:00,2025-05-25,16:52,3,0,3
118,2025-05-25T08:40:00+02:00,2025-05-25,16:40,1,6,7
118,2025-05-25T08:50:00+02:00,2025-05-25,16:50,4,0,4
124,2025-05-25T08:40:00+02:00,2025-05-25,16:40,1,0,1
131,2025-05-25T08:40:00+02:00,2025-05-25,16:40,6,3,9
132,2025-05-25T08:45:00+02:00,2025-05-25,16:45,10,9,19
133,2025-05-25T08:45:00+02:00,2025-05-25,16:45,46,33,79
133,2025-05-25T08:50:00+02:00,2025-05-25,16:50,53,36,89
135,2025-05-25T08:50:00+02:00,2025-05-25,16:50,40,31,71
140,2025-05-25T08:45:00+02:00,2025-05-25,16:45,7,7,14
140,2025-05-25T08:50:00+02:00,2025-05-25,16:50,8,9,17
165,2025-05-25T08:40:00+02:00,2025-05-25,16:40,2,5,7
165,2025-05-25T08:45:00+02:00,2025-05-25,16:45,7,0,7
165,2025-05-25T08:50:00+02:00,2025-05-25,16:50,9,4,13
167,2025-05-25T08:45:00+02:00,2025-05-25,16:45,9,15,24
179,2025-05-25T08:40:00+02:00,2025-05-25,16:40,4,4,8
1,2025-05-25T08:44:00+02:00,2025-05-25,16:44,29,18,47
1,2025-05-25T08:45:00+02:00,2025-05-25,16:45,55,19,74
1,2025-05-25T08:50:00+02:00,2025-05-25,16:50,17,15,32
1,2025-05-25T08:53:00+02:00,2025-05-25,16:53,21,17,38
1,2025-05-25T08:54:00+02:00,2025-05-25,16:54,11,16,27
2,2025-05-25T08:41:00+02:00,2025-05-25,16:41,8,11,19
2,2025-05-25T08:42:00+02:00,2025-05-25,16:42,12,8,20
2,2025-05-25T08:43:00+02:00,2025-05-25,16:43,5,8,13
2,2025-05-25T08:47:00+02:00,2025-05-25,16:47,10,4,14
2,2025-05-25T08:49:00+02:00,2025-05-25,16:49,4,9,13
2,2025-05-25T08:52:00+02:00,2025-05-25,16:52,16,8,24
9,2025-05-25T08:41:00+02:00,2025-05-25,16:41,2,0,2
9,2025-05-25T08:43:00+02:00,2025-05-25,16:43,0,1,1
9,2025-05-25T08:46:00+02:00,2025-05-25,16:46,0,3,3
9,2025-05-25T08:48:00+02:00,2025-05-25,16:48,0,2,2
9,2025-05-25T08:49:00+02:00,2025-05-25,16:49,3,0,3
10,2025-05-25T08:42:00+02:00,2025-05-25,16:42,0,1,1
10,2025-05-25T08:44:00+02:00,2025-05-25,16:44,2,0,2
11,2025-05-25T08:40:00+02:00,2025-05-25,16:40,19,6,25
11,2025-05-25T08:50:00+02:00,2025-05-25,16:50,8,3,11
11,2025-05-25T08:51:00+02:00,2025-05-25,16:51,1,4,5
11,2025-05-25T08:52:00+02:00,2025-05-25,16:52,3,1,4
11,2025-05-25T08:53:00+02:00,2025-05-25,16:53,3,2,5
11,2025-05-25T08:54:00+02:00,2025-05-25,16:54,1,3,4
12,2025-05-25T08:45:00+02:00,2025-05-25,16:45,8,3,11
12,2025-05-25T08:47:00+02:00,2025-05-25,16:47,17,3,20
12,2025-05-25T08:48:00+02:00,2025-05-25,16:48,5,2,7
12,2025-05-25T08:49:00+02:00,2025-05-25,16:49,5,7,12
12,2025-05-25T08:50:00+02:00,2025-05-25,16:50,5,4,9
12,2025-05-25T08:52:00+02:00,2025-05-25,16:52,8,5,13
12,2025-05-25T08:53:00+02:00,2025-05-25,16:53,6,1,7
12,2025-05-25T08:54:00+02:00,2025-05-25,16:54,3,8,11
17,2025-05-25T08:41:00+02:00,2025-05-25,16:41,1,1,2
17,2025-05-25T08:42:00+02:00,2025-05-25,16:42,0,4,4
17,2025-05-25T08:47:00+02:00,2025-05-25,16:47,1,0,1
17,2025-05-25T08:50:00+02:00,2025-05-25,16:50,5,0,5
17,2025-05-25T08:51:00+02:00,2025-05-25,16:51,0,2,2
17,2025-05-25T08:52:00+02:00,2025-05-25,16:52,2,3,5
17,2025-05-25T08:54:00+02:00,2025-05-25,16:54,1,3,4
18,2025-05-25T08:41:00+02:00,2025-05-25,16:41,0,2,2
18,2025-05-25T08:51:00+02:00,2025-05-25,16:51,4,0,4
19,2025-05-25T08:47:00+02:00,2025-05-25,16:47,3,11,14
19,2025-05-25T08:49:00+02:00,2025-05-25,16:49,14,4,18
19,2025-05-25T08:52:00+02:00,2025-05-25,16:52,15,17,32
19,2025-05-25T08:53:00+02:00,2025-05-25,16:53,16,5,21
20,2025-05-25T08:43:00+02:00,2025-05-25,16:43,5,4,9
20,2025-05-25T08:45:00+02:00,2025-05-25,16:45,17,0,17
20,2025-05-25T08:46:00+02:00,2025-05-25,16:46,7,2,9
20,2025-05-25T08:48:00+02:00,2025-05-25,16:48,4,5,9
20,2025-05-25T08:52:00+02:00,2025-05-25,16:52,8,6,14
20,2025-05-25T08:53:00+02:00,2025-05-25,16:53,3,2,5
23,2025-05-25T08:41:00+02:00,2025-05-25,16:41,4,2,6
23,2025-05-25T08:43:00+02:00,2025-05-25,16:43,0,4,4
23,2025-05-25T08:48:00+02:00,2025-05-25,16:48,3,0,3
23,2025-05-25T08:49:00+02:00,2025-05-25,16:49,1,1,2
24,2025-05-25T08:40:00+02:00,2025-05-25,16:40,10,3,13
24,2025-05-25T08:41:00+02:00,2025-05-25,16:41,5,8,13
24,2025-05-25T08:48:00+02:00,2025-05-25,16:48,3,3,6
25,2025-05-25T08:45:00+02:00,2025-05-25,16:45,87,26,113
27,2025-05-25T08:44:00+02:00,2025-05-25,16:44,1,2,3
30,2025-05-25T08:47:00+02:00,2025-05-25,16:47,6,7,13
35,2025-05-25T08:40:00+02:00,2025-05-25,16:40,22,15,37
35,2025-05-25T08:43:00+02:00,2025-05-25,16:43,13,15,28
35,2025-05-25T08:46:00+02:00,2025-05-25,16:46,15,22,37
35,2025-05-25T08:48:00+02:00,2025-05-25,16:48,29,10,39
35,2025-05-25T08:49:00+02:00,2025-05-25,16:49,14,20,34
35,2025-05-25T08:52:00+02:00,2025-05-25,16:52,15,25,40
35,2025-05-25T08:54:00+02:00,2025-05-25,16:54,16,27,43
48,2025-05-25T08:44:00+02:00,2025-05-25,16:44,9,2,11
48,2025-05-25T08:47:00+02:00,2025-05-25,16:47,1,16,17
48,2025-05-25T08:49:00+02:00,2025-05-25,16:49,4,8,12
48,2025-05-25T08:50:00+02:00,2025-05-25,16:50,2,0,2
49,2025-05-25T08:41:00+02:00,2025-05-25,16:41,6,6,12
49,2025-05-25T08:42:00+02:00,2025-05-25,16:42,3,19,22
49,2025-05-25T08:43:00+02:00,2025-05-25,16:43,3,4,7
49,2025-05-25T08:44:00+02:00,2025-05-25,16:44,1,8,9
49,2025-05-25T08:47:00+02:00,2025-05-25,16:47,4,8,12
49,2025-05-25T08:49:00+02:00,2025-05-25,16:49,4,3,7
49,2025-05-25T08:50:00+02:00,2025-05-25,16:50,8,2,10
49,2025-05-25T08:53:00+02:00,2025-05-25,16:53,2,6,8
51,2025-05-25T08:40:00+02:00,2025-05-25,16:40,2,4,6
51,2025-05-25T08:42:00+02:00,2025-05-25,16:42,1,4,5
51,2025-05-25T08:43:00+02:00,2025-05-25,16:43,1,2,3
51,2025-05-25T08:48:00+02:00,2025-05-25,16:48,1,2,3
51,2025-05-25T08:53:00+02:00,2025-05-25,16:53,2,2,4
51,2025-05-25T08:54:00+02:00,2025-05-25,16:54,2,1,3
52,2025-05-25T08:42:00+02:00,2025-05-25,16:42,7,2,9
52,2025-05-25T08:48:00+02:00,2025-05-25,16:48,5,2,7
52,2025-05-25T08:49:00+02:00,2025-05-25,16:49,5,4,9
52,2025-05-25T08:50:00+02:00,2025-05-25,16:50,4,0,4
52,2025-05-25T08:53:00+02:00,2025-05-25,16:53,2,3,5
53,2025-05-25T08:41:00+02:00,2025-05-25,16:41,8,5,13
53,2025-05-25T08:47:00+02:00,2025-05-25,16:47,8,9,17
53,2025-05-25T08:49:00+02:00,2025-05-25,16:49,3,4,7
53,2025-05-25T08:52:00+02:00,2025-05-25,16:52,1,4,5
53,2025-05-25T08:54:00+02:00,2025-05-25,16:54,3,2,5
56,2025-05-25T08:49:00+02:00,2025-05-25,16:49,14,6,20
56,2025-05-25T08:50:00+02:00,2025-05-25,16:50,10,3,13
56,2025-05-25T08:54:00+02:00,2025-05-25,16:54,9,9,18
58,2025-05-25T08:41:00+02:00,2025-05-25,16:41,11,10,21
58,2025-05-25T08:42:00+02:00,2025-05-25,16:42,2,0,2
58,2025-05-25T08:43:00+02:00,2025-05-25,16:43,11,7,18
58,2025-05-25T08:47:00+02:00,2025-05-25,16:47,5,6,11
58,2025-05-25T08:50:00+02:00,2025-05-25,16:50,6,0,6
58,2025-05-25T08:54:00+02:00,2025-05-25,16:54,13,5,18
62,2025-05-25T08:41:00+02:00,2025-05-25,16:41,1,1,2
62,2025-05-25T08:46:00+02:00,2025-05-25,16:46,3,6,9
62,2025-05-25T08:47:00+02:00,2025-05-25,16:47,3,5,8
62,2025-05-25T08:49:00+02:00,2025-05-25,16:49,2,0,2
62,2025-05-25T08:51:00+02:00,2025-05-25,16:51,2,6,8
63,2025-05-25T08:43:00+02:00,2025-05-25,16:43,7,9,16
63,2025-05-25T08:47:00+02:00,2025-05-25,16:47,2,12,14
63,2025-05-25T08:50:00+02:00,2025-05-25,16:50,1,11,12
63,2025-05-25T08:53:00+02:00,2025-05-25,16:53,7,10,17
63,2025-05-25T08:54:00+02:00,2025-05-25,16:54,5,2,7
67,2025-05-25T08:41:00+02:00,2025-05-25,16:41,4,12,16
67,2025-05-25T08:43:00+02:00,2025-05-25,16:43,4,11,15
67,2025-05-25T08:53:00+02:00,2025-05-25,16:53,3,2,5
68,2025-05-25T08:40:00+02:00,2025-05-25,16:40,5,2,7
68,2025-05-25T08:42:00+02:00,2025-05-25,16:42,6,0,6
68,2025-05-25T08:44:00+02:00,2025-05-25,16:44,7,1,8
68,2025-05-25T08:45:00+02:00,2025-05-25,16:45,1,4,5
68,2025-05-25T08:47:00+02:00,2025-05-25,16:47,2,3,5
68,2025-05-25T08:49:00+02:00,2025-05-25,16:49,6,8,14
68,2025-05-25T08:50:00+02:00,2025-05-25,16:50,9,2,11
68,2025-05-25T08:51:00+02:00,2025-05-25,16:51,1,0,1
72,2025-05-25T08:43:00+02:00,2025-05-25,16:43,9,8,17
72,2025-05-25T08:45:00+02:00,2025-05-25,16:45,7,3,10
72,2025-05-25T08:46:00+02:00,2025-05-25,16:46,9,6,15
72,2025-05-25T08:51:00+02:00,2025-05-25,16:51,8,18,26
72,2025-05-25T08:52:00+02:00,2025-05-25,16:52,3,3,6
72,2025-05-25T08:53:00+02:00,2025-05-25,16:53,8,5,13
76,2025-05-25T08:42:00+02:00,2025-05-25,16:42,0,1,1
76,2025-05-25T08:43:00+02:00,2025-05-25,16:43,2,0,2
76,2025-05-25T08:45:00+02:00,2025-05-25,16:45,1,0,1
76,2025-05-25T08:46:00+02:00,2025-05-25,16:46,0,1,1
76,2025-05-25T08:47:00+02:00,2025-05-25,16:47,1,0,1
76,2025-05-25T08:48:00+02:00,2025-05-25,16:48,1,1,2
76,2025-05-25T08:49:00+02:00,2025-05-25,16:49,1,0,1
79,2025-05-25T08:45:00+02:00,2025-05-25,16:45,9,7,16
79,2025-05-25T08:47:00+02:00,2025-05-25,16:47,5,5,10
79,2025-05-25T08:50:00+02:00,2025-05-25,16:50,7,2,9
79,2025-05-25T08:51:00+02:00,2025-05-25,16:51,16,7,23
79,2025-05-25T08:53:00+02:00,2025-05-25,16:53,3,4,7
85,2025-05-25T08:46:00+02:00,2025-05-25,16:46,1,1,2
85,2025-05-25T08:47:00+02:00,2025-05-25,16:47,1,0,1
85,2025-05-25T08:50:00+02:00,2025-05-25,16:50,1,0,1
85,2025-05-25T08:54:00+02:00,2025-05-25,16:54,2,3,5
86,2025-05-25T08:46:00+02:00,2025-05-25,16:46,0,4,4
109,2025-05-25T08:50:00+02:00,2025-05-25,16:50,4,10,14
130,2025-05-25T08:40:00+02:00,2025-05-25,16:40,2,9,11
130,2025-05-25T08:50:00+02:00,2025-05-25,16:50,3,12,15
136,2025-05-25T08:50:00+02:00,2025-05-25,16:50,11,9,20
137,2025-05-25T08:50:00+02:00,2025-05-25,16:50,0,2,2
138,2025-05-25T08:50:00+02:00,2025-05-25,16:50,1,6,7
139,2025-05-25T08:40:00+02:00,2025-05-25,16:40,5,3,8
141,2025-05-25T08:40:00+02:00,2025-05-25,16:40,22,6,28
142,2025-05-25T08:45:00+02:00,2025-05-25,16:45,45,42,87
142,2025-05-25T08:50:00+02:00,2025-05-25,16:50,28,67,95
161,2025-05-25T08:45:00+02:00,2025-05-25,16:45,30,21,51
164,2025-05-25T08:40:00+02:00,2025-05-25,16:40,14,6,20
164,2025-05-25T08:50:00+02:00,2025-05-25,16:50,5,27,32
181,2025-05-25T08:59:00+02:00,2025-05-25,16:59,9,30,39
181,2025-05-25T09:00:00+02:00,2025-05-25,17:00,8,14,22
181,2025-05-25T09:01:00+02:00,2025-05-25,17:01,21,15,36
181,2025-05-25T09:08:00+02:00,2025-05-25,17:08,10,8,18
182,2025-05-25T08:55:00+02:00,2025-05-25,16:55,28,14,42
180,2025-05-25T08:55:00+02:00,2025-05-25,16:55,0,2,2
180,2025-05-25T08:57:00+02:00,2025-05-25,16:57,3,0,3
180,2025-05-25T08:58:00+02:00,2025-05-25,16:58,0,1,1
3,2025-05-25T08:55:00+02:00,2025-05-25,16:55,37,21,58
3,2025-05-25T09:03:00+02:00,2025-05-25,17:03,4,10,14
3,2025-05-25T09:07:00+02:00,2025-05-25,17:07,17,21,38
4,2025-05-25T08:59:00+02:00,2025-05-25,16:59,45,16,61
4,2025-05-25T09:02:00+02:00,2025-05-25,17:02,28,13,41
4,2025-05-25T09:04:00+02:00,2025-05-25,17:04,35,20,55
4,2025-05-25T09:06:00+02:00,2025-05-25,17:06,40,22,62
6,2025-05-25T08:57:00+02:00,2025-05-25,16:57,8,11,19
6,2025-05-25T08:59:00+02:00,2025-05-25,16:59,15,11,26
6,2025-05-25T09:00:00+02:00,2025-05-25,17:00,11,13,24
6,2025-05-25T09:02:00+02:00,2025-05-25,17:02,12,8,20
6,2025-05-25T09:05:00+02:00,2025-05-25,17:05,18,11,29
6,2025-05-25T09:08:00+02:00,2025-05-25,17:08,8,12,20
6,2025-05-25T09:09:00+02:00,2025-05-25,17:09,20,7,27
8,2025-05-25T08:57:00+02:00,2025-05-25,16:57,3,5,8
8,2025-05-25T08:58:00+02:00,2025-05-25,16:58,2,1,3
28,2025-05-25T08:55:00+02:00,2025-05-25,16:55,1,13,14
28,2025-05-25T08:56:00+02:00,2025-05-25,16:56,1,12,13
28,2025-05-25T08:57:00+02:00,2025-05-25,16:57,2,13,15
28,2025-05-25T09:00:00+02:00,2025-05-25,17:00,7,10,17
28,2025-05-25T09:02:00+02:00,2025-05-25,17:02,3,13,16
28,2025-05-25T09:03:00+02:00,2025-05-25,17:03,10,18,28
28,2025-05-25T09:05:00+02:00,2025-05-25,17:05,8,20,28
28,2025-05-25T09:06:00+02:00,2025-05-25,17:06,4,8,12
29,2025-05-25T08:57:00+02:00,2025-05-25,16:57,11,10,21
29,2025-05-25T09:02:00+02:00,2025-05-25,17:02,12,17,29
31,2025-05-25T08:59:00+02:00,2025-05-25,16:59,4,0,4
31,2025-05-25T09:01:00+02:00,2025-05-25,17:01,10,1,11
31,2025-05-25T09:02:00+02:00,2025-05-25,17:02,2,11,13
31,2025-05-25T09:04:00+02:00,2025-05-25,17:04,0,1,1
31,2025-05-25T09:05:00+02:00,2025-05-25,17:05,0,1,1
36,2025-05-25T08:56:00+02:00,2025-05-25,16:56,0,2,2
36,2025-05-25T08:57:00+02:00,2025-05-25,16:57,0,6,6
36,2025-05-25T09:03:00+02:00,2025-05-25,17:03,1,0,1
36,2025-05-25T09:04:00+02:00,2025-05-25,17:04,2,2,4
40,2025-05-25T08:55:00+02:00,2025-05-25,16:55,1,3,4
40,2025-05-25T08:56:00+02:00,2025-05-25,16:56,5,2,7
40,2025-05-25T09:03:00+02:00,2025-05-25,17:03,4,3,7
40,2025-05-25T09:04:00+02:00,2025-05-25,17:04,0,6,6
40,2025-05-25T09:07:00+02:00,2025-05-25,17:07,2,2,4
40,2025-05-25T09:08:00+02:00,2025-05-25,17:08,2,4,6
40,2025-05-25T09:09:00+02:00,2025-05-25,17:09,1,1,2
41,2025-05-25T08:56:00+02:00,2025-05-25,16:56,11,6,17
41,2025-05-25T08:57:00+02:00,2025-05-25,16:57,6,1,7
41,2025-05-25T08:58:00+02:00,2025-05-25,16:58,5,2,7
41,2025-05-25T08:59:00+02:00,2025-05-25,16:59,13,8,21
41,2025-05-25T09:02:00+02:00,2025-05-25,17:02,4,11,15
41,2025-05-25T09:04:00+02:00,2025-05-25,17:04,4,3,7
41,2025-05-25T09:06:00+02:00,2025-05-25,17:06,8,9,17
43,2025-05-25T09:00:00+02:00,2025-05-25,17:00,5,3,8
44,2025-05-25T08:55:00+02:00,2025-05-25,16:55,8,5,13
45,2025-05-25T08:57:00+02:00,2025-05-25,16:57,18,15,33
45,2025-05-25T09:00:00+02:00,2025-05-25,17:00,33,10,43
45,2025-05-25T09:02:00+02:00,2025-05-25,17:02,11,17,28
45,2025-05-25T09:04:00+02:00,2025-05-25,17:04,26,15,41
45,2025-05-25T09:05:00+02:00,2025-05-25,17:05,27,13,40
47,2025-05-25T08:57:00+02:00,2025-05-25,16:57,17,9,26
47,2025-05-25T09:01:00+02:00,2025-05-25,17:01,14,19,33
47,2025-05-25T09:02:00+02:00,2025-05-25,17:02,27,15,42
47,2025-05-25T09:05:00+02:00,2025-05-25,17:05,20,13,33
47,2025-05-25T09:09:00+02:00,2025-05-25,17:09,16,7,23
50,2025-05-25T08:58:00+02:00,2025-05-25,16:58,7,4,11
50,2025-05-25T09:02:00+02:00,2025-05-25,17:02,4,5,9
50,2025-05-25T09:03:00+02:00,2025-05-25,17:03,5,9,14
50,2025-05-25T09:04:00+02:00,2025-05-25,17:04,7,5,12
50,2025-05-25T09:05:00+02:00,2025-05-25,17:05,3,4,7
54,2025-05-25T08:59:00+02:00,2025-05-25,16:59,1,1,2
54,2025-05-25T09:01:00+02:00,2025-05-25,17:01,0,2,2
54,2025-05-25T09:05:00+02:00,2025-05-25,17:05,2,1,3
59,2025-05-25T09:00:00+02:00,2025-05-25,17:00,20,44,64
61,2025-05-25T08:58:00+02:00,2025-05-25,16:58,7,10,17
61,2025-05-25T09:06:00+02:00,2025-05-25,17:06,5,5,10
61,2025-05-25T09:07:00+02:00,2025-05-25,17:07,12,9,21
61,2025-05-25T09:09:00+02:00,2025-05-25,17:09,4,4,8
66,2025-05-25T08:55:00+02:00,2025-05-25,16:55,26,37,63
66,2025-05-25T08:56:00+02:00,2025-05-25,16:56,15,10,25
66,2025-05-25T08:58:00+02:00,2025-05-25,16:58,23,46,69
66,2025-05-25T09:01:00+02:00,2025-05-25,17:01,30,41,71
66,2025-05-25T09:02:00+02:00,2025-05-25,17:02,29,12,41
66,2025-05-25T09:05:00+02:00,2025-05-25,17:05,17,16,33
66,2025-05-25T09:07:00+02:00,2025-05-25,17:07,8,38,46
69,2025-05-25T08:55:00+02:00,2025-05-25,16:55,3,3,6
69,2025-05-25T08:57:00+02:00,2025-05-25,16:57,3,3,6
69,2025-05-25T09:00:00+02:00,2025-05-25,17:00,3,0,3
69,2025-05-25T09:02:00+02:00,2025-05-25,17:02,5,3,8
69,2025-05-25T09:04:00+02:00,2025-05-25,17:04,2,5,7
69,2025-05-25T09:05:00+02:00,2025-05-25,17:05,0,3,3
69,2025-05-25T09:09:00+02:00,2025-05-25,17:09,2,4,6
70,2025-05-25T08:57:00+02:00,2025-05-25,16:57,1,1,2
70,2025-05-25T08:59:00+02:00,2025-05-25,16:59,3,0,3
70,2025-05-25T09:01:00+02:00,2025-05-25,17:01,1,2,3
70,2025-05-25T09:03:00+02:00,2025-05-25,17:03,1,4,5
70,2025-05-25T09:06:00+02:00,2025-05-25,17:06,5,4,9
70,2025-05-25T09:07:00+02:00,2025-05-25,17:07,3,3,6
71,2025-05-25T09:02:00+02:00,2025-05-25,17:02,1,0,1
71,2025-05-25T09:07:00+02:00,2025-05-25,17:07,3,2,5
75,2025-05-25T09:04:00+02:00,2025-05-25,17:04,2,3,5
78,2025-05-25T08:57:00+02:00,2025-05-25,16:57,3,0,3
78,2025-05-25T09:07:00+02:00,2025-05-25,17:07,0,2,2
84,2025-05-25T08:55:00+02:00,2025-05-25,16:55,95,99,194
87,2025-05-25T08:58:00+02:00,2025-05-25,16:58,0,3,3
87,2025-05-25T08:59:00+02:00,2025-05-25,16:59,0,1,1
87,2025-05-25T09:09:00+02:00,2025-05-25,17:09,5,0,5
108,2025-05-25T08:59:00+02:00,2025-05-25,16:59,2,1,3
108,2025-05-25T09:02:00+02:00,2025-05-25,17:02,2,0,2
108,2025-05-25T09:04:00+02:00,2025-05-25,17:04,3,1,4
108,2025-05-25T09:05:00+02:00,2025-05-25,17:05,2,2,4
108,2025-05-25T09:08:00+02:00,2025-05-25,17:08,1,3,4
118,2025-05-25T09:00:00+02:00,2025-05-25,17:00,0,1,1
132,2025-05-25T09:00:00+02:00,2025-05-25,17:00,8,10,18
134,2025-05-25T08:55:00+02:00,2025-05-25,16:55,31,27,58
134,2025-05-25T09:00:00+02:00,2025-05-25,17:00,37,35,72
140,2025-05-25T08:55:00+02:00,2025-05-25,16:55,6,10,16
140,2025-05-25T09:05:00+02:00,2025-05-25,17:05,4,9,13
165,2025-05-25T08:55:00+02:00,2025-05-25,16:55,6,1,7
165,2025-05-25T09:00:00+02:00,2025-05-25,17:00,1,0,1
165,2025-05-25T09:05:00+02:00,2025-05-25,17:05,5,2,7
167,2025-05-25T08:55:00+02:00,2025-05-25,16:55,7,5,12
1,2025-05-25T08:56:00+02:00,2025-05-25,16:56,31,11,42
1,2025-05-25T09:07:00+02:00,2025-05-25,17:07,15,26,41
2,2025-05-25T08:56:00+02:00,2025-05-25,16:56,12,6,18
2,2025-05-25T08:57:00+02:00,2025-05-25,16:57,15,5,20
2,2025-05-25T09:02:00+02:00,2025-05-25,17:02,15,10,25
2,2025-05-25T09:04:00+02:00,2025-05-25,17:04,14,1,15
2,2025-05-25T09:05:00+02:00,2025-05-25,17:05,13,7,20
9,2025-05-25T08:57:00+02:00,2025-05-25,16:57,6,0,6
9,2025-05-25T09:01:00+02:00,2025-05-25,17:01,0,3,3
9,2025-05-25T09:03:00+02:00,2025-05-25,17:03,4,0,4
10,2025-05-25T08:57:00+02:00,2025-05-25,16:57,1,0,1
10,2025-05-25T08:59:00+02:00,2025-05-25,16:59,1,1,2
10,2025-05-25T09:04:00+02:00,2025-05-25,17:04,2,2,4
11,2025-05-25T08:58:00+02:00,2025-05-25,16:58,2,2,4
11,2025-05-25T08:59:00+02:00,2025-05-25,16:59,1,4,5
11,2025-05-25T09:05:00+02:00,2025-05-25,17:05,4,2,6
12,2025-05-25T08:56:00+02:00,2025-05-25,16:56,1,11,12
12,2025-05-25T08:57:00+02:00,2025-05-25,16:57,4,2,6
12,2025-05-25T08:58:00+02:00,2025-05-25,16:58,3,5,8
12,2025-05-25T09:02:00+02:00,2025-05-25,17:02,3,4,7
12,2025-05-25T09:07:00+02:00,2025-05-25,17:07,2,4,6
17,2025-05-25T08:56:00+02:00,2025-05-25,16:56,2,3,5
17,2025-05-25T08:58:00+02:00,2025-05-25,16:58,0,4,4
17,2025-05-25T09:00:00+02:00,2025-05-25,17:00,1,5,6
17,2025-05-25T09:04:00+02:00,2025-05-25,17:04,5,2,7
17,2025-05-25T09:05:00+02:00,2025-05-25,17:05,0,1,1
19,2025-05-25T08:55:00+02:00,2025-05-25,16:55,14,6,20
19,2025-05-25T08:56:00+02:00,2025-05-25,16:56,26,4,30
19,2025-05-25T08:57:00+02:00,2025-05-25,16:57,12,7,19
19,2025-05-25T08:58:00+02:00,2025-05-25,16:58,11,9,20
19,2025-05-25T09:02:00+02:00,2025-05-25,17:02,11,7,18
19,2025-05-25T09:06:00+02:00,2025-05-25,17:06,13,8,21
19,2025-05-25T09:08:00+02:00,2025-05-25,17:08,9,15,24
20,2025-05-25T08:57:00+02:00,2025-05-25,16:57,11,0,11
20,2025-05-25T09:05:00+02:00,2025-05-25,17:05,3,2,5
20,2025-05-25T09:06:00+02:00,2025-05-25,17:06,10,0,10
20,2025-05-25T09:08:00+02:00,2025-05-25,17:08,5,1,6
20,2025-05-25T09:09:00+02:00,2025-05-25,17:09,8,2,10
23,2025-05-25T08:57:00+02:00,2025-05-25,16:57,0,12,12
23,2025-05-25T09:02:00+02:00,2025-05-25,17:02,7,5,12
23,2025-05-25T09:04:00+02:00,2025-05-25,17:04,1,2,3
23,2025-05-25T09:06:00+02:00,2025-05-25,17:06,4,2,6
23,2025-05-25T09:08:00+02:00,2025-05-25,17:08,3,4,7
24,2025-05-25T09:01:00+02:00,2025-05-25,17:01,4,8,12
24,2025-05-25T09:02:00+02:00,2025-05-25,17:02,3,26,29
24,2025-05-25T09:04:00+02:00,2025-05-25,17:04,7,6,13
24,2025-05-25T09:08:00+02:00,2025-05-25,17:08,2,3,5
27,2025-05-25T08:56:00+02:00,2025-05-25,16:56,2,2,4
27,2025-05-25T08:57:00+02:00,2025-05-25,16:57,2,0,2
27,2025-05-25T08:59:00+02:00,2025-05-25,16:59,15,4,19
27,2025-05-25T09:04:00+02:00,2025-05-25,17:04,2,0,2
27,2025-05-25T09:06:00+02:00,2025-05-25,17:06,0,2,2
30,2025-05-25T08:56:00+02:00,2025-05-25,16:56,4,5,9
30,2025-05-25T08:58:00+02:00,2025-05-25,16:58,8,3,11
30,2025-05-25T09:02:00+02:00,2025-05-25,17:02,2,10,12
30,2025-05-25T09:04:00+02:00,2025-05-25,17:04,1,14,15
30,2025-05-25T09:08:00+02:00,2025-05-25,17:08,1,2,3
30,2025-05-25T09:09:00+02:00,2025-05-25,17:09,10,1,11
35,2025-05-25T08:56:00+02:00,2025-05-25,16:56,11,25,36
35,2025-05-25T08:57:00+02:00,2025-05-25,16:57,22,28,50
35,2025-05-25T08:59:00+02:00,2025-05-25,16:59,17,12,29
35,2025-05-25T09:02:00+02:00,2025-05-25,17:02,16,45,61
35,2025-05-25T09:06:00+02:00,2025-05-25,17:06,15,16,31
35,2025-05-25T09:07:00+02:00,2025-05-25,17:07,33,27,60
35,2025-05-25T09:08:00+02:00,2025-05-25,17:08,24,17,41
46,2025-05-25T09:00:00+02:00,2025-05-25,17:00,6,4,10
46,2025-05-25T09:05:00+02:00,2025-05-25,17:05,9,5,14
48,2025-05-25T08:56:00+02:00,2025-05-25,16:56,0,5,5
48,2025-05-25T08:57:00+02:00,2025-05-25,16:57,2,2,4
48,2025-05-25T09:05:00+02:00,2025-05-25,17:05,2,4,6
48,2025-05-25T09:06:00+02:00,2025-05-25,17:06,1,2,3
49,2025-05-25T08:56:00+02:00,2025-05-25,16:56,4,5,9
49,2025-05-25T08:58:00+02:00,2025-05-25,16:58,3,2,5
49,2025-05-25T08:59:00+02:00,2025-05-25,16:59,1,6,7
49,2025-05-25T09:01:00+02:00,2025-05-25,17:01,4,4,8
49,2025-05-25T09:02:00+02:00,2025-05-25,17:02,4,5,9
49,2025-05-25T09:03:00+02:00,2025-05-25,17:03,4,2,6
49,2025-05-25T09:05:00+02:00,2025-05-25,17:05,6,3,9
49,2025-05-25T09:06:00+02:00,2025-05-25,17:06,3,6,9
49,2025-05-25T09:08:00+02:00,2025-05-25,17:08,5,6,11
49,2025-05-25T09:09:00+02:00,2025-05-25,17:09,8,10,18
51,2025-05-25T08:57:00+02:00,2025-05-25,16:57,5,2,7
51,2025-05-25T08:59:00+02:00,2025-05-25,16:59,1,2,3
51,2025-05-25T09:03:00+02:00,2025-05-25,17:03,3,0,3
51,2025-05-25T09:04:00+02:00,2025-05-25,17:04,2,0,2
51,2025-05-25T09:06:00+02:00,2025-05-25,17:06,1,5,6
51,2025-05-25T09:09:00+02:00,2025-05-25,17:09,0,1,1
52,2025-05-25T09:00:00+02:00,2025-05-25,17:00,6,2,8
52,2025-05-25T09:08:00+02:00,2025-05-25,17:08,9,2,11
53,2025-05-25T08:56:00+02:00,2025-05-25,16:56,9,2,11
53,2025-05-25T08:59:00+02:00,2025-05-25,16:59,7,6,13
53,2025-05-25T09:00:00+02:00,2025-05-25,17:00,9,3,12
53,2025-05-25T09:02:00+02:00,2025-05-25,17:02,1,4,5
53,2025-05-25T09:03:00+02:00,2025-05-25,17:03,10,3,13
53,2025-05-25T09:04:00+02:00,2025-05-25,17:04,4,2,6
53,2025-05-25T09:05:00+02:00,2025-05-25,17:05,7,2,9
53,2025-05-25T09:06:00+02:00,2025-05-25,17:06,1,11,12
53,2025-05-25T09:09:00+02:00,2025-05-25,17:09,10,2,12
56,2025-05-25T09:06:00+02:00,2025-05-25,17:06,5,8,13
58,2025-05-25T08:57:00+02:00,2025-05-25,16:57,9,1,10
58,2025-05-25T09:01:00+02:00,2025-05-25,17:01,7,5,12
58,2025-05-25T09:02:00+02:00,2025-05-25,17:02,4,1,5
58,2025-05-25T09:03:00+02:00,2025-05-25,17:03,13,6,19
58,2025-05-25T09:08:00+02:00,2025-05-25,17:08,3,23,26
62,2025-05-25T08:55:00+02:00,2025-05-25,16:55,5,3,8
62,2025-05-25T08:57:00+02:00,2025-05-25,16:57,2,5,7
62,2025-05-25T09:03:00+02:00,2025-05-25,17:03,1,4,5
63,2025-05-25T08:59:00+02:00,2025-05-25,16:59,4,15,19
63,2025-05-25T09:03:00+02:00,2025-05-25,17:03,5,8,13
63,2025-05-25T09:04:00+02:00,2025-05-25,17:04,14,9,23
63,2025-05-25T09:06:00+02:00,2025-05-25,17:06,0,2,2
63,2025-05-25T09:07:00+02:00,2025-05-25,17:07,5,0,5
63,2025-05-25T09:08:00+02:00,2025-05-25,17:08,6,2,8
67,2025-05-25T09:01:00+02:00,2025-05-25,17:01,1,3,4
67,2025-05-25T09:02:00+02:00,2025-05-25,17:02,15,10,25
67,2025-05-25T09:04:00+02:00,2025-05-25,17:04,5,5,10
67,2025-05-25T09:09:00+02:00,2025-05-25,17:09,3,3,6
68,2025-05-25T08:57:00+02:00,2025-05-25,16:57,2,4,6
68,2025-05-25T09:02:00+02:00,2025-05-25,17:02,9,3,12
68,2025-05-25T09:03:00+02:00,2025-05-25,17:03,1,1,2
68,2025-05-25T09:06:00+02:00,2025-05-25,17:06,9,5,14
68,2025-05-25T09:07:00+02:00,2025-05-25,17:07,2,1,3
72,2025-05-25T09:05:00+02:00,2025-05-25,17:05,6,10,16
72,2025-05-25T09:06:00+02:00,2025-05-25,17:06,3,22,25
72,2025-05-25T09:09:00+02:00,2025-05-25,17:09,3,8,11
76,2025-05-25T09:07:00+02:00,2025-05-25,17:07,1,1,2
76,2025-05-25T09:09:00+02:00,2025-05-25,17:09,1,1,2
79,2025-05-25T09:00:00+02:00,2025-05-25,17:00,13,5,18
79,2025-05-25T09:06:00+02:00,2025-05-25,17:06,8,9,17
79,2025-05-25T09:07:00+02:00,2025-05-25,17:07,10,3,13
79,2025-05-25T09:09:00+02:00,2025-05-25,17:09,17,7,24
85,2025-05-25T08:55:00+02:00,2025-05-25,16:55,0,1,1
85,2025-05-25T08:58:00+02:00,2025-05-25,16:58,2,1,3
85,2025-05-25T08:59:00+02:00,2025-05-25,16:59,1,1,2
85,2025-05-25T09:00:00+02:00,2025-05-25,17:00,1,3,4
85,2025-05-25T09:01:00+02:00,2025-05-25,17:01,2,1,3
85,2025-05-25T09:02:00+02:00,2025-05-25,17:02,2,1,3
85,2025-05-25T09:03:00+02:00,2025-05-25,17:03,1,0,1
85,2025-05-25T09:08:00+02:00,2025-05-25,17:08,0,3,3
86,2025-05-25T08:55:00+02:00,2025-05-25,16:55,0,2,2
86,2025-05-25T09:04:00+02:00,2025-05-25,17:04,0,1,1
109,2025-05-25T09:05:00+02:00,2025-05-25,17:05,5,12,17
123,2025-05-25T08:55:00+02:00,2025-05-25,16:55,14,3,17
130,2025-05-25T09:00:00+02:00,2025-05-25,17:00,5,1,6
136,2025-05-25T09:05:00+02:00,2025-05-25,17:05,18,11,29
137,2025-05-25T09:00:00+02:00,2025-05-25,17:00,0,3,3
139,2025-05-25T09:00:00+02:00,2025-05-25,17:00,5,4,9
161,2025-05-25T08:55:00+02:00,2025-05-25,16:55,27,14,41
181,2025-05-25T09:10:00+02:00,2025-05-25,17:10,20,8,28
181,2025-05-25T09:15:00+02:00,2025-05-25,17:15,15,11,26
181,2025-05-25T09:17:00+02:00,2025-05-25,17:17,19,3,22
181,2025-05-25T09:22:00+02:00,2025-05-25,17:22,18,17,35
181,2025-05-25T09:24:00+02:00,2025-05-25,17:24,18,25,43
182,2025-05-25T09:20:00+02:00,2025-05-25,17:20,20,15,35
180,2025-05-25T09:17:00+02:00,2025-05-25,17:17,1,0,1
180,2025-05-25T09:18:00+02:00,2025-05-25,17:18,4,1,5
180,2025-05-25T09:23:00+02:00,2025-05-25,17:23,1,1,2
3,2025-05-25T09:12:00+02:00,2025-05-25,17:12,16,27,43
3,2025-05-25T09:14:00+02:00,2025-05-25,17:14,19,28,47
3,2025-05-25T09:15:00+02:00,2025-05-25,17:15,17,17,34
3,2025-05-25T09:19:00+02:00,2025-05-25,17:19,9,32,41
3,2025-05-25T09:23:00+02:00,2025-05-25,17:23,24,9,33
3,2025-05-25T09:24:00+02:00,2025-05-25,17:24,15,19,34
4,2025-05-25T09:15:00+02:00,2025-05-25,17:15,32,20,52
4,2025-05-25T09:16:00+02:00,2025-05-25,17:16,43,23,66
4,2025-05-25T09:18:00+02:00,2025-05-25,17:18,45,38,83
4,2025-05-25T09:19:00+02:00,2025-05-25,17:19,41,27,68
4,2025-05-25T09:20:00+02:00,2025-05-25,17:20,27,31,58
4,2025-05-25T09:22:00+02:00,2025-05-25,17:22,41,23,64
4,2025-05-25T09:24:00+02:00,2025-05-25,17:24,27,27,54
5,2025-05-25T09:10:00+02:00,2025-05-25,17:10,94,89,183
5,2025-05-25T09:15:00+02:00,2025-05-25,17:15,69,115,184
6,2025-05-25T09:10:00+02:00,2025-05-25,17:10,12,8,20
6,2025-05-25T09:14:00+02:00,2025-05-25,17:14,26,16,42
6,2025-05-25T09:16:00+02:00,2025-05-25,17:16,21,6,27
6,2025-05-25T09:20:00+02:00,2025-05-25,17:20,12,11,23
6,2025-05-25T09:21:00+02:00,2025-05-25,17:21,12,19,31
6,2025-05-25T09:22:00+02:00,2025-05-25,17:22,26,12,38
8,2025-05-25T09:12:00+02:00,2025-05-25,17:12,3,0,3
8,2025-05-25T09:13:00+02:00,2025-05-25,17:13,1,2,3
8,2025-05-25T09:15:00+02:00,2025-05-25,17:15,3,9,12
8,2025-05-25T09:21:00+02:00,2025-05-25,17:21,4,1,5
28,2025-05-25T09:11:00+02:00,2025-05-25,17:11,3,13,16
28,2025-05-25T09:13:00+02:00,2025-05-25,17:13,14,16,30
28,2025-05-25T09:14:00+02:00,2025-05-25,17:14,2,14,16
28,2025-05-25T09:23:00+02:00,2025-05-25,17:23,0,6,6
29,2025-05-25T09:12:00+02:00,2025-05-25,17:12,12,11,23
29,2025-05-25T09:16:00+02:00,2025-05-25,17:16,12,12,24
29,2025-05-25T09:20:00+02:00,2025-05-25,17:20,3,3,6
31,2025-05-25T09:13:00+02:00,2025-05-25,17:13,7,2,9
31,2025-05-25T09:14:00+02:00,2025-05-25,17:14,4,2,6
31,2025-05-25T09:17:00+02:00,2025-05-25,17:17,4,2,6
31,2025-05-25T09:18:00+02:00,2025-05-25,17:18,15,1,16
31,2025-05-25T09:22:00+02:00,2025-05-25,17:22,0,3,3
36,2025-05-25T09:21:00+02:00,2025-05-25,17:21,1,2,3
36,2025-05-25T09:22:00+02:00,2025-05-25,17:22,1,1,2
39,2025-05-25T09:16:00+02:00,2025-05-25,17:16,1,0,1
40,2025-05-25T09:12:00+02:00,2025-05-25,17:12,1,4,5
40,2025-05-25T09:13:00+02:00,2025-05-25,17:13,1,4,5
40,2025-05-25T09:15:00+02:00,2025-05-25,17:15,0,1,1
40,2025-05-25T09:16:00+02:00,2025-05-25,17:16,0,1,1
40,2025-05-25T09:17:00+02:00,2025-05-25,17:17,0,4,4
40,2025-05-25T09:19:00+02:00,2025-05-25,17:19,0,9,9
40,2025-05-25T09:20:00+02:00,2025-05-25,17:20,5,5,10
41,2025-05-25T09:12:00+02:00,2025-05-25,17:12,4,5,9
41,2025-05-25T09:16:00+02:00,2025-05-25,17:16,4,10,14
41,2025-05-25T09:20:00+02:00,2025-05-25,17:20,9,5,14
41,2025-05-25T09:21:00+02:00,2025-05-25,17:21,3,7,10
43,2025-05-25T09:10:00+02:00,2025-05-25,17:10,2,11,13
45,2025-05-25T09:13:00+02:00,2025-05-25,17:13,25,7,32
45,2025-05-25T09:17:00+02:00,2025-05-25,17:17,6,21,27
45,2025-05-25T09:18:00+02:00,2025-05-25,17:18,13,17,30
45,2025-05-25T09:19:00+02:00,2025-05-25,17:19,33,19,52
45,2025-05-25T09:20:00+02:00,2025-05-25,17:20,18,15,33
45,2025-05-25T09:21:00+02:00,2025-05-25,17:21,21,16,37
47,2025-05-25T09:11:00+02:00,2025-05-25,17:11,19,17,36
47,2025-05-25T09:13:00+02:00,2025-05-25,17:13,22,12,34
47,2025-05-25T09:19:00+02:00,2025-05-25,17:19,14,7,21
47,2025-05-25T09:22:00+02:00,2025-05-25,17:22,18,29,47
47,2025-05-25T09:24:00+02:00,2025-05-25,17:24,10,15,25
50,2025-05-25T09:10:00+02:00,2025-05-25,17:10,3,7,10
50,2025-05-25T09:12:00+02:00,2025-05-25,17:12,3,9,12
50,2025-05-25T09:13:00+02:00,2025-05-25,17:13,2,2,4
50,2025-05-25T09:14:00+02:00,2025-05-25,17:14,3,9,12
50,2025-05-25T09:15:00+02:00,2025-05-25,17:15,3,5,8
50,2025-05-25T09:16:00+02:00,2025-05-25,17:16,2,3,5
50,2025-05-25T09:17:00+02:00,2025-05-25,17:17,5,5,10
50,2025-05-25T09:18:00+02:00,2025-05-25,17:18,1,4,5
50,2025-05-25T09:19:00+02:00,2025-05-25,17:19,3,4,7
50,2025-05-25T09:21:00+02:00,2025-05-25,17:21,2,3,5
54,2025-05-25T09:10:00+02:00,2025-05-25,17:10,5,0,5
54,2025-05-25T09:12:00+02:00,2025-05-25,17:12,5,4,9
54,2025-05-25T09:13:00+02:00,2025-05-25,17:13,1,2,3
54,2025-05-25T09:15:00+02:00,2025-05-25,17:15,2,3,5
54,2025-05-25T09:18:00+02:00,2025-05-25,17:18,5,1,6
54,2025-05-25T09:20:00+02:00,2025-05-25,17:20,2,4,6
59,2025-05-25T09:10:00+02:00,2025-05-25,17:10,28,21,49
59,2025-05-25T09:15:00+02:00,2025-05-25,17:15,26,10,36
61,2025-05-25T09:15:00+02:00,2025-05-25,17:15,5,4,9
61,2025-05-25T09:21:00+02:00,2025-05-25,17:21,12,1,13
61,2025-05-25T09:22:00+02:00,2025-05-25,17:22,6,2,8
66,2025-05-25T09:10:00+02:00,2025-05-25,17:10,16,24,40
66,2025-05-25T09:17:00+02:00,2025-05-25,17:17,21,11,32
66,2025-05-25T09:20:00+02:00,2025-05-25,17:20,8,12,20
66,2025-05-25T09:21:00+02:00,2025-05-25,17:21,34,67,101
66,2025-05-25T09:24:00+02:00,2025-05-25,17:24,25,32,57
69,2025-05-25T09:11:00+02:00,2025-05-25,17:11,0,4,4
69,2025-05-25T09:15:00+02:00,2025-05-25,17:15,3,5,8
69,2025-05-25T09:16:00+02:00,2025-05-25,17:16,1,2,3
69,2025-05-25T09:17:00+02:00,2025-05-25,17:17,4,4,8
69,2025-05-25T09:18:00+02:00,2025-05-25,17:18,2,2,4
69,2025-05-25T09:21:00+02:00,2025-05-25,17:21,3,1,4
69,2025-05-25T09:23:00+02:00,2025-05-25,17:23,2,1,3
70,2025-05-25T09:11:00+02:00,2025-05-25,17:11,3,3,6
70,2025-05-25T09:13:00+02:00,2025-05-25,17:13,1,1,2
71,2025-05-25T09:10:00+02:00,2025-05-25,17:10,0,1,1
75,2025-05-25T09:17:00+02:00,2025-05-25,17:17,0,3,3
75,2025-05-25T09:19:00+02:00,2025-05-25,17:19,0,2,2
75,2025-05-25T09:21:00+02:00,2025-05-25,17:21,2,0,2
77,2025-05-25T09:20:00+02:00,2025-05-25,17:20,10,12,22
78,2025-05-25T09:16:00+02:00,2025-05-25,17:16,0,1,1
78,2025-05-25T09:18:00+02:00,2025-05-25,17:18,0,1,1
87,2025-05-25T09:11:00+02:00,2025-05-25,17:11,0,3,3
87,2025-05-25T09:12:00+02:00,2025-05-25,17:12,2,0,2
87,2025-05-25T09:14:00+02:00,2025-05-25,17:14,6,2,8
87,2025-05-25T09:17:00+02:00,2025-05-25,17:17,4,1,5
87,2025-05-25T09:19:00+02:00,2025-05-25,17:19,1,1,2
87,2025-05-25T09:24:00+02:00,2025-05-25,17:24,3,3,6
107,2025-05-25T09:15:00+02:00,2025-05-25,17:15,3,5,8
108,2025-05-25T09:10:00+02:00,2025-05-25,17:10,0,4,4
108,2025-05-25T09:12:00+02:00,2025-05-25,17:12,0,1,1
108,2025-05-25T09:19:00+02:00,2025-05-25,17:19,1,1,2
108,2025-05-25T09:20:00+02:00,2025-05-25,17:20,1,0,1
108,2025-05-25T09:23:00+02:00,2025-05-25,17:23,0,2,2
118,2025-05-25T09:10:00+02:00,2025-05-25,17:10,1,0,1
118,2025-05-25T09:20:00+02:00,2025-05-25,17:20,2,0,2
131,2025-05-25T09:10:00+02:00,2025-05-25,17:10,7,6,13
131,2025-05-25T09:15:00+02:00,2025-05-25,17:15,12,8,20
132,2025-05-25T09:10:00+02:00,2025-05-25,17:10,13,13,26
135,2025-05-25T09:10:00+02:00,2025-05-25,17:10,30,34,64
135,2025-05-25T09:15:00+02:00,2025-05-25,17:15,29,32,61
162,2025-05-25T09:10:00+02:00,2025-05-25,17:10,17,21,38
162,2025-05-25T09:20:00+02:00,2025-05-25,17:20,14,23,37
165,2025-05-25T09:10:00+02:00,2025-05-25,17:10,6,4,10
166,2025-05-25T09:15:00+02:00,2025-05-25,17:15,9,6,15
1,2025-05-25T09:18:00+02:00,2025-05-25,17:18,25,20,45
1,2025-05-25T09:20:00+02:00,2025-05-25,17:20,18,22,40
1,2025-05-25T09:22:00+02:00,2025-05-25,17:22,10,20,30
1,2025-05-25T09:23:00+02:00,2025-05-25,17:23,16,13,29
2,2025-05-25T09:11:00+02:00,2025-05-25,17:11,9,9,18
2,2025-05-25T09:13:00+02:00,2025-05-25,17:13,12,11,23
2,2025-05-25T09:20:00+02:00,2025-05-25,17:20,5,13,18
2,2025-05-25T09:22:00+02:00,2025-05-25,17:22,4,18,22
2,2025-05-25T09:24:00+02:00,2025-05-25,17:24,2,13,15
9,2025-05-25T09:10:00+02:00,2025-05-25,17:10,2,0,2
9,2025-05-25T09:14:00+02:00,2025-05-25,17:14,0,1,1
9,2025-05-25T09:16:00+02:00,2025-05-25,17:16,1,0,1
9,2025-05-25T09:18:00+02:00,2025-05-25,17:18,1,1,2
9,2025-05-25T09:20:00+02:00,2025-05-25,17:20,1,1,2
9,2025-05-25T09:21:00+02:00,2025-05-25,17:21,3,2,5
9,2025-05-25T09:24:00+02:00,2025-05-25,17:24,0,2,2
10,2025-05-25T09:11:00+02:00,2025-05-25,17:11,1,0,1
11,2025-05-25T09:15:00+02:00,2025-05-25,17:15,6,1,7
12,2025-05-25T09:11:00+02:00,2025-05-25,17:11,2,3,5
12,2025-05-25T09:13:00+02:00,2025-05-25,17:13,2,4,6
12,2025-05-25T09:17:00+02:00,2025-05-25,17:17,3,8,11
12,2025-05-25T09:21:00+02:00,2025-05-25,17:21,2,4,6
12,2025-05-25T09:22:00+02:00,2025-05-25,17:22,0,2,2
12,2025-05-25T09:24:00+02:00,2025-05-25,17:24,4,1,5
17,2025-05-25T09:10:00+02:00,2025-05-25,17:10,5,0,5
17,2025-05-25T09:14:00+02:00,2025-05-25,17:14,5,0,5
17,2025-05-25T09:15:00+02:00,2025-05-25,17:15,0,1,1
17,2025-05-25T09:16:00+02:00,2025-05-25,17:16,3,0,3
17,2025-05-25T09:24:00+02:00,2025-05-25,17:24,5,1,6
18,2025-05-25T09:10:00+02:00,2025-05-25,17:10,0,1,1
18,2025-05-25T09:22:00+02:00,2025-05-25,17:22,1,1,2
19,2025-05-25T09:12:00+02:00,2025-05-25,17:12,4,3,7
19,2025-05-25T09:13:00+02:00,2025-05-25,17:13,10,14,24
19,2025-05-25T09:14:00+02:00,2025-05-25,17:14,9,8,17
19,2025-05-25T09:15:00+02:00,2025-05-25,17:15,11,3,14
19,2025-05-25T09:19:00+02:00,2025-05-25,17:19,11,8,19
19,2025-05-25T09:20:00+02:00,2025-05-25,17:20,8,10,18
19,2025-05-25T09:22:00+02:00,2025-05-25,17:22,19,3,22
19,2025-05-25T09:24:00+02:00,2025-05-25,17:24,7,14,21
20,2025-05-25T09:11:00+02:00,2025-05-25,17:11,6,10,16
20,2025-05-25T09:12:00+02:00,2025-05-25,17:12,7,4,11
20,2025-05-25T09:22:00+02:00,2025-05-25,17:22,6,2,8
23,2025-05-25T09:14:00+02:00,2025-05-25,17:14,2,1,3
23,2025-05-25T09:15:00+02:00,2025-05-25,17:15,5,0,5
23,2025-05-25T09:20:00+02:00,2025-05-25,17:20,0,2,2
24,2025-05-25T09:11:00+02:00,2025-05-25,17:11,3,13,16
24,2025-05-25T09:13:00+02:00,2025-05-25,17:13,2,26,28
24,2025-05-25T09:15:00+02:00,2025-05-25,17:15,18,2,20
24,2025-05-25T09:16:00+02:00,2025-05-25,17:16,6,10,16
24,2025-05-25T09:20:00+02:00,2025-05-25,17:20,3,0,3
24,2025-05-25T09:21:00+02:00,2025-05-25,17:21,9,5,14
24,2025-05-25T09:23:00+02:00,2025-05-25,17:23,10,21,31
25,2025-05-25T09:15:00+02:00,2025-05-25,17:15,94,43,137
27,2025-05-25T09:11:00+02:00,2025-05-25,17:11,1,0,1
27,2025-05-25T09:19:00+02:00,2025-05-25,17:19,0,1,1
27,2025-05-25T09:20:00+02:00,2025-05-25,17:20,2,2,4
27,2025-05-25T09:24:00+02:00,2025-05-25,17:24,2,0,2
30,2025-05-25T09:10:00+02:00,2025-05-25,17:10,6,5,11
30,2025-05-25T09:11:00+02:00,2025-05-25,17:11,1,17,18
30,2025-05-25T09:16:00+02:00,2025-05-25,17:16,6,4,10
30,2025-05-25T09:22:00+02:00,2025-05-25,17:22,6,3,9
30,2025-05-25T09:23:00+02:00,2025-05-25,17:23,5,3,8
35,2025-05-25T09:10:00+02:00,2025-05-25,17:10,17,27,44
35,2025-05-25T09:20:00+02:00,2025-05-25,17:20,18,17,35
35,2025-05-25T09:23:00+02:00,2025-05-25,17:23,18,20,38
46,2025-05-25T09:15:00+02:00,2025-05-25,17:15,3,6,9
46,2025-05-25T09:20:00+02:00,2025-05-25,17:20,4,5,9
48,2025-05-25T09:20:00+02:00,2025-05-25,17:20,6,1,7
48,2025-05-25T09:23:00+02:00,2025-05-25,17:23,2,0,2
49,2025-05-25T09:11:00+02:00,2025-05-25,17:11,0,1,1
49,2025-05-25T09:12:00+02:00,2025-05-25,17:12,7,9,16
49,2025-05-25T09:21:00+02:00,2025-05-25,17:21,0,6,6
51,2025-05-25T09:10:00+02:00,2025-05-25,17:10,0,4,4
51,2025-05-25T09:11:00+02:00,2025-05-25,17:11,1,3,4
51,2025-05-25T09:16:00+02:00,2025-05-25,17:16,1,9,10
51,2025-05-25T09:18:00+02:00,2025-05-25,17:18,1,1,2
51,2025-05-25T09:19:00+02:00,2025-05-25,17:19,1,3,4
51,2025-05-25T09:24:00+02:00,2025-05-25,17:24,0,1,1
52,2025-05-25T09:10:00+02:00,2025-05-25,17:10,1,6,7
52,2025-05-25T09:12:00+02:00,2025-05-25,17:12,6,13,19
52,2025-05-25T09:13:00+02:00,2025-05-25,17:13,12,4,16
52,2025-05-25T09:14:00+02:00,2025-05-25,17:14,4,1,5
52,2025-05-25T09:15:00+02:00,2025-05-25,17:15,1,7,8
52,2025-05-25T09:17:00+02:00,2025-05-25,17:17,4,2,6
52,2025-05-25T09:19:00+02:00,2025-05-25,17:19,7,6,13
52,2025-05-25T09:23:00+02:00,2025-05-25,17:23,1,3,4
53,2025-05-25T09:11:00+02:00,2025-05-25,17:11,7,6,13
53,2025-05-25T09:12:00+02:00,2025-05-25,17:12,5,2,7
53,2025-05-25T09:15:00+02:00,2025-05-25,17:15,3,5,8
53,2025-05-25T09:16:00+02:00,2025-05-25,17:16,13,2,15
53,2025-05-25T09:18:00+02:00,2025-05-25,17:18,6,3,9
53,2025-05-25T09:19:00+02:00,2025-05-25,17:19,8,4,12
53,2025-05-25T09:20:00+02:00,2025-05-25,17:20,5,4,9
53,2025-05-25T09:21:00+02:00,2025-05-25,17:21,6,2,8
53,2025-05-25T09:24:00+02:00,2025-05-25,17:24,4,4,8
56,2025-05-25T09:11:00+02:00,2025-05-25,17:11,4,6,10
56,2025-05-25T09:12:00+02:00,2025-05-25,17:12,1,18,19
56,2025-05-25T09:13:00+02:00,2025-05-25,17:13,3,8,11
56,2025-05-25T09:15:00+02:00,2025-05-25,17:15,9,2,11
56,2025-05-25T09:22:00+02:00,2025-05-25,17:22,6,2,8
56,2025-05-25T09:24:00+02:00,2025-05-25,17:24,7,10,17
58,2025-05-25T09:12:00+02:00,2025-05-25,17:12,2,7,9
58,2025-05-25T09:14:00+02:00,2025-05-25,17:14,14,2,16
58,2025-05-25T09:15:00+02:00,2025-05-25,17:15,2,3,5
58,2025-05-25T09:17:00+02:00,2025-05-25,17:17,14,6,20
58,2025-05-25T09:19:00+02:00,2025-05-25,17:19,13,5,18
58,2025-05-25T09:23:00+02:00,2025-05-25,17:23,1,2,3
62,2025-05-25T09:10:00+02:00,2025-05-25,17:10,2,1,3
62,2025-05-25T09:12:00+02:00,2025-05-25,17:12,2,3,5
62,2025-05-25T09:21:00+02:00,2025-05-25,17:21,5,3,8
62,2025-05-25T09:24:00+02:00,2025-05-25,17:24,2,2,4
63,2025-05-25T09:10:00+02:00,2025-05-25,17:10,3,13,16
63,2025-05-25T09:14:00+02:00,2025-05-25,17:14,4,1,5
63,2025-05-25T09:15:00+02:00,2025-05-25,17:15,4,4,8
63,2025-05-25T09:17:00+02:00,2025-05-25,17:17,7,8,15
63,2025-05-25T09:18:00+02:00,2025-05-25,17:18,8,10,18
63,2025-05-25T09:20:00+02:00,2025-05-25,17:20,6,8,14
63,2025-05-25T09:21:00+02:00,2025-05-25,17:21,4,5,9
63,2025-05-25T09:24:00+02:00,2025-05-25,17:24,9,11,20
67,2025-05-25T09:18:00+02:00,2025-05-25,17:18,4,3,7
67,2025-05-25T09:19:00+02:00,2025-05-25,17:19,6,5,11
67,2025-05-25T09:23:00+02:00,2025-05-25,17:23,6,11,17
68,2025-05-25T09:12:00+02:00,2025-05-25,17:12,2,3,5
68,2025-05-25T09:13:00+02:00,2025-05-25,17:13,4,2,6
68,2025-05-25T09:15:00+02:00,2025-05-25,17:15,2,3,5
68,2025-05-25T09:21:00+02:00,2025-05-25,17:21,3,4,7
68,2025-05-25T09:22:00+02:00,2025-05-25,17:22,4,0,4
68,2025-05-25T09:23:00+02:00,2025-05-25,17:23,3,1,4
72,2025-05-25T09:14:00+02:00,2025-05-25,17:14,17,15,32
72,2025-05-25T09:18:00+02:00,2025-05-25,17:18,8,7,15
72,2025-05-25T09:19:00+02:00,2025-05-25,17:19,2,14,16
76,2025-05-25T09:17:00+02:00,2025-05-25,17:17,0,1,1
76,2025-05-25T09:19:00+02:00,2025-05-25,17:19,2,1,3
76,2025-05-25T09:21:00+02:00,2025-05-25,17:21,0,1,1
76,2025-05-25T09:24:00+02:00,2025-05-25,17:24,1,1,2
79,2025-05-25T09:15:00+02:00,2025-05-25,17:15,3,9,12
79,2025-05-25T09:17:00+02:00,2025-05-25,17:17,15,12,27
79,2025-05-25T09:18:00+02:00,2025-05-25,17:18,11,15,26
79,2025-05-25T09:19:00+02:00,2025-05-25,17:19,17,3,20
79,2025-05-25T09:20:00+02:00,2025-05-25,17:20,12,9,21
79,2025-05-25T09:21:00+02:00,2025-05-25,17:21,14,8,22
85,2025-05-25T09:19:00+02:00,2025-05-25,17:19,0,1,1
86,2025-05-25T09:20:00+02:00,2025-05-25,17:20,0,2,2
86,2025-05-25T09:21:00+02:00,2025-05-25,17:21,2,0,2
86,2025-05-25T09:22:00+02:00,2025-05-25,17:22,4,0,4
86,2025-05-25T09:24:00+02:00,2025-05-25,17:24,1,2,3
109,2025-05-25T09:10:00+02:00,2025-05-25,17:10,4,8,12
117,2025-05-25T09:15:00+02:00,2025-05-25,17:15,41,24,65
123,2025-05-25T09:10:00+02:00,2025-05-25,17:10,13,1,14
130,2025-05-25T09:20:00+02:00,2025-05-25,17:20,7,3,10
139,2025-05-25T09:20:00+02:00,2025-05-25,17:20,8,1,9
141,2025-05-25T09:20:00+02:00,2025-05-25,17:20,13,10,23
142,2025-05-25T09:15:00+02:00,2025-05-25,17:15,32,41,73
164,2025-05-25T09:10:00+02:00,2025-05-25,17:10,5,19,24
181,2025-05-25T09:37:00+02:00,2025-05-25,17:37,13,21,34
181,2025-05-25T09:39:00+02:00,2025-05-25,17:39,18,10,28
180,2025-05-25T09:27:00+02:00,2025-05-25,17:27,0,1,1
3,2025-05-25T03:41:00+02:00,2025-05-25,11:41,5,9,14
3,2025-05-25T03:42:00+02:00,2025-05-25,11:42,9,24,33
3,2025-05-25T03:46:00+02:00,2025-05-25,11:46,15,17,32
3,2025-05-25T03:50:00+02:00,2025-05-25,11:50,17,13,30
3,2025-05-25T03:52:00+02:00,2025-05-25,11:52,15,6,21
3,2025-05-25T03:53:00+02:00,2025-05-25,11:53,8,17,25
3,2025-05-25T03:54:00+02:00,2025-05-25,11:54,3,13,16
4,2025-05-25T03:40:00+02:00,2025-05-25,11:40,21,23,44
4,2025-05-25T03:45:00+02:00,2025-05-25,11:45,30,11,41
4,2025-05-25T03:48:00+02:00,2025-05-25,11:48,24,16,40
4,2025-05-25T03:51:00+02:00,2025-05-25,11:51,24,16,40
4,2025-05-25T03:52:00+02:00,2025-05-25,11:52,21,21,42
4,2025-05-25T03:53:00+02:00,2025-05-25,11:53,28,14,42
5,2025-05-25T03:40:00+02:00,2025-05-25,11:40,60,60,120
5,2025-05-25T03:45:00+02:00,2025-05-25,11:45,58,95,153
6,2025-05-25T03:42:00+02:00,2025-05-25,11:42,12,12,24
6,2025-05-25T03:47:00+02:00,2025-05-25,11:47,16,13,29
6,2025-05-25T03:48:00+02:00,2025-05-25,11:48,12,24,36
6,2025-05-25T03:51:00+02:00,2025-05-25,11:51,22,11,33
6,2025-05-25T03:52:00+02:00,2025-05-25,11:52,10,11,21
8,2025-05-25T03:41:00+02:00,2025-05-25,11:41,1,9,10
8,2025-05-25T03:43:00+02:00,2025-05-25,11:43,7,5,12
8,2025-05-25T03:48:00+02:00,2025-05-25,11:48,4,8,12
8,2025-05-25T03:52:00+02:00,2025-05-25,11:52,6,4,10
28,2025-05-25T03:40:00+02:00,2025-05-25,11:40,11,10,21
28,2025-05-25T03:42:00+02:00,2025-05-25,11:42,12,5,17
28,2025-05-25T03:45:00+02:00,2025-05-25,11:45,2,5,7
28,2025-05-25T03:51:00+02:00,2025-05-25,11:51,6,12,18
29,2025-05-25T03:40:00+02:00,2025-05-25,11:40,16,5,21
29,2025-05-25T03:41:00+02:00,2025-05-25,11:41,11,6,17
29,2025-05-25T03:44:00+02:00,2025-05-25,11:44,6,7,13
29,2025-05-25T03:45:00+02:00,2025-05-25,11:45,9,13,22
29,2025-05-25T03:49:00+02:00,2025-05-25,11:49,8,1,9
29,2025-05-25T03:50:00+02:00,2025-05-25,11:50,11,13,24
29,2025-05-25T03:53:00+02:00,2025-05-25,11:53,5,5,10
29,2025-05-25T03:54:00+02:00,2025-05-25,11:54,5,12,17
31,2025-05-25T03:40:00+02:00,2025-05-25,11:40,3,10,13
31,2025-05-25T03:43:00+02:00,2025-05-25,11:43,2,3,5
31,2025-05-25T03:46:00+02:00,2025-05-25,11:46,1,6,7
31,2025-05-25T03:47:00+02:00,2025-05-25,11:47,8,1,9
31,2025-05-25T03:51:00+02:00,2025-05-25,11:51,3,3,6
31,2025-05-25T03:52:00+02:00,2025-05-25,11:52,6,1,7
31,2025-05-25T03:53:00+02:00,2025-05-25,11:53,5,3,8
36,2025-05-25T03:42:00+02:00,2025-05-25,11:42,3,1,4
36,2025-05-25T03:43:00+02:00,2025-05-25,11:43,5,3,8
36,2025-05-25T03:45:00+02:00,2025-05-25,11:45,0,6,6
36,2025-05-25T03:47:00+02:00,2025-05-25,11:47,1,5,6
36,2025-05-25T03:48:00+02:00,2025-05-25,11:48,1,4,5
36,2025-05-25T03:49:00+02:00,2025-05-25,11:49,0,4,4
36,2025-05-25T03:52:00+02:00,2025-05-25,11:52,4,3,7
37,2025-05-25T03:42:00+02:00,2025-05-25,11:42,1,1,2
37,2025-05-25T03:47:00+02:00,2025-05-25,11:47,6,0,6
37,2025-05-25T03:52:00+02:00,2025-05-25,11:52,4,0,4
39,2025-05-25T03:50:00+02:00,2025-05-25,11:50,1,3,4
39,2025-05-25T03:51:00+02:00,2025-05-25,11:51,3,3,6
40,2025-05-25T03:41:00+02:00,2025-05-25,11:41,0,6,6
40,2025-05-25T03:50:00+02:00,2025-05-25,11:50,3,3,6
40,2025-05-25T03:52:00+02:00,2025-05-25,11:52,6,3,9
40,2025-05-25T03:53:00+02:00,2025-05-25,11:53,1,3,4
41,2025-05-25T03:40:00+02:00,2025-05-25,11:40,4,0,4
41,2025-05-25T03:41:00+02:00,2025-05-25,11:41,3,3,6
41,2025-05-25T03:45:00+02:00,2025-05-25,11:45,5,9,14
41,2025-05-25T03:47:00+02:00,2025-05-25,11:47,3,2,5
41,2025-05-25T03:48:00+02:00,2025-05-25,11:48,1,3,4
41,2025-05-25T03:49:00+02:00,2025-05-25,11:49,12,6,18
41,2025-05-25T03:50:00+02:00,2025-05-25,11:50,6,4,10
43,2025-05-25T03:45:00+02:00,2025-05-25,11:45,3,4,7
44,2025-05-25T03:45:00+02:00,2025-05-25,11:45,2,1,3
45,2025-05-25T03:40:00+02:00,2025-05-25,11:40,12,12,24
45,2025-05-25T03:41:00+02:00,2025-05-25,11:41,0,10,10
45,2025-05-25T03:44:00+02:00,2025-05-25,11:44,13,12,25
45,2025-05-25T03:49:00+02:00,2025-05-25,11:49,24,11,35
45,2025-05-25T03:50:00+02:00,2025-05-25,11:50,16,5,21
45,2025-05-25T03:52:00+02:00,2025-05-25,11:52,27,20,47
45,2025-05-25T03:54:00+02:00,2025-05-25,11:54,13,20,33
47,2025-05-25T03:42:00+02:00,2025-05-25,11:42,7,15,22
47,2025-05-25T03:43:00+02:00,2025-05-25,11:43,18,18,36
47,2025-05-25T03:46:00+02:00,2025-05-25,11:46,3,18,21
47,2025-05-25T03:47:00+02:00,2025-05-25,11:47,8,8,16
47,2025-05-25T03:51:00+02:00,2025-05-25,11:51,12,26,38
47,2025-05-25T03:52:00+02:00,2025-05-25,11:52,5,16,21
50,2025-05-25T03:40:00+02:00,2025-05-25,11:40,2,0,2
50,2025-05-25T03:42:00+02:00,2025-05-25,11:42,5,8,13
50,2025-05-25T03:44:00+02:00,2025-05-25,11:44,3,8,11
50,2025-05-25T03:45:00+02:00,2025-05-25,11:45,2,8,10
50,2025-05-25T03:49:00+02:00,2025-05-25,11:49,4,3,7
50,2025-05-25T03:50:00+02:00,2025-05-25,11:50,2,8,10
50,2025-05-25T03:51:00+02:00,2025-05-25,11:51,4,8,12
54,2025-05-25T03:40:00+02:00,2025-05-25,11:40,3,0,3
54,2025-05-25T03:41:00+02:00,2025-05-25,11:41,3,1,4
54,2025-05-25T03:45:00+02:00,2025-05-25,11:45,2,1,3
54,2025-05-25T03:51:00+02:00,2025-05-25,11:51,0,2,2
61,2025-05-25T03:40:00+02:00,2025-05-25,11:40,2,4,6
61,2025-05-25T03:43:00+02:00,2025-05-25,11:43,4,11,15
61,2025-05-25T03:52:00+02:00,2025-05-25,11:52,2,4,6
61,2025-05-25T03:53:00+02:00,2025-05-25,11:53,5,7,12
66,2025-05-25T03:41:00+02:00,2025-05-25,11:41,15,8,23
66,2025-05-25T03:42:00+02:00,2025-05-25,11:42,8,14,22
66,2025-05-25T03:46:00+02:00,2025-05-25,11:46,16,15,31
69,2025-05-25T03:41:00+02:00,2025-05-25,11:41,5,2,7
69,2025-05-25T03:42:00+02:00,2025-05-25,11:42,1,7,8
69,2025-05-25T03:49:00+02:00,2025-05-25,11:49,7,1,8
69,2025-05-25T03:51:00+02:00,2025-05-25,11:51,2,6,8
69,2025-05-25T03:53:00+02:00,2025-05-25,11:53,2,2,4
70,2025-05-25T03:45:00+02:00,2025-05-25,11:45,2,0,2
70,2025-05-25T03:46:00+02:00,2025-05-25,11:46,1,3,4
70,2025-05-25T03:49:00+02:00,2025-05-25,11:49,1,2,3
70,2025-05-25T03:51:00+02:00,2025-05-25,11:51,2,8,10
70,2025-05-25T03:53:00+02:00,2025-05-25,11:53,0,3,3
75,2025-05-25T03:42:00+02:00,2025-05-25,11:42,3,2,5
75,2025-05-25T03:44:00+02:00,2025-05-25,11:44,2,2,4
75,2025-05-25T03:47:00+02:00,2025-05-25,11:47,1,0,1
75,2025-05-25T03:51:00+02:00,2025-05-25,11:51,0,1,1
77,2025-05-25T03:40:00+02:00,2025-05-25,11:40,17,13,30
78,2025-05-25T03:42:00+02:00,2025-05-25,11:42,0,2,2
78,2025-05-25T03:43:00+02:00,2025-05-25,11:43,0,5,5
78,2025-05-25T03:51:00+02:00,2025-05-25,11:51,1,2,3
84,2025-05-25T03:40:00+02:00,2025-05-25,11:40,96,75,171
87,2025-05-25T03:42:00+02:00,2025-05-25,11:42,2,1,3
87,2025-05-25T03:46:00+02:00,2025-05-25,11:46,2,0,2
87,2025-05-25T03:47:00+02:00,2025-05-25,11:47,1,3,4
87,2025-05-25T03:48:00+02:00,2025-05-25,11:48,2,4,6
87,2025-05-25T03:50:00+02:00,2025-05-25,11:50,2,0,2
87,2025-05-25T03:53:00+02:00,2025-05-25,11:53,0,8,8
107,2025-05-25T03:40:00+02:00,2025-05-25,11:40,12,6,18
108,2025-05-25T03:41:00+02:00,2025-05-25,11:41,3,1,4
108,2025-05-25T03:47:00+02:00,2025-05-25,11:47,0,2,2
131,2025-05-25T03:40:00+02:00,2025-05-25,11:40,11,17,28
131,2025-05-25T03:45:00+02:00,2025-05-25,11:45,9,14,23
132,2025-05-25T03:40:00+02:00,2025-05-25,11:40,12,8,20
133,2025-05-25T03:40:00+02:00,2025-05-25,11:40,44,43,87
133,2025-05-25T03:45:00+02:00,2025-05-25,11:45,48,39,87
133,2025-05-25T03:50:00+02:00,2025-05-25,11:50,33,41,74
140,2025-05-25T03:50:00+02:00,2025-05-25,11:50,12,8,20
162,2025-05-25T03:45:00+02:00,2025-05-25,11:45,56,75,131
167,2025-05-25T03:45:00+02:00,2025-05-25,11:45,2,10,12
167,2025-05-25T03:50:00+02:00,2025-05-25,11:50,4,12,16
1,2025-05-25T03:43:00+02:00,2025-05-25,11:43,26,11,37
1,2025-05-25T03:46:00+02:00,2025-05-25,11:46,19,19,38
1,2025-05-25T03:48:00+02:00,2025-05-25,11:48,23,8,31
1,2025-05-25T03:53:00+02:00,2025-05-25,11:53,17,31,48
2,2025-05-25T03:43:00+02:00,2025-05-25,11:43,7,12,19
2,2025-05-25T03:45:00+02:00,2025-05-25,11:45,4,13,17
2,2025-05-25T03:48:00+02:00,2025-05-25,11:48,19,5,24
2,2025-05-25T03:49:00+02:00,2025-05-25,11:49,7,7,14
9,2025-05-25T03:40:00+02:00,2025-05-25,11:40,3,0,3
9,2025-05-25T03:45:00+02:00,2025-05-25,11:45,2,2,4
9,2025-05-25T03:47:00+02:00,2025-05-25,11:47,0,2,2
9,2025-05-25T03:49:00+02:00,2025-05-25,11:49,1,4,5
9,2025-05-25T03:51:00+02:00,2025-05-25,11:51,1,2,3
10,2025-05-25T03:44:00+02:00,2025-05-25,11:44,2,0,2
11,2025-05-25T03:41:00+02:00,2025-05-25,11:41,0,4,4
11,2025-05-25T03:42:00+02:00,2025-05-25,11:42,4,2,6
11,2025-05-25T03:49:00+02:00,2025-05-25,11:49,0,1,1
11,2025-05-25T03:50:00+02:00,2025-05-25,11:50,3,5,8
11,2025-05-25T03:52:00+02:00,2025-05-25,11:52,0,1,1
11,2025-05-25T03:54:00+02:00,2025-05-25,11:54,1,0,1
12,2025-05-25T03:42:00+02:00,2025-05-25,11:42,3,6,9
12,2025-05-25T03:43:00+02:00,2025-05-25,11:43,0,7,7
12,2025-05-25T03:44:00+02:00,2025-05-25,11:44,5,2,7
12,2025-05-25T03:45:00+02:00,2025-05-25,11:45,2,9,11
12,2025-05-25T03:52:00+02:00,2025-05-25,11:52,6,2,8
12,2025-05-25T03:53:00+02:00,2025-05-25,11:53,5,7,12
17,2025-05-25T03:41:00+02:00,2025-05-25,11:41,3,6,9
17,2025-05-25T03:42:00+02:00,2025-05-25,11:42,10,2,12
17,2025-05-25T03:45:00+02:00,2025-05-25,11:45,4,0,4
17,2025-05-25T03:46:00+02:00,2025-05-25,11:46,2,3,5
17,2025-05-25T03:50:00+02:00,2025-05-25,11:50,1,0,1
17,2025-05-25T03:54:00+02:00,2025-05-25,11:54,1,0,1
18,2025-05-25T03:42:00+02:00,2025-05-25,11:42,0,1,1
18,2025-05-25T03:47:00+02:00,2025-05-25,11:47,1,2,3
18,2025-05-25T03:48:00+02:00,2025-05-25,11:48,2,2,4
18,2025-05-25T03:51:00+02:00,2025-05-25,11:51,3,1,4
18,2025-05-25T03:53:00+02:00,2025-05-25,11:53,0,2,2
19,2025-05-25T03:40:00+02:00,2025-05-25,11:40,4,2,6
19,2025-05-25T03:41:00+02:00,2025-05-25,11:41,6,3,9
19,2025-05-25T03:43:00+02:00,2025-05-25,11:43,4,6,10
19,2025-05-25T03:44:00+02:00,2025-05-25,11:44,2,8,10
19,2025-05-25T03:47:00+02:00,2025-05-25,11:47,6,9,15
19,2025-05-25T03:48:00+02:00,2025-05-25,11:48,4,6,10
19,2025-05-25T03:52:00+02:00,2025-05-25,11:52,12,6,18
19,2025-05-25T03:53:00+02:00,2025-05-25,11:53,11,6,17
19,2025-05-25T03:54:00+02:00,2025-05-25,11:54,9,2,11
20,2025-05-25T03:43:00+02:00,2025-05-25,11:43,4,6,10
20,2025-05-25T03:47:00+02:00,2025-05-25,11:47,7,0,7
20,2025-05-25T03:49:00+02:00,2025-05-25,11:49,4,8,12
20,2025-05-25T03:51:00+02:00,2025-05-25,11:51,4,1,5
20,2025-05-25T03:53:00+02:00,2025-05-25,11:53,8,8,16
20,2025-05-25T03:54:00+02:00,2025-05-25,11:54,17,6,23
23,2025-05-25T03:40:00+02:00,2025-05-25,11:40,3,7,10
23,2025-05-25T03:45:00+02:00,2025-05-25,11:45,1,3,4
23,2025-05-25T03:48:00+02:00,2025-05-25,11:48,4,4,8
24,2025-05-25T03:45:00+02:00,2025-05-25,11:45,16,2,18
24,2025-05-25T03:47:00+02:00,2025-05-25,11:47,31,11,42
24,2025-05-25T03:48:00+02:00,2025-05-25,11:48,17,7,24
25,2025-05-25T03:50:00+02:00,2025-05-25,11:50,43,81,124
27,2025-05-25T03:44:00+02:00,2025-05-25,11:44,2,4,6
27,2025-05-25T03:45:00+02:00,2025-05-25,11:45,3,1,4
27,2025-05-25T03:46:00+02:00,2025-05-25,11:46,6,3,9
27,2025-05-25T03:49:00+02:00,2025-05-25,11:49,6,2,8
27,2025-05-25T03:51:00+02:00,2025-05-25,11:51,3,2,5
27,2025-05-25T03:52:00+02:00,2025-05-25,11:52,2,5,7
27,2025-05-25T03:54:00+02:00,2025-05-25,11:54,11,5,16
30,2025-05-25T03:41:00+02:00,2025-05-25,11:41,1,12,13
30,2025-05-25T03:47:00+02:00,2025-05-25,11:47,3,7,10
30,2025-05-25T03:48:00+02:00,2025-05-25,11:48,2,0,2
30,2025-05-25T03:49:00+02:00,2025-05-25,11:49,4,2,6
30,2025-05-25T03:50:00+02:00,2025-05-25,11:50,0,3,3
30,2025-05-25T03:52:00+02:00,2025-05-25,11:52,7,4,11
30,2025-05-25T03:53:00+02:00,2025-05-25,11:53,3,6,9
35,2025-05-25T03:44:00+02:00,2025-05-25,11:44,12,14,26
35,2025-05-25T03:45:00+02:00,2025-05-25,11:45,15,19,34
35,2025-05-25T03:46:00+02:00,2025-05-25,11:46,18,14,32
35,2025-05-25T03:47:00+02:00,2025-05-25,11:47,25,26,51
35,2025-05-25T03:50:00+02:00,2025-05-25,11:50,26,25,51
35,2025-05-25T03:54:00+02:00,2025-05-25,11:54,22,17,39
48,2025-05-25T03:44:00+02:00,2025-05-25,11:44,9,2,11
48,2025-05-25T03:45:00+02:00,2025-05-25,11:45,11,4,15
48,2025-05-25T03:47:00+02:00,2025-05-25,11:47,12,5,17
48,2025-05-25T03:48:00+02:00,2025-05-25,11:48,9,8,17
48,2025-05-25T03:50:00+02:00,2025-05-25,11:50,7,8,15
48,2025-05-25T03:51:00+02:00,2025-05-25,11:51,9,9,18
48,2025-05-25T03:53:00+02:00,2025-05-25,11:53,18,11,29
48,2025-05-25T03:54:00+02:00,2025-05-25,11:54,17,6,23
49,2025-05-25T03:43:00+02:00,2025-05-25,11:43,8,5,13
49,2025-05-25T03:44:00+02:00,2025-05-25,11:44,7,12,19
49,2025-05-25T03:47:00+02:00,2025-05-25,11:47,5,13,18
49,2025-05-25T03:48:00+02:00,2025-05-25,11:48,11,10,21
49,2025-05-25T03:49:00+02:00,2025-05-25,11:49,7,10,17
49,2025-05-25T03:54:00+02:00,2025-05-25,11:54,9,6,15
51,2025-05-25T03:49:00+02:00,2025-05-25,11:49,2,7,9
51,2025-05-25T03:50:00+02:00,2025-05-25,11:50,5,7,12
51,2025-05-25T03:51:00+02:00,2025-05-25,11:51,6,1,7
51,2025-05-25T03:53:00+02:00,2025-05-25,11:53,8,4,12
52,2025-05-25T03:50:00+02:00,2025-05-25,11:50,18,5,23
52,2025-05-25T03:51:00+02:00,2025-05-25,11:51,2,3,5
52,2025-05-25T03:52:00+02:00,2025-05-25,11:52,3,6,9
53,2025-05-25T03:41:00+02:00,2025-05-25,11:41,13,7,20
53,2025-05-25T03:43:00+02:00,2025-05-25,11:43,12,7,19
53,2025-05-25T03:52:00+02:00,2025-05-25,11:52,7,1,8
53,2025-05-25T03:54:00+02:00,2025-05-25,11:54,13,3,16
56,2025-05-25T03:40:00+02:00,2025-05-25,11:40,3,4,7
56,2025-05-25T03:42:00+02:00,2025-05-25,11:42,0,3,3
56,2025-05-25T03:45:00+02:00,2025-05-25,11:45,7,5,12
56,2025-05-25T03:46:00+02:00,2025-05-25,11:46,5,4,9
56,2025-05-25T03:50:00+02:00,2025-05-25,11:50,14,3,17
58,2025-05-25T03:46:00+02:00,2025-05-25,11:46,6,7,13
58,2025-05-25T03:48:00+02:00,2025-05-25,11:48,12,0,12
58,2025-05-25T03:50:00+02:00,2025-05-25,11:50,10,17,27
62,2025-05-25T03:40:00+02:00,2025-05-25,11:40,3,2,5
62,2025-05-25T03:46:00+02:00,2025-05-25,11:46,2,0,2
62,2025-05-25T03:47:00+02:00,2025-05-25,11:47,4,0,4
62,2025-05-25T03:50:00+02:00,2025-05-25,11:50,3,1,4
62,2025-05-25T03:51:00+02:00,2025-05-25,11:51,3,0,3
62,2025-05-25T03:52:00+02:00,2025-05-25,11:52,1,4,5
63,2025-05-25T03:41:00+02:00,2025-05-25,11:41,5,5,10
63,2025-05-25T03:49:00+02:00,2025-05-25,11:49,8,2,10
67,2025-05-25T03:42:00+02:00,2025-05-25,11:42,4,14,18
67,2025-05-25T03:48:00+02:00,2025-05-25,11:48,14,9,23
67,2025-05-25T03:49:00+02:00,2025-05-25,11:49,2,6,8
67,2025-05-25T03:50:00+02:00,2025-05-25,11:50,7,4,11
68,2025-05-25T03:43:00+02:00,2025-05-25,11:43,15,4,19
68,2025-05-25T03:46:00+02:00,2025-05-25,11:46,7,5,12
68,2025-05-25T03:51:00+02:00,2025-05-25,11:51,6,6,12
68,2025-05-25T03:52:00+02:00,2025-05-25,11:52,10,4,14
72,2025-05-25T03:40:00+02:00,2025-05-25,11:40,3,1,4
72,2025-05-25T03:42:00+02:00,2025-05-25,11:42,5,1,6
72,2025-05-25T03:49:00+02:00,2025-05-25,11:49,3,3,6
72,2025-05-25T03:52:00+02:00,2025-05-25,11:52,7,12,19
79,2025-05-25T03:41:00+02:00,2025-05-25,11:41,12,8,20
79,2025-05-25T03:45:00+02:00,2025-05-25,11:45,11,3,14
79,2025-05-25T03:50:00+02:00,2025-05-25,11:50,8,12,20
79,2025-05-25T03:52:00+02:00,2025-05-25,11:52,11,3,14
85,2025-05-25T03:43:00+02:00,2025-05-25,11:43,0,5,5
85,2025-05-25T03:47:00+02:00,2025-05-25,11:47,5,3,8
85,2025-05-25T03:49:00+02:00,2025-05-25,11:49,1,0,1
85,2025-05-25T03:50:00+02:00,2025-05-25,11:50,0,1,1
85,2025-05-25T03:52:00+02:00,2025-05-25,11:52,2,0,2
85,2025-05-25T03:54:00+02:00,2025-05-25,11:54,1,0,1
86,2025-05-25T03:40:00+02:00,2025-05-25,11:40,0,4,4
86,2025-05-25T03:43:00+02:00,2025-05-25,11:43,1,0,1
86,2025-05-25T03:44:00+02:00,2025-05-25,11:44,0,4,4
86,2025-05-25T03:45:00+02:00,2025-05-25,11:45,1,1,2
86,2025-05-25T03:48:00+02:00,2025-05-25,11:48,4,1,5
86,2025-05-25T03:52:00+02:00,2025-05-25,11:52,1,1,2
86,2025-05-25T03:53:00+02:00,2025-05-25,11:53,1,2,3
86,2025-05-25T03:54:00+02:00,2025-05-25,11:54,4,0,4
109,2025-05-25T03:50:00+02:00,2025-05-25,11:50,8,12,20
117,2025-05-25T03:45:00+02:00,2025-05-25,11:45,9,20,29
123,2025-05-25T03:45:00+02:00,2025-05-25,11:45,4,5,9
123,2025-05-25T03:50:00+02:00,2025-05-25,11:50,5,1,6
136,2025-05-25T03:40:00+02:00,2025-05-25,11:40,13,10,23
136,2025-05-25T03:45:00+02:00,2025-05-25,11:45,12,6,18
139,2025-05-25T03:40:00+02:00,2025-05-25,11:40,6,13,19
139,2025-05-25T03:45:00+02:00,2025-05-25,11:45,3,4,7
141,2025-05-25T03:40:00+02:00,2025-05-25,11:40,17,16,33
141,2025-05-25T03:45:00+02:00,2025-05-25,11:45,8,7,15
161,2025-05-25T03:50:00+02:00,2025-05-25,11:50,43,25,68
164,2025-05-25T03:40:00+02:00,2025-05-25,11:40,8,3,11
181,2025-05-25T03:40:00+02:00,2025-05-25,11:40,8,18,26
181,2025-05-25T03:46:00+02:00,2025-05-25,11:46,10,15,25
181,2025-05-25T03:52:00+02:00,2025-05-25,11:52,3,17,20
182,2025-05-25T03:45:00+02:00,2025-05-25,11:45,29,10,39
182,2025-05-25T03:50:00+02:00,2025-05-25,11:50,24,9,33
180,2025-05-25T03:40:00+02:00,2025-05-25,11:40,1,0,1
180,2025-05-25T03:43:00+02:00,2025-05-25,11:43,0,2,2
180,2025-05-25T03:49:00+02:00,2025-05-25,11:49,1,0,1
3,2025-05-25T04:12:00+02:00,2025-05-25,12:12,5,28,33
3,2025-05-25T04:21:00+02:00,2025-05-25,12:21,20,16,36
3,2025-05-25T04:22:00+02:00,2025-05-25,12:22,16,20,36
3,2025-05-25T04:24:00+02:00,2025-05-25,12:24,13,21,34
4,2025-05-25T04:10:00+02:00,2025-05-25,12:10,33,33,66
4,2025-05-25T04:13:00+02:00,2025-05-25,12:13,32,18,50
4,2025-05-25T04:18:00+02:00,2025-05-25,12:18,32,20,52
4,2025-05-25T04:22:00+02:00,2025-05-25,12:22,32,26,58
4,2025-05-25T04:24:00+02:00,2025-05-25,12:24,18,24,42
5,2025-05-25T04:10:00+02:00,2025-05-25,12:10,74,71,145
6,2025-05-25T04:10:00+02:00,2025-05-25,12:10,19,10,29
6,2025-05-25T04:11:00+02:00,2025-05-25,12:11,11,19,30
6,2025-05-25T04:14:00+02:00,2025-05-25,12:14,6,12,18
6,2025-05-25T04:16:00+02:00,2025-05-25,12:16,13,10,23
6,2025-05-25T04:22:00+02:00,2025-05-25,12:22,7,10,17
8,2025-05-25T04:23:00+02:00,2025-05-25,12:23,4,1,5
8,2025-05-25T04:24:00+02:00,2025-05-25,12:24,0,10,10
28,2025-05-25T04:13:00+02:00,2025-05-25,12:13,11,8,19
28,2025-05-25T04:15:00+02:00,2025-05-25,12:15,6,10,16
28,2025-05-25T04:17:00+02:00,2025-05-25,12:17,5,12,17
28,2025-05-25T04:18:00+02:00,2025-05-25,12:18,8,10,18
28,2025-05-25T04:20:00+02:00,2025-05-25,12:20,8,11,19
28,2025-05-25T04:22:00+02:00,2025-05-25,12:22,8,5,13
29,2025-05-25T04:10:00+02:00,2025-05-25,12:10,12,15,27
29,2025-05-25T04:12:00+02:00,2025-05-25,12:12,4,10,14
29,2025-05-25T04:13:00+02:00,2025-05-25,12:13,10,6,16
29,2025-05-25T04:18:00+02:00,2025-05-25,12:18,7,6,13
29,2025-05-25T04:20:00+02:00,2025-05-25,12:20,11,5,16
29,2025-05-25T04:21:00+02:00,2025-05-25,12:21,8,8,16
29,2025-05-25T04:22:00+02:00,2025-05-25,12:22,6,10,16
29,2025-05-25T04:23:00+02:00,2025-05-25,12:23,12,11,23
31,2025-05-25T04:11:00+02:00,2025-05-25,12:11,0,1,1
31,2025-05-25T04:18:00+02:00,2025-05-25,12:18,8,3,11
31,2025-05-25T04:19:00+02:00,2025-05-25,12:19,3,1,4
31,2025-05-25T04:20:00+02:00,2025-05-25,12:20,3,3,6
36,2025-05-25T04:14:00+02:00,2025-05-25,12:14,2,2,4
36,2025-05-25T04:16:00+02:00,2025-05-25,12:16,0,1,1
36,2025-05-25T04:17:00+02:00,2025-05-25,12:17,1,4,5
36,2025-05-25T04:19:00+02:00,2025-05-25,12:19,0,2,2
36,2025-05-25T04:23:00+02:00,2025-05-25,12:23,5,0,5
37,2025-05-25T04:11:00+02:00,2025-05-25,12:11,1,6,7
37,2025-05-25T04:13:00+02:00,2025-05-25,12:13,1,0,1
37,2025-05-25T04:16:00+02:00,2025-05-25,12:16,0,3,3
37,2025-05-25T04:17:00+02:00,2025-05-25,12:17,1,9,10
37,2025-05-25T04:18:00+02:00,2025-05-25,12:18,0,2,2
37,2025-05-25T04:21:00+02:00,2025-05-25,12:21,3,1,4
39,2025-05-25T04:11:00+02:00,2025-05-25,12:11,1,3,4
39,2025-05-25T04:12:00+02:00,2025-05-25,12:12,2,0,2
39,2025-05-25T04:17:00+02:00,2025-05-25,12:17,0,1,1
40,2025-05-25T04:11:00+02:00,2025-05-25,12:11,1,8,9
40,2025-05-25T04:12:00+02:00,2025-05-25,12:12,1,5,6
40,2025-05-25T04:13:00+02:00,2025-05-25,12:13,5,0,5
40,2025-05-25T04:18:00+02:00,2025-05-25,12:18,2,5,7
40,2025-05-25T04:21:00+02:00,2025-05-25,12:21,3,7,10
41,2025-05-25T04:10:00+02:00,2025-05-25,12:10,13,10,23
41,2025-05-25T04:13:00+02:00,2025-05-25,12:13,11,5,16
41,2025-05-25T04:16:00+02:00,2025-05-25,12:16,9,15,24
41,2025-05-25T04:17:00+02:00,2025-05-25,12:17,10,3,13
41,2025-05-25T04:18:00+02:00,2025-05-25,12:18,8,6,14
43,2025-05-25T04:10:00+02:00,2025-05-25,12:10,6,5,11
43,2025-05-25T04:15:00+02:00,2025-05-25,12:15,3,12,15
45,2025-05-25T04:10:00+02:00,2025-05-25,12:10,19,2,21
45,2025-05-25T04:13:00+02:00,2025-05-25,12:13,14,9,23
45,2025-05-25T04:14:00+02:00,2025-05-25,12:14,19,25,44
45,2025-05-25T04:20:00+02:00,2025-05-25,12:20,9,28,37
47,2025-05-25T04:11:00+02:00,2025-05-25,12:11,0,10,10
47,2025-05-25T04:15:00+02:00,2025-05-25,12:15,11,28,39
47,2025-05-25T04:16:00+02:00,2025-05-25,12:16,4,37,41
47,2025-05-25T04:17:00+02:00,2025-05-25,12:17,12,7,19
47,2025-05-25T04:19:00+02:00,2025-05-25,12:19,14,14,28
47,2025-05-25T04:20:00+02:00,2025-05-25,12:20,11,6,17
50,2025-05-25T04:10:00+02:00,2025-05-25,12:10,3,3,6
50,2025-05-25T04:12:00+02:00,2025-05-25,12:12,1,3,4
50,2025-05-25T04:16:00+02:00,2025-05-25,12:16,7,3,10
50,2025-05-25T04:23:00+02:00,2025-05-25,12:23,6,5,11
54,2025-05-25T04:14:00+02:00,2025-05-25,12:14,1,1,2
54,2025-05-25T04:21:00+02:00,2025-05-25,12:21,0,1,1
54,2025-05-25T04:22:00+02:00,2025-05-25,12:22,2,1,3
59,2025-05-25T04:10:00+02:00,2025-05-25,12:10,17,26,43
59,2025-05-25T04:15:00+02:00,2025-05-25,12:15,14,25,39
61,2025-05-25T04:12:00+02:00,2025-05-25,12:12,4,10,14
61,2025-05-25T04:13:00+02:00,2025-05-25,12:13,6,4,10
61,2025-05-25T04:14:00+02:00,2025-05-25,12:14,3,7,10
61,2025-05-25T04:16:00+02:00,2025-05-25,12:16,5,0,5
61,2025-05-25T04:17:00+02:00,2025-05-25,12:17,4,24,28
61,2025-05-25T04:19:00+02:00,2025-05-25,12:19,5,12,17
61,2025-05-25T04:21:00+02:00,2025-05-25,12:21,6,2,8
66,2025-05-25T04:10:00+02:00,2025-05-25,12:10,9,8,17
66,2025-05-25T04:11:00+02:00,2025-05-25,12:11,20,14,34
66,2025-05-25T04:12:00+02:00,2025-05-25,12:12,24,20,44
66,2025-05-25T04:13:00+02:00,2025-05-25,12:13,20,18,38
66,2025-05-25T04:18:00+02:00,2025-05-25,12:18,19,14,33
66,2025-05-25T04:21:00+02:00,2025-05-25,12:21,9,22,31
69,2025-05-25T04:12:00+02:00,2025-05-25,12:12,3,4,7
69,2025-05-25T04:16:00+02:00,2025-05-25,12:16,11,2,13
69,2025-05-25T04:17:00+02:00,2025-05-25,12:17,9,4,13
69,2025-05-25T04:18:00+02:00,2025-05-25,12:18,10,5,15
69,2025-05-25T04:20:00+02:00,2025-05-25,12:20,7,6,13
70,2025-05-25T04:13:00+02:00,2025-05-25,12:13,2,5,7
70,2025-05-25T04:15:00+02:00,2025-05-25,12:15,0,5,5
70,2025-05-25T04:18:00+02:00,2025-05-25,12:18,3,4,7
70,2025-05-25T04:21:00+02:00,2025-05-25,12:21,1,0,1
71,2025-05-25T04:18:00+02:00,2025-05-25,12:18,1,0,1
71,2025-05-25T04:22:00+02:00,2025-05-25,12:22,0,1,1
75,2025-05-25T04:13:00+02:00,2025-05-25,12:13,1,1,2
75,2025-05-25T04:17:00+02:00,2025-05-25,12:17,2,0,2
75,2025-05-25T04:18:00+02:00,2025-05-25,12:18,1,0,1
75,2025-05-25T04:23:00+02:00,2025-05-25,12:23,0,4,4
77,2025-05-25T04:15:00+02:00,2025-05-25,12:15,21,7,28
77,2025-05-25T04:20:00+02:00,2025-05-25,12:20,5,11,16
78,2025-05-25T04:10:00+02:00,2025-05-25,12:10,4,0,4
78,2025-05-25T04:24:00+02:00,2025-05-25,12:24,2,2,4
84,2025-05-25T04:15:00+02:00,2025-05-25,12:15,69,71,140
87,2025-05-25T04:10:00+02:00,2025-05-25,12:10,1,1,2
87,2025-05-25T04:22:00+02:00,2025-05-25,12:22,0,5,5
87,2025-05-25T04:23:00+02:00,2025-05-25,12:23,4,4,8
107,2025-05-25T04:20:00+02:00,2025-05-25,12:20,10,18,28
108,2025-05-25T04:11:00+02:00,2025-05-25,12:11,1,5,6
108,2025-05-25T04:12:00+02:00,2025-05-25,12:12,4,1,5
108,2025-05-25T04:14:00+02:00,2025-05-25,12:14,6,7,13
108,2025-05-25T04:15:00+02:00,2025-05-25,12:15,4,3,7
108,2025-05-25T04:16:00+02:00,2025-05-25,12:16,5,1,6
108,2025-05-25T04:20:00+02:00,2025-05-25,12:20,2,2,4
118,2025-05-25T04:20:00+02:00,2025-05-25,12:20,2,5,7
131,2025-05-25T04:15:00+02:00,2025-05-25,12:15,11,7,18
132,2025-05-25T04:10:00+02:00,2025-05-25,12:10,16,8,24
133,2025-05-25T04:10:00+02:00,2025-05-25,12:10,32,48,80
134,2025-05-25T04:20:00+02:00,2025-05-25,12:20,31,33,64
140,2025-05-25T04:10:00+02:00,2025-05-25,12:10,9,11,20
140,2025-05-25T04:20:00+02:00,2025-05-25,12:20,15,4,19
162,2025-05-25T04:10:00+02:00,2025-05-25,12:10,58,58,116
165,2025-05-25T04:15:00+02:00,2025-05-25,12:15,2,2,4
166,2025-05-25T04:15:00+02:00,2025-05-25,12:15,5,5,10
179,2025-05-25T04:15:00+02:00,2025-05-25,12:15,5,8,13
179,2025-05-25T04:20:00+02:00,2025-05-25,12:20,2,5,7
1,2025-05-25T04:15:00+02:00,2025-05-25,12:15,26,13,39
1,2025-05-25T04:24:00+02:00,2025-05-25,12:24,25,12,37
2,2025-05-25T04:13:00+02:00,2025-05-25,12:13,2,11,13
2,2025-05-25T04:14:00+02:00,2025-05-25,12:14,11,11,22
2,2025-05-25T04:15:00+02:00,2025-05-25,12:15,9,7,16
2,2025-05-25T04:17:00+02:00,2025-05-25,12:17,11,15,26
2,2025-05-25T04:20:00+02:00,2025-05-25,12:20,17,12,29
2,2025-05-25T04:22:00+02:00,2025-05-25,12:22,12,13,25
2,2025-05-25T04:23:00+02:00,2025-05-25,12:23,8,15,23
9,2025-05-25T04:16:00+02:00,2025-05-25,12:16,2,1,3
9,2025-05-25T04:17:00+02:00,2025-05-25,12:17,1,1,2
9,2025-05-25T04:19:00+02:00,2025-05-25,12:19,0,1,1
9,2025-05-25T04:20:00+02:00,2025-05-25,12:20,0,3,3
9,2025-05-25T04:23:00+02:00,2025-05-25,12:23,1,1,2
10,2025-05-25T04:11:00+02:00,2025-05-25,12:11,1,0,1
10,2025-05-25T04:15:00+02:00,2025-05-25,12:15,0,1,1
11,2025-05-25T04:10:00+02:00,2025-05-25,12:10,11,3,14
11,2025-05-25T04:12:00+02:00,2025-05-25,12:12,1,2,3
11,2025-05-25T04:13:00+02:00,2025-05-25,12:13,2,1,3
11,2025-05-25T04:15:00+02:00,2025-05-25,12:15,9,12,21
11,2025-05-25T04:16:00+02:00,2025-05-25,12:16,5,0,5
11,2025-05-25T04:17:00+02:00,2025-05-25,12:17,1,0,1
12,2025-05-25T04:10:00+02:00,2025-05-25,12:10,5,2,7
12,2025-05-25T04:13:00+02:00,2025-05-25,12:13,5,16,21
12,2025-05-25T04:14:00+02:00,2025-05-25,12:14,3,2,5
12,2025-05-25T04:15:00+02:00,2025-05-25,12:15,5,7,12
12,2025-05-25T04:23:00+02:00,2025-05-25,12:23,0,4,4
17,2025-05-25T04:10:00+02:00,2025-05-25,12:10,1,2,3
17,2025-05-25T04:11:00+02:00,2025-05-25,12:11,8,2,10
17,2025-05-25T04:16:00+02:00,2025-05-25,12:16,4,4,8
17,2025-05-25T04:21:00+02:00,2025-05-25,12:21,4,6,10
18,2025-05-25T04:15:00+02:00,2025-05-25,12:15,1,0,1
18,2025-05-25T04:16:00+02:00,2025-05-25,12:16,0,1,1
18,2025-05-25T04:19:00+02:00,2025-05-25,12:19,4,1,5
18,2025-05-25T04:20:00+02:00,2025-05-25,12:20,4,0,4
18,2025-05-25T04:22:00+02:00,2025-05-25,12:22,1,0,1
19,2025-05-25T04:10:00+02:00,2025-05-25,12:10,9,3,12
19,2025-05-25T04:15:00+02:00,2025-05-25,12:15,8,6,14
19,2025-05-25T04:18:00+02:00,2025-05-25,12:18,7,4,11
19,2025-05-25T04:21:00+02:00,2025-05-25,12:21,13,2,15
20,2025-05-25T04:10:00+02:00,2025-05-25,12:10,0,4,4
20,2025-05-25T04:11:00+02:00,2025-05-25,12:11,16,2,18
20,2025-05-25T04:18:00+02:00,2025-05-25,12:18,7,1,8
20,2025-05-25T04:19:00+02:00,2025-05-25,12:19,1,6,7
20,2025-05-25T04:20:00+02:00,2025-05-25,12:20,13,5,18
20,2025-05-25T04:21:00+02:00,2025-05-25,12:21,8,8,16
20,2025-05-25T04:22:00+02:00,2025-05-25,12:22,0,1,1
20,2025-05-25T04:24:00+02:00,2025-05-25,12:24,7,6,13
23,2025-05-25T04:20:00+02:00,2025-05-25,12:20,0,1,1
23,2025-05-25T04:21:00+02:00,2025-05-25,12:21,1,1,2
23,2025-05-25T04:22:00+02:00,2025-05-25,12:22,1,1,2
23,2025-05-25T04:24:00+02:00,2025-05-25,12:24,1,3,4
24,2025-05-25T04:13:00+02:00,2025-05-25,12:13,1,5,6
24,2025-05-25T04:14:00+02:00,2025-05-25,12:14,11,3,14
24,2025-05-25T04:16:00+02:00,2025-05-25,12:16,17,15,32
24,2025-05-25T04:17:00+02:00,2025-05-25,12:17,31,1,32
24,2025-05-25T04:19:00+02:00,2025-05-25,12:19,16,4,20
24,2025-05-25T04:20:00+02:00,2025-05-25,12:20,24,6,30
25,2025-05-25T04:15:00+02:00,2025-05-25,12:15,69,83,152
25,2025-05-25T04:20:00+02:00,2025-05-25,12:20,65,86,151
27,2025-05-25T04:12:00+02:00,2025-05-25,12:12,7,3,10
27,2025-05-25T04:13:00+02:00,2025-05-25,12:13,7,6,13
27,2025-05-25T04:15:00+02:00,2025-05-25,12:15,11,2,13
27,2025-05-25T04:18:00+02:00,2025-05-25,12:18,2,9,11
27,2025-05-25T04:19:00+02:00,2025-05-25,12:19,6,12,18
27,2025-05-25T04:21:00+02:00,2025-05-25,12:21,8,3,11
27,2025-05-25T04:22:00+02:00,2025-05-25,12:22,3,6,9
27,2025-05-25T04:23:00+02:00,2025-05-25,12:23,4,3,7
30,2025-05-25T04:14:00+02:00,2025-05-25,12:14,7,4,11
30,2025-05-25T04:16:00+02:00,2025-05-25,12:16,2,5,7
30,2025-05-25T04:19:00+02:00,2025-05-25,12:19,3,4,7
30,2025-05-25T04:22:00+02:00,2025-05-25,12:22,3,3,6
30,2025-05-25T04:23:00+02:00,2025-05-25,12:23,2,15,17
30,2025-05-25T04:24:00+02:00,2025-05-25,12:24,6,11,17
35,2025-05-25T04:17:00+02:00,2025-05-25,12:17,13,14,27
35,2025-05-25T04:18:00+02:00,2025-05-25,12:18,16,11,27
35,2025-05-25T04:19:00+02:00,2025-05-25,12:19,24,15,39
35,2025-05-25T04:20:00+02:00,2025-05-25,12:20,9,9,18
35,2025-05-25T04:21:00+02:00,2025-05-25,12:21,19,18,37
35,2025-05-25T04:24:00+02:00,2025-05-25,12:24,7,24,31
46,2025-05-25T04:10:00+02:00,2025-05-25,12:10,6,4,10
46,2025-05-25T04:15:00+02:00,2025-05-25,12:15,2,3,5
48,2025-05-25T04:13:00+02:00,2025-05-25,12:13,9,5,14
48,2025-05-25T04:14:00+02:00,2025-05-25,12:14,5,3,8
48,2025-05-25T04:18:00+02:00,2025-05-25,12:18,11,5,16
48,2025-05-25T04:22:00+02:00,2025-05-25,12:22,7,15,22
49,2025-05-25T04:10:00+02:00,2025-05-25,12:10,7,11,18
49,2025-05-25T04:14:00+02:00,2025-05-25,12:14,2,15,17
49,2025-05-25T04:18:00+02:00,2025-05-25,12:18,10,5,15
49,2025-05-25T04:24:00+02:00,2025-05-25,12:24,2,16,18
51,2025-05-25T04:15:00+02:00,2025-05-25,12:15,1,2,3
51,2025-05-25T04:16:00+02:00,2025-05-25,12:16,0,1,1
52,2025-05-25T04:12:00+02:00,2025-05-25,12:12,2,6,8
52,2025-05-25T04:14:00+02:00,2025-05-25,12:14,2,4,6
52,2025-05-25T04:15:00+02:00,2025-05-25,12:15,2,4,6
52,2025-05-25T04:24:00+02:00,2025-05-25,12:24,0,8,8
53,2025-05-25T04:11:00+02:00,2025-05-25,12:11,12,12,24
53,2025-05-25T04:15:00+02:00,2025-05-25,12:15,8,5,13
53,2025-05-25T04:19:00+02:00,2025-05-25,12:19,7,12,19
56,2025-05-25T04:10:00+02:00,2025-05-25,12:10,5,6,11
56,2025-05-25T04:12:00+02:00,2025-05-25,12:12,3,4,7
56,2025-05-25T04:13:00+02:00,2025-05-25,12:13,1,13,14
56,2025-05-25T04:16:00+02:00,2025-05-25,12:16,6,9,15
56,2025-05-25T04:18:00+02:00,2025-05-25,12:18,9,4,13
56,2025-05-25T04:19:00+02:00,2025-05-25,12:19,4,10,14
58,2025-05-25T04:11:00+02:00,2025-05-25,12:11,29,1,30
58,2025-05-25T04:12:00+02:00,2025-05-25,12:12,29,1,30
58,2025-05-25T04:13:00+02:00,2025-05-25,12:13,6,3,9
58,2025-05-25T04:16:00+02:00,2025-05-25,12:16,11,11,22
58,2025-05-25T04:18:00+02:00,2025-05-25,12:18,8,8,16
58,2025-05-25T04:19:00+02:00,2025-05-25,12:19,22,5,27
58,2025-05-25T04:20:00+02:00,2025-05-25,12:20,10,7,17
58,2025-05-25T04:23:00+02:00,2025-05-25,12:23,12,3,15
62,2025-05-25T04:11:00+02:00,2025-05-25,12:11,4,0,4
62,2025-05-25T04:14:00+02:00,2025-05-25,12:14,3,10,13
62,2025-05-25T04:15:00+02:00,2025-05-25,12:15,2,2,4
62,2025-05-25T04:17:00+02:00,2025-05-25,12:17,4,3,7
62,2025-05-25T04:21:00+02:00,2025-05-25,12:21,1,1,2
62,2025-05-25T04:22:00+02:00,2025-05-25,12:22,6,5,11
63,2025-05-25T04:10:00+02:00,2025-05-25,12:10,9,4,13
63,2025-05-25T04:12:00+02:00,2025-05-25,12:12,2,7,9
63,2025-05-25T04:13:00+02:00,2025-05-25,12:13,10,0,10
63,2025-05-25T04:16:00+02:00,2025-05-25,12:16,7,1,8
63,2025-05-25T04:17:00+02:00,2025-05-25,12:17,10,6,16
63,2025-05-25T04:18:00+02:00,2025-05-25,12:18,10,15,25
63,2025-05-25T04:23:00+02:00,2025-05-25,12:23,4,3,7
67,2025-05-25T04:13:00+02:00,2025-05-25,12:13,12,22,34
67,2025-05-25T04:15:00+02:00,2025-05-25,12:15,14,8,22
67,2025-05-25T04:17:00+02:00,2025-05-25,12:17,10,12,22
67,2025-05-25T04:20:00+02:00,2025-05-25,12:20,4,8,12
68,2025-05-25T04:10:00+02:00,2025-05-25,12:10,1,2,3
68,2025-05-25T04:11:00+02:00,2025-05-25,12:11,6,2,8
68,2025-05-25T04:15:00+02:00,2025-05-25,12:15,10,21,31
68,2025-05-25T04:16:00+02:00,2025-05-25,12:16,10,3,13
76,2025-05-25T04:10:00+02:00,2025-05-25,12:10,1,0,1
76,2025-05-25T04:13:00+02:00,2025-05-25,12:13,3,0,3
76,2025-05-25T04:20:00+02:00,2025-05-25,12:20,6,0,6
79,2025-05-25T04:11:00+02:00,2025-05-25,12:11,7,11,18
79,2025-05-25T04:12:00+02:00,2025-05-25,12:12,10,4,14
79,2025-05-25T04:15:00+02:00,2025-05-25,12:15,9,7,16
79,2025-05-25T04:21:00+02:00,2025-05-25,12:21,7,15,22
85,2025-05-25T04:20:00+02:00,2025-05-25,12:20,1,3,4
85,2025-05-25T04:21:00+02:00,2025-05-25,12:21,3,0,3
86,2025-05-25T04:17:00+02:00,2025-05-25,12:17,2,2,4
86,2025-05-25T04:20:00+02:00,2025-05-25,12:20,1,0,1
86,2025-05-25T04:23:00+02:00,2025-05-25,12:23,0,2,2
109,2025-05-25T04:10:00+02:00,2025-05-25,12:10,7,4,11
117,2025-05-25T04:10:00+02:00,2025-05-25,12:10,11,31,42
117,2025-05-25T04:15:00+02:00,2025-05-25,12:15,27,11,38
117,2025-05-25T04:20:00+02:00,2025-05-25,12:20,17,29,46
123,2025-05-25T04:20:00+02:00,2025-05-25,12:20,12,2,14
136,2025-05-25T04:15:00+02:00,2025-05-25,12:15,42,5,47
138,2025-05-25T04:10:00+02:00,2025-05-25,12:10,2,0,2
139,2025-05-25T04:10:00+02:00,2025-05-25,12:10,5,2,7
141,2025-05-25T04:10:00+02:00,2025-05-25,12:10,8,7,15
141,2025-05-25T04:15:00+02:00,2025-05-25,12:15,5,14,19
3,2025-05-25T03:56:00+02:00,2025-05-25,11:56,3,21,24
3,2025-05-25T03:59:00+02:00,2025-05-25,11:59,10,18,28
3,2025-05-25T04:01:00+02:00,2025-05-25,12:01,10,4,14
3,2025-05-25T04:05:00+02:00,2025-05-25,12:05,20,16,36
3,2025-05-25T04:07:00+02:00,2025-05-25,12:07,18,23,41
4,2025-05-25T03:55:00+02:00,2025-05-25,11:55,30,12,42
4,2025-05-25T03:59:00+02:00,2025-05-25,11:59,35,14,49
4,2025-05-25T04:02:00+02:00,2025-05-25,12:02,25,10,35
4,2025-05-25T04:05:00+02:00,2025-05-25,12:05,22,23,45
4,2025-05-25T04:08:00+02:00,2025-05-25,12:08,28,10,38
5,2025-05-25T03:55:00+02:00,2025-05-25,11:55,59,87,146
5,2025-05-25T04:05:00+02:00,2025-05-25,12:05,65,72,137
6,2025-05-25T03:57:00+02:00,2025-05-25,11:57,13,5,18
6,2025-05-25T03:58:00+02:00,2025-05-25,11:58,18,14,32
6,2025-05-25T04:00:00+02:00,2025-05-25,12:00,6,10,16
6,2025-05-25T04:07:00+02:00,2025-05-25,12:07,13,6,19
6,2025-05-25T04:08:00+02:00,2025-05-25,12:08,22,18,40
6,2025-05-25T04:09:00+02:00,2025-05-25,12:09,13,17,30
8,2025-05-25T04:01:00+02:00,2025-05-25,12:01,10,3,13
8,2025-05-25T04:06:00+02:00,2025-05-25,12:06,2,4,6
8,2025-05-25T04:09:00+02:00,2025-05-25,12:09,6,3,9
28,2025-05-25T03:56:00+02:00,2025-05-25,11:56,3,10,13
28,2025-05-25T03:58:00+02:00,2025-05-25,11:58,12,10,22
28,2025-05-25T04:02:00+02:00,2025-05-25,12:02,10,13,23
28,2025-05-25T04:03:00+02:00,2025-05-25,12:03,5,12,17
28,2025-05-25T04:05:00+02:00,2025-05-25,12:05,10,15,25
28,2025-05-25T04:06:00+02:00,2025-05-25,12:06,7,2,9
28,2025-05-25T04:09:00+02:00,2025-05-25,12:09,12,3,15
29,2025-05-25T03:59:00+02:00,2025-05-25,11:59,3,5,8
29,2025-05-25T04:00:00+02:00,2025-05-25,12:00,8,4,12
29,2025-05-25T04:02:00+02:00,2025-05-25,12:02,17,14,31
29,2025-05-25T04:08:00+02:00,2025-05-25,12:08,15,2,17
29,2025-05-25T04:09:00+02:00,2025-05-25,12:09,18,3,21
31,2025-05-25T04:01:00+02:00,2025-05-25,12:01,0,1,1
31,2025-05-25T04:04:00+02:00,2025-05-25,12:04,1,2,3
31,2025-05-25T04:06:00+02:00,2025-05-25,12:06,5,5,10
31,2025-05-25T04:08:00+02:00,2025-05-25,12:08,4,5,9
31,2025-05-25T04:09:00+02:00,2025-05-25,12:09,1,3,4
36,2025-05-25T03:55:00+02:00,2025-05-25,11:55,2,1,3
36,2025-05-25T03:58:00+02:00,2025-05-25,11:58,4,0,4
36,2025-05-25T04:01:00+02:00,2025-05-25,12:01,1,2,3
36,2025-05-25T04:02:00+02:00,2025-05-25,12:02,1,0,1
36,2025-05-25T04:08:00+02:00,2025-05-25,12:08,5,2,7
37,2025-05-25T03:59:00+02:00,2025-05-25,11:59,5,5,10
37,2025-05-25T04:05:00+02:00,2025-05-25,12:05,3,0,3
37,2025-05-25T04:07:00+02:00,2025-05-25,12:07,2,3,5
39,2025-05-25T04:08:00+02:00,2025-05-25,12:08,2,0,2
39,2025-05-25T04:09:00+02:00,2025-05-25,12:09,1,1,2
40,2025-05-25T03:55:00+02:00,2025-05-25,11:55,0,3,3
40,2025-05-25T03:56:00+02:00,2025-05-25,11:56,0,9,9
40,2025-05-25T03:57:00+02:00,2025-05-25,11:57,7,2,9
40,2025-05-25T03:59:00+02:00,2025-05-25,11:59,1,6,7
40,2025-05-25T04:03:00+02:00,2025-05-25,12:03,0,4,4
41,2025-05-25T03:57:00+02:00,2025-05-25,11:57,2,3,5
41,2025-05-25T04:03:00+02:00,2025-05-25,12:03,4,4,8
41,2025-05-25T04:04:00+02:00,2025-05-25,12:04,5,11,16
41,2025-05-25T04:07:00+02:00,2025-05-25,12:07,4,2,6
41,2025-05-25T04:08:00+02:00,2025-05-25,12:08,12,8,20
45,2025-05-25T03:55:00+02:00,2025-05-25,11:55,13,8,21
45,2025-05-25T03:56:00+02:00,2025-05-25,11:56,16,16,32
45,2025-05-25T03:58:00+02:00,2025-05-25,11:58,16,16,32
45,2025-05-25T03:59:00+02:00,2025-05-25,11:59,24,19,43
45,2025-05-25T04:03:00+02:00,2025-05-25,12:03,18,15,33
45,2025-05-25T04:06:00+02:00,2025-05-25,12:06,21,10,31
45,2025-05-25T04:07:00+02:00,2025-05-25,12:07,24,6,30
47,2025-05-25T03:56:00+02:00,2025-05-25,11:56,17,6,23
47,2025-05-25T03:57:00+02:00,2025-05-25,11:57,12,16,28
47,2025-05-25T03:58:00+02:00,2025-05-25,11:58,18,6,24
47,2025-05-25T03:59:00+02:00,2025-05-25,11:59,13,5,18
47,2025-05-25T04:05:00+02:00,2025-05-25,12:05,4,11,15
47,2025-05-25T04:07:00+02:00,2025-05-25,12:07,11,11,22
50,2025-05-25T04:01:00+02:00,2025-05-25,12:01,2,4,6
50,2025-05-25T04:03:00+02:00,2025-05-25,12:03,0,3,3
50,2025-05-25T04:05:00+02:00,2025-05-25,12:05,6,5,11
50,2025-05-25T04:06:00+02:00,2025-05-25,12:06,1,7,8
50,2025-05-25T04:07:00+02:00,2025-05-25,12:07,7,4,11
50,2025-05-25T04:09:00+02:00,2025-05-25,12:09,3,7,10
54,2025-05-25T03:55:00+02:00,2025-05-25,11:55,3,0,3
54,2025-05-25T03:59:00+02:00,2025-05-25,11:59,3,0,3
54,2025-05-25T04:01:00+02:00,2025-05-25,12:01,0,5,5
54,2025-05-25T04:05:00+02:00,2025-05-25,12:05,1,0,1
54,2025-05-25T04:07:00+02:00,2025-05-25,12:07,3,2,5
59,2025-05-25T04:00:00+02:00,2025-05-25,12:00,18,36,54
61,2025-05-25T04:02:00+02:00,2025-05-25,12:02,7,6,13
61,2025-05-25T04:07:00+02:00,2025-05-25,12:07,6,2,8
66,2025-05-25T03:56:00+02:00,2025-05-25,11:56,15,32,47
66,2025-05-25T03:58:00+02:00,2025-05-25,11:58,15,21,36
66,2025-05-25T04:00:00+02:00,2025-05-25,12:00,16,21,37
66,2025-05-25T04:02:00+02:00,2025-05-25,12:02,21,23,44
66,2025-05-25T04:09:00+02:00,2025-05-25,12:09,6,34,40
69,2025-05-25T03:55:00+02:00,2025-05-25,11:55,2,6,8
69,2025-05-25T03:59:00+02:00,2025-05-25,11:59,3,4,7
69,2025-05-25T04:03:00+02:00,2025-05-25,12:03,1,6,7
69,2025-05-25T04:04:00+02:00,2025-05-25,12:04,6,5,11
70,2025-05-25T04:04:00+02:00,2025-05-25,12:04,4,2,6
70,2025-05-25T04:07:00+02:00,2025-05-25,12:07,6,3,9
70,2025-05-25T04:08:00+02:00,2025-05-25,12:08,0,1,1
71,2025-05-25T04:03:00+02:00,2025-05-25,12:03,0,1,1
75,2025-05-25T04:06:00+02:00,2025-05-25,12:06,0,1,1
75,2025-05-25T04:08:00+02:00,2025-05-25,12:08,0,1,1
75,2025-05-25T04:09:00+02:00,2025-05-25,12:09,1,0,1
77,2025-05-25T04:05:00+02:00,2025-05-25,12:05,22,3,25
78,2025-05-25T03:55:00+02:00,2025-05-25,11:55,0,3,3
78,2025-05-25T03:56:00+02:00,2025-05-25,11:56,1,0,1
78,2025-05-25T03:59:00+02:00,2025-05-25,11:59,3,1,4
78,2025-05-25T04:00:00+02:00,2025-05-25,12:00,0,1,1
78,2025-05-25T04:05:00+02:00,2025-05-25,12:05,0,1,1
78,2025-05-25T04:08:00+02:00,2025-05-25,12:08,1,0,1
84,2025-05-25T04:00:00+02:00,2025-05-25,12:00,73,65,138
87,2025-05-25T03:58:00+02:00,2025-05-25,11:58,2,3,5
87,2025-05-25T03:59:00+02:00,2025-05-25,11:59,3,3,6
87,2025-05-25T04:02:00+02:00,2025-05-25,12:02,3,0,3
87,2025-05-25T04:06:00+02:00,2025-05-25,12:06,1,3,4
87,2025-05-25T04:09:00+02:00,2025-05-25,12:09,7,0,7
108,2025-05-25T04:00:00+02:00,2025-05-25,12:00,0,2,2
108,2025-05-25T04:08:00+02:00,2025-05-25,12:08,3,5,8
124,2025-05-25T04:00:00+02:00,2025-05-25,12:00,1,2,3
131,2025-05-25T04:00:00+02:00,2025-05-25,12:00,10,9,19
132,2025-05-25T04:00:00+02:00,2025-05-25,12:00,14,3,17
132,2025-05-25T04:05:00+02:00,2025-05-25,12:05,13,7,20
134,2025-05-25T04:05:00+02:00,2025-05-25,12:05,38,25,63
135,2025-05-25T04:00:00+02:00,2025-05-25,12:00,38,61,99
162,2025-05-25T03:55:00+02:00,2025-05-25,11:55,70,78,148
165,2025-05-25T03:55:00+02:00,2025-05-25,11:55,1,4,5
165,2025-05-25T04:00:00+02:00,2025-05-25,12:00,8,4,12
166,2025-05-25T03:55:00+02:00,2025-05-25,11:55,3,2,5
167,2025-05-25T03:55:00+02:00,2025-05-25,11:55,2,6,8
167,2025-05-25T04:05:00+02:00,2025-05-25,12:05,3,6,9
1,2025-05-25T03:56:00+02:00,2025-05-25,11:56,35,22,57
1,2025-05-25T03:59:00+02:00,2025-05-25,11:59,28,22,50
1,2025-05-25T04:01:00+02:00,2025-05-25,12:01,37,20,57
1,2025-05-25T04:07:00+02:00,2025-05-25,12:07,18,22,40
2,2025-05-25T03:58:00+02:00,2025-05-25,11:58,12,15,27
2,2025-05-25T04:01:00+02:00,2025-05-25,12:01,11,11,22
2,2025-05-25T04:08:00+02:00,2025-05-25,12:08,4,12,16
2,2025-05-25T04:09:00+02:00,2025-05-25,12:09,10,10,20
9,2025-05-25T04:03:00+02:00,2025-05-25,12:03,2,5,7
9,2025-05-25T04:09:00+02:00,2025-05-25,12:09,1,2,3
10,2025-05-25T03:57:00+02:00,2025-05-25,11:57,0,1,1
10,2025-05-25T03:58:00+02:00,2025-05-25,11:58,1,0,1
10,2025-05-25T04:06:00+02:00,2025-05-25,12:06,1,0,1
11,2025-05-25T03:59:00+02:00,2025-05-25,11:59,0,1,1
11,2025-05-25T04:04:00+02:00,2025-05-25,12:04,0,7,7
11,2025-05-25T04:07:00+02:00,2025-05-25,12:07,4,5,9
11,2025-05-25T04:08:00+02:00,2025-05-25,12:08,3,0,3
12,2025-05-25T03:57:00+02:00,2025-05-25,11:57,2,8,10
12,2025-05-25T03:58:00+02:00,2025-05-25,11:58,0,3,3
12,2025-05-25T04:02:00+02:00,2025-05-25,12:02,0,2,2
12,2025-05-25T04:03:00+02:00,2025-05-25,12:03,2,2,4
12,2025-05-25T04:06:00+02:00,2025-05-25,12:06,15,5,20
12,2025-05-25T04:07:00+02:00,2025-05-25,12:07,7,0,7
12,2025-05-25T04:08:00+02:00,2025-05-25,12:08,1,3,4
17,2025-05-25T03:55:00+02:00,2025-05-25,11:55,12,2,14
17,2025-05-25T03:59:00+02:00,2025-05-25,11:59,9,2,11
17,2025-05-25T04:00:00+02:00,2025-05-25,12:00,9,0,9
17,2025-05-25T04:07:00+02:00,2025-05-25,12:07,3,5,8
18,2025-05-25T03:56:00+02:00,2025-05-25,11:56,0,3,3
18,2025-05-25T04:01:00+02:00,2025-05-25,12:01,1,1,2
18,2025-05-25T04:02:00+02:00,2025-05-25,12:02,3,5,8
19,2025-05-25T03:55:00+02:00,2025-05-25,11:55,8,2,10
19,2025-05-25T03:57:00+02:00,2025-05-25,11:57,11,9,20
19,2025-05-25T04:00:00+02:00,2025-05-25,12:00,9,4,13
19,2025-05-25T04:07:00+02:00,2025-05-25,12:07,13,6,19
20,2025-05-25T03:55:00+02:00,2025-05-25,11:55,5,1,6
20,2025-05-25T03:56:00+02:00,2025-05-25,11:56,7,1,8
20,2025-05-25T03:57:00+02:00,2025-05-25,11:57,15,3,18
20,2025-05-25T03:58:00+02:00,2025-05-25,11:58,2,2,4
20,2025-05-25T04:02:00+02:00,2025-05-25,12:02,0,1,1
23,2025-05-25T03:55:00+02:00,2025-05-25,11:55,2,0,2
23,2025-05-25T03:59:00+02:00,2025-05-25,11:59,6,3,9
23,2025-05-25T04:02:00+02:00,2025-05-25,12:02,4,1,5
23,2025-05-25T04:07:00+02:00,2025-05-25,12:07,5,3,8
24,2025-05-25T03:56:00+02:00,2025-05-25,11:56,9,6,15
24,2025-05-25T03:57:00+02:00,2025-05-25,11:57,17,5,22
24,2025-05-25T04:00:00+02:00,2025-05-25,12:00,10,6,16
24,2025-05-25T04:05:00+02:00,2025-05-25,12:05,12,11,23
24,2025-05-25T04:06:00+02:00,2025-05-25,12:06,23,3,26
24,2025-05-25T04:09:00+02:00,2025-05-25,12:09,16,5,21
27,2025-05-25T03:55:00+02:00,2025-05-25,11:55,5,11,16
27,2025-05-25T03:56:00+02:00,2025-05-25,11:56,0,1,1
27,2025-05-25T03:58:00+02:00,2025-05-25,11:58,3,5,8
27,2025-05-25T04:00:00+02:00,2025-05-25,12:00,7,0,7
27,2025-05-25T04:05:00+02:00,2025-05-25,12:05,1,3,4
27,2025-05-25T04:08:00+02:00,2025-05-25,12:08,8,7,15
27,2025-05-25T04:09:00+02:00,2025-05-25,12:09,0,12,12
30,2025-05-25T03:57:00+02:00,2025-05-25,11:57,5,6,11
30,2025-05-25T03:58:00+02:00,2025-05-25,11:58,6,9,15
30,2025-05-25T03:59:00+02:00,2025-05-25,11:59,4,10,14
30,2025-05-25T04:04:00+02:00,2025-05-25,12:04,4,1,5
35,2025-05-25T03:55:00+02:00,2025-05-25,11:55,36,32,68
35,2025-05-25T03:56:00+02:00,2025-05-25,11:56,27,20,47
35,2025-05-25T03:57:00+02:00,2025-05-25,11:57,20,22,42
35,2025-05-25T03:59:00+02:00,2025-05-25,11:59,15,14,29
35,2025-05-25T04:02:00+02:00,2025-05-25,12:02,21,18,39
35,2025-05-25T04:04:00+02:00,2025-05-25,12:04,22,19,41
35,2025-05-25T04:05:00+02:00,2025-05-25,12:05,21,23,44
46,2025-05-25T03:55:00+02:00,2025-05-25,11:55,4,7,11
46,2025-05-25T04:00:00+02:00,2025-05-25,12:00,1,4,5
48,2025-05-25T03:57:00+02:00,2025-05-25,11:57,8,2,10
48,2025-05-25T03:58:00+02:00,2025-05-25,11:58,10,4,14
48,2025-05-25T04:01:00+02:00,2025-05-25,12:01,10,3,13
48,2025-05-25T04:04:00+02:00,2025-05-25,12:04,10,9,19
48,2025-05-25T04:05:00+02:00,2025-05-25,12:05,11,5,16
48,2025-05-25T04:06:00+02:00,2025-05-25,12:06,12,2,14
48,2025-05-25T04:09:00+02:00,2025-05-25,12:09,7,5,12
49,2025-05-25T03:57:00+02:00,2025-05-25,11:57,7,17,24
49,2025-05-25T03:58:00+02:00,2025-05-25,11:58,6,16,22
49,2025-05-25T04:00:00+02:00,2025-05-25,12:00,11,15,26
49,2025-05-25T04:01:00+02:00,2025-05-25,12:01,8,10,18
49,2025-05-25T04:07:00+02:00,2025-05-25,12:07,8,5,13
49,2025-05-25T04:09:00+02:00,2025-05-25,12:09,13,12,25
51,2025-05-25T03:58:00+02:00,2025-05-25,11:58,1,2,3
51,2025-05-25T04:00:00+02:00,2025-05-25,12:00,6,1,7
51,2025-05-25T04:04:00+02:00,2025-05-25,12:04,1,1,2
52,2025-05-25T03:58:00+02:00,2025-05-25,11:58,6,7,13
52,2025-05-25T03:59:00+02:00,2025-05-25,11:59,6,16,22
52,2025-05-25T04:01:00+02:00,2025-05-25,12:01,5,3,8
52,2025-05-25T04:05:00+02:00,2025-05-25,12:05,7,6,13
52,2025-05-25T04:07:00+02:00,2025-05-25,12:07,6,10,16
53,2025-05-25T03:56:00+02:00,2025-05-25,11:56,15,4,19
53,2025-05-25T03:59:00+02:00,2025-05-25,11:59,5,9,14
53,2025-05-25T04:02:00+02:00,2025-05-25,12:02,14,7,21
53,2025-05-25T04:05:00+02:00,2025-05-25,12:05,5,7,12
53,2025-05-25T04:07:00+02:00,2025-05-25,12:07,15,7,22
53,2025-05-25T04:09:00+02:00,2025-05-25,12:09,15,6,21
56,2025-05-25T03:57:00+02:00,2025-05-25,11:57,11,1,12
56,2025-05-25T04:05:00+02:00,2025-05-25,12:05,25,12,37
56,2025-05-25T04:07:00+02:00,2025-05-25,12:07,4,5,9
56,2025-05-25T04:09:00+02:00,2025-05-25,12:09,3,2,5
58,2025-05-25T03:59:00+02:00,2025-05-25,11:59,2,8,10
58,2025-05-25T04:00:00+02:00,2025-05-25,12:00,4,3,7
58,2025-05-25T04:05:00+02:00,2025-05-25,12:05,17,0,17
62,2025-05-25T03:55:00+02:00,2025-05-25,11:55,4,2,6
62,2025-05-25T03:57:00+02:00,2025-05-25,11:57,0,1,1
62,2025-05-25T04:02:00+02:00,2025-05-25,12:02,5,2,7
62,2025-05-25T04:03:00+02:00,2025-05-25,12:03,3,4,7
62,2025-05-25T04:08:00+02:00,2025-05-25,12:08,9,6,15
63,2025-05-25T04:01:00+02:00,2025-05-25,12:01,14,2,16
67,2025-05-25T03:55:00+02:00,2025-05-25,11:55,10,5,15
67,2025-05-25T03:59:00+02:00,2025-05-25,11:59,3,2,5
67,2025-05-25T04:00:00+02:00,2025-05-25,12:00,11,9,20
67,2025-05-25T04:02:00+02:00,2025-05-25,12:02,2,6,8
68,2025-05-25T04:00:00+02:00,2025-05-25,12:00,6,2,8
68,2025-05-25T04:01:00+02:00,2025-05-25,12:01,1,5,6
68,2025-05-25T04:02:00+02:00,2025-05-25,12:02,5,8,13
68,2025-05-25T04:09:00+02:00,2025-05-25,12:09,5,3,8
72,2025-05-25T03:59:00+02:00,2025-05-25,11:59,1,0,1
72,2025-05-25T04:02:00+02:00,2025-05-25,12:02,0,4,4
72,2025-05-25T04:03:00+02:00,2025-05-25,12:03,1,11,12
72,2025-05-25T04:07:00+02:00,2025-05-25,12:07,5,7,12
76,2025-05-25T03:59:00+02:00,2025-05-25,11:59,1,0,1
76,2025-05-25T04:00:00+02:00,2025-05-25,12:00,2,1,3
76,2025-05-25T04:03:00+02:00,2025-05-25,12:03,1,0,1
76,2025-05-25T04:05:00+02:00,2025-05-25,12:05,1,1,2
79,2025-05-25T04:03:00+02:00,2025-05-25,12:03,7,8,15
79,2025-05-25T04:04:00+02:00,2025-05-25,12:04,17,6,23
79,2025-05-25T04:05:00+02:00,2025-05-25,12:05,1,5,6
79,2025-05-25T04:06:00+02:00,2025-05-25,12:06,15,10,25
85,2025-05-25T03:56:00+02:00,2025-05-25,11:56,1,5,6
85,2025-05-25T03:57:00+02:00,2025-05-25,11:57,0,1,1
85,2025-05-25T03:59:00+02:00,2025-05-25,11:59,0,4,4
85,2025-05-25T04:00:00+02:00,2025-05-25,12:00,0,1,1
85,2025-05-25T04:02:00+02:00,2025-05-25,12:02,1,5,6
85,2025-05-25T04:04:00+02:00,2025-05-25,12:04,2,0,2
85,2025-05-25T04:05:00+02:00,2025-05-25,12:05,3,1,4
85,2025-05-25T04:06:00+02:00,2025-05-25,12:06,1,0,1
86,2025-05-25T03:56:00+02:00,2025-05-25,11:56,0,1,1
86,2025-05-25T04:02:00+02:00,2025-05-25,12:02,1,4,5
86,2025-05-25T04:03:00+02:00,2025-05-25,12:03,0,2,2
86,2025-05-25T04:04:00+02:00,2025-05-25,12:04,6,0,6
86,2025-05-25T04:05:00+02:00,2025-05-25,12:05,2,1,3
86,2025-05-25T04:09:00+02:00,2025-05-25,12:09,1,0,1
109,2025-05-25T03:55:00+02:00,2025-05-25,11:55,13,5,18
117,2025-05-25T04:00:00+02:00,2025-05-25,12:00,13,13,26
117,2025-05-25T04:05:00+02:00,2025-05-25,12:05,6,23,29
123,2025-05-25T03:55:00+02:00,2025-05-25,11:55,7,2,9
123,2025-05-25T04:00:00+02:00,2025-05-25,12:00,7,1,8
123,2025-05-25T04:05:00+02:00,2025-05-25,12:05,6,13,19
130,2025-05-25T03:55:00+02:00,2025-05-25,11:55,3,4,7
136,2025-05-25T04:00:00+02:00,2025-05-25,12:00,14,13,27
136,2025-05-25T04:05:00+02:00,2025-05-25,12:05,22,6,28
139,2025-05-25T04:00:00+02:00,2025-05-25,12:00,4,0,4
141,2025-05-25T03:55:00+02:00,2025-05-25,11:55,26,8,34
141,2025-05-25T04:00:00+02:00,2025-05-25,12:00,17,3,20
142,2025-05-25T04:00:00+02:00,2025-05-25,12:00,71,59,130
164,2025-05-25T03:55:00+02:00,2025-05-25,11:55,7,3,10
164,2025-05-25T04:00:00+02:00,2025-05-25,12:00,9,3,12
181,2025-05-25T04:01:00+02:00,2025-05-25,12:01,5,17,22
181,2025-05-25T04:02:00+02:00,2025-05-25,12:02,7,22,29
181,2025-05-25T04:03:00+02:00,2025-05-25,12:03,16,14,30
181,2025-05-25T04:04:00+02:00,2025-05-25,12:04,9,22,31
181,2025-05-25T04:08:00+02:00,2025-05-25,12:08,5,24,29
182,2025-05-25T03:55:00+02:00,2025-05-25,11:55,35,5,40
182,2025-05-25T04:00:00+02:00,2025-05-25,12:00,14,20,34
180,2025-05-25T03:55:00+02:00,2025-05-25,11:55,0,1,1
180,2025-05-25T03:59:00+02:00,2025-05-25,11:59,1,0,1
180,2025-05-25T04:05:00+02:00,2025-05-25,12:05,1,1,2
180,2025-05-25T04:09:00+02:00,2025-05-25,12:09,3,0,3
181,2025-05-25T04:11:00+02:00,2025-05-25,12:11,3,10,13
181,2025-05-25T04:15:00+02:00,2025-05-25,12:15,16,23,39
181,2025-05-25T04:16:00+02:00,2025-05-25,12:16,20,10,30
181,2025-05-25T04:18:00+02:00,2025-05-25,12:18,4,21,25
181,2025-05-25T04:22:00+02:00,2025-05-25,12:22,10,17,27
182,2025-05-25T04:10:00+02:00,2025-05-25,12:10,11,6,17
180,2025-05-25T04:14:00+02:00,2025-05-25,12:14,1,1,2
180,2025-05-25T04:21:00+02:00,2025-05-25,12:21,0,2,2
180,2025-05-25T04:24:00+02:00,2025-05-25,12:24,2,6,8
3,2025-05-25T04:28:00+02:00,2025-05-25,12:28,14,20,34
3,2025-05-25T04:31:00+02:00,2025-05-25,12:31,31,25,56
3,2025-05-25T04:34:00+02:00,2025-05-25,12:34,13,25,38
3,2025-05-25T04:35:00+02:00,2025-05-25,12:35,5,26,31
3,2025-05-25T04:37:00+02:00,2025-05-25,12:37,12,15,27
3,2025-05-25T04:38:00+02:00,2025-05-25,12:38,12,22,34
3,2025-05-25T04:39:00+02:00,2025-05-25,12:39,12,25,37
4,2025-05-25T04:29:00+02:00,2025-05-25,12:29,29,23,52
4,2025-05-25T04:31:00+02:00,2025-05-25,12:31,30,11,41
4,2025-05-25T04:33:00+02:00,2025-05-25,12:33,46,29,75
4,2025-05-25T04:36:00+02:00,2025-05-25,12:36,37,10,47
5,2025-05-25T04:35:00+02:00,2025-05-25,12:35,102,105,207
6,2025-05-25T04:25:00+02:00,2025-05-25,12:25,15,21,36
6,2025-05-25T04:29:00+02:00,2025-05-25,12:29,11,11,22
6,2025-05-25T04:33:00+02:00,2025-05-25,12:33,21,13,34
6,2025-05-25T04:34:00+02:00,2025-05-25,12:34,16,0,16
6,2025-05-25T04:36:00+02:00,2025-05-25,12:36,8,12,20
8,2025-05-25T04:29:00+02:00,2025-05-25,12:29,5,2,7
8,2025-05-25T04:30:00+02:00,2025-05-25,12:30,2,7,9
8,2025-05-25T04:31:00+02:00,2025-05-25,12:31,6,0,6
8,2025-05-25T04:32:00+02:00,2025-05-25,12:32,3,6,9
8,2025-05-25T04:33:00+02:00,2025-05-25,12:33,3,4,7
8,2025-05-25T04:38:00+02:00,2025-05-25,12:38,2,3,5
8,2025-05-25T04:39:00+02:00,2025-05-25,12:39,0,1,1
28,2025-05-25T04:26:00+02:00,2025-05-25,12:26,9,10,19
28,2025-05-25T04:27:00+02:00,2025-05-25,12:27,4,8,12
28,2025-05-25T04:29:00+02:00,2025-05-25,12:29,8,4,12
28,2025-05-25T04:34:00+02:00,2025-05-25,12:34,7,10,17
29,2025-05-25T04:25:00+02:00,2025-05-25,12:25,8,17,25
29,2025-05-25T04:26:00+02:00,2025-05-25,12:26,1,6,7
29,2025-05-25T04:30:00+02:00,2025-05-25,12:30,19,5,24
29,2025-05-25T04:32:00+02:00,2025-05-25,12:32,9,7,16
29,2025-05-25T04:34:00+02:00,2025-05-25,12:34,16,18,34
29,2025-05-25T04:38:00+02:00,2025-05-25,12:38,4,5,9
31,2025-05-25T04:25:00+02:00,2025-05-25,12:25,1,1,2
31,2025-05-25T04:27:00+02:00,2025-05-25,12:27,2,1,3
31,2025-05-25T04:28:00+02:00,2025-05-25,12:28,6,0,6
31,2025-05-25T04:32:00+02:00,2025-05-25,12:32,3,0,3
31,2025-05-25T04:33:00+02:00,2025-05-25,12:33,1,2,3
31,2025-05-25T04:34:00+02:00,2025-05-25,12:34,6,3,9
31,2025-05-25T04:37:00+02:00,2025-05-25,12:37,1,5,6
31,2025-05-25T04:39:00+02:00,2025-05-25,12:39,6,2,8
36,2025-05-25T04:27:00+02:00,2025-05-25,12:27,0,1,1
36,2025-05-25T04:28:00+02:00,2025-05-25,12:28,0,4,4
36,2025-05-25T04:30:00+02:00,2025-05-25,12:30,24,1,25
36,2025-05-25T04:31:00+02:00,2025-05-25,12:31,2,5,7
36,2025-05-25T04:32:00+02:00,2025-05-25,12:32,0,2,2
36,2025-05-25T04:34:00+02:00,2025-05-25,12:34,0,5,5
36,2025-05-25T04:36:00+02:00,2025-05-25,12:36,1,0,1
36,2025-05-25T04:37:00+02:00,2025-05-25,12:37,1,3,4
37,2025-05-25T04:28:00+02:00,2025-05-25,12:28,1,7,8
37,2025-05-25T04:31:00+02:00,2025-05-25,12:31,5,1,6
37,2025-05-25T04:32:00+02:00,2025-05-25,12:32,11,0,11
39,2025-05-25T04:26:00+02:00,2025-05-25,12:26,2,0,2
39,2025-05-25T04:32:00+02:00,2025-05-25,12:32,0,3,3
39,2025-05-25T04:36:00+02:00,2025-05-25,12:36,0,1,1
39,2025-05-25T04:39:00+02:00,2025-05-25,12:39,2,0,2
40,2025-05-25T04:26:00+02:00,2025-05-25,12:26,6,4,10
40,2025-05-25T04:29:00+02:00,2025-05-25,12:29,4,3,7
40,2025-05-25T04:31:00+02:00,2025-05-25,12:31,3,14,17
40,2025-05-25T04:35:00+02:00,2025-05-25,12:35,0,9,9
40,2025-05-25T04:38:00+02:00,2025-05-25,12:38,4,10,14
41,2025-05-25T04:26:00+02:00,2025-05-25,12:26,8,1,9
41,2025-05-25T04:29:00+02:00,2025-05-25,12:29,8,2,10
41,2025-05-25T04:34:00+02:00,2025-05-25,12:34,4,2,6
43,2025-05-25T04:30:00+02:00,2025-05-25,12:30,5,1,6
44,2025-05-25T04:25:00+02:00,2025-05-25,12:25,5,3,8
44,2025-05-25T04:35:00+02:00,2025-05-25,12:35,2,5,7
45,2025-05-25T04:25:00+02:00,2025-05-25,12:25,17,9,26
45,2025-05-25T04:28:00+02:00,2025-05-25,12:28,15,12,27
45,2025-05-25T04:34:00+02:00,2025-05-25,12:34,22,19,41
47,2025-05-25T04:25:00+02:00,2025-05-25,12:25,16,11,27
47,2025-05-25T04:26:00+02:00,2025-05-25,12:26,11,6,17
47,2025-05-25T04:28:00+02:00,2025-05-25,12:28,23,24,47
47,2025-05-25T04:30:00+02:00,2025-05-25,12:30,13,23,36
47,2025-05-25T04:31:00+02:00,2025-05-25,12:31,14,13,27
47,2025-05-25T04:38:00+02:00,2025-05-25,12:38,18,9,27
47,2025-05-25T04:39:00+02:00,2025-05-25,12:39,16,21,37
50,2025-05-25T04:25:00+02:00,2025-05-25,12:25,4,1,5
50,2025-05-25T04:26:00+02:00,2025-05-25,12:26,5,6,11
50,2025-05-25T04:27:00+02:00,2025-05-25,12:27,1,4,5
50,2025-05-25T04:28:00+02:00,2025-05-25,12:28,1,1,2
50,2025-05-25T04:32:00+02:00,2025-05-25,12:32,4,3,7
50,2025-05-25T04:38:00+02:00,2025-05-25,12:38,5,6,11
54,2025-05-25T04:27:00+02:00,2025-05-25,12:27,0,4,4
54,2025-05-25T04:31:00+02:00,2025-05-25,12:31,0,2,2
54,2025-05-25T04:38:00+02:00,2025-05-25,12:38,6,2,8
54,2025-05-25T04:39:00+02:00,2025-05-25,12:39,1,3,4
59,2025-05-25T04:30:00+02:00,2025-05-25,12:30,14,33,47
61,2025-05-25T04:26:00+02:00,2025-05-25,12:26,8,4,12
61,2025-05-25T04:31:00+02:00,2025-05-25,12:31,9,15,24
61,2025-05-25T04:38:00+02:00,2025-05-25,12:38,7,8,15
61,2025-05-25T04:39:00+02:00,2025-05-25,12:39,6,5,11
66,2025-05-25T04:27:00+02:00,2025-05-25,12:27,24,39,63
66,2025-05-25T04:31:00+02:00,2025-05-25,12:31,23,11,34
66,2025-05-25T04:32:00+02:00,2025-05-25,12:32,26,23,49
66,2025-05-25T04:38:00+02:00,2025-05-25,12:38,34,16,50
69,2025-05-25T04:25:00+02:00,2025-05-25,12:25,3,3,6
69,2025-05-25T04:27:00+02:00,2025-05-25,12:27,5,0,5
69,2025-05-25T04:29:00+02:00,2025-05-25,12:29,2,13,15
69,2025-05-25T04:31:00+02:00,2025-05-25,12:31,4,0,4
69,2025-05-25T04:34:00+02:00,2025-05-25,12:34,0,1,1
69,2025-05-25T04:38:00+02:00,2025-05-25,12:38,2,3,5
70,2025-05-25T04:26:00+02:00,2025-05-25,12:26,4,3,7
70,2025-05-25T04:28:00+02:00,2025-05-25,12:28,2,3,5
70,2025-05-25T04:35:00+02:00,2025-05-25,12:35,1,3,4
70,2025-05-25T04:37:00+02:00,2025-05-25,12:37,3,4,7
70,2025-05-25T04:38:00+02:00,2025-05-25,12:38,0,3,3
75,2025-05-25T04:32:00+02:00,2025-05-25,12:32,1,0,1
75,2025-05-25T04:34:00+02:00,2025-05-25,12:34,0,1,1
77,2025-05-25T04:25:00+02:00,2025-05-25,12:25,12,10,22
77,2025-05-25T04:35:00+02:00,2025-05-25,12:35,21,14,35
78,2025-05-25T04:26:00+02:00,2025-05-25,12:26,2,2,4
78,2025-05-25T04:29:00+02:00,2025-05-25,12:29,2,2,4
78,2025-05-25T04:39:00+02:00,2025-05-25,12:39,3,0,3
84,2025-05-25T04:30:00+02:00,2025-05-25,12:30,96,72,168
87,2025-05-25T04:25:00+02:00,2025-05-25,12:25,8,2,10
87,2025-05-25T04:26:00+02:00,2025-05-25,12:26,2,2,4
87,2025-05-25T04:27:00+02:00,2025-05-25,12:27,2,0,2
87,2025-05-25T04:30:00+02:00,2025-05-25,12:30,5,5,10
87,2025-05-25T04:32:00+02:00,2025-05-25,12:32,4,5,9
87,2025-05-25T04:33:00+02:00,2025-05-25,12:33,1,1,2
87,2025-05-25T04:37:00+02:00,2025-05-25,12:37,3,0,3
87,2025-05-25T04:38:00+02:00,2025-05-25,12:38,4,2,6
108,2025-05-25T04:27:00+02:00,2025-05-25,12:27,0,2,2
108,2025-05-25T04:31:00+02:00,2025-05-25,12:31,9,2,11
108,2025-05-25T04:34:00+02:00,2025-05-25,12:34,4,5,9
108,2025-05-25T04:35:00+02:00,2025-05-25,12:35,6,4,10
108,2025-05-25T04:39:00+02:00,2025-05-25,12:39,2,2,4
118,2025-05-25T04:25:00+02:00,2025-05-25,12:25,3,6,9
118,2025-05-25T04:35:00+02:00,2025-05-25,12:35,0,2,2
124,2025-05-25T04:25:00+02:00,2025-05-25,12:25,3,3,6
124,2025-05-25T04:35:00+02:00,2025-05-25,12:35,0,4,4
131,2025-05-25T04:25:00+02:00,2025-05-25,12:25,17,17,34
131,2025-05-25T04:30:00+02:00,2025-05-25,12:30,7,15,22
131,2025-05-25T04:35:00+02:00,2025-05-25,12:35,8,9,17
132,2025-05-25T04:30:00+02:00,2025-05-25,12:30,11,6,17
132,2025-05-25T04:35:00+02:00,2025-05-25,12:35,20,14,34
134,2025-05-25T04:30:00+02:00,2025-05-25,12:30,25,20,45
134,2025-05-25T04:35:00+02:00,2025-05-25,12:35,23,28,51
135,2025-05-25T04:30:00+02:00,2025-05-25,12:30,44,26,70
135,2025-05-25T04:35:00+02:00,2025-05-25,12:35,26,38,64
140,2025-05-25T04:25:00+02:00,2025-05-25,12:25,11,5,16
165,2025-05-25T04:30:00+02:00,2025-05-25,12:30,1,1,2
165,2025-05-25T04:35:00+02:00,2025-05-25,12:35,2,1,3
166,2025-05-25T04:30:00+02:00,2025-05-25,12:30,10,8,18
167,2025-05-25T04:25:00+02:00,2025-05-25,12:25,2,4,6
179,2025-05-25T04:25:00+02:00,2025-05-25,12:25,11,3,14
179,2025-05-25T04:30:00+02:00,2025-05-25,12:30,2,3,5
1,2025-05-25T04:26:00+02:00,2025-05-25,12:26,23,27,50
1,2025-05-25T04:29:00+02:00,2025-05-25,12:29,13,15,28
1,2025-05-25T04:34:00+02:00,2025-05-25,12:34,28,16,44
1,2025-05-25T04:37:00+02:00,2025-05-25,12:37,22,25,47
1,2025-05-25T04:38:00+02:00,2025-05-25,12:38,16,15,31
2,2025-05-25T04:26:00+02:00,2025-05-25,12:26,23,9,32
2,2025-05-25T04:27:00+02:00,2025-05-25,12:27,20,15,35
2,2025-05-25T04:29:00+02:00,2025-05-25,12:29,14,13,27
2,2025-05-25T04:33:00+02:00,2025-05-25,12:33,12,9,21
2,2025-05-25T04:35:00+02:00,2025-05-25,12:35,10,14,24
2,2025-05-25T04:36:00+02:00,2025-05-25,12:36,4,7,11
2,2025-05-25T04:38:00+02:00,2025-05-25,12:38,6,10,16
2,2025-05-25T04:39:00+02:00,2025-05-25,12:39,10,10,20
9,2025-05-25T04:25:00+02:00,2025-05-25,12:25,1,9,10
9,2025-05-25T04:27:00+02:00,2025-05-25,12:27,2,0,2
9,2025-05-25T04:33:00+02:00,2025-05-25,12:33,0,3,3
9,2025-05-25T04:35:00+02:00,2025-05-25,12:35,0,2,2
10,2025-05-25T04:27:00+02:00,2025-05-25,12:27,1,2,3
10,2025-05-25T04:31:00+02:00,2025-05-25,12:31,1,1,2
10,2025-05-25T04:32:00+02:00,2025-05-25,12:32,0,2,2
10,2025-05-25T04:35:00+02:00,2025-05-25,12:35,9,0,9
11,2025-05-25T04:30:00+02:00,2025-05-25,12:30,3,1,4
11,2025-05-25T04:34:00+02:00,2025-05-25,12:34,0,3,3
11,2025-05-25T04:36:00+02:00,2025-05-25,12:36,2,0,2
11,2025-05-25T04:37:00+02:00,2025-05-25,12:37,1,0,1
12,2025-05-25T04:26:00+02:00,2025-05-25,12:26,2,0,2
12,2025-05-25T04:28:00+02:00,2025-05-25,12:28,2,2,4
12,2025-05-25T04:35:00+02:00,2025-05-25,12:35,3,3,6
12,2025-05-25T04:36:00+02:00,2025-05-25,12:36,0,1,1
17,2025-05-25T04:25:00+02:00,2025-05-25,12:25,3,1,4
17,2025-05-25T04:30:00+02:00,2025-05-25,12:30,9,1,10
17,2025-05-25T04:31:00+02:00,2025-05-25,12:31,8,2,10
17,2025-05-25T04:35:00+02:00,2025-05-25,12:35,8,5,13
18,2025-05-25T04:25:00+02:00,2025-05-25,12:25,1,2,3
18,2025-05-25T04:26:00+02:00,2025-05-25,12:26,10,0,10
18,2025-05-25T04:29:00+02:00,2025-05-25,12:29,3,0,3
18,2025-05-25T04:30:00+02:00,2025-05-25,12:30,8,0,8
18,2025-05-25T04:31:00+02:00,2025-05-25,12:31,3,2,5
18,2025-05-25T04:33:00+02:00,2025-05-25,12:33,4,5,9
18,2025-05-25T04:38:00+02:00,2025-05-25,12:38,1,1,2
19,2025-05-25T04:25:00+02:00,2025-05-25,12:25,12,8,20
19,2025-05-25T04:26:00+02:00,2025-05-25,12:26,12,6,18
19,2025-05-25T04:28:00+02:00,2025-05-25,12:28,5,1,6
19,2025-05-25T04:29:00+02:00,2025-05-25,12:29,11,2,13
19,2025-05-25T04:33:00+02:00,2025-05-25,12:33,9,13,22
19,2025-05-25T04:36:00+02:00,2025-05-25,12:36,16,6,22
19,2025-05-25T04:39:00+02:00,2025-05-25,12:39,4,5,9
20,2025-05-25T04:25:00+02:00,2025-05-25,12:25,6,0,6
20,2025-05-25T04:27:00+02:00,2025-05-25,12:27,5,1,6
20,2025-05-25T04:28:00+02:00,2025-05-25,12:28,1,4,5
20,2025-05-25T04:29:00+02:00,2025-05-25,12:29,10,6,16
20,2025-05-25T04:33:00+02:00,2025-05-25,12:33,5,6,11
20,2025-05-25T04:35:00+02:00,2025-05-25,12:35,3,0,3
20,2025-05-25T04:37:00+02:00,2025-05-25,12:37,5,5,10
23,2025-05-25T04:25:00+02:00,2025-05-25,12:25,0,3,3
23,2025-05-25T04:26:00+02:00,2025-05-25,12:26,1,0,1
23,2025-05-25T04:27:00+02:00,2025-05-25,12:27,5,1,6
23,2025-05-25T04:30:00+02:00,2025-05-25,12:30,0,4,4
23,2025-05-25T04:33:00+02:00,2025-05-25,12:33,0,5,5
23,2025-05-25T04:34:00+02:00,2025-05-25,12:34,3,7,10
24,2025-05-25T04:26:00+02:00,2025-05-25,12:26,8,5,13
24,2025-05-25T04:27:00+02:00,2025-05-25,12:27,31,0,31
24,2025-05-25T04:28:00+02:00,2025-05-25,12:28,3,10,13
24,2025-05-25T04:29:00+02:00,2025-05-25,12:29,29,9,38
24,2025-05-25T04:31:00+02:00,2025-05-25,12:31,1,14,15
24,2025-05-25T04:32:00+02:00,2025-05-25,12:32,9,14,23
24,2025-05-25T04:37:00+02:00,2025-05-25,12:37,13,1,14
27,2025-05-25T04:26:00+02:00,2025-05-25,12:26,1,3,4
27,2025-05-25T04:28:00+02:00,2025-05-25,12:28,3,5,8
27,2025-05-25T04:29:00+02:00,2025-05-25,12:29,3,1,4
27,2025-05-25T04:31:00+02:00,2025-05-25,12:31,2,6,8
27,2025-05-25T04:35:00+02:00,2025-05-25,12:35,5,4,9
27,2025-05-25T04:36:00+02:00,2025-05-25,12:36,3,2,5
27,2025-05-25T04:37:00+02:00,2025-05-25,12:37,8,8,16
27,2025-05-25T04:39:00+02:00,2025-05-25,12:39,3,9,12
30,2025-05-25T04:27:00+02:00,2025-05-25,12:27,4,4,8
30,2025-05-25T04:29:00+02:00,2025-05-25,12:29,0,8,8
30,2025-05-25T04:33:00+02:00,2025-05-25,12:33,9,2,11
30,2025-05-25T04:35:00+02:00,2025-05-25,12:35,7,4,11
30,2025-05-25T04:36:00+02:00,2025-05-25,12:36,3,4,7
30,2025-05-25T04:38:00+02:00,2025-05-25,12:38,3,5,8
35,2025-05-25T04:26:00+02:00,2025-05-25,12:26,21,12,33
35,2025-05-25T04:27:00+02:00,2025-05-25,12:27,40,50,90
35,2025-05-25T04:28:00+02:00,2025-05-25,12:28,23,21,44
35,2025-05-25T04:30:00+02:00,2025-05-25,12:30,15,23,38
35,2025-05-25T04:31:00+02:00,2025-05-25,12:31,26,14,40
35,2025-05-25T04:32:00+02:00,2025-05-25,12:32,24,12,36
35,2025-05-25T04:33:00+02:00,2025-05-25,12:33,14,20,34
35,2025-05-25T04:36:00+02:00,2025-05-25,12:36,23,22,45
46,2025-05-25T04:25:00+02:00,2025-05-25,12:25,8,3,11
48,2025-05-25T04:27:00+02:00,2025-05-25,12:27,6,6,12
48,2025-05-25T04:29:00+02:00,2025-05-25,12:29,17,7,24
48,2025-05-25T04:30:00+02:00,2025-05-25,12:30,8,2,10
48,2025-05-25T04:32:00+02:00,2025-05-25,12:32,9,8,17
48,2025-05-25T04:37:00+02:00,2025-05-25,12:37,16,6,22
49,2025-05-25T04:25:00+02:00,2025-05-25,12:25,13,4,17
49,2025-05-25T04:26:00+02:00,2025-05-25,12:26,10,12,22
49,2025-05-25T04:28:00+02:00,2025-05-25,12:28,3,18,21
49,2025-05-25T04:33:00+02:00,2025-05-25,12:33,8,17,25
49,2025-05-25T04:34:00+02:00,2025-05-25,12:34,2,9,11
51,2025-05-25T04:28:00+02:00,2025-05-25,12:28,1,2,3
51,2025-05-25T04:30:00+02:00,2025-05-25,12:30,0,2,2
51,2025-05-25T04:32:00+02:00,2025-05-25,12:32,3,12,15
51,2025-05-25T04:33:00+02:00,2025-05-25,12:33,6,6,12
51,2025-05-25T04:35:00+02:00,2025-05-25,12:35,9,5,14
51,2025-05-25T04:39:00+02:00,2025-05-25,12:39,2,2,4
52,2025-05-25T04:25:00+02:00,2025-05-25,12:25,11,1,12
52,2025-05-25T04:31:00+02:00,2025-05-25,12:31,7,2,9
52,2025-05-25T04:33:00+02:00,2025-05-25,12:33,2,2,4
52,2025-05-25T04:34:00+02:00,2025-05-25,12:34,5,2,7
52,2025-05-25T04:37:00+02:00,2025-05-25,12:37,10,6,16
52,2025-05-25T04:39:00+02:00,2025-05-25,12:39,1,6,7
53,2025-05-25T04:25:00+02:00,2025-05-25,12:25,20,8,28
53,2025-05-25T04:30:00+02:00,2025-05-25,12:30,16,12,28
53,2025-05-25T04:32:00+02:00,2025-05-25,12:32,13,10,23
53,2025-05-25T04:38:00+02:00,2025-05-25,12:38,20,7,27
56,2025-05-25T04:30:00+02:00,2025-05-25,12:30,6,1,7
56,2025-05-25T04:33:00+02:00,2025-05-25,12:33,11,4,15
56,2025-05-25T04:39:00+02:00,2025-05-25,12:39,9,10,19
58,2025-05-25T04:26:00+02:00,2025-05-25,12:26,7,15,22
58,2025-05-25T04:28:00+02:00,2025-05-25,12:28,7,18,25
58,2025-05-25T04:29:00+02:00,2025-05-25,12:29,11,4,15
58,2025-05-25T04:33:00+02:00,2025-05-25,12:33,12,6,18
58,2025-05-25T04:35:00+02:00,2025-05-25,12:35,16,2,18
58,2025-05-25T04:36:00+02:00,2025-05-25,12:36,12,2,14
58,2025-05-25T04:39:00+02:00,2025-05-25,12:39,11,4,15
62,2025-05-25T04:29:00+02:00,2025-05-25,12:29,1,0,1
62,2025-05-25T04:30:00+02:00,2025-05-25,12:30,1,3,4
62,2025-05-25T04:32:00+02:00,2025-05-25,12:32,3,2,5
62,2025-05-25T04:37:00+02:00,2025-05-25,12:37,3,2,5
62,2025-05-25T04:38:00+02:00,2025-05-25,12:38,0,6,6
62,2025-05-25T04:39:00+02:00,2025-05-25,12:39,0,2,2
63,2025-05-25T04:29:00+02:00,2025-05-25,12:29,17,5,22
63,2025-05-25T04:35:00+02:00,2025-05-25,12:35,6,3,9
63,2025-05-25T04:37:00+02:00,2025-05-25,12:37,6,5,11
3,2025-05-25T11:40:00+02:00,2025-05-25,19:40,6,9,15
67,2025-05-25T04:27:00+02:00,2025-05-25,12:27,5,8,13
3,2025-05-25T11:42:00+02:00,2025-05-25,19:42,9,19,28
67,2025-05-25T04:28:00+02:00,2025-05-25,12:28,9,5,14
3,2025-05-25T11:43:00+02:00,2025-05-25,19:43,14,17,31
67,2025-05-25T04:30:00+02:00,2025-05-25,12:30,3,11,14
3,2025-05-25T11:50:00+02:00,2025-05-25,19:50,15,15,30
67,2025-05-25T04:31:00+02:00,2025-05-25,12:31,11,3,14
4,2025-05-25T11:40:00+02:00,2025-05-25,19:40,16,11,27
67,2025-05-25T04:34:00+02:00,2025-05-25,12:34,5,4,9
4,2025-05-25T11:42:00+02:00,2025-05-25,19:42,16,14,30
67,2025-05-25T04:36:00+02:00,2025-05-25,12:36,2,6,8
4,2025-05-25T11:43:00+02:00,2025-05-25,19:43,4,22,26
67,2025-05-25T04:39:00+02:00,2025-05-25,12:39,11,2,13
4,2025-05-25T11:53:00+02:00,2025-05-25,19:53,14,13,27
68,2025-05-25T04:26:00+02:00,2025-05-25,12:26,10,5,15
4,2025-05-25T11:54:00+02:00,2025-05-25,19:54,13,12,25
68,2025-05-25T04:29:00+02:00,2025-05-25,12:29,6,12,18
5,2025-05-25T11:40:00+02:00,2025-05-25,19:40,34,34,68
68,2025-05-25T04:33:00+02:00,2025-05-25,12:33,6,2,8
5,2025-05-25T11:45:00+02:00,2025-05-25,19:45,23,50,73
68,2025-05-25T04:34:00+02:00,2025-05-25,12:34,5,9,14
5,2025-05-25T11:50:00+02:00,2025-05-25,19:50,26,30,56
68,2025-05-25T04:37:00+02:00,2025-05-25,12:37,4,5,9
6,2025-05-25T11:47:00+02:00,2025-05-25,19:47,1,13,14
72,2025-05-25T04:25:00+02:00,2025-05-25,12:25,6,6,12
6,2025-05-25T11:48:00+02:00,2025-05-25,19:48,4,4,8
72,2025-05-25T04:26:00+02:00,2025-05-25,12:26,0,14,14
6,2025-05-25T11:49:00+02:00,2025-05-25,19:49,13,10,23
72,2025-05-25T04:30:00+02:00,2025-05-25,12:30,5,5,10
6,2025-05-25T11:50:00+02:00,2025-05-25,19:50,7,4,11
72,2025-05-25T04:31:00+02:00,2025-05-25,12:31,6,3,9
6,2025-05-25T11:51:00+02:00,2025-05-25,19:51,7,3,10
72,2025-05-25T04:34:00+02:00,2025-05-25,12:34,6,6,12
6,2025-05-25T11:53:00+02:00,2025-05-25,19:53,5,6,11
72,2025-05-25T04:35:00+02:00,2025-05-25,12:35,4,9,13
8,2025-05-25T11:44:00+02:00,2025-05-25,19:44,0,1,1
72,2025-05-25T04:37:00+02:00,2025-05-25,12:37,3,11,14
8,2025-05-25T11:54:00+02:00,2025-05-25,19:54,1,1,2
72,2025-05-25T04:38:00+02:00,2025-05-25,12:38,4,5,9
28,2025-05-25T11:45:00+02:00,2025-05-25,19:45,1,3,4
76,2025-05-25T04:34:00+02:00,2025-05-25,12:34,2,0,2
28,2025-05-25T11:49:00+02:00,2025-05-25,19:49,6,5,11
76,2025-05-25T04:36:00+02:00,2025-05-25,12:36,0,4,4
28,2025-05-25T11:54:00+02:00,2025-05-25,19:54,2,0,2
76,2025-05-25T04:37:00+02:00,2025-05-25,12:37,3,1,4
29,2025-05-25T11:40:00+02:00,2025-05-25,19:40,3,0,3
79,2025-05-25T04:26:00+02:00,2025-05-25,12:26,2,10,12
29,2025-05-25T11:41:00+02:00,2025-05-25,19:41,1,7,8
79,2025-05-25T04:28:00+02:00,2025-05-25,12:28,7,7,14
29,2025-05-25T11:46:00+02:00,2025-05-25,19:46,3,8,11
79,2025-05-25T04:29:00+02:00,2025-05-25,12:29,30,10,40
29,2025-05-25T11:47:00+02:00,2025-05-25,19:47,0,6,6
79,2025-05-25T04:33:00+02:00,2025-05-25,12:33,6,11,17
29,2025-05-25T11:49:00+02:00,2025-05-25,19:49,0,2,2
85,2025-05-25T04:27:00+02:00,2025-05-25,12:27,2,7,9
29,2025-05-25T11:50:00+02:00,2025-05-25,19:50,3,4,7
85,2025-05-25T04:29:00+02:00,2025-05-25,12:29,2,1,3
29,2025-05-25T11:51:00+02:00,2025-05-25,19:51,4,9,13
85,2025-05-25T04:30:00+02:00,2025-05-25,12:30,6,0,6
29,2025-05-25T11:54:00+02:00,2025-05-25,19:54,2,1,3
86,2025-05-25T04:26:00+02:00,2025-05-25,12:26,1,2,3
31,2025-05-25T11:41:00+02:00,2025-05-25,19:41,1,13,14
86,2025-05-25T04:27:00+02:00,2025-05-25,12:27,6,2,8
31,2025-05-25T11:42:00+02:00,2025-05-25,19:42,0,9,9
86,2025-05-25T04:28:00+02:00,2025-05-25,12:28,2,2,4
31,2025-05-25T11:45:00+02:00,2025-05-25,19:45,5,2,7
86,2025-05-25T04:29:00+02:00,2025-05-25,12:29,0,1,1
31,2025-05-25T11:53:00+02:00,2025-05-25,19:53,3,1,4
86,2025-05-25T04:33:00+02:00,2025-05-25,12:33,1,0,1
36,2025-05-25T11:48:00+02:00,2025-05-25,19:48,6,1,7
109,2025-05-25T04:30:00+02:00,2025-05-25,12:30,4,5,9
36,2025-05-25T11:51:00+02:00,2025-05-25,19:51,0,1,1
117,2025-05-25T04:25:00+02:00,2025-05-25,12:25,24,17,41
36,2025-05-25T11:53:00+02:00,2025-05-25,19:53,4,0,4
117,2025-05-25T04:30:00+02:00,2025-05-25,12:30,9,13,22
36,2025-05-25T11:54:00+02:00,2025-05-25,19:54,2,2,4
123,2025-05-25T04:25:00+02:00,2025-05-25,12:25,6,5,11
39,2025-05-25T11:49:00+02:00,2025-05-25,19:49,1,1,2
123,2025-05-25T04:35:00+02:00,2025-05-25,12:35,12,8,20
39,2025-05-25T11:53:00+02:00,2025-05-25,19:53,0,2,2
130,2025-05-25T04:25:00+02:00,2025-05-25,12:25,3,5,8
40,2025-05-25T11:40:00+02:00,2025-05-25,19:40,1,2,3
136,2025-05-25T04:35:00+02:00,2025-05-25,12:35,14,11,25
40,2025-05-25T11:41:00+02:00,2025-05-25,19:41,6,0,6
138,2025-05-25T04:30:00+02:00,2025-05-25,12:30,1,0,1
40,2025-05-25T11:44:00+02:00,2025-05-25,19:44,3,0,3
141,2025-05-25T04:25:00+02:00,2025-05-25,12:25,9,22,31
40,2025-05-25T11:47:00+02:00,2025-05-25,19:47,1,1,2
141,2025-05-25T04:30:00+02:00,2025-05-25,12:30,10,13,23
40,2025-05-25T11:49:00+02:00,2025-05-25,19:49,1,0,1
161,2025-05-25T04:25:00+02:00,2025-05-25,12:25,63,18,81
41,2025-05-25T11:41:00+02:00,2025-05-25,19:41,3,3,6
161,2025-05-25T04:35:00+02:00,2025-05-25,12:35,33,14,47
41,2025-05-25T11:44:00+02:00,2025-05-25,19:44,2,2,4
164,2025-05-25T04:25:00+02:00,2025-05-25,12:25,10,0,10
41,2025-05-25T11:45:00+02:00,2025-05-25,19:45,8,7,15
164,2025-05-25T04:30:00+02:00,2025-05-25,12:30,13,2,15
41,2025-05-25T11:47:00+02:00,2025-05-25,19:47,8,0,8
164,2025-05-25T04:35:00+02:00,2025-05-25,12:35,5,13,18
41,2025-05-25T11:48:00+02:00,2025-05-25,19:48,1,4,5
41,2025-05-25T11:50:00+02:00,2025-05-25,19:50,1,3,4
41,2025-05-25T11:53:00+02:00,2025-05-25,19:53,1,2,3
43,2025-05-25T11:40:00+02:00,2025-05-25,19:40,3,0,3
44,2025-05-25T11:40:00+02:00,2025-05-25,19:40,4,1,5
44,2025-05-25T11:50:00+02:00,2025-05-25,19:50,1,0,1
45,2025-05-25T11:41:00+02:00,2025-05-25,19:41,10,9,19
45,2025-05-25T11:46:00+02:00,2025-05-25,19:46,3,10,13
45,2025-05-25T11:49:00+02:00,2025-05-25,19:49,3,14,17
45,2025-05-25T11:52:00+02:00,2025-05-25,19:52,6,13,19
47,2025-05-25T11:42:00+02:00,2025-05-25,19:42,13,9,22
47,2025-05-25T11:44:00+02:00,2025-05-25,19:44,13,4,17
47,2025-05-25T11:46:00+02:00,2025-05-25,19:46,8,22,30
47,2025-05-25T11:51:00+02:00,2025-05-25,19:51,8,16,24
47,2025-05-25T11:54:00+02:00,2025-05-25,19:54,6,25,31
50,2025-05-25T11:43:00+02:00,2025-05-25,19:43,2,0,2
50,2025-05-25T11:47:00+02:00,2025-05-25,19:47,2,2,4
50,2025-05-25T11:54:00+02:00,2025-05-25,19:54,8,11,19
54,2025-05-25T11:40:00+02:00,2025-05-25,19:40,4,4,8
54,2025-05-25T11:48:00+02:00,2025-05-25,19:48,2,1,3
54,2025-05-25T11:49:00+02:00,2025-05-25,19:49,3,0,3
54,2025-05-25T11:53:00+02:00,2025-05-25,19:53,2,1,3
61,2025-05-25T11:42:00+02:00,2025-05-25,19:42,8,1,9
61,2025-05-25T11:43:00+02:00,2025-05-25,19:43,2,2,4
61,2025-05-25T11:44:00+02:00,2025-05-25,19:44,7,2,9
61,2025-05-25T11:47:00+02:00,2025-05-25,19:47,5,5,10
61,2025-05-25T11:49:00+02:00,2025-05-25,19:49,6,2,8
61,2025-05-25T11:50:00+02:00,2025-05-25,19:50,5,2,7
61,2025-05-25T11:54:00+02:00,2025-05-25,19:54,3,0,3
66,2025-05-25T11:41:00+02:00,2025-05-25,19:41,13,26,39
66,2025-05-25T11:43:00+02:00,2025-05-25,19:43,11,9,20
66,2025-05-25T11:44:00+02:00,2025-05-25,19:44,9,11,20
66,2025-05-25T11:45:00+02:00,2025-05-25,19:45,28,9,37
66,2025-05-25T11:47:00+02:00,2025-05-25,19:47,14,12,26
66,2025-05-25T11:49:00+02:00,2025-05-25,19:49,19,22,41
69,2025-05-25T11:49:00+02:00,2025-05-25,19:49,1,0,1
69,2025-05-25T11:52:00+02:00,2025-05-25,19:52,1,1,2
70,2025-05-25T11:40:00+02:00,2025-05-25,19:40,0,2,2
70,2025-05-25T11:41:00+02:00,2025-05-25,19:41,0,1,1
70,2025-05-25T11:49:00+02:00,2025-05-25,19:49,6,1,7
71,2025-05-25T11:49:00+02:00,2025-05-25,19:49,0,1,1
71,2025-05-25T11:50:00+02:00,2025-05-25,19:50,1,0,1
77,2025-05-25T11:40:00+02:00,2025-05-25,19:40,38,8,46
84,2025-05-25T11:40:00+02:00,2025-05-25,19:40,41,61,102
87,2025-05-25T11:45:00+02:00,2025-05-25,19:45,1,0,1
87,2025-05-25T11:49:00+02:00,2025-05-25,19:49,1,2,3
87,2025-05-25T11:52:00+02:00,2025-05-25,19:52,1,0,1
87,2025-05-25T11:54:00+02:00,2025-05-25,19:54,2,0,2
107,2025-05-25T11:40:00+02:00,2025-05-25,19:40,11,5,16
108,2025-05-25T11:46:00+02:00,2025-05-25,19:46,1,2,3
108,2025-05-25T11:51:00+02:00,2025-05-25,19:51,2,0,2
108,2025-05-25T11:52:00+02:00,2025-05-25,19:52,1,0,1
108,2025-05-25T11:53:00+02:00,2025-05-25,19:53,1,5,6
108,2025-05-25T11:54:00+02:00,2025-05-25,19:54,1,3,4
118,2025-05-25T11:40:00+02:00,2025-05-25,19:40,3,0,3
131,2025-05-25T11:40:00+02:00,2025-05-25,19:40,8,5,13
131,2025-05-25T11:45:00+02:00,2025-05-25,19:45,3,6,9
132,2025-05-25T11:45:00+02:00,2025-05-25,19:45,16,21,37
133,2025-05-25T11:40:00+02:00,2025-05-25,19:40,27,26,53
133,2025-05-25T11:45:00+02:00,2025-05-25,19:45,57,24,81
134,2025-05-25T11:40:00+02:00,2025-05-25,19:40,24,17,41
162,2025-05-25T11:50:00+02:00,2025-05-25,19:50,7,5,12
166,2025-05-25T11:40:00+02:00,2025-05-25,19:40,0,2,2
179,2025-05-25T11:45:00+02:00,2025-05-25,19:45,3,5,8
179,2025-05-25T11:50:00+02:00,2025-05-25,19:50,4,2,6
1,2025-05-25T11:45:00+02:00,2025-05-25,19:45,7,2,9
1,2025-05-25T11:46:00+02:00,2025-05-25,19:46,1,1,2
1,2025-05-25T11:48:00+02:00,2025-05-25,19:48,3,2,5
1,2025-05-25T11:51:00+02:00,2025-05-25,19:51,4,3,7
2,2025-05-25T11:41:00+02:00,2025-05-25,19:41,0,3,3
2,2025-05-25T11:43:00+02:00,2025-05-25,19:43,5,3,8
2,2025-05-25T11:45:00+02:00,2025-05-25,19:45,0,3,3
2,2025-05-25T11:49:00+02:00,2025-05-25,19:49,2,4,6
2,2025-05-25T11:51:00+02:00,2025-05-25,19:51,7,4,11
9,2025-05-25T11:40:00+02:00,2025-05-25,19:40,2,0,2
9,2025-05-25T11:43:00+02:00,2025-05-25,19:43,0,1,1
9,2025-05-25T11:44:00+02:00,2025-05-25,19:44,3,0,3
9,2025-05-25T11:45:00+02:00,2025-05-25,19:45,0,1,1
9,2025-05-25T11:52:00+02:00,2025-05-25,19:52,0,1,1
10,2025-05-25T11:40:00+02:00,2025-05-25,19:40,1,0,1
10,2025-05-25T11:44:00+02:00,2025-05-25,19:44,0,1,1
10,2025-05-25T11:45:00+02:00,2025-05-25,19:45,0,1,1
10,2025-05-25T11:47:00+02:00,2025-05-25,19:47,0,1,1
10,2025-05-25T11:51:00+02:00,2025-05-25,19:51,1,1,2
12,2025-05-25T11:40:00+02:00,2025-05-25,19:40,1,2,3
12,2025-05-25T11:41:00+02:00,2025-05-25,19:41,2,4,6
12,2025-05-25T11:46:00+02:00,2025-05-25,19:46,1,5,6
12,2025-05-25T11:47:00+02:00,2025-05-25,19:47,1,4,5
12,2025-05-25T11:49:00+02:00,2025-05-25,19:49,4,3,7
17,2025-05-25T11:44:00+02:00,2025-05-25,19:44,0,1,1
17,2025-05-25T11:48:00+02:00,2025-05-25,19:48,6,0,6
17,2025-05-25T11:52:00+02:00,2025-05-25,19:52,0,5,5
17,2025-05-25T11:54:00+02:00,2025-05-25,19:54,1,0,1
18,2025-05-25T11:48:00+02:00,2025-05-25,19:48,1,0,1
18,2025-05-25T11:50:00+02:00,2025-05-25,19:50,0,1,1
19,2025-05-25T11:40:00+02:00,2025-05-25,19:40,8,1,9
19,2025-05-25T11:41:00+02:00,2025-05-25,19:41,10,8,18
19,2025-05-25T11:47:00+02:00,2025-05-25,19:47,5,9,14
19,2025-05-25T11:49:00+02:00,2025-05-25,19:49,8,8,16
19,2025-05-25T11:50:00+02:00,2025-05-25,19:50,8,5,13
20,2025-05-25T11:41:00+02:00,2025-05-25,19:41,2,2,4
20,2025-05-25T11:45:00+02:00,2025-05-25,19:45,0,9,9
20,2025-05-25T11:47:00+02:00,2025-05-25,19:47,7,6,13
20,2025-05-25T11:48:00+02:00,2025-05-25,19:48,7,3,10
20,2025-05-25T11:49:00+02:00,2025-05-25,19:49,2,9,11
20,2025-05-25T11:51:00+02:00,2025-05-25,19:51,0,12,12
20,2025-05-25T11:52:00+02:00,2025-05-25,19:52,3,1,4
23,2025-05-25T11:41:00+02:00,2025-05-25,19:41,1,2,3
23,2025-05-25T11:44:00+02:00,2025-05-25,19:44,0,1,1
23,2025-05-25T11:53:00+02:00,2025-05-25,19:53,2,4,6
23,2025-05-25T11:54:00+02:00,2025-05-25,19:54,0,4,4
24,2025-05-25T11:43:00+02:00,2025-05-25,19:43,8,17,25
24,2025-05-25T11:48:00+02:00,2025-05-25,19:48,11,6,17
24,2025-05-25T11:52:00+02:00,2025-05-25,19:52,2,3,5
24,2025-05-25T11:54:00+02:00,2025-05-25,19:54,2,10,12
25,2025-05-25T11:40:00+02:00,2025-05-25,19:40,16,21,37
25,2025-05-25T11:45:00+02:00,2025-05-25,19:45,9,14,23
27,2025-05-25T11:45:00+02:00,2025-05-25,19:45,5,0,5
27,2025-05-25T11:46:00+02:00,2025-05-25,19:46,3,0,3
30,2025-05-25T11:43:00+02:00,2025-05-25,19:43,1,10,11
30,2025-05-25T11:46:00+02:00,2025-05-25,19:46,8,8,16
30,2025-05-25T11:48:00+02:00,2025-05-25,19:48,4,4,8
35,2025-05-25T11:44:00+02:00,2025-05-25,19:44,10,9,19
35,2025-05-25T11:45:00+02:00,2025-05-25,19:45,0,20,20
35,2025-05-25T11:47:00+02:00,2025-05-25,19:47,6,9,15
48,2025-05-25T11:41:00+02:00,2025-05-25,19:41,0,2,2
48,2025-05-25T11:43:00+02:00,2025-05-25,19:43,0,1,1
48,2025-05-25T11:51:00+02:00,2025-05-25,19:51,4,2,6
48,2025-05-25T11:54:00+02:00,2025-05-25,19:54,1,0,1
49,2025-05-25T11:40:00+02:00,2025-05-25,19:40,3,5,8
49,2025-05-25T11:44:00+02:00,2025-05-25,19:44,1,2,3
49,2025-05-25T11:46:00+02:00,2025-05-25,19:46,3,1,4
49,2025-05-25T11:53:00+02:00,2025-05-25,19:53,3,1,4
49,2025-05-25T11:54:00+02:00,2025-05-25,19:54,0,5,5
51,2025-05-25T11:45:00+02:00,2025-05-25,19:45,1,1,2
51,2025-05-25T11:51:00+02:00,2025-05-25,19:51,1,2,3
51,2025-05-25T11:53:00+02:00,2025-05-25,19:53,1,2,3
52,2025-05-25T11:40:00+02:00,2025-05-25,19:40,3,2,5
52,2025-05-25T11:42:00+02:00,2025-05-25,19:42,0,7,7
52,2025-05-25T11:45:00+02:00,2025-05-25,19:45,1,4,5
52,2025-05-25T11:46:00+02:00,2025-05-25,19:46,4,2,6
53,2025-05-25T11:47:00+02:00,2025-05-25,19:47,1,2,3
53,2025-05-25T11:49:00+02:00,2025-05-25,19:49,3,2,5
53,2025-05-25T11:51:00+02:00,2025-05-25,19:51,12,3,15
56,2025-05-25T11:45:00+02:00,2025-05-25,19:45,9,4,13
56,2025-05-25T11:46:00+02:00,2025-05-25,19:46,2,15,17
56,2025-05-25T11:47:00+02:00,2025-05-25,19:47,3,0,3
56,2025-05-25T11:51:00+02:00,2025-05-25,19:51,0,5,5
58,2025-05-25T11:44:00+02:00,2025-05-25,19:44,1,9,10
58,2025-05-25T11:48:00+02:00,2025-05-25,19:48,29,4,33
58,2025-05-25T11:51:00+02:00,2025-05-25,19:51,4,8,12
62,2025-05-25T11:40:00+02:00,2025-05-25,19:40,5,1,6
62,2025-05-25T11:43:00+02:00,2025-05-25,19:43,6,7,13
62,2025-05-25T11:44:00+02:00,2025-05-25,19:44,0,2,2
62,2025-05-25T11:45:00+02:00,2025-05-25,19:45,2,2,4
62,2025-05-25T11:47:00+02:00,2025-05-25,19:47,8,2,10
62,2025-05-25T11:49:00+02:00,2025-05-25,19:49,2,2,4
62,2025-05-25T11:50:00+02:00,2025-05-25,19:50,0,2,2
62,2025-05-25T11:51:00+02:00,2025-05-25,19:51,2,1,3
62,2025-05-25T11:52:00+02:00,2025-05-25,19:52,1,9,10
63,2025-05-25T11:44:00+02:00,2025-05-25,19:44,1,3,4
63,2025-05-25T11:47:00+02:00,2025-05-25,19:47,0,2,2
63,2025-05-25T11:51:00+02:00,2025-05-25,19:51,2,1,3
63,2025-05-25T11:52:00+02:00,2025-05-25,19:52,0,3,3
67,2025-05-25T11:43:00+02:00,2025-05-25,19:43,0,8,8
67,2025-05-25T11:45:00+02:00,2025-05-25,19:45,1,1,2
67,2025-05-25T11:46:00+02:00,2025-05-25,19:46,2,2,4
67,2025-05-25T11:48:00+02:00,2025-05-25,19:48,4,4,8
67,2025-05-25T11:50:00+02:00,2025-05-25,19:50,5,5,10
67,2025-05-25T11:52:00+02:00,2025-05-25,19:52,1,4,5
68,2025-05-25T11:44:00+02:00,2025-05-25,19:44,2,0,2
68,2025-05-25T11:47:00+02:00,2025-05-25,19:47,2,0,2
68,2025-05-25T11:49:00+02:00,2025-05-25,19:49,9,1,10
68,2025-05-25T11:50:00+02:00,2025-05-25,19:50,2,0,2
68,2025-05-25T11:54:00+02:00,2025-05-25,19:54,3,2,5
72,2025-05-25T11:41:00+02:00,2025-05-25,19:41,3,0,3
72,2025-05-25T11:49:00+02:00,2025-05-25,19:49,2,2,4
72,2025-05-25T11:51:00+02:00,2025-05-25,19:51,1,3,4
72,2025-05-25T11:54:00+02:00,2025-05-25,19:54,0,7,7
79,2025-05-25T11:42:00+02:00,2025-05-25,19:42,7,3,10
79,2025-05-25T11:45:00+02:00,2025-05-25,19:45,7,8,15
79,2025-05-25T11:47:00+02:00,2025-05-25,19:47,2,4,6
79,2025-05-25T11:48:00+02:00,2025-05-25,19:48,5,12,17
79,2025-05-25T11:54:00+02:00,2025-05-25,19:54,0,6,6
85,2025-05-25T11:47:00+02:00,2025-05-25,19:47,1,0,1
85,2025-05-25T11:52:00+02:00,2025-05-25,19:52,0,2,2
86,2025-05-25T11:40:00+02:00,2025-05-25,19:40,0,3,3
109,2025-05-25T11:50:00+02:00,2025-05-25,19:50,13,5,18
117,2025-05-25T11:50:00+02:00,2025-05-25,19:50,27,3,30
130,2025-05-25T11:50:00+02:00,2025-05-25,19:50,2,0,2
139,2025-05-25T11:45:00+02:00,2025-05-25,19:45,3,0,3
142,2025-05-25T11:45:00+02:00,2025-05-25,19:45,1,1,2
161,2025-05-25T11:50:00+02:00,2025-05-25,19:50,1,0,1
181,2025-05-25T11:40:00+02:00,2025-05-25,19:40,24,7,31
181,2025-05-25T11:42:00+02:00,2025-05-25,19:42,7,16,23
181,2025-05-25T11:46:00+02:00,2025-05-25,19:46,13,17,30
181,2025-05-25T11:47:00+02:00,2025-05-25,19:47,9,5,14
181,2025-05-25T11:50:00+02:00,2025-05-25,19:50,8,21,29
181,2025-05-25T11:52:00+02:00,2025-05-25,19:52,14,4,18
182,2025-05-25T11:45:00+02:00,2025-05-25,19:45,26,16,42
181,2025-05-25T04:27:00+02:00,2025-05-25,12:27,10,16,26
181,2025-05-25T04:35:00+02:00,2025-05-25,12:35,19,28,47
181,2025-05-25T04:37:00+02:00,2025-05-25,12:37,12,13,25
181,2025-05-25T04:38:00+02:00,2025-05-25,12:38,11,14,25
182,2025-05-25T04:35:00+02:00,2025-05-25,12:35,17,11,28
180,2025-05-25T04:28:00+02:00,2025-05-25,12:28,0,2,2
180,2025-05-25T04:34:00+02:00,2025-05-25,12:34,2,0,2
180,2025-05-25T04:36:00+02:00,2025-05-25,12:36,1,0,1
19,2025-05-25T04:45:00+02:00,2025-05-25,12:45,15,16,31
19,2025-05-25T04:47:00+02:00,2025-05-25,12:47,15,6,21
19,2025-05-25T04:49:00+02:00,2025-05-25,12:49,19,15,34
19,2025-05-25T04:50:00+02:00,2025-05-25,12:50,3,15,18
19,2025-05-25T04:53:00+02:00,2025-05-25,12:53,18,1,19
19,2025-05-25T04:54:00+02:00,2025-05-25,12:54,7,5,12
20,2025-05-25T04:40:00+02:00,2025-05-25,12:40,5,0,5
20,2025-05-25T04:41:00+02:00,2025-05-25,12:41,2,8,10
20,2025-05-25T04:42:00+02:00,2025-05-25,12:42,12,2,14
20,2025-05-25T04:48:00+02:00,2025-05-25,12:48,7,8,15
20,2025-05-25T04:54:00+02:00,2025-05-25,12:54,12,3,15
23,2025-05-25T04:42:00+02:00,2025-05-25,12:42,6,2,8
23,2025-05-25T04:43:00+02:00,2025-05-25,12:43,11,6,17
3,2025-05-25T11:57:00+02:00,2025-05-25,19:57,31,22,53
23,2025-05-25T04:51:00+02:00,2025-05-25,12:51,3,7,10
3,2025-05-25T12:05:00+02:00,2025-05-25,20:05,22,18,40
4,2025-05-25T11:56:00+02:00,2025-05-25,19:56,11,6,17
4,2025-05-25T11:59:00+02:00,2025-05-25,19:59,8,16,24
24,2025-05-25T04:41:00+02:00,2025-05-25,12:41,2,1,3
24,2025-05-25T04:42:00+02:00,2025-05-25,12:42,12,2,14
24,2025-05-25T04:43:00+02:00,2025-05-25,12:43,3,3,6
24,2025-05-25T04:45:00+02:00,2025-05-25,12:45,5,6,11
24,2025-05-25T04:49:00+02:00,2025-05-25,12:49,11,7,18
24,2025-05-25T04:51:00+02:00,2025-05-25,12:51,7,1,8
24,2025-05-25T04:53:00+02:00,2025-05-25,12:53,9,4,13
5,2025-05-25T11:55:00+02:00,2025-05-25,19:55,29,38,67
25,2025-05-25T04:45:00+02:00,2025-05-25,12:45,84,86,170
6,2025-05-25T11:56:00+02:00,2025-05-25,19:56,7,16,23
6,2025-05-25T11:59:00+02:00,2025-05-25,19:59,7,11,18
6,2025-05-25T12:02:00+02:00,2025-05-25,20:02,7,10,17
6,2025-05-25T12:04:00+02:00,2025-05-25,20:04,1,3,4
6,2025-05-25T12:06:00+02:00,2025-05-25,20:06,6,5,11
27,2025-05-25T04:47:00+02:00,2025-05-25,12:47,6,5,11
6,2025-05-25T12:07:00+02:00,2025-05-25,20:07,6,6,12
27,2025-05-25T04:48:00+02:00,2025-05-25,12:48,14,1,15
27,2025-05-25T04:54:00+02:00,2025-05-25,12:54,3,5,8
8,2025-05-25T11:55:00+02:00,2025-05-25,19:55,0,1,1
8,2025-05-25T12:02:00+02:00,2025-05-25,20:02,1,0,1
30,2025-05-25T04:45:00+02:00,2025-05-25,12:45,5,3,8
21,2025-05-25T11:55:00+02:00,2025-05-25,19:55,18,20,38
21,2025-05-25T12:00:00+02:00,2025-05-25,20:00,26,31,57
28,2025-05-25T11:55:00+02:00,2025-05-25,19:55,2,3,5
28,2025-05-25T11:57:00+02:00,2025-05-25,19:57,3,0,3
28,2025-05-25T11:59:00+02:00,2025-05-25,19:59,1,0,1
28,2025-05-25T12:02:00+02:00,2025-05-25,20:02,1,0,1
28,2025-05-25T12:04:00+02:00,2025-05-25,20:04,3,2,5
28,2025-05-25T12:07:00+02:00,2025-05-25,20:07,0,6,6
35,2025-05-25T04:40:00+02:00,2025-05-25,12:40,24,35,59
35,2025-05-25T04:45:00+02:00,2025-05-25,12:45,18,21,39
35,2025-05-25T04:46:00+02:00,2025-05-25,12:46,26,30,56
29,2025-05-25T12:03:00+02:00,2025-05-25,20:03,1,11,12
46,2025-05-25T04:40:00+02:00,2025-05-25,12:40,5,4,9
48,2025-05-25T04:41:00+02:00,2025-05-25,12:41,8,13,21
48,2025-05-25T04:42:00+02:00,2025-05-25,12:42,9,7,16
31,2025-05-25T11:57:00+02:00,2025-05-25,19:57,2,0,2
48,2025-05-25T04:46:00+02:00,2025-05-25,12:46,7,5,12
31,2025-05-25T11:58:00+02:00,2025-05-25,19:58,1,2,3
48,2025-05-25T04:49:00+02:00,2025-05-25,12:49,11,15,26
31,2025-05-25T11:59:00+02:00,2025-05-25,19:59,2,2,4
48,2025-05-25T04:50:00+02:00,2025-05-25,12:50,20,2,22
31,2025-05-25T12:01:00+02:00,2025-05-25,20:01,8,5,13
48,2025-05-25T04:51:00+02:00,2025-05-25,12:51,3,4,7
31,2025-05-25T12:05:00+02:00,2025-05-25,20:05,8,6,14
48,2025-05-25T04:54:00+02:00,2025-05-25,12:54,9,4,13
31,2025-05-25T12:06:00+02:00,2025-05-25,20:06,0,2,2
31,2025-05-25T12:07:00+02:00,2025-05-25,20:07,3,1,4
49,2025-05-25T04:41:00+02:00,2025-05-25,12:41,8,18,26
49,2025-05-25T04:42:00+02:00,2025-05-25,12:42,7,14,21
49,2025-05-25T04:44:00+02:00,2025-05-25,12:44,9,14,23
49,2025-05-25T04:53:00+02:00,2025-05-25,12:53,11,13,24
36,2025-05-25T11:57:00+02:00,2025-05-25,19:57,0,1,1
36,2025-05-25T12:02:00+02:00,2025-05-25,20:02,4,1,5
36,2025-05-25T12:04:00+02:00,2025-05-25,20:04,0,3,3
36,2025-05-25T12:07:00+02:00,2025-05-25,20:07,3,3,6
39,2025-05-25T12:04:00+02:00,2025-05-25,20:04,0,1,1
51,2025-05-25T04:41:00+02:00,2025-05-25,12:41,0,1,1
51,2025-05-25T04:44:00+02:00,2025-05-25,12:44,0,3,3
51,2025-05-25T04:45:00+02:00,2025-05-25,12:45,1,2,3
40,2025-05-25T11:55:00+02:00,2025-05-25,19:55,2,0,2
51,2025-05-25T04:46:00+02:00,2025-05-25,12:46,5,6,11
51,2025-05-25T04:48:00+02:00,2025-05-25,12:48,2,3,5
51,2025-05-25T04:50:00+02:00,2025-05-25,12:50,3,4,7
52,2025-05-25T04:40:00+02:00,2025-05-25,12:40,7,1,8
41,2025-05-25T11:58:00+02:00,2025-05-25,19:58,0,1,1
52,2025-05-25T04:43:00+02:00,2025-05-25,12:43,4,0,4
41,2025-05-25T12:02:00+02:00,2025-05-25,20:02,5,2,7
52,2025-05-25T04:47:00+02:00,2025-05-25,12:47,6,10,16
41,2025-05-25T12:03:00+02:00,2025-05-25,20:03,0,5,5
41,2025-05-25T12:07:00+02:00,2025-05-25,20:07,2,0,2
41,2025-05-25T12:08:00+02:00,2025-05-25,20:08,6,3,9
43,2025-05-25T12:00:00+02:00,2025-05-25,20:00,3,5,8
53,2025-05-25T04:44:00+02:00,2025-05-25,12:44,19,8,27
43,2025-05-25T12:05:00+02:00,2025-05-25,20:05,2,7,9
53,2025-05-25T04:46:00+02:00,2025-05-25,12:46,8,10,18
53,2025-05-25T04:47:00+02:00,2025-05-25,12:47,4,20,24
53,2025-05-25T04:50:00+02:00,2025-05-25,12:50,3,12,15
44,2025-05-25T12:00:00+02:00,2025-05-25,20:00,2,5,7
45,2025-05-25T11:55:00+02:00,2025-05-25,19:55,9,7,16
45,2025-05-25T11:56:00+02:00,2025-05-25,19:56,14,17,31
45,2025-05-25T11:57:00+02:00,2025-05-25,19:57,5,9,14
45,2025-05-25T12:00:00+02:00,2025-05-25,20:00,4,13,17
45,2025-05-25T12:01:00+02:00,2025-05-25,20:01,2,5,7
45,2025-05-25T12:03:00+02:00,2025-05-25,20:03,7,11,18
45,2025-05-25T12:05:00+02:00,2025-05-25,20:05,9,3,12
56,2025-05-25T04:40:00+02:00,2025-05-25,12:40,13,6,19
56,2025-05-25T04:47:00+02:00,2025-05-25,12:47,12,7,19
56,2025-05-25T04:50:00+02:00,2025-05-25,12:50,4,2,6
47,2025-05-25T11:57:00+02:00,2025-05-25,19:57,5,14,19
58,2025-05-25T04:41:00+02:00,2025-05-25,12:41,5,7,12
47,2025-05-25T12:01:00+02:00,2025-05-25,20:01,4,7,11
58,2025-05-25T04:47:00+02:00,2025-05-25,12:47,25,4,29
47,2025-05-25T12:02:00+02:00,2025-05-25,20:02,7,5,12
58,2025-05-25T04:48:00+02:00,2025-05-25,12:48,4,11,15
47,2025-05-25T12:03:00+02:00,2025-05-25,20:03,6,11,17
58,2025-05-25T04:51:00+02:00,2025-05-25,12:51,17,6,23
47,2025-05-25T12:05:00+02:00,2025-05-25,20:05,4,16,20
58,2025-05-25T04:52:00+02:00,2025-05-25,12:52,11,10,21
47,2025-05-25T12:08:00+02:00,2025-05-25,20:08,5,2,7
62,2025-05-25T04:41:00+02:00,2025-05-25,12:41,5,3,8
62,2025-05-25T04:42:00+02:00,2025-05-25,12:42,3,1,4
62,2025-05-25T04:45:00+02:00,2025-05-25,12:45,4,0,4
62,2025-05-25T04:48:00+02:00,2025-05-25,12:48,6,2,8
50,2025-05-25T11:55:00+02:00,2025-05-25,19:55,4,2,6
62,2025-05-25T04:49:00+02:00,2025-05-25,12:49,5,2,7
50,2025-05-25T11:59:00+02:00,2025-05-25,19:59,1,0,1
62,2025-05-25T04:54:00+02:00,2025-05-25,12:54,3,0,3
50,2025-05-25T12:01:00+02:00,2025-05-25,20:01,0,7,7
50,2025-05-25T12:02:00+02:00,2025-05-25,20:02,3,1,4
50,2025-05-25T12:08:00+02:00,2025-05-25,20:08,3,4,7
63,2025-05-25T04:40:00+02:00,2025-05-25,12:40,5,4,9
63,2025-05-25T04:46:00+02:00,2025-05-25,12:46,5,4,9
63,2025-05-25T04:49:00+02:00,2025-05-25,12:49,2,1,3
54,2025-05-25T11:55:00+02:00,2025-05-25,19:55,2,1,3
63,2025-05-25T04:50:00+02:00,2025-05-25,12:50,13,4,17
54,2025-05-25T11:56:00+02:00,2025-05-25,19:56,2,1,3
63,2025-05-25T04:51:00+02:00,2025-05-25,12:51,5,4,9
54,2025-05-25T11:57:00+02:00,2025-05-25,19:57,6,6,12
63,2025-05-25T04:52:00+02:00,2025-05-25,12:52,8,5,13
54,2025-05-25T11:58:00+02:00,2025-05-25,19:58,1,1,2
63,2025-05-25T04:54:00+02:00,2025-05-25,12:54,10,12,22
54,2025-05-25T12:02:00+02:00,2025-05-25,20:02,1,2,3
54,2025-05-25T12:03:00+02:00,2025-05-25,20:03,3,4,7
59,2025-05-25T11:55:00+02:00,2025-05-25,19:55,9,12,21
59,2025-05-25T12:00:00+02:00,2025-05-25,20:00,8,17,25
59,2025-05-25T12:05:00+02:00,2025-05-25,20:05,11,13,24
61,2025-05-25T11:56:00+02:00,2025-05-25,19:56,4,2,6
61,2025-05-25T11:57:00+02:00,2025-05-25,19:57,2,2,4
61,2025-05-25T11:59:00+02:00,2025-05-25,19:59,2,1,3
61,2025-05-25T12:04:00+02:00,2025-05-25,20:04,8,3,11
61,2025-05-25T12:06:00+02:00,2025-05-25,20:06,4,1,5
61,2025-05-25T12:07:00+02:00,2025-05-25,20:07,6,3,9
61,2025-05-25T12:08:00+02:00,2025-05-25,20:08,1,0,1
61,2025-05-25T12:09:00+02:00,2025-05-25,20:09,2,1,3
67,2025-05-25T04:41:00+02:00,2025-05-25,12:41,5,8,13
67,2025-05-25T04:42:00+02:00,2025-05-25,12:42,10,11,21
67,2025-05-25T04:43:00+02:00,2025-05-25,12:43,6,4,10
67,2025-05-25T04:47:00+02:00,2025-05-25,12:47,9,4,13
67,2025-05-25T04:50:00+02:00,2025-05-25,12:50,7,12,19
67,2025-05-25T04:51:00+02:00,2025-05-25,12:51,9,8,17
67,2025-05-25T04:53:00+02:00,2025-05-25,12:53,3,6,9
66,2025-05-25T12:03:00+02:00,2025-05-25,20:03,9,5,14
66,2025-05-25T12:05:00+02:00,2025-05-25,20:05,6,20,26
66,2025-05-25T12:09:00+02:00,2025-05-25,20:09,15,6,21
69,2025-05-25T11:55:00+02:00,2025-05-25,19:55,0,1,1
69,2025-05-25T12:01:00+02:00,2025-05-25,20:01,1,0,1
69,2025-05-25T12:02:00+02:00,2025-05-25,20:02,0,1,1
68,2025-05-25T04:40:00+02:00,2025-05-25,12:40,13,4,17
69,2025-05-25T12:05:00+02:00,2025-05-25,20:05,0,1,1
68,2025-05-25T04:42:00+02:00,2025-05-25,12:42,4,4,8
69,2025-05-25T12:09:00+02:00,2025-05-25,20:09,0,1,1
68,2025-05-25T04:43:00+02:00,2025-05-25,12:43,10,3,13
68,2025-05-25T04:46:00+02:00,2025-05-25,12:46,7,5,12
68,2025-05-25T04:47:00+02:00,2025-05-25,12:47,3,4,7
68,2025-05-25T04:49:00+02:00,2025-05-25,12:49,8,2,10
68,2025-05-25T04:53:00+02:00,2025-05-25,12:53,6,1,7
70,2025-05-25T11:57:00+02:00,2025-05-25,19:57,1,4,5
70,2025-05-25T11:59:00+02:00,2025-05-25,19:59,3,2,5
72,2025-05-25T04:40:00+02:00,2025-05-25,12:40,6,10,16
72,2025-05-25T04:46:00+02:00,2025-05-25,12:46,6,15,21
72,2025-05-25T04:47:00+02:00,2025-05-25,12:47,6,7,13
72,2025-05-25T04:50:00+02:00,2025-05-25,12:50,5,16,21
84,2025-05-25T12:00:00+02:00,2025-05-25,20:00,59,61,120
87,2025-05-25T11:57:00+02:00,2025-05-25,19:57,1,3,4
87,2025-05-25T11:58:00+02:00,2025-05-25,19:58,1,1,2
87,2025-05-25T12:00:00+02:00,2025-05-25,20:00,0,1,1
87,2025-05-25T12:07:00+02:00,2025-05-25,20:07,0,1,1
107,2025-05-25T12:05:00+02:00,2025-05-25,20:05,5,8,13
108,2025-05-25T12:00:00+02:00,2025-05-25,20:00,1,1,2
108,2025-05-25T12:01:00+02:00,2025-05-25,20:01,1,1,2
108,2025-05-25T12:08:00+02:00,2025-05-25,20:08,2,1,3
108,2025-05-25T12:09:00+02:00,2025-05-25,20:09,0,3,3
76,2025-05-25T04:42:00+02:00,2025-05-25,12:42,2,1,3
76,2025-05-25T04:44:00+02:00,2025-05-25,12:44,1,0,1
76,2025-05-25T04:49:00+02:00,2025-05-25,12:49,0,5,5
76,2025-05-25T04:50:00+02:00,2025-05-25,12:50,0,2,2
76,2025-05-25T04:51:00+02:00,2025-05-25,12:51,4,0,4
76,2025-05-25T04:53:00+02:00,2025-05-25,12:53,2,1,3
76,2025-05-25T04:54:00+02:00,2025-05-25,12:54,1,0,1
131,2025-05-25T11:55:00+02:00,2025-05-25,19:55,7,1,8
131,2025-05-25T12:05:00+02:00,2025-05-25,20:05,9,2,11
132,2025-05-25T11:55:00+02:00,2025-05-25,19:55,9,3,12
132,2025-05-25T12:00:00+02:00,2025-05-25,20:00,9,7,16
79,2025-05-25T04:41:00+02:00,2025-05-25,12:41,16,10,26
133,2025-05-25T12:05:00+02:00,2025-05-25,20:05,24,21,45
79,2025-05-25T04:49:00+02:00,2025-05-25,12:49,8,5,13
79,2025-05-25T04:51:00+02:00,2025-05-25,12:51,3,14,17
134,2025-05-25T12:05:00+02:00,2025-05-25,20:05,15,11,26
162,2025-05-25T12:00:00+02:00,2025-05-25,20:00,25,7,32
166,2025-05-25T11:55:00+02:00,2025-05-25,19:55,0,2,2
85,2025-05-25T04:43:00+02:00,2025-05-25,12:43,2,0,2
166,2025-05-25T12:00:00+02:00,2025-05-25,20:00,2,2,4
85,2025-05-25T04:50:00+02:00,2025-05-25,12:50,2,1,3
166,2025-05-25T12:05:00+02:00,2025-05-25,20:05,0,1,1
85,2025-05-25T04:51:00+02:00,2025-05-25,12:51,2,1,3
85,2025-05-25T04:54:00+02:00,2025-05-25,12:54,0,1,1
167,2025-05-25T11:55:00+02:00,2025-05-25,19:55,0,5,5
179,2025-05-25T11:55:00+02:00,2025-05-25,19:55,1,2,3
179,2025-05-25T12:00:00+02:00,2025-05-25,20:00,9,4,13
86,2025-05-25T04:42:00+02:00,2025-05-25,12:42,1,0,1
86,2025-05-25T04:48:00+02:00,2025-05-25,12:48,1,2,3
1,2025-05-25T11:56:00+02:00,2025-05-25,19:56,2,8,10
86,2025-05-25T04:53:00+02:00,2025-05-25,12:53,1,1,2
1,2025-05-25T11:59:00+02:00,2025-05-25,19:59,1,4,5
1,2025-05-25T12:01:00+02:00,2025-05-25,20:01,11,3,14
1,2025-05-25T12:03:00+02:00,2025-05-25,20:03,20,3,23
123,2025-05-25T04:40:00+02:00,2025-05-25,12:40,4,5,9
2,2025-05-25T11:59:00+02:00,2025-05-25,19:59,5,0,5
2,2025-05-25T12:08:00+02:00,2025-05-25,20:08,0,2,2
130,2025-05-25T04:45:00+02:00,2025-05-25,12:45,1,2,3
136,2025-05-25T04:40:00+02:00,2025-05-25,12:40,34,4,38
9,2025-05-25T11:59:00+02:00,2025-05-25,19:59,0,1,1
9,2025-05-25T12:00:00+02:00,2025-05-25,20:00,1,1,2
9,2025-05-25T12:06:00+02:00,2025-05-25,20:06,1,0,1
139,2025-05-25T04:40:00+02:00,2025-05-25,12:40,18,5,23
139,2025-05-25T04:45:00+02:00,2025-05-25,12:45,4,0,4
139,2025-05-25T04:50:00+02:00,2025-05-25,12:50,2,2,4
10,2025-05-25T11:59:00+02:00,2025-05-25,19:59,3,5,8
10,2025-05-25T12:02:00+02:00,2025-05-25,20:02,2,0,2
10,2025-05-25T12:06:00+02:00,2025-05-25,20:06,2,0,2
164,2025-05-25T04:40:00+02:00,2025-05-25,12:40,5,5,10
11,2025-05-25T12:00:00+02:00,2025-05-25,20:00,4,5,9
11,2025-05-25T12:05:00+02:00,2025-05-25,20:05,3,1,4
12,2025-05-25T12:06:00+02:00,2025-05-25,20:06,1,0,1
12,2025-05-25T12:09:00+02:00,2025-05-25,20:09,1,4,5
181,2025-05-25T04:45:00+02:00,2025-05-25,12:45,14,15,29
181,2025-05-25T04:47:00+02:00,2025-05-25,12:47,16,23,39
17,2025-05-25T11:58:00+02:00,2025-05-25,19:58,1,2,3
17,2025-05-25T12:00:00+02:00,2025-05-25,20:00,0,2,2
17,2025-05-25T12:02:00+02:00,2025-05-25,20:02,0,2,2
182,2025-05-25T04:40:00+02:00,2025-05-25,12:40,11,19,30
182,2025-05-25T04:50:00+02:00,2025-05-25,12:50,32,11,43
18,2025-05-25T11:56:00+02:00,2025-05-25,19:56,2,1,3
180,2025-05-25T04:52:00+02:00,2025-05-25,12:52,3,0,3
3,2025-05-25T04:40:00+02:00,2025-05-25,12:40,22,22,44
3,2025-05-25T04:45:00+02:00,2025-05-25,12:45,12,55,67
19,2025-05-25T11:58:00+02:00,2025-05-25,19:58,4,7,11
3,2025-05-25T04:46:00+02:00,2025-05-25,12:46,15,16,31
19,2025-05-25T12:00:00+02:00,2025-05-25,20:00,1,12,13
3,2025-05-25T04:48:00+02:00,2025-05-25,12:48,14,34,48
19,2025-05-25T12:02:00+02:00,2025-05-25,20:02,6,4,10
3,2025-05-25T04:52:00+02:00,2025-05-25,12:52,20,38,58
19,2025-05-25T12:08:00+02:00,2025-05-25,20:08,10,14,24
19,2025-05-25T12:09:00+02:00,2025-05-25,20:09,7,14,21
20,2025-05-25T11:59:00+02:00,2025-05-25,19:59,3,6,9
20,2025-05-25T12:02:00+02:00,2025-05-25,20:02,8,6,14
20,2025-05-25T12:04:00+02:00,2025-05-25,20:04,5,2,7
4,2025-05-25T04:40:00+02:00,2025-05-25,12:40,37,17,54
4,2025-05-25T04:41:00+02:00,2025-05-25,12:41,23,29,52
4,2025-05-25T04:44:00+02:00,2025-05-25,12:44,42,14,56
4,2025-05-25T04:45:00+02:00,2025-05-25,12:45,63,25,88
4,2025-05-25T04:50:00+02:00,2025-05-25,12:50,24,22,46
4,2025-05-25T04:51:00+02:00,2025-05-25,12:51,39,30,69
4,2025-05-25T04:54:00+02:00,2025-05-25,12:54,56,28,84
23,2025-05-25T11:56:00+02:00,2025-05-25,19:56,2,0,2
23,2025-05-25T11:57:00+02:00,2025-05-25,19:57,2,10,12
23,2025-05-25T11:58:00+02:00,2025-05-25,19:58,0,5,5
5,2025-05-25T04:40:00+02:00,2025-05-25,12:40,61,71,132
6,2025-05-25T04:42:00+02:00,2025-05-25,12:42,16,20,36
6,2025-05-25T04:46:00+02:00,2025-05-25,12:46,12,6,18
6,2025-05-25T04:49:00+02:00,2025-05-25,12:49,9,11,20
24,2025-05-25T11:55:00+02:00,2025-05-25,19:55,2,6,8
6,2025-05-25T04:54:00+02:00,2025-05-25,12:54,23,12,35
24,2025-05-25T11:56:00+02:00,2025-05-25,19:56,4,17,21
24,2025-05-25T12:01:00+02:00,2025-05-25,20:01,2,3,5
24,2025-05-25T12:05:00+02:00,2025-05-25,20:05,5,10,15
24,2025-05-25T12:08:00+02:00,2025-05-25,20:08,7,2,9
8,2025-05-25T04:42:00+02:00,2025-05-25,12:42,4,7,11
8,2025-05-25T04:47:00+02:00,2025-05-25,12:47,1,2,3
8,2025-05-25T04:48:00+02:00,2025-05-25,12:48,3,2,5
8,2025-05-25T04:49:00+02:00,2025-05-25,12:49,0,3,3
8,2025-05-25T04:50:00+02:00,2025-05-25,12:50,1,0,1
8,2025-05-25T04:51:00+02:00,2025-05-25,12:51,2,1,3
8,2025-05-25T04:52:00+02:00,2025-05-25,12:52,1,4,5
8,2025-05-25T04:53:00+02:00,2025-05-25,12:53,3,9,12
8,2025-05-25T04:54:00+02:00,2025-05-25,12:54,0,16,16
25,2025-05-25T11:55:00+02:00,2025-05-25,19:55,19,3,22
27,2025-05-25T11:58:00+02:00,2025-05-25,19:58,5,0,5
27,2025-05-25T11:59:00+02:00,2025-05-25,19:59,1,0,1
27,2025-05-25T12:01:00+02:00,2025-05-25,20:01,0,4,4
27,2025-05-25T12:02:00+02:00,2025-05-25,20:02,3,3,6
27,2025-05-25T12:09:00+02:00,2025-05-25,20:09,0,1,1
28,2025-05-25T04:43:00+02:00,2025-05-25,12:43,17,14,31
28,2025-05-25T04:45:00+02:00,2025-05-25,12:45,5,18,23
28,2025-05-25T04:49:00+02:00,2025-05-25,12:49,3,20,23
30,2025-05-25T11:56:00+02:00,2025-05-25,19:56,4,9,13
28,2025-05-25T04:51:00+02:00,2025-05-25,12:51,11,6,17
30,2025-05-25T11:58:00+02:00,2025-05-25,19:58,4,13,17
28,2025-05-25T04:53:00+02:00,2025-05-25,12:53,14,8,22
30,2025-05-25T11:59:00+02:00,2025-05-25,19:59,12,2,14
28,2025-05-25T04:54:00+02:00,2025-05-25,12:54,17,4,21
30,2025-05-25T12:00:00+02:00,2025-05-25,20:00,5,4,9
30,2025-05-25T12:02:00+02:00,2025-05-25,20:02,6,6,12
30,2025-05-25T12:04:00+02:00,2025-05-25,20:04,2,12,14
30,2025-05-25T12:05:00+02:00,2025-05-25,20:05,10,3,13
30,2025-05-25T12:06:00+02:00,2025-05-25,20:06,8,3,11
30,2025-05-25T12:07:00+02:00,2025-05-25,20:07,2,11,13
30,2025-05-25T12:09:00+02:00,2025-05-25,20:09,3,3,6
29,2025-05-25T04:43:00+02:00,2025-05-25,12:43,3,6,9
29,2025-05-25T04:47:00+02:00,2025-05-25,12:47,8,15,23
29,2025-05-25T04:48:00+02:00,2025-05-25,12:48,7,9,16
29,2025-05-25T04:54:00+02:00,2025-05-25,12:54,5,17,22
35,2025-05-25T11:59:00+02:00,2025-05-25,19:59,7,8,15
35,2025-05-25T12:01:00+02:00,2025-05-25,20:01,2,6,8
35,2025-05-25T12:04:00+02:00,2025-05-25,20:04,12,7,19
35,2025-05-25T12:05:00+02:00,2025-05-25,20:05,5,5,10
35,2025-05-25T12:09:00+02:00,2025-05-25,20:09,6,7,13
31,2025-05-25T04:41:00+02:00,2025-05-25,12:41,6,1,7
31,2025-05-25T04:43:00+02:00,2025-05-25,12:43,3,2,5
31,2025-05-25T04:47:00+02:00,2025-05-25,12:47,2,12,14
31,2025-05-25T04:54:00+02:00,2025-05-25,12:54,8,4,12
48,2025-05-25T12:03:00+02:00,2025-05-25,20:03,3,0,3
48,2025-05-25T12:06:00+02:00,2025-05-25,20:06,2,4,6
36,2025-05-25T04:40:00+02:00,2025-05-25,12:40,1,0,1
36,2025-05-25T04:43:00+02:00,2025-05-25,12:43,2,0,2
36,2025-05-25T04:46:00+02:00,2025-05-25,12:46,2,0,2
36,2025-05-25T04:49:00+02:00,2025-05-25,12:49,5,0,5
36,2025-05-25T04:51:00+02:00,2025-05-25,12:51,1,2,3
36,2025-05-25T04:53:00+02:00,2025-05-25,12:53,1,0,1
49,2025-05-25T11:58:00+02:00,2025-05-25,19:58,0,4,4
49,2025-05-25T12:00:00+02:00,2025-05-25,20:00,1,6,7
49,2025-05-25T12:01:00+02:00,2025-05-25,20:01,6,4,10
49,2025-05-25T12:07:00+02:00,2025-05-25,20:07,1,0,1
51,2025-05-25T11:58:00+02:00,2025-05-25,19:58,0,5,5
51,2025-05-25T12:01:00+02:00,2025-05-25,20:01,0,1,1
51,2025-05-25T12:03:00+02:00,2025-05-25,20:03,0,2,2
51,2025-05-25T12:07:00+02:00,2025-05-25,20:07,1,0,1
39,2025-05-25T04:43:00+02:00,2025-05-25,12:43,2,1,3
39,2025-05-25T04:49:00+02:00,2025-05-25,12:49,1,0,1
39,2025-05-25T04:52:00+02:00,2025-05-25,12:52,1,0,1
39,2025-05-25T04:54:00+02:00,2025-05-25,12:54,1,0,1
52,2025-05-25T11:55:00+02:00,2025-05-25,19:55,7,11,18
52,2025-05-25T11:56:00+02:00,2025-05-25,19:56,5,4,9
52,2025-05-25T11:58:00+02:00,2025-05-25,19:58,0,5,5
52,2025-05-25T12:00:00+02:00,2025-05-25,20:00,3,1,4
52,2025-05-25T12:01:00+02:00,2025-05-25,20:01,6,0,6
52,2025-05-25T12:05:00+02:00,2025-05-25,20:05,2,2,4
52,2025-05-25T12:08:00+02:00,2025-05-25,20:08,3,2,5
52,2025-05-25T12:09:00+02:00,2025-05-25,20:09,3,1,4
40,2025-05-25T04:42:00+02:00,2025-05-25,12:42,1,9,10
40,2025-05-25T04:43:00+02:00,2025-05-25,12:43,8,5,13
40,2025-05-25T04:45:00+02:00,2025-05-25,12:45,1,2,3
40,2025-05-25T04:51:00+02:00,2025-05-25,12:51,5,5,10
40,2025-05-25T04:52:00+02:00,2025-05-25,12:52,3,10,13
53,2025-05-25T12:09:00+02:00,2025-05-25,20:09,2,5,7
41,2025-05-25T04:40:00+02:00,2025-05-25,12:40,20,1,21
41,2025-05-25T04:41:00+02:00,2025-05-25,12:41,9,3,12
41,2025-05-25T04:44:00+02:00,2025-05-25,12:44,4,4,8
41,2025-05-25T04:47:00+02:00,2025-05-25,12:47,4,9,13
41,2025-05-25T04:49:00+02:00,2025-05-25,12:49,4,0,4
41,2025-05-25T04:54:00+02:00,2025-05-25,12:54,5,7,12
56,2025-05-25T11:55:00+02:00,2025-05-25,19:55,2,2,4
56,2025-05-25T11:59:00+02:00,2025-05-25,19:59,2,4,6
56,2025-05-25T12:09:00+02:00,2025-05-25,20:09,6,5,11
43,2025-05-25T04:45:00+02:00,2025-05-25,12:45,10,8,18
43,2025-05-25T04:50:00+02:00,2025-05-25,12:50,10,15,25
44,2025-05-25T04:40:00+02:00,2025-05-25,12:40,3,4,7
44,2025-05-25T04:50:00+02:00,2025-05-25,12:50,6,4,10
58,2025-05-25T12:00:00+02:00,2025-05-25,20:00,10,1,11
58,2025-05-25T12:02:00+02:00,2025-05-25,20:02,10,13,23
58,2025-05-25T12:03:00+02:00,2025-05-25,20:03,4,5,9
45,2025-05-25T04:47:00+02:00,2025-05-25,12:47,30,25,55
58,2025-05-25T12:09:00+02:00,2025-05-25,20:09,1,3,4
45,2025-05-25T04:49:00+02:00,2025-05-25,12:49,14,19,33
45,2025-05-25T04:50:00+02:00,2025-05-25,12:50,24,22,46
62,2025-05-25T11:55:00+02:00,2025-05-25,19:55,1,0,1
62,2025-05-25T11:57:00+02:00,2025-05-25,19:57,3,3,6
62,2025-05-25T12:01:00+02:00,2025-05-25,20:01,1,0,1
62,2025-05-25T12:03:00+02:00,2025-05-25,20:03,3,11,14
62,2025-05-25T12:04:00+02:00,2025-05-25,20:04,3,5,8
62,2025-05-25T12:05:00+02:00,2025-05-25,20:05,4,1,5
62,2025-05-25T12:06:00+02:00,2025-05-25,20:06,4,0,4
47,2025-05-25T04:41:00+02:00,2025-05-25,12:41,12,18,30
47,2025-05-25T04:42:00+02:00,2025-05-25,12:42,22,8,30
47,2025-05-25T04:43:00+02:00,2025-05-25,12:43,14,22,36
47,2025-05-25T04:48:00+02:00,2025-05-25,12:48,29,15,44
47,2025-05-25T04:49:00+02:00,2025-05-25,12:49,14,37,51
47,2025-05-25T04:51:00+02:00,2025-05-25,12:51,18,18,36
47,2025-05-25T04:53:00+02:00,2025-05-25,12:53,15,7,22
63,2025-05-25T11:55:00+02:00,2025-05-25,19:55,0,5,5
63,2025-05-25T11:56:00+02:00,2025-05-25,19:56,0,4,4
63,2025-05-25T11:59:00+02:00,2025-05-25,19:59,1,1,2
63,2025-05-25T12:01:00+02:00,2025-05-25,20:01,1,0,1
63,2025-05-25T12:03:00+02:00,2025-05-25,20:03,0,3,3
63,2025-05-25T12:06:00+02:00,2025-05-25,20:06,0,2,2
63,2025-05-25T12:07:00+02:00,2025-05-25,20:07,0,3,3
50,2025-05-25T04:41:00+02:00,2025-05-25,12:41,4,11,15
50,2025-05-25T04:44:00+02:00,2025-05-25,12:44,5,8,13
50,2025-05-25T04:50:00+02:00,2025-05-25,12:50,2,1,3
50,2025-05-25T04:52:00+02:00,2025-05-25,12:52,2,1,3
67,2025-05-25T11:57:00+02:00,2025-05-25,19:57,2,8,10
67,2025-05-25T11:58:00+02:00,2025-05-25,19:58,0,4,4
67,2025-05-25T11:59:00+02:00,2025-05-25,19:59,0,4,4
67,2025-05-25T12:01:00+02:00,2025-05-25,20:01,2,4,6
67,2025-05-25T12:03:00+02:00,2025-05-25,20:03,1,4,5
67,2025-05-25T12:09:00+02:00,2025-05-25,20:09,1,6,7
54,2025-05-25T04:42:00+02:00,2025-05-25,12:42,2,0,2
54,2025-05-25T04:43:00+02:00,2025-05-25,12:43,3,0,3
54,2025-05-25T04:44:00+02:00,2025-05-25,12:44,8,3,11
54,2025-05-25T04:45:00+02:00,2025-05-25,12:45,1,0,1
54,2025-05-25T04:46:00+02:00,2025-05-25,12:46,1,7,8
54,2025-05-25T04:49:00+02:00,2025-05-25,12:49,3,6,9
54,2025-05-25T04:50:00+02:00,2025-05-25,12:50,1,3,4
54,2025-05-25T04:51:00+02:00,2025-05-25,12:51,2,3,5
54,2025-05-25T04:52:00+02:00,2025-05-25,12:52,0,3,3
68,2025-05-25T12:00:00+02:00,2025-05-25,20:00,0,1,1
68,2025-05-25T12:06:00+02:00,2025-05-25,20:06,1,0,1
68,2025-05-25T12:08:00+02:00,2025-05-25,20:08,0,1,1
72,2025-05-25T11:56:00+02:00,2025-05-25,19:56,3,4,7
72,2025-05-25T11:57:00+02:00,2025-05-25,19:57,5,9,14
59,2025-05-25T04:45:00+02:00,2025-05-25,12:45,33,25,58
72,2025-05-25T12:00:00+02:00,2025-05-25,20:00,5,9,14
59,2025-05-25T04:50:00+02:00,2025-05-25,12:50,50,25,75
72,2025-05-25T12:01:00+02:00,2025-05-25,20:01,2,0,2
72,2025-05-25T12:09:00+02:00,2025-05-25,20:09,0,2,2
61,2025-05-25T04:41:00+02:00,2025-05-25,12:41,6,3,9
61,2025-05-25T04:43:00+02:00,2025-05-25,12:43,13,12,25
61,2025-05-25T04:46:00+02:00,2025-05-25,12:46,5,10,15
61,2025-05-25T04:51:00+02:00,2025-05-25,12:51,9,9,18
66,2025-05-25T04:44:00+02:00,2025-05-25,12:44,13,20,33
79,2025-05-25T11:55:00+02:00,2025-05-25,19:55,5,2,7
66,2025-05-25T04:50:00+02:00,2025-05-25,12:50,15,23,38
79,2025-05-25T11:59:00+02:00,2025-05-25,19:59,4,2,6
66,2025-05-25T04:51:00+02:00,2025-05-25,12:51,7,22,29
79,2025-05-25T12:02:00+02:00,2025-05-25,20:02,1,6,7
66,2025-05-25T04:52:00+02:00,2025-05-25,12:52,13,23,36
66,2025-05-25T04:53:00+02:00,2025-05-25,12:53,11,32,43
66,2025-05-25T04:54:00+02:00,2025-05-25,12:54,30,27,57
85,2025-05-25T11:56:00+02:00,2025-05-25,19:56,0,2,2
86,2025-05-25T11:58:00+02:00,2025-05-25,19:58,1,0,1
86,2025-05-25T12:03:00+02:00,2025-05-25,20:03,0,5,5
86,2025-05-25T12:06:00+02:00,2025-05-25,20:06,0,1,1
69,2025-05-25T04:40:00+02:00,2025-05-25,12:40,6,2,8
86,2025-05-25T12:08:00+02:00,2025-05-25,20:08,0,3,3
69,2025-05-25T04:50:00+02:00,2025-05-25,12:50,3,8,11
86,2025-05-25T12:09:00+02:00,2025-05-25,20:09,1,5,6
69,2025-05-25T04:51:00+02:00,2025-05-25,12:51,6,5,11
69,2025-05-25T04:52:00+02:00,2025-05-25,12:52,2,4,6
69,2025-05-25T04:54:00+02:00,2025-05-25,12:54,8,4,12
109,2025-05-25T11:55:00+02:00,2025-05-25,19:55,2,16,18
117,2025-05-25T12:05:00+02:00,2025-05-25,20:05,6,5,11
130,2025-05-25T11:55:00+02:00,2025-05-25,19:55,0,1,1
70,2025-05-25T04:43:00+02:00,2025-05-25,12:43,0,1,1
70,2025-05-25T04:46:00+02:00,2025-05-25,12:46,1,2,3
70,2025-05-25T04:47:00+02:00,2025-05-25,12:47,1,2,3
70,2025-05-25T04:48:00+02:00,2025-05-25,12:48,2,3,5
136,2025-05-25T12:00:00+02:00,2025-05-25,20:00,0,2,2
70,2025-05-25T04:51:00+02:00,2025-05-25,12:51,0,1,1
137,2025-05-25T12:05:00+02:00,2025-05-25,20:05,0,1,1
139,2025-05-25T12:05:00+02:00,2025-05-25,20:05,1,3,4
141,2025-05-25T12:00:00+02:00,2025-05-25,20:00,6,7,13
142,2025-05-25T12:05:00+02:00,2025-05-25,20:05,3,3,6
75,2025-05-25T04:40:00+02:00,2025-05-25,12:40,0,1,1
75,2025-05-25T04:53:00+02:00,2025-05-25,12:53,3,3,6
77,2025-05-25T04:40:00+02:00,2025-05-25,12:40,13,15,28
77,2025-05-25T04:45:00+02:00,2025-05-25,12:45,23,5,28
77,2025-05-25T04:50:00+02:00,2025-05-25,12:50,25,9,34
78,2025-05-25T04:43:00+02:00,2025-05-25,12:43,0,3,3
78,2025-05-25T04:45:00+02:00,2025-05-25,12:45,2,4,6
78,2025-05-25T04:48:00+02:00,2025-05-25,12:48,2,1,3
78,2025-05-25T04:51:00+02:00,2025-05-25,12:51,0,2,2
78,2025-05-25T04:53:00+02:00,2025-05-25,12:53,1,0,1
84,2025-05-25T04:45:00+02:00,2025-05-25,12:45,63,65,128
87,2025-05-25T04:40:00+02:00,2025-05-25,12:40,1,2,3
87,2025-05-25T04:42:00+02:00,2025-05-25,12:42,2,2,4
87,2025-05-25T04:44:00+02:00,2025-05-25,12:44,1,4,5
87,2025-05-25T04:51:00+02:00,2025-05-25,12:51,5,0,5
87,2025-05-25T04:53:00+02:00,2025-05-25,12:53,3,5,8
107,2025-05-25T04:50:00+02:00,2025-05-25,12:50,5,11,16
108,2025-05-25T04:41:00+02:00,2025-05-25,12:41,3,0,3
108,2025-05-25T04:43:00+02:00,2025-05-25,12:43,2,1,3
108,2025-05-25T04:44:00+02:00,2025-05-25,12:44,1,1,2
108,2025-05-25T04:47:00+02:00,2025-05-25,12:47,0,8,8
108,2025-05-25T04:48:00+02:00,2025-05-25,12:48,4,1,5
108,2025-05-25T04:49:00+02:00,2025-05-25,12:49,2,1,3
108,2025-05-25T04:50:00+02:00,2025-05-25,12:50,0,4,4
108,2025-05-25T04:53:00+02:00,2025-05-25,12:53,4,0,4
108,2025-05-25T04:54:00+02:00,2025-05-25,12:54,2,0,2
118,2025-05-25T04:40:00+02:00,2025-05-25,12:40,1,3,4
124,2025-05-25T04:40:00+02:00,2025-05-25,12:40,1,1,2
124,2025-05-25T04:50:00+02:00,2025-05-25,12:50,1,1,2
134,2025-05-25T04:45:00+02:00,2025-05-25,12:45,30,28,58
135,2025-05-25T04:50:00+02:00,2025-05-25,12:50,27,51,78
165,2025-05-25T04:40:00+02:00,2025-05-25,12:40,1,2,3
179,2025-05-25T04:40:00+02:00,2025-05-25,12:40,2,4,6
179,2025-05-25T04:50:00+02:00,2025-05-25,12:50,6,3,9
1,2025-05-25T04:42:00+02:00,2025-05-25,12:42,33,18,51
1,2025-05-25T04:45:00+02:00,2025-05-25,12:45,15,16,31
1,2025-05-25T04:46:00+02:00,2025-05-25,12:46,21,13,34
1,2025-05-25T04:48:00+02:00,2025-05-25,12:48,18,22,40
1,2025-05-25T04:49:00+02:00,2025-05-25,12:49,14,11,25
2,2025-05-25T04:42:00+02:00,2025-05-25,12:42,17,9,26
2,2025-05-25T04:44:00+02:00,2025-05-25,12:44,6,17,23
2,2025-05-25T04:47:00+02:00,2025-05-25,12:47,7,12,19
2,2025-05-25T04:49:00+02:00,2025-05-25,12:49,9,11,20
9,2025-05-25T04:41:00+02:00,2025-05-25,12:41,2,0,2
10,2025-05-25T04:40:00+02:00,2025-05-25,12:40,1,0,1
10,2025-05-25T04:41:00+02:00,2025-05-25,12:41,0,1,1
10,2025-05-25T04:54:00+02:00,2025-05-25,12:54,2,0,2
11,2025-05-25T04:44:00+02:00,2025-05-25,12:44,2,4,6
11,2025-05-25T04:49:00+02:00,2025-05-25,12:49,0,1,1
11,2025-05-25T04:51:00+02:00,2025-05-25,12:51,1,1,2
12,2025-05-25T04:40:00+02:00,2025-05-25,12:40,6,6,12
12,2025-05-25T04:47:00+02:00,2025-05-25,12:47,4,1,5
12,2025-05-25T04:49:00+02:00,2025-05-25,12:49,1,0,1
12,2025-05-25T04:51:00+02:00,2025-05-25,12:51,1,3,4
17,2025-05-25T04:41:00+02:00,2025-05-25,12:41,6,0,6
17,2025-05-25T04:44:00+02:00,2025-05-25,12:44,11,1,12
17,2025-05-25T04:45:00+02:00,2025-05-25,12:45,0,2,2
17,2025-05-25T04:48:00+02:00,2025-05-25,12:48,0,3,3
17,2025-05-25T04:50:00+02:00,2025-05-25,12:50,1,2,3
17,2025-05-25T04:51:00+02:00,2025-05-25,12:51,2,1,3
18,2025-05-25T04:43:00+02:00,2025-05-25,12:43,3,0,3
18,2025-05-25T04:47:00+02:00,2025-05-25,12:47,5,0,5
18,2025-05-25T04:50:00+02:00,2025-05-25,12:50,2,0,2
3,2025-05-24T17:55:00+02:00,2025-05-25,01:55,6,1,7
3,2025-05-24T17:58:00+02:00,2025-05-25,01:58,4,3,7
3,2025-05-24T17:59:00+02:00,2025-05-25,01:59,7,3,10
3,2025-05-24T18:00:00+02:00,2025-05-25,02:00,1,1,2
3,2025-05-24T18:01:00+02:00,2025-05-25,02:01,3,6,9
3,2025-05-24T18:08:00+02:00,2025-05-25,02:08,4,0,4
4,2025-05-24T17:57:00+02:00,2025-05-25,01:57,1,3,4
4,2025-05-24T18:05:00+02:00,2025-05-25,02:05,0,1,1
4,2025-05-24T18:08:00+02:00,2025-05-25,02:08,1,7,8
5,2025-05-24T17:55:00+02:00,2025-05-25,01:55,14,8,22
6,2025-05-24T17:55:00+02:00,2025-05-25,01:55,3,2,5
6,2025-05-24T18:00:00+02:00,2025-05-25,02:00,6,2,8
6,2025-05-24T18:03:00+02:00,2025-05-25,02:03,2,4,6
6,2025-05-24T18:04:00+02:00,2025-05-25,02:04,3,0,3
6,2025-05-24T18:09:00+02:00,2025-05-25,02:09,5,0,5
28,2025-05-24T17:55:00+02:00,2025-05-25,01:55,1,0,1
28,2025-05-24T18:00:00+02:00,2025-05-25,02:00,2,1,3
28,2025-05-24T18:01:00+02:00,2025-05-25,02:01,3,0,3
28,2025-05-24T18:08:00+02:00,2025-05-25,02:08,1,2,3
29,2025-05-24T18:08:00+02:00,2025-05-25,02:08,1,0,1
31,2025-05-24T17:56:00+02:00,2025-05-25,01:56,1,0,1
31,2025-05-24T17:59:00+02:00,2025-05-25,01:59,0,1,1
31,2025-05-24T18:00:00+02:00,2025-05-25,02:00,2,0,2
36,2025-05-24T17:59:00+02:00,2025-05-25,01:59,1,4,5
36,2025-05-24T18:01:00+02:00,2025-05-25,02:01,2,1,3
36,2025-05-24T18:04:00+02:00,2025-05-25,02:04,1,3,4
36,2025-05-24T18:05:00+02:00,2025-05-25,02:05,0,4,4
37,2025-05-24T18:00:00+02:00,2025-05-25,02:00,1,0,1
37,2025-05-24T18:02:00+02:00,2025-05-25,02:02,3,0,3
41,2025-05-24T17:55:00+02:00,2025-05-25,01:55,2,0,2
41,2025-05-24T17:59:00+02:00,2025-05-25,01:59,0,1,1
41,2025-05-24T18:02:00+02:00,2025-05-25,02:02,1,2,3
41,2025-05-24T18:07:00+02:00,2025-05-25,02:07,1,4,5
43,2025-05-24T17:55:00+02:00,2025-05-25,01:55,0,1,1
43,2025-05-24T18:05:00+02:00,2025-05-25,02:05,1,0,1
44,2025-05-24T17:55:00+02:00,2025-05-25,01:55,0,3,3
45,2025-05-24T17:57:00+02:00,2025-05-25,01:57,1,3,4
45,2025-05-24T17:59:00+02:00,2025-05-25,01:59,2,1,3
45,2025-05-24T18:02:00+02:00,2025-05-25,02:02,0,14,14
45,2025-05-24T18:04:00+02:00,2025-05-25,02:04,2,2,4
45,2025-05-24T18:05:00+02:00,2025-05-25,02:05,0,11,11
45,2025-05-24T18:07:00+02:00,2025-05-25,02:07,8,1,9
45,2025-05-24T18:09:00+02:00,2025-05-25,02:09,0,1,1
47,2025-05-24T17:55:00+02:00,2025-05-25,01:55,1,5,6
47,2025-05-24T17:59:00+02:00,2025-05-25,01:59,4,0,4
47,2025-05-24T18:00:00+02:00,2025-05-25,02:00,1,0,1
47,2025-05-24T18:01:00+02:00,2025-05-25,02:01,0,6,6
47,2025-05-24T18:07:00+02:00,2025-05-25,02:07,1,5,6
47,2025-05-24T18:09:00+02:00,2025-05-25,02:09,1,3,4
50,2025-05-24T18:00:00+02:00,2025-05-25,02:00,2,0,2
50,2025-05-24T18:05:00+02:00,2025-05-25,02:05,1,0,1
54,2025-05-24T18:00:00+02:00,2025-05-25,02:00,1,0,1
181,2025-05-25T11:55:00+02:00,2025-05-25,19:55,10,9,19
54,2025-05-24T18:01:00+02:00,2025-05-25,02:01,0,1,1
181,2025-05-25T11:59:00+02:00,2025-05-25,19:59,7,9,16
54,2025-05-24T18:03:00+02:00,2025-05-25,02:03,2,0,2
181,2025-05-25T12:02:00+02:00,2025-05-25,20:02,17,10,27
59,2025-05-24T18:00:00+02:00,2025-05-25,02:00,3,4,7
181,2025-05-25T12:05:00+02:00,2025-05-25,20:05,6,11,17
61,2025-05-24T17:56:00+02:00,2025-05-25,01:56,0,1,1
181,2025-05-25T12:07:00+02:00,2025-05-25,20:07,10,11,21
61,2025-05-24T18:05:00+02:00,2025-05-25,02:05,0,2,2
66,2025-05-24T17:56:00+02:00,2025-05-25,01:56,2,3,5
66,2025-05-24T17:58:00+02:00,2025-05-25,01:58,0,3,3
66,2025-05-24T18:03:00+02:00,2025-05-25,02:03,0,4,4
70,2025-05-24T17:57:00+02:00,2025-05-25,01:57,0,3,3
71,2025-05-24T18:03:00+02:00,2025-05-25,02:03,1,0,1
75,2025-05-24T18:04:00+02:00,2025-05-25,02:04,1,0,1
77,2025-05-24T18:00:00+02:00,2025-05-25,02:00,0,1,1
84,2025-05-24T18:05:00+02:00,2025-05-25,02:05,12,16,28
107,2025-05-24T18:05:00+02:00,2025-05-25,02:05,4,0,4
108,2025-05-24T17:57:00+02:00,2025-05-25,01:57,0,5,5
108,2025-05-24T18:02:00+02:00,2025-05-25,02:02,2,1,3
108,2025-05-24T18:04:00+02:00,2025-05-25,02:04,5,0,5
131,2025-05-24T17:55:00+02:00,2025-05-25,01:55,6,1,7
132,2025-05-24T18:05:00+02:00,2025-05-25,02:05,4,5,9
182,2025-05-25T11:55:00+02:00,2025-05-25,19:55,9,36,45
134,2025-05-24T18:05:00+02:00,2025-05-25,02:05,7,2,9
135,2025-05-24T18:05:00+02:00,2025-05-25,02:05,4,5,9
162,2025-05-24T18:00:00+02:00,2025-05-25,02:00,6,2,8
165,2025-05-24T18:05:00+02:00,2025-05-25,02:05,1,0,1
1,2025-05-24T17:59:00+02:00,2025-05-25,01:59,1,0,1
9,2025-05-24T17:58:00+02:00,2025-05-25,01:58,0,2,2
9,2025-05-24T18:01:00+02:00,2025-05-25,02:01,0,1,1
19,2025-05-24T17:56:00+02:00,2025-05-25,01:56,0,2,2
19,2025-05-24T18:03:00+02:00,2025-05-25,02:03,1,3,4
180,2025-05-25T11:58:00+02:00,2025-05-25,19:58,1,0,1
19,2025-05-24T18:04:00+02:00,2025-05-25,02:04,1,7,8
19,2025-05-24T18:05:00+02:00,2025-05-25,02:05,0,2,2
19,2025-05-24T18:08:00+02:00,2025-05-25,02:08,0,1,1
19,2025-05-24T18:09:00+02:00,2025-05-25,02:09,1,5,6
20,2025-05-24T18:00:00+02:00,2025-05-25,02:00,8,9,17
20,2025-05-24T18:04:00+02:00,2025-05-25,02:04,1,1,2
23,2025-05-24T17:55:00+02:00,2025-05-25,01:55,0,4,4
24,2025-05-24T18:07:00+02:00,2025-05-25,02:07,2,0,2
24,2025-05-24T18:08:00+02:00,2025-05-25,02:08,2,2,4
25,2025-05-24T17:55:00+02:00,2025-05-25,01:55,2,3,5
30,2025-05-24T17:59:00+02:00,2025-05-25,01:59,2,6,8
30,2025-05-24T18:00:00+02:00,2025-05-25,02:00,4,1,5
30,2025-05-24T18:02:00+02:00,2025-05-25,02:02,1,0,1
30,2025-05-24T18:07:00+02:00,2025-05-25,02:07,3,2,5
30,2025-05-24T18:09:00+02:00,2025-05-25,02:09,0,13,13
35,2025-05-24T18:01:00+02:00,2025-05-25,02:01,0,2,2
35,2025-05-24T18:04:00+02:00,2025-05-25,02:04,2,0,2
35,2025-05-24T18:05:00+02:00,2025-05-25,02:05,0,3,3
35,2025-05-24T18:06:00+02:00,2025-05-25,02:06,0,2,2
35,2025-05-24T18:08:00+02:00,2025-05-25,02:08,3,3,6
49,2025-05-24T17:56:00+02:00,2025-05-25,01:56,0,2,2
49,2025-05-24T17:57:00+02:00,2025-05-25,01:57,1,2,3
49,2025-05-24T17:58:00+02:00,2025-05-25,01:58,0,2,2
49,2025-05-24T18:01:00+02:00,2025-05-25,02:01,0,3,3
49,2025-05-24T18:02:00+02:00,2025-05-25,02:02,2,2,4
49,2025-05-24T18:03:00+02:00,2025-05-25,02:03,1,0,1
49,2025-05-24T18:06:00+02:00,2025-05-25,02:06,5,9,14
49,2025-05-24T18:07:00+02:00,2025-05-25,02:07,0,3,3
49,2025-05-24T18:09:00+02:00,2025-05-25,02:09,1,2,3
51,2025-05-24T17:56:00+02:00,2025-05-25,01:56,0,1,1
51,2025-05-24T17:58:00+02:00,2025-05-25,01:58,1,0,1
51,2025-05-24T18:01:00+02:00,2025-05-25,02:01,1,2,3
51,2025-05-24T18:09:00+02:00,2025-05-25,02:09,2,0,2
53,2025-05-24T18:02:00+02:00,2025-05-25,02:02,0,2,2
53,2025-05-24T18:04:00+02:00,2025-05-25,02:04,0,1,1
56,2025-05-24T17:56:00+02:00,2025-05-25,01:56,2,0,2
56,2025-05-24T18:05:00+02:00,2025-05-25,02:05,0,1,1
56,2025-05-24T18:08:00+02:00,2025-05-25,02:08,1,0,1
58,2025-05-24T17:56:00+02:00,2025-05-25,01:56,0,4,4
58,2025-05-24T17:57:00+02:00,2025-05-25,01:57,0,5,5
58,2025-05-24T17:58:00+02:00,2025-05-25,01:58,7,3,10
58,2025-05-24T18:05:00+02:00,2025-05-25,02:05,1,0,1
58,2025-05-24T18:07:00+02:00,2025-05-25,02:07,0,2,2
62,2025-05-24T18:00:00+02:00,2025-05-25,02:00,3,3,6
62,2025-05-24T18:01:00+02:00,2025-05-25,02:01,1,1,2
62,2025-05-24T18:05:00+02:00,2025-05-25,02:05,2,0,2
62,2025-05-24T18:07:00+02:00,2025-05-25,02:07,1,0,1
63,2025-05-24T17:55:00+02:00,2025-05-25,01:55,0,4,4
63,2025-05-24T18:07:00+02:00,2025-05-25,02:07,0,1,1
67,2025-05-24T17:55:00+02:00,2025-05-25,01:55,0,1,1
67,2025-05-24T18:01:00+02:00,2025-05-25,02:01,0,2,2
67,2025-05-24T18:07:00+02:00,2025-05-25,02:07,1,0,1
68,2025-05-24T18:03:00+02:00,2025-05-25,02:03,1,0,1
72,2025-05-24T18:02:00+02:00,2025-05-25,02:02,0,2,2
72,2025-05-24T18:06:00+02:00,2025-05-25,02:06,0,2,2
72,2025-05-24T18:09:00+02:00,2025-05-25,02:09,0,1,1
79,2025-05-24T17:59:00+02:00,2025-05-25,01:59,1,1,2
79,2025-05-24T18:01:00+02:00,2025-05-25,02:01,0,1,1
79,2025-05-24T18:02:00+02:00,2025-05-25,02:02,1,1,2
109,2025-05-24T18:00:00+02:00,2025-05-25,02:00,3,1,4
141,2025-05-24T18:05:00+02:00,2025-05-25,02:05,7,8,15
142,2025-05-24T17:55:00+02:00,2025-05-25,01:55,1,0,1
164,2025-05-24T18:05:00+02:00,2025-05-25,02:05,0,1,1
3,2025-05-24T17:47:00+02:00,2025-05-25,01:47,2,1,3
3,2025-05-24T17:50:00+02:00,2025-05-25,01:50,0,4,4
3,2025-05-24T17:51:00+02:00,2025-05-25,01:51,3,3,6
3,2025-05-24T17:52:00+02:00,2025-05-25,01:52,1,0,1
4,2025-05-24T17:40:00+02:00,2025-05-25,01:40,1,3,4
4,2025-05-24T17:42:00+02:00,2025-05-25,01:42,4,3,7
4,2025-05-24T17:43:00+02:00,2025-05-25,01:43,3,0,3
4,2025-05-24T17:44:00+02:00,2025-05-25,01:44,0,3,3
4,2025-05-24T17:50:00+02:00,2025-05-25,01:50,4,9,13
4,2025-05-24T17:51:00+02:00,2025-05-25,01:51,4,5,9
5,2025-05-24T17:40:00+02:00,2025-05-25,01:40,3,9,12
5,2025-05-24T17:45:00+02:00,2025-05-25,01:45,4,5,9
6,2025-05-24T17:40:00+02:00,2025-05-25,01:40,0,3,3
6,2025-05-24T17:43:00+02:00,2025-05-25,01:43,3,2,5
6,2025-05-24T17:49:00+02:00,2025-05-25,01:49,2,0,2
6,2025-05-24T17:50:00+02:00,2025-05-25,01:50,1,2,3
6,2025-05-24T17:52:00+02:00,2025-05-25,01:52,1,5,6
6,2025-05-24T17:54:00+02:00,2025-05-25,01:54,7,1,8
29,2025-05-24T17:54:00+02:00,2025-05-25,01:54,0,1,1
31,2025-05-24T17:41:00+02:00,2025-05-25,01:41,0,1,1
36,2025-05-24T17:45:00+02:00,2025-05-25,01:45,2,10,12
36,2025-05-24T17:48:00+02:00,2025-05-25,01:48,6,3,9
36,2025-05-24T17:50:00+02:00,2025-05-25,01:50,0,5,5
36,2025-05-24T17:52:00+02:00,2025-05-25,01:52,0,6,6
37,2025-05-24T17:50:00+02:00,2025-05-25,01:50,1,0,1
39,2025-05-24T17:44:00+02:00,2025-05-25,01:44,3,0,3
40,2025-05-24T17:40:00+02:00,2025-05-25,01:40,3,0,3
40,2025-05-24T17:42:00+02:00,2025-05-25,01:42,2,0,2
41,2025-05-24T17:40:00+02:00,2025-05-25,01:40,2,2,4
41,2025-05-24T17:49:00+02:00,2025-05-25,01:49,0,1,1
41,2025-05-24T17:52:00+02:00,2025-05-25,01:52,0,2,2
43,2025-05-24T17:50:00+02:00,2025-05-25,01:50,0,1,1
44,2025-05-24T17:45:00+02:00,2025-05-25,01:45,2,0,2
45,2025-05-24T17:40:00+02:00,2025-05-25,01:40,0,2,2
45,2025-05-24T17:43:00+02:00,2025-05-25,01:43,0,2,2
45,2025-05-24T17:44:00+02:00,2025-05-25,01:44,0,5,5
45,2025-05-24T17:48:00+02:00,2025-05-25,01:48,0,5,5
45,2025-05-24T17:49:00+02:00,2025-05-25,01:49,1,1,2
45,2025-05-24T17:54:00+02:00,2025-05-25,01:54,0,3,3
47,2025-05-24T17:46:00+02:00,2025-05-25,01:46,1,1,2
47,2025-05-24T17:48:00+02:00,2025-05-25,01:48,0,2,2
47,2025-05-24T17:51:00+02:00,2025-05-25,01:51,1,1,2
50,2025-05-24T17:43:00+02:00,2025-05-25,01:43,1,0,1
54,2025-05-24T17:42:00+02:00,2025-05-25,01:42,1,2,3
54,2025-05-24T17:43:00+02:00,2025-05-25,01:43,1,2,3
54,2025-05-24T17:47:00+02:00,2025-05-25,01:47,1,4,5
54,2025-05-24T17:49:00+02:00,2025-05-25,01:49,1,1,2
61,2025-05-24T17:40:00+02:00,2025-05-25,01:40,2,0,2
61,2025-05-24T17:42:00+02:00,2025-05-25,01:42,1,0,1
61,2025-05-24T17:43:00+02:00,2025-05-25,01:43,0,4,4
61,2025-05-24T17:50:00+02:00,2025-05-25,01:50,0,1,1
61,2025-05-24T17:51:00+02:00,2025-05-25,01:51,1,0,1
66,2025-05-24T17:42:00+02:00,2025-05-25,01:42,2,0,2
66,2025-05-24T17:49:00+02:00,2025-05-25,01:49,2,4,6
66,2025-05-24T17:50:00+02:00,2025-05-25,01:50,3,0,3
66,2025-05-24T17:51:00+02:00,2025-05-25,01:51,2,0,2
66,2025-05-24T17:52:00+02:00,2025-05-25,01:52,6,7,13
66,2025-05-24T17:54:00+02:00,2025-05-25,01:54,2,3,5
70,2025-05-24T17:51:00+02:00,2025-05-25,01:51,1,0,1
84,2025-05-24T17:50:00+02:00,2025-05-25,01:50,5,18,23
87,2025-05-24T17:47:00+02:00,2025-05-25,01:47,1,0,1
107,2025-05-24T17:45:00+02:00,2025-05-25,01:45,2,2,4
107,2025-05-24T17:50:00+02:00,2025-05-25,01:50,4,3,7
108,2025-05-24T17:42:00+02:00,2025-05-25,01:42,3,1,4
108,2025-05-24T17:43:00+02:00,2025-05-25,01:43,1,1,2
108,2025-05-24T17:48:00+02:00,2025-05-25,01:48,1,0,1
131,2025-05-24T17:45:00+02:00,2025-05-25,01:45,9,12,21
132,2025-05-24T17:45:00+02:00,2025-05-25,01:45,0,1,1
133,2025-05-24T17:40:00+02:00,2025-05-25,01:40,3,1,4
133,2025-05-24T17:45:00+02:00,2025-05-25,01:45,4,2,6
134,2025-05-24T17:50:00+02:00,2025-05-25,01:50,23,1,24
135,2025-05-24T17:50:00+02:00,2025-05-25,01:50,11,2,13
162,2025-05-24T17:40:00+02:00,2025-05-25,01:40,2,0,2
162,2025-05-24T17:50:00+02:00,2025-05-25,01:50,11,2,13
167,2025-05-24T17:45:00+02:00,2025-05-25,01:45,2,0,2
179,2025-05-24T17:45:00+02:00,2025-05-25,01:45,3,2,5
1,2025-05-24T17:42:00+02:00,2025-05-25,01:42,0,2,2
1,2025-05-24T17:43:00+02:00,2025-05-25,01:43,1,2,3
1,2025-05-24T17:49:00+02:00,2025-05-25,01:49,2,0,2
2,2025-05-24T17:42:00+02:00,2025-05-25,01:42,1,1,2
9,2025-05-24T17:48:00+02:00,2025-05-25,01:48,0,1,1
12,2025-05-24T17:43:00+02:00,2025-05-25,01:43,0,1,1
17,2025-05-24T17:42:00+02:00,2025-05-25,01:42,0,1,1
17,2025-05-24T17:47:00+02:00,2025-05-25,01:47,1,0,1
18,2025-05-24T17:45:00+02:00,2025-05-25,01:45,1,0,1
19,2025-05-24T17:51:00+02:00,2025-05-25,01:51,0,4,4
19,2025-05-24T17:53:00+02:00,2025-05-25,01:53,0,1,1
20,2025-05-24T17:40:00+02:00,2025-05-25,01:40,2,3,5
20,2025-05-24T17:44:00+02:00,2025-05-25,01:44,0,5,5
20,2025-05-24T17:45:00+02:00,2025-05-25,01:45,1,3,4
20,2025-05-24T17:46:00+02:00,2025-05-25,01:46,2,0,2
20,2025-05-24T17:47:00+02:00,2025-05-25,01:47,6,0,6
23,2025-05-24T17:52:00+02:00,2025-05-25,01:52,0,8,8
24,2025-05-24T17:40:00+02:00,2025-05-25,01:40,5,0,5
24,2025-05-24T17:43:00+02:00,2025-05-25,01:43,0,8,8
24,2025-05-24T17:45:00+02:00,2025-05-25,01:45,0,2,2
24,2025-05-24T17:46:00+02:00,2025-05-25,01:46,2,3,5
24,2025-05-24T17:49:00+02:00,2025-05-25,01:49,1,4,5
24,2025-05-24T17:53:00+02:00,2025-05-25,01:53,0,1,1
25,2025-05-24T17:45:00+02:00,2025-05-25,01:45,1,10,11
30,2025-05-24T17:41:00+02:00,2025-05-25,01:41,2,0,2
30,2025-05-24T17:44:00+02:00,2025-05-25,01:44,2,2,4
30,2025-05-24T17:51:00+02:00,2025-05-25,01:51,5,0,5
3,2025-05-25T12:14:00+02:00,2025-05-25,20:14,7,15,22
30,2025-05-24T17:52:00+02:00,2025-05-25,01:52,0,3,3
3,2025-05-25T12:15:00+02:00,2025-05-25,20:15,32,14,46
30,2025-05-24T17:53:00+02:00,2025-05-25,01:53,3,6,9
3,2025-05-25T12:17:00+02:00,2025-05-25,20:17,13,17,30
35,2025-05-24T17:42:00+02:00,2025-05-25,01:42,0,2,2
3,2025-05-25T12:18:00+02:00,2025-05-25,20:18,11,6,17
35,2025-05-24T17:44:00+02:00,2025-05-25,01:44,2,5,7
3,2025-05-25T12:21:00+02:00,2025-05-25,20:21,8,4,12
35,2025-05-24T17:51:00+02:00,2025-05-25,01:51,6,2,8
3,2025-05-25T12:23:00+02:00,2025-05-25,20:23,14,4,18
35,2025-05-24T17:52:00+02:00,2025-05-25,01:52,2,1,3
4,2025-05-25T12:10:00+02:00,2025-05-25,20:10,6,10,16
49,2025-05-24T17:40:00+02:00,2025-05-25,01:40,4,2,6
4,2025-05-25T12:11:00+02:00,2025-05-25,20:11,1,4,5
49,2025-05-24T17:42:00+02:00,2025-05-25,01:42,0,2,2
4,2025-05-25T12:13:00+02:00,2025-05-25,20:13,20,15,35
49,2025-05-24T17:45:00+02:00,2025-05-25,01:45,2,1,3
4,2025-05-25T12:16:00+02:00,2025-05-25,20:16,6,10,16
49,2025-05-24T17:49:00+02:00,2025-05-25,01:49,3,0,3
4,2025-05-25T12:20:00+02:00,2025-05-25,20:20,14,10,24
49,2025-05-24T17:51:00+02:00,2025-05-25,01:51,2,1,3
4,2025-05-25T12:21:00+02:00,2025-05-25,20:21,6,7,13
51,2025-05-24T17:42:00+02:00,2025-05-25,01:42,2,0,2
4,2025-05-25T12:22:00+02:00,2025-05-25,20:22,15,16,31
52,2025-05-24T17:41:00+02:00,2025-05-25,01:41,1,0,1
5,2025-05-25T12:10:00+02:00,2025-05-25,20:10,33,29,62
52,2025-05-24T17:46:00+02:00,2025-05-25,01:46,0,2,2
5,2025-05-25T12:20:00+02:00,2025-05-25,20:20,23,19,42
52,2025-05-24T17:47:00+02:00,2025-05-25,01:47,0,6,6
6,2025-05-25T12:15:00+02:00,2025-05-25,20:15,9,9,18
53,2025-05-24T17:43:00+02:00,2025-05-25,01:43,0,1,1
6,2025-05-25T12:20:00+02:00,2025-05-25,20:20,8,4,12
53,2025-05-24T17:46:00+02:00,2025-05-25,01:46,0,1,1
6,2025-05-25T12:22:00+02:00,2025-05-25,20:22,9,11,20
53,2025-05-24T17:50:00+02:00,2025-05-25,01:50,2,0,2
8,2025-05-25T12:10:00+02:00,2025-05-25,20:10,1,0,1
53,2025-05-24T17:51:00+02:00,2025-05-25,01:51,0,2,2
8,2025-05-25T12:23:00+02:00,2025-05-25,20:23,0,1,1
53,2025-05-24T17:52:00+02:00,2025-05-25,01:52,1,1,2
8,2025-05-25T12:24:00+02:00,2025-05-25,20:24,0,1,1
56,2025-05-24T17:40:00+02:00,2025-05-25,01:40,0,5,5
28,2025-05-25T12:11:00+02:00,2025-05-25,20:11,0,7,7
56,2025-05-24T17:44:00+02:00,2025-05-25,01:44,1,0,1
28,2025-05-25T12:15:00+02:00,2025-05-25,20:15,1,0,1
56,2025-05-24T17:54:00+02:00,2025-05-25,01:54,0,1,1
28,2025-05-25T12:17:00+02:00,2025-05-25,20:17,0,1,1
58,2025-05-24T17:41:00+02:00,2025-05-25,01:41,0,1,1
28,2025-05-25T12:23:00+02:00,2025-05-25,20:23,3,0,3
58,2025-05-24T17:44:00+02:00,2025-05-25,01:44,3,3,6
28,2025-05-25T12:24:00+02:00,2025-05-25,20:24,2,1,3
58,2025-05-24T17:48:00+02:00,2025-05-25,01:48,0,4,4
29,2025-05-25T12:11:00+02:00,2025-05-25,20:11,0,1,1
62,2025-05-24T17:42:00+02:00,2025-05-25,01:42,1,0,1
29,2025-05-25T12:14:00+02:00,2025-05-25,20:14,0,2,2
67,2025-05-24T17:41:00+02:00,2025-05-25,01:41,0,1,1
29,2025-05-25T12:16:00+02:00,2025-05-25,20:16,2,2,4
67,2025-05-24T17:42:00+02:00,2025-05-25,01:42,0,2,2
29,2025-05-25T12:19:00+02:00,2025-05-25,20:19,0,2,2
67,2025-05-24T17:44:00+02:00,2025-05-25,01:44,1,1,2
29,2025-05-25T12:20:00+02:00,2025-05-25,20:20,0,2,2
67,2025-05-24T17:52:00+02:00,2025-05-25,01:52,0,1,1
29,2025-05-25T12:23:00+02:00,2025-05-25,20:23,0,2,2
67,2025-05-24T17:53:00+02:00,2025-05-25,01:53,2,0,2
31,2025-05-25T12:11:00+02:00,2025-05-25,20:11,5,13,18
72,2025-05-24T17:47:00+02:00,2025-05-25,01:47,0,1,1
31,2025-05-25T12:12:00+02:00,2025-05-25,20:12,0,9,9
72,2025-05-24T17:51:00+02:00,2025-05-25,01:51,0,1,1
31,2025-05-25T12:16:00+02:00,2025-05-25,20:16,1,4,5
79,2025-05-24T17:41:00+02:00,2025-05-25,01:41,1,5,6
31,2025-05-25T12:23:00+02:00,2025-05-25,20:23,2,4,6
79,2025-05-24T17:44:00+02:00,2025-05-25,01:44,1,2,3
36,2025-05-25T12:11:00+02:00,2025-05-25,20:11,2,0,2
79,2025-05-24T17:45:00+02:00,2025-05-25,01:45,2,3,5
36,2025-05-25T12:12:00+02:00,2025-05-25,20:12,0,1,1
79,2025-05-24T17:48:00+02:00,2025-05-25,01:48,2,4,6
36,2025-05-25T12:14:00+02:00,2025-05-25,20:14,2,1,3
79,2025-05-24T17:50:00+02:00,2025-05-25,01:50,2,6,8
36,2025-05-25T12:19:00+02:00,2025-05-25,20:19,1,0,1
79,2025-05-24T17:51:00+02:00,2025-05-25,01:51,0,1,1
36,2025-05-25T12:22:00+02:00,2025-05-25,20:22,1,6,7
79,2025-05-24T17:53:00+02:00,2025-05-25,01:53,1,1,2
40,2025-05-25T12:16:00+02:00,2025-05-25,20:16,1,0,1
109,2025-05-24T17:40:00+02:00,2025-05-25,01:40,0,1,1
40,2025-05-25T12:18:00+02:00,2025-05-25,20:18,6,2,8
142,2025-05-24T17:45:00+02:00,2025-05-25,01:45,0,1,1
40,2025-05-25T12:19:00+02:00,2025-05-25,20:19,6,2,8
40,2025-05-25T12:22:00+02:00,2025-05-25,20:22,2,2,4
41,2025-05-25T12:12:00+02:00,2025-05-25,20:12,2,3,5
41,2025-05-25T12:17:00+02:00,2025-05-25,20:17,3,1,4
41,2025-05-25T12:23:00+02:00,2025-05-25,20:23,1,1,2
41,2025-05-25T12:24:00+02:00,2025-05-25,20:24,1,0,1
43,2025-05-25T12:10:00+02:00,2025-05-25,20:10,0,3,3
45,2025-05-25T12:12:00+02:00,2025-05-25,20:12,2,8,10
181,2025-05-24T17:44:00+02:00,2025-05-25,01:44,2,1,3
45,2025-05-25T12:15:00+02:00,2025-05-25,20:15,11,13,24
181,2025-05-24T17:45:00+02:00,2025-05-25,01:45,0,4,4
45,2025-05-25T12:21:00+02:00,2025-05-25,20:21,2,13,15
181,2025-05-24T17:46:00+02:00,2025-05-25,01:46,2,4,6
45,2025-05-25T12:23:00+02:00,2025-05-25,20:23,8,11,19
181,2025-05-24T17:51:00+02:00,2025-05-25,01:51,1,1,2
45,2025-05-25T12:24:00+02:00,2025-05-25,20:24,8,8,16
181,2025-05-24T17:54:00+02:00,2025-05-25,01:54,2,14,16
47,2025-05-25T12:14:00+02:00,2025-05-25,20:14,9,17,26
182,2025-05-24T17:45:00+02:00,2025-05-25,01:45,12,10,22
47,2025-05-25T12:15:00+02:00,2025-05-25,20:15,9,9,18
47,2025-05-25T12:19:00+02:00,2025-05-25,20:19,5,11,16
47,2025-05-25T12:21:00+02:00,2025-05-25,20:21,0,8,8
50,2025-05-25T12:12:00+02:00,2025-05-25,20:12,1,2,3
50,2025-05-25T12:18:00+02:00,2025-05-25,20:18,1,6,7
50,2025-05-25T12:19:00+02:00,2025-05-25,20:19,2,1,3
50,2025-05-25T12:21:00+02:00,2025-05-25,20:21,4,0,4
50,2025-05-25T12:23:00+02:00,2025-05-25,20:23,6,0,6
54,2025-05-25T12:11:00+02:00,2025-05-25,20:11,0,2,2
54,2025-05-25T12:13:00+02:00,2025-05-25,20:13,3,8,11
54,2025-05-25T12:14:00+02:00,2025-05-25,20:14,2,0,2
54,2025-05-25T12:18:00+02:00,2025-05-25,20:18,0,1,1
54,2025-05-25T12:19:00+02:00,2025-05-25,20:19,0,1,1
181,2025-05-24T17:59:00+02:00,2025-05-25,01:59,3,0,3
54,2025-05-25T12:21:00+02:00,2025-05-25,20:21,1,9,10
181,2025-05-24T18:00:00+02:00,2025-05-25,02:00,4,3,7
54,2025-05-25T12:24:00+02:00,2025-05-25,20:24,7,1,8
182,2025-05-24T17:55:00+02:00,2025-05-25,01:55,10,15,25
61,2025-05-25T12:14:00+02:00,2025-05-25,20:14,2,5,7
182,2025-05-24T18:00:00+02:00,2025-05-25,02:00,13,5,18
61,2025-05-25T12:16:00+02:00,2025-05-25,20:16,4,0,4
61,2025-05-25T12:17:00+02:00,2025-05-25,20:17,4,3,7
61,2025-05-25T12:18:00+02:00,2025-05-25,20:18,2,1,3
61,2025-05-25T12:23:00+02:00,2025-05-25,20:23,5,2,7
66,2025-05-25T12:10:00+02:00,2025-05-25,20:10,15,14,29
66,2025-05-25T12:11:00+02:00,2025-05-25,20:11,11,16,27
66,2025-05-25T12:17:00+02:00,2025-05-25,20:17,13,7,20
66,2025-05-25T12:21:00+02:00,2025-05-25,20:21,12,11,23
69,2025-05-25T12:15:00+02:00,2025-05-25,20:15,0,1,1
69,2025-05-25T12:20:00+02:00,2025-05-25,20:20,0,1,1
70,2025-05-25T12:12:00+02:00,2025-05-25,20:12,3,1,4
70,2025-05-25T12:14:00+02:00,2025-05-25,20:14,2,4,6
70,2025-05-25T12:19:00+02:00,2025-05-25,20:19,7,4,11
70,2025-05-25T12:23:00+02:00,2025-05-25,20:23,1,1,2
70,2025-05-25T12:24:00+02:00,2025-05-25,20:24,3,1,4
84,2025-05-25T12:10:00+02:00,2025-05-25,20:10,53,55,108
87,2025-05-25T12:20:00+02:00,2025-05-25,20:20,0,5,5
87,2025-05-25T12:24:00+02:00,2025-05-25,20:24,0,1,1
107,2025-05-25T12:20:00+02:00,2025-05-25,20:20,7,6,13
108,2025-05-25T12:11:00+02:00,2025-05-25,20:11,8,2,10
108,2025-05-25T12:13:00+02:00,2025-05-25,20:13,2,3,5
108,2025-05-25T12:15:00+02:00,2025-05-25,20:15,0,3,3
108,2025-05-25T12:23:00+02:00,2025-05-25,20:23,1,9,10
118,2025-05-25T12:15:00+02:00,2025-05-25,20:15,4,1,5
131,2025-05-25T12:20:00+02:00,2025-05-25,20:20,1,1,2
132,2025-05-25T12:10:00+02:00,2025-05-25,20:10,17,11,28
132,2025-05-25T12:15:00+02:00,2025-05-25,20:15,11,7,18
133,2025-05-25T12:10:00+02:00,2025-05-25,20:10,17,23,40
134,2025-05-25T12:15:00+02:00,2025-05-25,20:15,21,20,41
135,2025-05-25T12:10:00+02:00,2025-05-25,20:10,13,18,31
135,2025-05-25T12:15:00+02:00,2025-05-25,20:15,14,19,33
162,2025-05-25T12:10:00+02:00,2025-05-25,20:10,4,9,13
162,2025-05-25T12:15:00+02:00,2025-05-25,20:15,14,11,25
166,2025-05-25T12:10:00+02:00,2025-05-25,20:10,0,1,1
167,2025-05-25T12:15:00+02:00,2025-05-25,20:15,4,3,7
179,2025-05-25T12:10:00+02:00,2025-05-25,20:10,6,11,17
179,2025-05-25T12:15:00+02:00,2025-05-25,20:15,4,2,6
1,2025-05-25T12:12:00+02:00,2025-05-25,20:12,0,2,2
1,2025-05-25T12:14:00+02:00,2025-05-25,20:14,4,3,7
1,2025-05-25T12:16:00+02:00,2025-05-25,20:16,0,7,7
1,2025-05-25T12:20:00+02:00,2025-05-25,20:20,1,7,8
1,2025-05-25T12:23:00+02:00,2025-05-25,20:23,12,3,15
2,2025-05-25T12:10:00+02:00,2025-05-25,20:10,0,1,1
2,2025-05-25T12:15:00+02:00,2025-05-25,20:15,7,6,13
2,2025-05-25T12:18:00+02:00,2025-05-25,20:18,0,5,5
9,2025-05-25T12:22:00+02:00,2025-05-25,20:22,0,2,2
9,2025-05-25T12:23:00+02:00,2025-05-25,20:23,2,4,6
10,2025-05-25T12:12:00+02:00,2025-05-25,20:12,1,0,1
10,2025-05-25T12:13:00+02:00,2025-05-25,20:13,0,3,3
10,2025-05-25T12:18:00+02:00,2025-05-25,20:18,2,6,8
10,2025-05-25T12:23:00+02:00,2025-05-25,20:23,0,2,2
12,2025-05-25T12:13:00+02:00,2025-05-25,20:13,3,0,3
12,2025-05-25T12:14:00+02:00,2025-05-25,20:14,2,2,4
12,2025-05-25T12:15:00+02:00,2025-05-25,20:15,2,0,2
12,2025-05-25T12:19:00+02:00,2025-05-25,20:19,1,4,5
17,2025-05-25T12:12:00+02:00,2025-05-25,20:12,6,1,7
17,2025-05-25T12:13:00+02:00,2025-05-25,20:13,3,0,3
17,2025-05-25T12:14:00+02:00,2025-05-25,20:14,2,0,2
17,2025-05-25T12:22:00+02:00,2025-05-25,20:22,0,2,2
18,2025-05-25T12:12:00+02:00,2025-05-25,20:12,0,1,1
18,2025-05-25T12:17:00+02:00,2025-05-25,20:17,0,2,2
19,2025-05-25T12:10:00+02:00,2025-05-25,20:10,2,8,10
19,2025-05-25T12:13:00+02:00,2025-05-25,20:13,18,1,19
19,2025-05-25T12:20:00+02:00,2025-05-25,20:20,13,16,29
19,2025-05-25T12:24:00+02:00,2025-05-25,20:24,11,5,16
20,2025-05-25T12:10:00+02:00,2025-05-25,20:10,6,8,14
20,2025-05-25T12:22:00+02:00,2025-05-25,20:22,1,4,5
23,2025-05-25T12:11:00+02:00,2025-05-25,20:11,4,1,5
23,2025-05-25T12:12:00+02:00,2025-05-25,20:12,4,3,7
23,2025-05-25T12:13:00+02:00,2025-05-25,20:13,6,1,7
23,2025-05-25T12:20:00+02:00,2025-05-25,20:20,3,1,4
23,2025-05-25T12:21:00+02:00,2025-05-25,20:21,1,2,3
23,2025-05-25T12:24:00+02:00,2025-05-25,20:24,5,0,5
24,2025-05-25T12:10:00+02:00,2025-05-25,20:10,4,1,5
24,2025-05-25T12:12:00+02:00,2025-05-25,20:12,2,5,7
24,2025-05-25T12:13:00+02:00,2025-05-25,20:13,2,5,7
24,2025-05-25T12:15:00+02:00,2025-05-25,20:15,7,17,24
24,2025-05-25T12:19:00+02:00,2025-05-25,20:19,2,4,6
24,2025-05-25T12:23:00+02:00,2025-05-25,20:23,2,6,8
25,2025-05-25T12:10:00+02:00,2025-05-25,20:10,14,11,25
25,2025-05-25T12:15:00+02:00,2025-05-25,20:15,13,17,30
27,2025-05-25T12:10:00+02:00,2025-05-25,20:10,1,0,1
27,2025-05-25T12:21:00+02:00,2025-05-25,20:21,0,1,1
27,2025-05-25T12:22:00+02:00,2025-05-25,20:22,1,0,1
27,2025-05-25T12:23:00+02:00,2025-05-25,20:23,3,0,3
30,2025-05-25T12:11:00+02:00,2025-05-25,20:11,0,10,10
30,2025-05-25T12:15:00+02:00,2025-05-25,20:15,2,6,8
30,2025-05-25T12:16:00+02:00,2025-05-25,20:16,0,4,4
30,2025-05-25T12:17:00+02:00,2025-05-25,20:17,2,8,10
30,2025-05-25T12:18:00+02:00,2025-05-25,20:18,0,11,11
30,2025-05-25T12:19:00+02:00,2025-05-25,20:19,4,5,9
35,2025-05-25T12:10:00+02:00,2025-05-25,20:10,6,5,11
35,2025-05-25T12:15:00+02:00,2025-05-25,20:15,2,9,11
35,2025-05-25T12:16:00+02:00,2025-05-25,20:16,4,4,8
35,2025-05-25T12:20:00+02:00,2025-05-25,20:20,12,4,16
35,2025-05-25T12:21:00+02:00,2025-05-25,20:21,4,11,15
35,2025-05-25T12:23:00+02:00,2025-05-25,20:23,5,10,15
35,2025-05-25T12:24:00+02:00,2025-05-25,20:24,3,5,8
48,2025-05-25T12:11:00+02:00,2025-05-25,20:11,0,2,2
48,2025-05-25T12:12:00+02:00,2025-05-25,20:12,1,0,1
48,2025-05-25T12:14:00+02:00,2025-05-25,20:14,3,0,3
48,2025-05-25T12:17:00+02:00,2025-05-25,20:17,1,1,2
48,2025-05-25T12:18:00+02:00,2025-05-25,20:18,1,0,1
48,2025-05-25T12:19:00+02:00,2025-05-25,20:19,0,1,1
48,2025-05-25T12:20:00+02:00,2025-05-25,20:20,3,2,5
48,2025-05-25T12:22:00+02:00,2025-05-25,20:22,0,3,3
49,2025-05-25T12:19:00+02:00,2025-05-25,20:19,2,8,10
49,2025-05-25T12:20:00+02:00,2025-05-25,20:20,2,2,4
49,2025-05-25T12:21:00+02:00,2025-05-25,20:21,4,4,8
51,2025-05-25T12:12:00+02:00,2025-05-25,20:12,0,1,1
51,2025-05-25T12:23:00+02:00,2025-05-25,20:23,0,2,2
52,2025-05-25T12:10:00+02:00,2025-05-25,20:10,5,5,10
52,2025-05-25T12:12:00+02:00,2025-05-25,20:12,3,2,5
52,2025-05-25T12:15:00+02:00,2025-05-25,20:15,4,0,4
52,2025-05-25T12:20:00+02:00,2025-05-25,20:20,3,2,5
53,2025-05-25T12:10:00+02:00,2025-05-25,20:10,5,1,6
53,2025-05-25T12:11:00+02:00,2025-05-25,20:11,0,1,1
53,2025-05-25T12:15:00+02:00,2025-05-25,20:15,3,5,8
53,2025-05-25T12:20:00+02:00,2025-05-25,20:20,2,4,6
53,2025-05-25T12:22:00+02:00,2025-05-25,20:22,4,0,4
56,2025-05-25T12:10:00+02:00,2025-05-25,20:10,2,0,2
56,2025-05-25T12:11:00+02:00,2025-05-25,20:11,9,5,14
56,2025-05-25T12:12:00+02:00,2025-05-25,20:12,6,3,9
56,2025-05-25T12:14:00+02:00,2025-05-25,20:14,15,5,20
56,2025-05-25T12:16:00+02:00,2025-05-25,20:16,1,1,2
56,2025-05-25T12:19:00+02:00,2025-05-25,20:19,1,3,4
56,2025-05-25T12:23:00+02:00,2025-05-25,20:23,5,8,13
56,2025-05-25T12:24:00+02:00,2025-05-25,20:24,0,4,4
58,2025-05-25T12:13:00+02:00,2025-05-25,20:13,6,8,14
58,2025-05-25T12:15:00+02:00,2025-05-25,20:15,3,5,8
58,2025-05-25T12:17:00+02:00,2025-05-25,20:17,4,8,12
62,2025-05-25T12:14:00+02:00,2025-05-25,20:14,3,3,6
62,2025-05-25T12:15:00+02:00,2025-05-25,20:15,3,3,6
62,2025-05-25T12:17:00+02:00,2025-05-25,20:17,2,4,6
62,2025-05-25T12:18:00+02:00,2025-05-25,20:18,3,3,6
62,2025-05-25T12:21:00+02:00,2025-05-25,20:21,1,0,1
63,2025-05-25T12:14:00+02:00,2025-05-25,20:14,0,1,1
63,2025-05-25T12:18:00+02:00,2025-05-25,20:18,0,9,9
67,2025-05-25T12:10:00+02:00,2025-05-25,20:10,1,5,6
67,2025-05-25T12:12:00+02:00,2025-05-25,20:12,0,6,6
67,2025-05-25T12:13:00+02:00,2025-05-25,20:13,1,2,3
67,2025-05-25T12:15:00+02:00,2025-05-25,20:15,4,6,10
67,2025-05-25T12:16:00+02:00,2025-05-25,20:16,1,2,3
67,2025-05-25T12:18:00+02:00,2025-05-25,20:18,0,9,9
67,2025-05-25T12:21:00+02:00,2025-05-25,20:21,4,5,9
68,2025-05-25T12:11:00+02:00,2025-05-25,20:11,0,1,1
68,2025-05-25T12:13:00+02:00,2025-05-25,20:13,0,1,1
68,2025-05-25T12:18:00+02:00,2025-05-25,20:18,0,4,4
68,2025-05-25T12:21:00+02:00,2025-05-25,20:21,3,0,3
68,2025-05-25T12:22:00+02:00,2025-05-25,20:22,5,1,6
68,2025-05-25T12:24:00+02:00,2025-05-25,20:24,1,0,1
72,2025-05-25T12:11:00+02:00,2025-05-25,20:11,2,5,7
72,2025-05-25T12:12:00+02:00,2025-05-25,20:12,4,1,5
72,2025-05-25T12:14:00+02:00,2025-05-25,20:14,6,3,9
72,2025-05-25T12:17:00+02:00,2025-05-25,20:17,5,2,7
72,2025-05-25T12:19:00+02:00,2025-05-25,20:19,2,2,4
72,2025-05-25T12:23:00+02:00,2025-05-25,20:23,0,4,4
76,2025-05-25T12:18:00+02:00,2025-05-25,20:18,1,0,1
79,2025-05-25T12:17:00+02:00,2025-05-25,20:17,7,6,13
79,2025-05-25T12:20:00+02:00,2025-05-25,20:20,5,3,8
79,2025-05-25T12:22:00+02:00,2025-05-25,20:22,3,8,11
79,2025-05-25T12:24:00+02:00,2025-05-25,20:24,1,13,14
85,2025-05-25T12:24:00+02:00,2025-05-25,20:24,0,1,1
86,2025-05-25T12:10:00+02:00,2025-05-25,20:10,1,1,2
86,2025-05-25T12:16:00+02:00,2025-05-25,20:16,0,2,2
109,2025-05-25T12:15:00+02:00,2025-05-25,20:15,12,7,19
109,2025-05-25T12:20:00+02:00,2025-05-25,20:20,4,12,16
117,2025-05-25T12:20:00+02:00,2025-05-25,20:20,8,5,13
130,2025-05-25T12:10:00+02:00,2025-05-25,20:10,0,2,2
137,2025-05-25T12:10:00+02:00,2025-05-25,20:10,0,1,1
137,2025-05-25T12:15:00+02:00,2025-05-25,20:15,1,2,3
141,2025-05-25T12:15:00+02:00,2025-05-25,20:15,6,5,11
142,2025-05-25T12:15:00+02:00,2025-05-25,20:15,1,4,5
181,2025-05-24T17:30:00+02:00,2025-05-25,01:30,3,1,4
181,2025-05-24T17:32:00+02:00,2025-05-25,01:32,8,1,9
181,2025-05-24T17:35:00+02:00,2025-05-25,01:35,5,3,8
181,2025-05-24T17:37:00+02:00,2025-05-25,01:37,4,0,4
181,2025-05-24T17:38:00+02:00,2025-05-25,01:38,3,2,5
181,2025-05-24T17:39:00+02:00,2025-05-25,01:39,1,0,1
182,2025-05-24T17:25:00+02:00,2025-05-25,01:25,8,13,21
3,2025-05-24T17:25:00+02:00,2025-05-25,01:25,2,4,6
3,2025-05-24T17:29:00+02:00,2025-05-25,01:29,1,4,5
3,2025-05-24T17:34:00+02:00,2025-05-25,01:34,0,3,3
3,2025-05-24T17:38:00+02:00,2025-05-25,01:38,13,2,15
4,2025-05-24T17:25:00+02:00,2025-05-25,01:25,5,0,5
4,2025-05-24T17:26:00+02:00,2025-05-25,01:26,2,1,3
4,2025-05-24T17:27:00+02:00,2025-05-25,01:27,2,2,4
4,2025-05-24T17:29:00+02:00,2025-05-25,01:29,10,6,16
4,2025-05-24T17:33:00+02:00,2025-05-25,01:33,1,8,9
4,2025-05-24T17:36:00+02:00,2025-05-25,01:36,9,6,15
5,2025-05-24T17:25:00+02:00,2025-05-25,01:25,4,2,6
6,2025-05-24T17:28:00+02:00,2025-05-25,01:28,2,3,5
6,2025-05-24T17:30:00+02:00,2025-05-25,01:30,5,1,6
6,2025-05-24T17:31:00+02:00,2025-05-25,01:31,7,3,10
6,2025-05-24T17:32:00+02:00,2025-05-25,01:32,2,0,2
6,2025-05-24T17:34:00+02:00,2025-05-25,01:34,6,0,6
6,2025-05-24T17:36:00+02:00,2025-05-25,01:36,2,1,3
28,2025-05-24T17:27:00+02:00,2025-05-25,01:27,0,1,1
28,2025-05-24T17:38:00+02:00,2025-05-25,01:38,4,0,4
29,2025-05-24T17:27:00+02:00,2025-05-25,01:27,3,0,3
29,2025-05-24T17:29:00+02:00,2025-05-25,01:29,0,2,2
29,2025-05-24T17:32:00+02:00,2025-05-25,01:32,2,0,2
29,2025-05-24T17:37:00+02:00,2025-05-25,01:37,2,0,2
29,2025-05-24T17:38:00+02:00,2025-05-25,01:38,0,5,5
31,2025-05-24T17:29:00+02:00,2025-05-25,01:29,0,3,3
31,2025-05-24T17:30:00+02:00,2025-05-25,01:30,0,2,2
31,2025-05-24T17:37:00+02:00,2025-05-25,01:37,1,0,1
36,2025-05-24T17:26:00+02:00,2025-05-25,01:26,2,3,5
36,2025-05-24T17:29:00+02:00,2025-05-25,01:29,2,5,7
36,2025-05-24T17:34:00+02:00,2025-05-25,01:34,3,5,8
36,2025-05-24T17:35:00+02:00,2025-05-25,01:35,2,4,6
36,2025-05-24T17:36:00+02:00,2025-05-25,01:36,2,3,5
41,2025-05-24T17:25:00+02:00,2025-05-25,01:25,0,1,1
41,2025-05-24T17:26:00+02:00,2025-05-25,01:26,0,1,1
41,2025-05-24T17:31:00+02:00,2025-05-25,01:31,1,4,5
41,2025-05-24T17:36:00+02:00,2025-05-25,01:36,2,5,7
41,2025-05-24T17:38:00+02:00,2025-05-25,01:38,1,4,5
41,2025-05-24T17:39:00+02:00,2025-05-25,01:39,0,3,3
43,2025-05-24T17:25:00+02:00,2025-05-25,01:25,0,1,1
45,2025-05-24T17:25:00+02:00,2025-05-25,01:25,1,2,3
45,2025-05-24T17:26:00+02:00,2025-05-25,01:26,0,3,3
45,2025-05-24T17:29:00+02:00,2025-05-25,01:29,0,7,7
45,2025-05-24T17:32:00+02:00,2025-05-25,01:32,0,2,2
45,2025-05-24T17:35:00+02:00,2025-05-25,01:35,1,15,16
47,2025-05-24T17:26:00+02:00,2025-05-25,01:26,4,1,5
47,2025-05-24T17:28:00+02:00,2025-05-25,01:28,0,3,3
47,2025-05-24T17:29:00+02:00,2025-05-25,01:29,2,0,2
47,2025-05-24T17:30:00+02:00,2025-05-25,01:30,8,1,9
47,2025-05-24T17:32:00+02:00,2025-05-25,01:32,3,1,4
47,2025-05-24T17:33:00+02:00,2025-05-25,01:33,10,0,10
47,2025-05-24T17:34:00+02:00,2025-05-25,01:34,1,4,5
47,2025-05-24T17:38:00+02:00,2025-05-25,01:38,3,2,5
50,2025-05-24T17:38:00+02:00,2025-05-25,01:38,4,0,4
54,2025-05-24T17:32:00+02:00,2025-05-25,01:32,0,1,1
54,2025-05-24T17:35:00+02:00,2025-05-25,01:35,2,0,2
54,2025-05-24T17:39:00+02:00,2025-05-25,01:39,3,0,3
61,2025-05-24T17:25:00+02:00,2025-05-25,01:25,1,0,1
61,2025-05-24T17:32:00+02:00,2025-05-25,01:32,3,0,3
66,2025-05-24T17:26:00+02:00,2025-05-25,01:26,0,4,4
66,2025-05-24T17:29:00+02:00,2025-05-25,01:29,1,4,5
66,2025-05-24T17:30:00+02:00,2025-05-25,01:30,3,0,3
66,2025-05-24T17:33:00+02:00,2025-05-25,01:33,2,0,2
66,2025-05-24T17:35:00+02:00,2025-05-25,01:35,2,2,4
66,2025-05-24T17:36:00+02:00,2025-05-25,01:36,4,0,4
71,2025-05-24T17:32:00+02:00,2025-05-25,01:32,0,1,1
75,2025-05-24T17:29:00+02:00,2025-05-25,01:29,0,1,1
77,2025-05-24T17:25:00+02:00,2025-05-25,01:25,2,1,3
77,2025-05-24T17:35:00+02:00,2025-05-25,01:35,1,0,1
78,2025-05-24T17:36:00+02:00,2025-05-25,01:36,0,1,1
84,2025-05-24T17:30:00+02:00,2025-05-25,01:30,13,12,25
87,2025-05-24T17:32:00+02:00,2025-05-25,01:32,1,0,1
107,2025-05-24T17:25:00+02:00,2025-05-25,01:25,4,0,4
107,2025-05-24T17:30:00+02:00,2025-05-25,01:30,5,1,6
118,2025-05-24T17:35:00+02:00,2025-05-25,01:35,0,1,1
131,2025-05-24T17:25:00+02:00,2025-05-25,01:25,23,9,32
131,2025-05-24T17:30:00+02:00,2025-05-25,01:30,10,13,23
134,2025-05-24T17:35:00+02:00,2025-05-25,01:35,3,5,8
135,2025-05-24T17:35:00+02:00,2025-05-25,01:35,4,3,7
1,2025-05-24T17:30:00+02:00,2025-05-25,01:30,1,4,5
1,2025-05-24T17:38:00+02:00,2025-05-25,01:38,1,0,1
2,2025-05-24T17:25:00+02:00,2025-05-25,01:25,0,4,4
2,2025-05-24T17:31:00+02:00,2025-05-25,01:31,0,4,4
2,2025-05-24T17:32:00+02:00,2025-05-25,01:32,0,2,2
2,2025-05-24T17:38:00+02:00,2025-05-25,01:38,0,1,1
2,2025-05-24T17:39:00+02:00,2025-05-25,01:39,1,0,1
9,2025-05-24T17:25:00+02:00,2025-05-25,01:25,0,2,2
9,2025-05-24T17:27:00+02:00,2025-05-25,01:27,0,2,2
9,2025-05-24T17:34:00+02:00,2025-05-25,01:34,0,3,3
11,2025-05-24T17:28:00+02:00,2025-05-25,01:28,3,0,3
12,2025-05-24T17:28:00+02:00,2025-05-25,01:28,0,1,1
12,2025-05-24T17:29:00+02:00,2025-05-25,01:29,1,0,1
12,2025-05-24T17:36:00+02:00,2025-05-25,01:36,0,2,2
17,2025-05-24T17:28:00+02:00,2025-05-25,01:28,0,1,1
18,2025-05-24T17:29:00+02:00,2025-05-25,01:29,2,0,2
19,2025-05-24T17:30:00+02:00,2025-05-25,01:30,0,1,1
19,2025-05-24T17:39:00+02:00,2025-05-25,01:39,1,1,2
20,2025-05-24T17:25:00+02:00,2025-05-25,01:25,1,1,2
20,2025-05-24T17:26:00+02:00,2025-05-25,01:26,1,6,7
20,2025-05-24T17:30:00+02:00,2025-05-25,01:30,3,0,3
20,2025-05-24T17:31:00+02:00,2025-05-25,01:31,4,0,4
20,2025-05-24T17:33:00+02:00,2025-05-25,01:33,5,0,5
20,2025-05-24T17:38:00+02:00,2025-05-25,01:38,8,7,15
23,2025-05-24T17:30:00+02:00,2025-05-25,01:30,1,0,1
23,2025-05-24T17:38:00+02:00,2025-05-25,01:38,0,2,2
24,2025-05-24T17:25:00+02:00,2025-05-25,01:25,3,2,5
24,2025-05-24T17:26:00+02:00,2025-05-25,01:26,0,5,5
24,2025-05-24T17:28:00+02:00,2025-05-25,01:28,1,0,1
24,2025-05-24T17:37:00+02:00,2025-05-25,01:37,4,1,5
24,2025-05-24T17:38:00+02:00,2025-05-25,01:38,0,1,1
24,2025-05-24T17:39:00+02:00,2025-05-25,01:39,2,1,3
25,2025-05-24T17:25:00+02:00,2025-05-25,01:25,1,1,2
27,2025-05-24T17:25:00+02:00,2025-05-25,01:25,2,0,2
27,2025-05-24T17:33:00+02:00,2025-05-25,01:33,1,0,1
30,2025-05-24T17:31:00+02:00,2025-05-25,01:31,6,2,8
30,2025-05-24T17:33:00+02:00,2025-05-25,01:33,5,1,6
30,2025-05-24T17:37:00+02:00,2025-05-25,01:37,2,2,4
30,2025-05-24T17:38:00+02:00,2025-05-25,01:38,1,1,2
49,2025-05-24T17:26:00+02:00,2025-05-25,01:26,0,1,1
49,2025-05-24T17:28:00+02:00,2025-05-25,01:28,2,2,4
49,2025-05-24T17:36:00+02:00,2025-05-25,01:36,1,2,3
51,2025-05-24T17:29:00+02:00,2025-05-25,01:29,0,1,1
51,2025-05-24T17:36:00+02:00,2025-05-25,01:36,0,4,4
52,2025-05-24T17:25:00+02:00,2025-05-25,01:25,3,4,7
52,2025-05-24T17:26:00+02:00,2025-05-25,01:26,4,0,4
52,2025-05-24T17:30:00+02:00,2025-05-25,01:30,0,1,1
52,2025-05-24T17:31:00+02:00,2025-05-25,01:31,1,4,5
52,2025-05-24T17:32:00+02:00,2025-05-25,01:32,2,4,6
52,2025-05-24T17:33:00+02:00,2025-05-25,01:33,0,3,3
52,2025-05-24T17:34:00+02:00,2025-05-25,01:34,0,4,4
52,2025-05-24T17:37:00+02:00,2025-05-25,01:37,4,2,6
52,2025-05-24T17:38:00+02:00,2025-05-25,01:38,1,2,3
53,2025-05-24T17:25:00+02:00,2025-05-25,01:25,5,0,5
53,2025-05-24T17:33:00+02:00,2025-05-25,01:33,1,0,1
53,2025-05-24T17:35:00+02:00,2025-05-25,01:35,2,1,3
53,2025-05-24T17:36:00+02:00,2025-05-25,01:36,7,0,7
56,2025-05-24T17:32:00+02:00,2025-05-25,01:32,2,0,2
56,2025-05-24T17:36:00+02:00,2025-05-25,01:36,1,0,1
56,2025-05-24T17:38:00+02:00,2025-05-25,01:38,4,0,4
58,2025-05-24T17:30:00+02:00,2025-05-25,01:30,2,4,6
58,2025-05-24T17:32:00+02:00,2025-05-25,01:32,0,1,1
58,2025-05-24T17:34:00+02:00,2025-05-25,01:34,2,2,4
58,2025-05-24T17:39:00+02:00,2025-05-25,01:39,0,3,3
62,2025-05-24T17:27:00+02:00,2025-05-25,01:27,4,0,4
62,2025-05-24T17:29:00+02:00,2025-05-25,01:29,1,0,1
62,2025-05-24T17:32:00+02:00,2025-05-25,01:32,0,1,1
63,2025-05-24T17:25:00+02:00,2025-05-25,01:25,0,3,3
63,2025-05-24T17:26:00+02:00,2025-05-25,01:26,0,2,2
63,2025-05-24T17:32:00+02:00,2025-05-25,01:32,0,3,3
63,2025-05-24T17:34:00+02:00,2025-05-25,01:34,1,2,3
63,2025-05-24T17:38:00+02:00,2025-05-25,01:38,0,1,1
67,2025-05-24T17:27:00+02:00,2025-05-25,01:27,1,0,1
67,2025-05-24T17:28:00+02:00,2025-05-25,01:28,0,1,1
67,2025-05-24T17:32:00+02:00,2025-05-25,01:32,1,0,1
67,2025-05-24T17:37:00+02:00,2025-05-25,01:37,3,0,3
67,2025-05-24T17:38:00+02:00,2025-05-25,01:38,0,3,3
72,2025-05-24T17:25:00+02:00,2025-05-25,01:25,0,2,2
72,2025-05-24T17:27:00+02:00,2025-05-25,01:27,2,0,2
72,2025-05-24T17:29:00+02:00,2025-05-25,01:29,4,0,4
72,2025-05-24T17:36:00+02:00,2025-05-25,01:36,1,0,1
79,2025-05-24T17:25:00+02:00,2025-05-25,01:25,2,2,4
79,2025-05-24T17:29:00+02:00,2025-05-25,01:29,4,0,4
79,2025-05-24T17:32:00+02:00,2025-05-25,01:32,0,1,1
79,2025-05-24T17:33:00+02:00,2025-05-25,01:33,2,2,4
79,2025-05-24T17:35:00+02:00,2025-05-25,01:35,1,2,3
86,2025-05-24T17:37:00+02:00,2025-05-25,01:37,0,1,1
117,2025-05-24T17:25:00+02:00,2025-05-25,01:25,9,2,11
117,2025-05-24T17:30:00+02:00,2025-05-25,01:30,4,0,4
164,2025-05-24T17:30:00+02:00,2025-05-25,01:30,4,0,4
3,2025-05-24T18:11:00+02:00,2025-05-25,02:11,0,2,2
3,2025-05-24T18:12:00+02:00,2025-05-25,02:12,1,1,2
3,2025-05-24T18:13:00+02:00,2025-05-25,02:13,4,4,8
3,2025-05-24T18:14:00+02:00,2025-05-25,02:14,9,2,11
3,2025-05-24T18:17:00+02:00,2025-05-25,02:17,8,1,9
3,2025-05-24T18:20:00+02:00,2025-05-25,02:20,3,0,3
4,2025-05-24T18:16:00+02:00,2025-05-25,02:16,1,5,6
4,2025-05-24T18:19:00+02:00,2025-05-25,02:19,1,2,3
5,2025-05-24T18:15:00+02:00,2025-05-25,02:15,2,2,4
6,2025-05-24T18:10:00+02:00,2025-05-25,02:10,1,0,1
6,2025-05-24T18:12:00+02:00,2025-05-25,02:12,3,0,3
6,2025-05-24T18:13:00+02:00,2025-05-25,02:13,0,1,1
6,2025-05-24T18:14:00+02:00,2025-05-25,02:14,4,0,4
28,2025-05-24T18:19:00+02:00,2025-05-25,02:19,0,1,1
29,2025-05-24T18:14:00+02:00,2025-05-25,02:14,0,1,1
29,2025-05-24T18:22:00+02:00,2025-05-25,02:22,1,1,2
31,2025-05-24T18:13:00+02:00,2025-05-25,02:13,3,0,3
36,2025-05-24T18:11:00+02:00,2025-05-25,02:11,3,2,5
36,2025-05-24T18:19:00+02:00,2025-05-25,02:19,1,1,2
36,2025-05-24T18:22:00+02:00,2025-05-25,02:22,6,0,6
37,2025-05-24T18:18:00+02:00,2025-05-25,02:18,0,1,1
41,2025-05-24T18:10:00+02:00,2025-05-25,02:10,0,3,3
41,2025-05-24T18:11:00+02:00,2025-05-25,02:11,2,0,2
41,2025-05-24T18:21:00+02:00,2025-05-25,02:21,0,3,3
45,2025-05-24T18:13:00+02:00,2025-05-25,02:13,1,3,4
45,2025-05-24T18:15:00+02:00,2025-05-25,02:15,3,2,5
45,2025-05-24T18:18:00+02:00,2025-05-25,02:18,0,1,1
45,2025-05-24T18:23:00+02:00,2025-05-25,02:23,0,2,2
45,2025-05-24T18:24:00+02:00,2025-05-25,02:24,2,4,6
47,2025-05-24T18:13:00+02:00,2025-05-25,02:13,1,0,1
47,2025-05-24T18:14:00+02:00,2025-05-25,02:14,2,2,4
47,2025-05-24T18:17:00+02:00,2025-05-25,02:17,3,0,3
47,2025-05-24T18:22:00+02:00,2025-05-25,02:22,2,0,2
47,2025-05-24T18:23:00+02:00,2025-05-25,02:23,2,3,5
47,2025-05-24T18:24:00+02:00,2025-05-25,02:24,5,0,5
54,2025-05-24T18:11:00+02:00,2025-05-25,02:11,1,0,1
59,2025-05-24T18:15:00+02:00,2025-05-25,02:15,3,1,4
61,2025-05-24T18:12:00+02:00,2025-05-25,02:12,0,1,1
61,2025-05-24T18:15:00+02:00,2025-05-25,02:15,2,0,2
61,2025-05-24T18:20:00+02:00,2025-05-25,02:20,1,0,1
66,2025-05-24T18:10:00+02:00,2025-05-25,02:10,6,0,6
66,2025-05-24T18:12:00+02:00,2025-05-25,02:12,2,0,2
66,2025-05-24T18:15:00+02:00,2025-05-25,02:15,4,4,8
66,2025-05-24T18:22:00+02:00,2025-05-25,02:22,5,1,6
69,2025-05-24T18:24:00+02:00,2025-05-25,02:24,1,1,2
70,2025-05-24T18:19:00+02:00,2025-05-25,02:19,0,2,2
77,2025-05-24T18:15:00+02:00,2025-05-25,02:15,1,0,1
84,2025-05-24T18:10:00+02:00,2025-05-25,02:10,4,8,12
84,2025-05-24T18:15:00+02:00,2025-05-25,02:15,11,24,35
87,2025-05-24T18:10:00+02:00,2025-05-25,02:10,1,0,1
87,2025-05-24T18:20:00+02:00,2025-05-25,02:20,1,0,1
108,2025-05-24T18:13:00+02:00,2025-05-25,02:13,1,0,1
108,2025-05-24T18:24:00+02:00,2025-05-25,02:24,1,0,1
132,2025-05-24T18:15:00+02:00,2025-05-25,02:15,0,2,2
132,2025-05-24T18:20:00+02:00,2025-05-25,02:20,3,0,3
162,2025-05-24T18:15:00+02:00,2025-05-25,02:15,3,7,10
166,2025-05-24T18:20:00+02:00,2025-05-25,02:20,2,0,2
1,2025-05-24T18:13:00+02:00,2025-05-25,02:13,1,4,5
1,2025-05-24T18:15:00+02:00,2025-05-25,02:15,1,0,1
1,2025-05-24T18:21:00+02:00,2025-05-25,02:21,0,1,1
2,2025-05-24T18:23:00+02:00,2025-05-25,02:23,0,6,6
2,2025-05-24T18:24:00+02:00,2025-05-25,02:24,2,2,4
9,2025-05-24T18:23:00+02:00,2025-05-25,02:23,2,0,2
17,2025-05-24T18:10:00+02:00,2025-05-25,02:10,0,1,1
17,2025-05-24T18:13:00+02:00,2025-05-25,02:13,1,0,1
17,2025-05-24T18:19:00+02:00,2025-05-25,02:19,2,0,2
19,2025-05-24T18:10:00+02:00,2025-05-25,02:10,5,9,14
19,2025-05-24T18:20:00+02:00,2025-05-25,02:20,2,3,5
19,2025-05-24T18:24:00+02:00,2025-05-25,02:24,4,9,13
20,2025-05-24T18:13:00+02:00,2025-05-25,02:13,5,1,6
20,2025-05-24T18:14:00+02:00,2025-05-25,02:14,5,0,5
20,2025-05-24T18:17:00+02:00,2025-05-25,02:17,2,2,4
20,2025-05-24T18:19:00+02:00,2025-05-25,02:19,4,3,7
20,2025-05-24T18:20:00+02:00,2025-05-25,02:20,0,1,1
20,2025-05-24T18:21:00+02:00,2025-05-25,02:21,2,2,4
20,2025-05-24T18:23:00+02:00,2025-05-25,02:23,0,2,2
23,2025-05-24T18:12:00+02:00,2025-05-25,02:12,2,0,2
23,2025-05-24T18:14:00+02:00,2025-05-25,02:14,3,0,3
23,2025-05-24T18:17:00+02:00,2025-05-25,02:17,2,0,2
24,2025-05-24T18:13:00+02:00,2025-05-25,02:13,0,4,4
181,2025-05-25T12:10:00+02:00,2025-05-25,20:10,7,9,16
24,2025-05-24T18:15:00+02:00,2025-05-25,02:15,0,4,4
181,2025-05-25T12:13:00+02:00,2025-05-25,20:13,13,12,25
24,2025-05-24T18:21:00+02:00,2025-05-25,02:21,1,4,5
181,2025-05-25T12:17:00+02:00,2025-05-25,20:17,19,3,22
25,2025-05-24T18:10:00+02:00,2025-05-25,02:10,0,3,3
181,2025-05-25T12:20:00+02:00,2025-05-25,20:20,4,10,14
25,2025-05-24T18:15:00+02:00,2025-05-25,02:15,2,2,4
182,2025-05-25T12:10:00+02:00,2025-05-25,20:10,22,29,51
25,2025-05-24T18:20:00+02:00,2025-05-25,02:20,13,5,18
182,2025-05-25T12:15:00+02:00,2025-05-25,20:15,17,8,25
27,2025-05-24T18:17:00+02:00,2025-05-25,02:17,2,1,3
180,2025-05-25T12:12:00+02:00,2025-05-25,20:12,1,0,1
30,2025-05-24T18:12:00+02:00,2025-05-25,02:12,1,4,5
30,2025-05-24T18:15:00+02:00,2025-05-25,02:15,4,3,7
30,2025-05-24T18:17:00+02:00,2025-05-25,02:17,2,1,3
30,2025-05-24T18:20:00+02:00,2025-05-25,02:20,11,0,11
30,2025-05-24T18:23:00+02:00,2025-05-25,02:23,0,2,2
30,2025-05-24T18:24:00+02:00,2025-05-25,02:24,1,2,3
35,2025-05-24T18:13:00+02:00,2025-05-25,02:13,1,0,1
35,2025-05-24T18:15:00+02:00,2025-05-25,02:15,1,0,1
35,2025-05-24T18:16:00+02:00,2025-05-25,02:16,1,0,1
35,2025-05-24T18:17:00+02:00,2025-05-25,02:17,0,1,1
35,2025-05-24T18:20:00+02:00,2025-05-25,02:20,0,1,1
181,2025-05-25T12:27:00+02:00,2025-05-25,20:27,18,3,21
35,2025-05-24T18:23:00+02:00,2025-05-25,02:23,1,1,2
181,2025-05-25T12:30:00+02:00,2025-05-25,20:30,8,12,20
49,2025-05-24T18:10:00+02:00,2025-05-25,02:10,4,1,5
181,2025-05-25T12:33:00+02:00,2025-05-25,20:33,5,10,15
49,2025-05-24T18:11:00+02:00,2025-05-25,02:11,0,1,1
181,2025-05-25T12:34:00+02:00,2025-05-25,20:34,2,14,16
49,2025-05-24T18:12:00+02:00,2025-05-25,02:12,7,0,7
181,2025-05-25T12:37:00+02:00,2025-05-25,20:37,14,14,28
49,2025-05-24T18:14:00+02:00,2025-05-25,02:14,0,7,7
182,2025-05-25T12:25:00+02:00,2025-05-25,20:25,11,17,28
49,2025-05-24T18:18:00+02:00,2025-05-25,02:18,1,1,2
182,2025-05-25T12:30:00+02:00,2025-05-25,20:30,25,16,41
49,2025-05-24T18:19:00+02:00,2025-05-25,02:19,7,0,7
49,2025-05-24T18:20:00+02:00,2025-05-25,02:20,0,1,1
49,2025-05-24T18:21:00+02:00,2025-05-25,02:21,3,1,4
49,2025-05-24T18:24:00+02:00,2025-05-25,02:24,1,0,1
51,2025-05-24T18:10:00+02:00,2025-05-25,02:10,2,0,2
51,2025-05-24T18:20:00+02:00,2025-05-25,02:20,0,1,1
51,2025-05-24T18:23:00+02:00,2025-05-25,02:23,0,1,1
52,2025-05-24T18:10:00+02:00,2025-05-25,02:10,4,1,5
52,2025-05-24T18:15:00+02:00,2025-05-25,02:15,7,1,8
52,2025-05-24T18:17:00+02:00,2025-05-25,02:17,1,0,1
52,2025-05-24T18:22:00+02:00,2025-05-25,02:22,1,2,3
52,2025-05-24T18:23:00+02:00,2025-05-25,02:23,0,1,1
53,2025-05-24T18:24:00+02:00,2025-05-25,02:24,1,0,1
56,2025-05-24T18:17:00+02:00,2025-05-25,02:17,1,0,1
56,2025-05-24T18:18:00+02:00,2025-05-25,02:18,0,2,2
56,2025-05-24T18:21:00+02:00,2025-05-25,02:21,0,5,5
58,2025-05-24T18:10:00+02:00,2025-05-25,02:10,0,2,2
58,2025-05-24T18:14:00+02:00,2025-05-25,02:14,1,2,3
58,2025-05-24T18:18:00+02:00,2025-05-25,02:18,1,0,1
58,2025-05-24T18:21:00+02:00,2025-05-25,02:21,1,2,3
58,2025-05-24T18:22:00+02:00,2025-05-25,02:22,2,0,2
58,2025-05-24T18:23:00+02:00,2025-05-25,02:23,2,1,3
58,2025-05-24T18:24:00+02:00,2025-05-25,02:24,0,1,1
62,2025-05-24T18:15:00+02:00,2025-05-25,02:15,2,4,6
62,2025-05-24T18:16:00+02:00,2025-05-25,02:16,3,0,3
62,2025-05-24T18:17:00+02:00,2025-05-25,02:17,2,0,2
62,2025-05-24T18:18:00+02:00,2025-05-25,02:18,4,4,8
62,2025-05-24T18:21:00+02:00,2025-05-25,02:21,0,2,2
62,2025-05-24T18:22:00+02:00,2025-05-25,02:22,3,0,3
63,2025-05-24T18:11:00+02:00,2025-05-25,02:11,0,1,1
63,2025-05-24T18:13:00+02:00,2025-05-25,02:13,0,2,2
63,2025-05-24T18:21:00+02:00,2025-05-25,02:21,0,3,3
67,2025-05-24T18:16:00+02:00,2025-05-25,02:16,1,1,2
67,2025-05-24T18:19:00+02:00,2025-05-25,02:19,0,2,2
67,2025-05-24T18:21:00+02:00,2025-05-25,02:21,0,1,1
72,2025-05-24T18:11:00+02:00,2025-05-25,02:11,0,1,1
72,2025-05-24T18:22:00+02:00,2025-05-25,02:22,1,0,1
79,2025-05-24T18:23:00+02:00,2025-05-25,02:23,1,1,2
79,2025-05-24T18:24:00+02:00,2025-05-25,02:24,1,2,3
109,2025-05-24T18:15:00+02:00,2025-05-25,02:15,1,0,1
136,2025-05-24T18:15:00+02:00,2025-05-25,02:15,1,0,1
137,2025-05-24T18:20:00+02:00,2025-05-25,02:20,0,2,2
139,2025-05-24T18:10:00+02:00,2025-05-25,02:10,1,0,1
3,2025-05-25T13:26:00+02:00,2025-05-25,21:26,18,7,25
141,2025-05-24T18:10:00+02:00,2025-05-25,02:10,9,2,11
3,2025-05-25T13:27:00+02:00,2025-05-25,21:27,6,10,16
141,2025-05-24T18:15:00+02:00,2025-05-25,02:15,12,5,17
3,2025-05-25T13:28:00+02:00,2025-05-25,21:28,8,15,23
141,2025-05-24T18:20:00+02:00,2025-05-25,02:20,13,7,20
3,2025-05-25T13:29:00+02:00,2025-05-25,21:29,24,5,29
164,2025-05-24T18:15:00+02:00,2025-05-25,02:15,0,1,1
3,2025-05-25T13:31:00+02:00,2025-05-25,21:31,4,7,11
3,2025-05-25T13:34:00+02:00,2025-05-25,21:34,2,1,3
3,2025-05-25T13:35:00+02:00,2025-05-25,21:35,12,8,20
3,2025-05-25T13:36:00+02:00,2025-05-25,21:36,15,3,18
3,2025-05-25T13:39:00+02:00,2025-05-25,21:39,5,4,9
4,2025-05-25T13:30:00+02:00,2025-05-25,21:30,1,7,8
4,2025-05-25T13:32:00+02:00,2025-05-25,21:32,6,2,8
4,2025-05-25T13:37:00+02:00,2025-05-25,21:37,5,8,13
181,2025-05-24T18:10:00+02:00,2025-05-25,02:10,2,4,6
6,2025-05-25T13:28:00+02:00,2025-05-25,21:28,2,9,11
181,2025-05-24T18:17:00+02:00,2025-05-25,02:17,4,5,9
6,2025-05-25T13:30:00+02:00,2025-05-25,21:30,20,6,26
181,2025-05-24T18:21:00+02:00,2025-05-25,02:21,0,3,3
6,2025-05-25T13:31:00+02:00,2025-05-25,21:31,5,12,17
181,2025-05-24T18:22:00+02:00,2025-05-25,02:22,3,4,7
6,2025-05-25T13:32:00+02:00,2025-05-25,21:32,6,1,7
6,2025-05-25T13:34:00+02:00,2025-05-25,21:34,7,5,12
6,2025-05-25T13:38:00+02:00,2025-05-25,21:38,1,9,10
21,2025-05-25T13:25:00+02:00,2025-05-25,21:25,20,16,36
28,2025-05-25T13:26:00+02:00,2025-05-25,21:26,1,0,1
28,2025-05-25T13:31:00+02:00,2025-05-25,21:31,0,1,1
28,2025-05-25T13:34:00+02:00,2025-05-25,21:34,0,2,2
29,2025-05-25T13:26:00+02:00,2025-05-25,21:26,0,5,5
29,2025-05-25T13:35:00+02:00,2025-05-25,21:35,2,1,3
29,2025-05-25T13:36:00+02:00,2025-05-25,21:36,6,4,10
29,2025-05-25T13:39:00+02:00,2025-05-25,21:39,1,0,1
31,2025-05-25T13:31:00+02:00,2025-05-25,21:31,1,3,4
31,2025-05-25T13:33:00+02:00,2025-05-25,21:33,8,2,10
31,2025-05-25T13:35:00+02:00,2025-05-25,21:35,6,10,16
31,2025-05-25T13:36:00+02:00,2025-05-25,21:36,2,5,7
39,2025-05-25T13:28:00+02:00,2025-05-25,21:28,1,0,1
39,2025-05-25T13:34:00+02:00,2025-05-25,21:34,1,0,1
39,2025-05-25T13:36:00+02:00,2025-05-25,21:36,0,1,1
40,2025-05-25T13:31:00+02:00,2025-05-25,21:31,2,0,2
40,2025-05-25T13:36:00+02:00,2025-05-25,21:36,1,0,1
40,2025-05-25T13:38:00+02:00,2025-05-25,21:38,1,0,1
41,2025-05-25T13:26:00+02:00,2025-05-25,21:26,2,1,3
41,2025-05-25T13:36:00+02:00,2025-05-25,21:36,3,3,6
43,2025-05-25T13:25:00+02:00,2025-05-25,21:25,1,1,2
43,2025-05-25T13:35:00+02:00,2025-05-25,21:35,2,4,6
45,2025-05-25T13:27:00+02:00,2025-05-25,21:27,1,8,9
45,2025-05-25T13:31:00+02:00,2025-05-25,21:31,3,10,13
45,2025-05-25T13:34:00+02:00,2025-05-25,21:34,3,14,17
45,2025-05-25T13:38:00+02:00,2025-05-25,21:38,6,4,10
47,2025-05-25T13:25:00+02:00,2025-05-25,21:25,7,0,7
47,2025-05-25T13:26:00+02:00,2025-05-25,21:26,6,12,18
47,2025-05-25T13:28:00+02:00,2025-05-25,21:28,6,1,7
47,2025-05-25T13:29:00+02:00,2025-05-25,21:29,0,4,4
47,2025-05-25T13:30:00+02:00,2025-05-25,21:30,4,4,8
47,2025-05-25T13:32:00+02:00,2025-05-25,21:32,9,9,18
47,2025-05-25T13:33:00+02:00,2025-05-25,21:33,2,7,9
47,2025-05-25T13:36:00+02:00,2025-05-25,21:36,13,7,20
47,2025-05-25T13:37:00+02:00,2025-05-25,21:37,7,2,9
47,2025-05-25T13:38:00+02:00,2025-05-25,21:38,9,2,11
47,2025-05-25T13:39:00+02:00,2025-05-25,21:39,2,1,3
50,2025-05-25T13:28:00+02:00,2025-05-25,21:28,2,0,2
50,2025-05-25T13:29:00+02:00,2025-05-25,21:29,2,0,2
50,2025-05-25T13:30:00+02:00,2025-05-25,21:30,4,0,4
50,2025-05-25T13:31:00+02:00,2025-05-25,21:31,0,4,4
50,2025-05-25T13:32:00+02:00,2025-05-25,21:32,1,0,1
54,2025-05-25T13:26:00+02:00,2025-05-25,21:26,0,2,2
54,2025-05-25T13:32:00+02:00,2025-05-25,21:32,4,0,4
59,2025-05-25T13:30:00+02:00,2025-05-25,21:30,5,12,17
61,2025-05-25T13:25:00+02:00,2025-05-25,21:25,5,0,5
61,2025-05-25T13:26:00+02:00,2025-05-25,21:26,6,0,6
61,2025-05-25T13:34:00+02:00,2025-05-25,21:34,4,0,4
61,2025-05-25T13:36:00+02:00,2025-05-25,21:36,3,0,3
66,2025-05-25T13:25:00+02:00,2025-05-25,21:25,19,10,29
66,2025-05-25T13:29:00+02:00,2025-05-25,21:29,5,12,17
66,2025-05-25T13:37:00+02:00,2025-05-25,21:37,20,8,28
70,2025-05-25T13:37:00+02:00,2025-05-25,21:37,14,6,20
71,2025-05-25T13:29:00+02:00,2025-05-25,21:29,1,0,1
75,2025-05-25T13:39:00+02:00,2025-05-25,21:39,1,0,1
77,2025-05-25T13:30:00+02:00,2025-05-25,21:30,2,5,7
87,2025-05-25T13:34:00+02:00,2025-05-25,21:34,1,3,4
87,2025-05-25T13:37:00+02:00,2025-05-25,21:37,3,4,7
108,2025-05-25T13:28:00+02:00,2025-05-25,21:28,1,1,2
108,2025-05-25T13:30:00+02:00,2025-05-25,21:30,3,1,4
131,2025-05-25T13:25:00+02:00,2025-05-25,21:25,2,7,9
131,2025-05-25T13:35:00+02:00,2025-05-25,21:35,1,13,14
132,2025-05-25T13:25:00+02:00,2025-05-25,21:25,12,6,18
132,2025-05-25T13:35:00+02:00,2025-05-25,21:35,6,2,8
133,2025-05-25T13:30:00+02:00,2025-05-25,21:30,20,14,34
162,2025-05-25T13:35:00+02:00,2025-05-25,21:35,1,5,6
165,2025-05-25T13:30:00+02:00,2025-05-25,21:30,2,0,2
166,2025-05-25T13:30:00+02:00,2025-05-25,21:30,0,1,1
167,2025-05-25T13:30:00+02:00,2025-05-25,21:30,1,0,1
179,2025-05-25T13:35:00+02:00,2025-05-25,21:35,3,4,7
1,2025-05-25T13:27:00+02:00,2025-05-25,21:27,1,1,2
1,2025-05-25T13:36:00+02:00,2025-05-25,21:36,1,3,4
1,2025-05-25T13:38:00+02:00,2025-05-25,21:38,3,0,3
2,2025-05-25T13:25:00+02:00,2025-05-25,21:25,0,5,5
2,2025-05-25T13:26:00+02:00,2025-05-25,21:26,0,4,4
2,2025-05-25T13:31:00+02:00,2025-05-25,21:31,2,4,6
2,2025-05-25T13:33:00+02:00,2025-05-25,21:33,1,0,1
2,2025-05-25T13:35:00+02:00,2025-05-25,21:35,1,0,1
9,2025-05-25T13:25:00+02:00,2025-05-25,21:25,0,1,1
9,2025-05-25T13:34:00+02:00,2025-05-25,21:34,4,0,4
9,2025-05-25T13:36:00+02:00,2025-05-25,21:36,3,0,3
9,2025-05-25T13:39:00+02:00,2025-05-25,21:39,1,0,1
11,2025-05-25T13:25:00+02:00,2025-05-25,21:25,3,1,4
11,2025-05-25T13:30:00+02:00,2025-05-25,21:30,9,0,9
12,2025-05-25T13:33:00+02:00,2025-05-25,21:33,2,0,2
12,2025-05-25T13:34:00+02:00,2025-05-25,21:34,0,1,1
12,2025-05-25T13:36:00+02:00,2025-05-25,21:36,5,1,6
12,2025-05-25T13:37:00+02:00,2025-05-25,21:37,6,1,7
12,2025-05-25T13:39:00+02:00,2025-05-25,21:39,4,0,4
17,2025-05-25T13:25:00+02:00,2025-05-25,21:25,0,1,1
17,2025-05-25T13:29:00+02:00,2025-05-25,21:29,3,0,3
17,2025-05-25T13:34:00+02:00,2025-05-25,21:34,0,2,2
19,2025-05-25T13:32:00+02:00,2025-05-25,21:32,0,8,8
19,2025-05-25T13:35:00+02:00,2025-05-25,21:35,2,2,4
19,2025-05-25T13:37:00+02:00,2025-05-25,21:37,10,13,23
20,2025-05-25T13:27:00+02:00,2025-05-25,21:27,0,7,7
20,2025-05-25T13:36:00+02:00,2025-05-25,21:36,5,3,8
20,2025-05-25T13:39:00+02:00,2025-05-25,21:39,0,20,20
23,2025-05-25T13:25:00+02:00,2025-05-25,21:25,2,6,8
23,2025-05-25T13:27:00+02:00,2025-05-25,21:27,0,13,13
23,2025-05-25T13:32:00+02:00,2025-05-25,21:32,1,1,2
23,2025-05-25T13:34:00+02:00,2025-05-25,21:34,1,7,8
23,2025-05-25T13:36:00+02:00,2025-05-25,21:36,1,0,1
23,2025-05-25T13:37:00+02:00,2025-05-25,21:37,0,3,3
24,2025-05-25T13:26:00+02:00,2025-05-25,21:26,0,2,2
24,2025-05-25T13:32:00+02:00,2025-05-25,21:32,1,3,4
24,2025-05-25T13:35:00+02:00,2025-05-25,21:35,5,8,13
24,2025-05-25T13:36:00+02:00,2025-05-25,21:36,3,2,5
24,2025-05-25T13:38:00+02:00,2025-05-25,21:38,1,1,2
25,2025-05-25T13:35:00+02:00,2025-05-25,21:35,12,15,27
27,2025-05-25T13:27:00+02:00,2025-05-25,21:27,2,1,3
27,2025-05-25T13:33:00+02:00,2025-05-25,21:33,6,0,6
27,2025-05-25T13:34:00+02:00,2025-05-25,21:34,2,0,2
27,2025-05-25T13:38:00+02:00,2025-05-25,21:38,1,1,2
30,2025-05-25T13:30:00+02:00,2025-05-25,21:30,3,4,7
30,2025-05-25T13:31:00+02:00,2025-05-25,21:31,3,4,7
30,2025-05-25T13:32:00+02:00,2025-05-25,21:32,0,4,4
30,2025-05-25T13:33:00+02:00,2025-05-25,21:33,3,3,6
30,2025-05-25T13:35:00+02:00,2025-05-25,21:35,2,10,12
30,2025-05-25T13:38:00+02:00,2025-05-25,21:38,2,6,8
35,2025-05-25T13:27:00+02:00,2025-05-25,21:27,1,1,2
35,2025-05-25T13:34:00+02:00,2025-05-25,21:34,4,5,9
35,2025-05-25T13:37:00+02:00,2025-05-25,21:37,17,10,27
48,2025-05-25T13:25:00+02:00,2025-05-25,21:25,4,5,9
48,2025-05-25T13:30:00+02:00,2025-05-25,21:30,1,1,2
48,2025-05-25T13:31:00+02:00,2025-05-25,21:31,0,2,2
49,2025-05-25T13:25:00+02:00,2025-05-25,21:25,2,2,4
49,2025-05-25T13:26:00+02:00,2025-05-25,21:26,5,0,5
49,2025-05-25T13:27:00+02:00,2025-05-25,21:27,0,2,2
49,2025-05-25T13:33:00+02:00,2025-05-25,21:33,3,3,6
49,2025-05-25T13:35:00+02:00,2025-05-25,21:35,1,0,1
49,2025-05-25T13:38:00+02:00,2025-05-25,21:38,4,0,4
51,2025-05-25T13:26:00+02:00,2025-05-25,21:26,0,2,2
51,2025-05-25T13:28:00+02:00,2025-05-25,21:28,0,2,2
51,2025-05-25T13:30:00+02:00,2025-05-25,21:30,0,1,1
51,2025-05-25T13:35:00+02:00,2025-05-25,21:35,0,2,2
51,2025-05-25T13:38:00+02:00,2025-05-25,21:38,1,0,1
51,2025-05-25T13:39:00+02:00,2025-05-25,21:39,0,2,2
52,2025-05-25T13:25:00+02:00,2025-05-25,21:25,0,2,2
52,2025-05-25T13:27:00+02:00,2025-05-25,21:27,0,1,1
52,2025-05-25T13:30:00+02:00,2025-05-25,21:30,10,3,13
52,2025-05-25T13:31:00+02:00,2025-05-25,21:31,5,8,13
52,2025-05-25T13:36:00+02:00,2025-05-25,21:36,0,1,1
52,2025-05-25T13:39:00+02:00,2025-05-25,21:39,3,3,6
53,2025-05-25T13:26:00+02:00,2025-05-25,21:26,2,4,6
53,2025-05-25T13:28:00+02:00,2025-05-25,21:28,0,3,3
53,2025-05-25T13:33:00+02:00,2025-05-25,21:33,2,2,4
53,2025-05-25T13:39:00+02:00,2025-05-25,21:39,2,0,2
56,2025-05-25T13:25:00+02:00,2025-05-25,21:25,0,2,2
56,2025-05-25T13:39:00+02:00,2025-05-25,21:39,2,15,17
58,2025-05-25T13:27:00+02:00,2025-05-25,21:27,1,4,5
58,2025-05-25T13:28:00+02:00,2025-05-25,21:28,8,3,11
58,2025-05-25T13:32:00+02:00,2025-05-25,21:32,5,2,7
58,2025-05-25T13:33:00+02:00,2025-05-25,21:33,4,0,4
58,2025-05-25T13:38:00+02:00,2025-05-25,21:38,5,3,8
62,2025-05-25T13:30:00+02:00,2025-05-25,21:30,6,3,9
62,2025-05-25T13:37:00+02:00,2025-05-25,21:37,1,3,4
63,2025-05-25T13:32:00+02:00,2025-05-25,21:32,0,3,3
67,2025-05-25T13:26:00+02:00,2025-05-25,21:26,0,2,2
67,2025-05-25T13:27:00+02:00,2025-05-25,21:27,0,2,2
67,2025-05-25T13:28:00+02:00,2025-05-25,21:28,1,2,3
67,2025-05-25T13:33:00+02:00,2025-05-25,21:33,1,1,2
68,2025-05-25T13:25:00+02:00,2025-05-25,21:25,0,1,1
68,2025-05-25T13:26:00+02:00,2025-05-25,21:26,2,0,2
68,2025-05-25T13:28:00+02:00,2025-05-25,21:28,0,1,1
68,2025-05-25T13:38:00+02:00,2025-05-25,21:38,4,0,4
72,2025-05-25T13:25:00+02:00,2025-05-25,21:25,5,0,5
72,2025-05-25T13:27:00+02:00,2025-05-25,21:27,1,4,5
72,2025-05-25T13:28:00+02:00,2025-05-25,21:28,3,3,6
72,2025-05-25T13:32:00+02:00,2025-05-25,21:32,1,1,2
72,2025-05-25T13:33:00+02:00,2025-05-25,21:33,0,1,1
72,2025-05-25T13:35:00+02:00,2025-05-25,21:35,0,2,2
79,2025-05-25T13:26:00+02:00,2025-05-25,21:26,2,4,6
79,2025-05-25T13:29:00+02:00,2025-05-25,21:29,2,0,2
79,2025-05-25T13:30:00+02:00,2025-05-25,21:30,1,2,3
79,2025-05-25T13:31:00+02:00,2025-05-25,21:31,3,2,5
79,2025-05-25T13:37:00+02:00,2025-05-25,21:37,0,2,2
85,2025-05-25T13:39:00+02:00,2025-05-25,21:39,0,1,1
86,2025-05-25T13:33:00+02:00,2025-05-25,21:33,0,6,6
86,2025-05-25T13:37:00+02:00,2025-05-25,21:37,0,2,2
86,2025-05-25T13:38:00+02:00,2025-05-25,21:38,1,6,7
123,2025-05-25T13:30:00+02:00,2025-05-25,21:30,3,0,3
123,2025-05-25T13:35:00+02:00,2025-05-25,21:35,1,0,1
130,2025-05-25T13:30:00+02:00,2025-05-25,21:30,2,0,2
137,2025-05-25T13:25:00+02:00,2025-05-25,21:25,0,1,1
141,2025-05-25T13:25:00+02:00,2025-05-25,21:25,1,6,7
142,2025-05-25T13:25:00+02:00,2025-05-25,21:25,4,0,4
161,2025-05-25T13:35:00+02:00,2025-05-25,21:35,0,6,6
3,2025-05-25T14:01:00+02:00,2025-05-25,22:01,2,5,7
3,2025-05-25T14:02:00+02:00,2025-05-25,22:02,24,5,29
3,2025-05-25T14:03:00+02:00,2025-05-25,22:03,14,4,18
3,2025-05-25T14:04:00+02:00,2025-05-25,22:04,14,1,15
3,2025-05-25T14:06:00+02:00,2025-05-25,22:06,10,4,14
3,2025-05-25T14:07:00+02:00,2025-05-25,22:07,0,5,5
3,2025-05-25T14:09:00+02:00,2025-05-25,22:09,5,2,7
4,2025-05-25T13:56:00+02:00,2025-05-25,21:56,16,23,39
4,2025-05-25T13:57:00+02:00,2025-05-25,21:57,16,11,27
4,2025-05-25T13:58:00+02:00,2025-05-25,21:58,17,7,24
4,2025-05-25T13:59:00+02:00,2025-05-25,21:59,10,13,23
4,2025-05-25T14:03:00+02:00,2025-05-25,22:03,7,5,12
5,2025-05-25T13:55:00+02:00,2025-05-25,21:55,36,23,59
5,2025-05-25T14:05:00+02:00,2025-05-25,22:05,197,11,208
6,2025-05-25T13:56:00+02:00,2025-05-25,21:56,5,5,10
6,2025-05-25T13:57:00+02:00,2025-05-25,21:57,2,6,8
6,2025-05-25T13:58:00+02:00,2025-05-25,21:58,2,1,3
6,2025-05-25T14:00:00+02:00,2025-05-25,22:00,4,4,8
6,2025-05-25T14:04:00+02:00,2025-05-25,22:04,7,0,7
6,2025-05-25T14:06:00+02:00,2025-05-25,22:06,3,5,8
6,2025-05-25T14:07:00+02:00,2025-05-25,22:07,1,2,3
6,2025-05-25T14:09:00+02:00,2025-05-25,22:09,1,4,5
8,2025-05-25T13:56:00+02:00,2025-05-25,21:56,0,1,1
21,2025-05-25T13:55:00+02:00,2025-05-25,21:55,12,15,27
21,2025-05-25T14:00:00+02:00,2025-05-25,22:00,14,5,19
21,2025-05-25T14:05:00+02:00,2025-05-25,22:05,8,14,22
28,2025-05-25T14:01:00+02:00,2025-05-25,22:01,64,1,65
28,2025-05-25T14:02:00+02:00,2025-05-25,22:02,51,1,52
28,2025-05-25T14:04:00+02:00,2025-05-25,22:04,57,1,58
28,2025-05-25T14:05:00+02:00,2025-05-25,22:05,41,0,41
28,2025-05-25T14:06:00+02:00,2025-05-25,22:06,19,1,20
29,2025-05-25T13:55:00+02:00,2025-05-25,21:55,3,0,3
29,2025-05-25T13:57:00+02:00,2025-05-25,21:57,2,1,3
29,2025-05-25T14:00:00+02:00,2025-05-25,22:00,14,20,34
29,2025-05-25T14:03:00+02:00,2025-05-25,22:03,11,1,12
29,2025-05-25T14:04:00+02:00,2025-05-25,22:04,2,0,2
31,2025-05-25T13:55:00+02:00,2025-05-25,21:55,0,6,6
31,2025-05-25T14:01:00+02:00,2025-05-25,22:01,3,0,3
31,2025-05-25T14:03:00+02:00,2025-05-25,22:03,2,1,3
31,2025-05-25T14:04:00+02:00,2025-05-25,22:04,2,1,3
31,2025-05-25T14:06:00+02:00,2025-05-25,22:06,0,9,9
31,2025-05-25T14:07:00+02:00,2025-05-25,22:07,1,4,5
31,2025-05-25T14:08:00+02:00,2025-05-25,22:08,1,4,5
36,2025-05-25T14:00:00+02:00,2025-05-25,22:00,2,2,4
36,2025-05-25T14:03:00+02:00,2025-05-25,22:03,0,4,4
36,2025-05-25T14:08:00+02:00,2025-05-25,22:08,2,0,2
40,2025-05-25T13:55:00+02:00,2025-05-25,21:55,2,2,4
181,2025-05-24T16:54:00+02:00,2025-05-25,00:54,6,4,10
40,2025-05-25T13:56:00+02:00,2025-05-25,21:56,0,1,1
182,2025-05-24T16:50:00+02:00,2025-05-25,00:50,9,9,18
41,2025-05-25T13:56:00+02:00,2025-05-25,21:56,3,0,3
180,2025-05-24T16:43:00+02:00,2025-05-25,00:43,0,2,2
41,2025-05-25T13:58:00+02:00,2025-05-25,21:58,2,0,2
41,2025-05-25T13:59:00+02:00,2025-05-25,21:59,0,2,2
41,2025-05-25T14:03:00+02:00,2025-05-25,22:03,0,1,1
41,2025-05-25T14:05:00+02:00,2025-05-25,22:05,1,1,2
41,2025-05-25T14:06:00+02:00,2025-05-25,22:06,3,0,3
41,2025-05-25T14:09:00+02:00,2025-05-25,22:09,0,5,5
43,2025-05-25T14:00:00+02:00,2025-05-25,22:00,0,2,2
44,2025-05-25T14:05:00+02:00,2025-05-25,22:05,2,0,2
45,2025-05-25T13:56:00+02:00,2025-05-25,21:56,5,4,9
45,2025-05-25T13:57:00+02:00,2025-05-25,21:57,4,0,4
45,2025-05-25T14:03:00+02:00,2025-05-25,22:03,5,2,7
45,2025-05-25T14:05:00+02:00,2025-05-25,22:05,4,6,10
45,2025-05-25T14:07:00+02:00,2025-05-25,22:07,14,5,19
45,2025-05-25T14:09:00+02:00,2025-05-25,22:09,3,4,7
47,2025-05-25T13:57:00+02:00,2025-05-25,21:57,16,3,19
47,2025-05-25T13:58:00+02:00,2025-05-25,21:58,5,5,10
47,2025-05-25T14:06:00+02:00,2025-05-25,22:06,4,3,7
50,2025-05-25T13:56:00+02:00,2025-05-25,21:56,3,1,4
50,2025-05-25T13:59:00+02:00,2025-05-25,21:59,2,0,2
50,2025-05-25T14:01:00+02:00,2025-05-25,22:01,0,2,2
50,2025-05-25T14:04:00+02:00,2025-05-25,22:04,2,0,2
50,2025-05-25T14:07:00+02:00,2025-05-25,22:07,0,1,1
54,2025-05-25T13:55:00+02:00,2025-05-25,21:55,3,0,3
54,2025-05-25T13:56:00+02:00,2025-05-25,21:56,1,0,1
54,2025-05-25T14:05:00+02:00,2025-05-25,22:05,3,1,4
54,2025-05-25T14:06:00+02:00,2025-05-25,22:06,5,1,6
54,2025-05-25T14:09:00+02:00,2025-05-25,22:09,1,2,3
59,2025-05-25T13:55:00+02:00,2025-05-25,21:55,10,6,16
61,2025-05-25T13:59:00+02:00,2025-05-25,21:59,3,2,5
61,2025-05-25T14:01:00+02:00,2025-05-25,22:01,0,1,1
61,2025-05-25T14:07:00+02:00,2025-05-25,22:07,9,1,10
61,2025-05-25T14:09:00+02:00,2025-05-25,22:09,6,2,8
66,2025-05-25T13:55:00+02:00,2025-05-25,21:55,12,4,16
66,2025-05-25T13:58:00+02:00,2025-05-25,21:58,20,3,23
66,2025-05-25T14:02:00+02:00,2025-05-25,22:02,4,4,8
66,2025-05-25T14:03:00+02:00,2025-05-25,22:03,18,8,26
66,2025-05-25T14:05:00+02:00,2025-05-25,22:05,3,11,14
66,2025-05-25T14:06:00+02:00,2025-05-25,22:06,12,6,18
66,2025-05-25T14:07:00+02:00,2025-05-25,22:07,10,10,20
66,2025-05-25T14:09:00+02:00,2025-05-25,22:09,13,1,14
69,2025-05-25T13:57:00+02:00,2025-05-25,21:57,1,0,1
70,2025-05-25T14:02:00+02:00,2025-05-25,22:02,2,1,3
70,2025-05-25T14:09:00+02:00,2025-05-25,22:09,1,1,2
75,2025-05-25T14:09:00+02:00,2025-05-25,22:09,1,0,1
78,2025-05-25T13:58:00+02:00,2025-05-25,21:58,0,1,1
78,2025-05-25T14:02:00+02:00,2025-05-25,22:02,0,1,1
87,2025-05-25T14:06:00+02:00,2025-05-25,22:06,0,4,4
107,2025-05-25T13:55:00+02:00,2025-05-25,21:55,5,7,12
108,2025-05-25T14:00:00+02:00,2025-05-25,22:00,7,0,7
108,2025-05-25T14:01:00+02:00,2025-05-25,22:01,1,5,6
108,2025-05-25T14:05:00+02:00,2025-05-25,22:05,6,0,6
108,2025-05-25T14:08:00+02:00,2025-05-25,22:08,2,0,2
118,2025-05-25T14:05:00+02:00,2025-05-25,22:05,1,2,3
131,2025-05-25T14:05:00+02:00,2025-05-25,22:05,6,1,7
132,2025-05-25T14:00:00+02:00,2025-05-25,22:00,2,4,6
132,2025-05-25T14:05:00+02:00,2025-05-25,22:05,2,3,5
133,2025-05-25T14:05:00+02:00,2025-05-25,22:05,35,14,49
135,2025-05-25T13:55:00+02:00,2025-05-25,21:55,4,8,12
135,2025-05-25T14:00:00+02:00,2025-05-25,22:00,11,9,20
162,2025-05-25T14:00:00+02:00,2025-05-25,22:00,4,7,11
166,2025-05-25T13:55:00+02:00,2025-05-25,21:55,2,0,2
167,2025-05-25T13:55:00+02:00,2025-05-25,21:55,0,1,1
167,2025-05-25T14:05:00+02:00,2025-05-25,22:05,2,2,4
1,2025-05-25T14:01:00+02:00,2025-05-25,22:01,5,0,5
1,2025-05-25T14:08:00+02:00,2025-05-25,22:08,3,0,3
2,2025-05-25T13:56:00+02:00,2025-05-25,21:56,0,3,3
2,2025-05-25T14:00:00+02:00,2025-05-25,22:00,0,1,1
2,2025-05-25T14:02:00+02:00,2025-05-25,22:02,0,2,2
2,2025-05-25T14:04:00+02:00,2025-05-25,22:04,0,2,2
9,2025-05-25T14:01:00+02:00,2025-05-25,22:01,1,0,1
9,2025-05-25T14:02:00+02:00,2025-05-25,22:02,0,2,2
11,2025-05-25T14:05:00+02:00,2025-05-25,22:05,1,1,2
12,2025-05-25T13:56:00+02:00,2025-05-25,21:56,1,0,1
12,2025-05-25T14:00:00+02:00,2025-05-25,22:00,1,0,1
12,2025-05-25T14:01:00+02:00,2025-05-25,22:01,0,3,3
12,2025-05-25T14:06:00+02:00,2025-05-25,22:06,1,0,1
17,2025-05-25T14:06:00+02:00,2025-05-25,22:06,1,1,2
17,2025-05-25T14:07:00+02:00,2025-05-25,22:07,1,4,5
18,2025-05-25T14:00:00+02:00,2025-05-25,22:00,1,0,1
18,2025-05-25T14:09:00+02:00,2025-05-25,22:09,1,0,1
19,2025-05-25T13:58:00+02:00,2025-05-25,21:58,8,7,15
19,2025-05-25T14:01:00+02:00,2025-05-25,22:01,6,12,18
19,2025-05-25T14:02:00+02:00,2025-05-25,22:02,3,8,11
19,2025-05-25T14:03:00+02:00,2025-05-25,22:03,1,5,6
19,2025-05-25T14:06:00+02:00,2025-05-25,22:06,0,8,8
19,2025-05-25T14:08:00+02:00,2025-05-25,22:08,6,6,12
20,2025-05-25T13:57:00+02:00,2025-05-25,21:57,2,3,5
20,2025-05-25T13:58:00+02:00,2025-05-25,21:58,0,3,3
20,2025-05-25T14:02:00+02:00,2025-05-25,22:02,0,7,7
20,2025-05-25T14:03:00+02:00,2025-05-25,22:03,1,2,3
20,2025-05-25T14:05:00+02:00,2025-05-25,22:05,0,2,2
20,2025-05-25T14:06:00+02:00,2025-05-25,22:06,0,2,2
20,2025-05-25T14:09:00+02:00,2025-05-25,22:09,0,3,3
23,2025-05-25T13:55:00+02:00,2025-05-25,21:55,2,1,3
23,2025-05-25T13:56:00+02:00,2025-05-25,21:56,0,2,2
23,2025-05-25T14:06:00+02:00,2025-05-25,22:06,1,0,1
23,2025-05-25T14:08:00+02:00,2025-05-25,22:08,0,5,5
24,2025-05-25T13:57:00+02:00,2025-05-25,21:57,1,7,8
24,2025-05-25T14:00:00+02:00,2025-05-25,22:00,1,4,5
24,2025-05-25T14:09:00+02:00,2025-05-25,22:09,0,14,14
25,2025-05-25T13:55:00+02:00,2025-05-25,21:55,5,8,13
25,2025-05-25T14:05:00+02:00,2025-05-25,22:05,5,15,20
27,2025-05-25T13:57:00+02:00,2025-05-25,21:57,0,1,1
27,2025-05-25T13:58:00+02:00,2025-05-25,21:58,0,1,1
27,2025-05-25T14:07:00+02:00,2025-05-25,22:07,0,1,1
27,2025-05-25T14:08:00+02:00,2025-05-25,22:08,5,1,6
30,2025-05-25T13:58:00+02:00,2025-05-25,21:58,5,0,5
30,2025-05-25T13:59:00+02:00,2025-05-25,21:59,3,14,17
30,2025-05-25T14:03:00+02:00,2025-05-25,22:03,3,5,8
30,2025-05-25T14:07:00+02:00,2025-05-25,22:07,7,2,9
35,2025-05-25T13:59:00+02:00,2025-05-25,21:59,3,2,5
35,2025-05-25T14:03:00+02:00,2025-05-25,22:03,0,8,8
35,2025-05-25T14:04:00+02:00,2025-05-25,22:04,0,15,15
35,2025-05-25T14:05:00+02:00,2025-05-25,22:05,2,12,14
35,2025-05-25T14:06:00+02:00,2025-05-25,22:06,7,11,18
35,2025-05-25T14:08:00+02:00,2025-05-25,22:08,5,8,13
35,2025-05-25T14:09:00+02:00,2025-05-25,22:09,4,8,12
48,2025-05-25T14:00:00+02:00,2025-05-25,22:00,1,1,2
48,2025-05-25T14:04:00+02:00,2025-05-25,22:04,2,5,7
49,2025-05-25T13:57:00+02:00,2025-05-25,21:57,4,9,13
49,2025-05-25T13:59:00+02:00,2025-05-25,21:59,0,2,2
49,2025-05-25T14:01:00+02:00,2025-05-25,22:01,6,0,6
49,2025-05-25T14:04:00+02:00,2025-05-25,22:04,2,6,8
49,2025-05-25T14:06:00+02:00,2025-05-25,22:06,3,0,3
49,2025-05-25T14:07:00+02:00,2025-05-25,22:07,2,0,2
51,2025-05-25T14:00:00+02:00,2025-05-25,22:00,0,5,5
51,2025-05-25T14:07:00+02:00,2025-05-25,22:07,2,2,4
51,2025-05-25T14:09:00+02:00,2025-05-25,22:09,1,0,1
52,2025-05-25T13:59:00+02:00,2025-05-25,21:59,5,4,9
52,2025-05-25T14:05:00+02:00,2025-05-25,22:05,0,6,6
53,2025-05-25T13:56:00+02:00,2025-05-25,21:56,2,0,2
53,2025-05-25T13:57:00+02:00,2025-05-25,21:57,0,3,3
53,2025-05-25T14:00:00+02:00,2025-05-25,22:00,1,3,4
53,2025-05-25T14:03:00+02:00,2025-05-25,22:03,2,2,4
53,2025-05-25T14:07:00+02:00,2025-05-25,22:07,2,1,3
56,2025-05-25T13:58:00+02:00,2025-05-25,21:58,5,1,6
56,2025-05-25T14:09:00+02:00,2025-05-25,22:09,3,1,4
58,2025-05-25T14:04:00+02:00,2025-05-25,22:04,3,3,6
58,2025-05-25T14:08:00+02:00,2025-05-25,22:08,1,2,3
58,2025-05-25T14:09:00+02:00,2025-05-25,22:09,6,4,10
62,2025-05-25T13:55:00+02:00,2025-05-25,21:55,2,7,9
62,2025-05-25T13:56:00+02:00,2025-05-25,21:56,2,0,2
62,2025-05-25T13:57:00+02:00,2025-05-25,21:57,0,2,2
62,2025-05-25T13:58:00+02:00,2025-05-25,21:58,1,0,1
62,2025-05-25T14:06:00+02:00,2025-05-25,22:06,2,3,5
63,2025-05-25T14:03:00+02:00,2025-05-25,22:03,0,4,4
63,2025-05-25T14:04:00+02:00,2025-05-25,22:04,1,0,1
67,2025-05-25T13:58:00+02:00,2025-05-25,21:58,6,5,11
67,2025-05-25T13:59:00+02:00,2025-05-25,21:59,0,3,3
67,2025-05-25T14:09:00+02:00,2025-05-25,22:09,1,3,4
68,2025-05-25T14:05:00+02:00,2025-05-25,22:05,0,1,1
72,2025-05-25T14:03:00+02:00,2025-05-25,22:03,0,1,1
72,2025-05-25T14:04:00+02:00,2025-05-25,22:04,1,1,2
72,2025-05-25T14:06:00+02:00,2025-05-25,22:06,4,0,4
76,2025-05-25T13:59:00+02:00,2025-05-25,21:59,0,1,1
76,2025-05-25T14:05:00+02:00,2025-05-25,22:05,0,2,2
79,2025-05-25T13:55:00+02:00,2025-05-25,21:55,1,9,10
79,2025-05-25T13:57:00+02:00,2025-05-25,21:57,5,4,9
79,2025-05-25T14:00:00+02:00,2025-05-25,22:00,0,7,7
79,2025-05-25T14:02:00+02:00,2025-05-25,22:02,0,3,3
79,2025-05-25T14:04:00+02:00,2025-05-25,22:04,2,3,5
3,2025-05-24T17:16:00+02:00,2025-05-25,01:16,13,0,13
79,2025-05-25T14:06:00+02:00,2025-05-25,22:06,1,8,9
3,2025-05-24T17:17:00+02:00,2025-05-25,01:17,0,2,2
79,2025-05-25T14:07:00+02:00,2025-05-25,22:07,5,2,7
3,2025-05-24T17:23:00+02:00,2025-05-25,01:23,1,3,4
79,2025-05-25T14:09:00+02:00,2025-05-25,22:09,5,8,13
3,2025-05-24T17:24:00+02:00,2025-05-25,01:24,2,0,2
85,2025-05-25T13:58:00+02:00,2025-05-25,21:58,0,1,1
4,2025-05-24T17:14:00+02:00,2025-05-25,01:14,1,11,12
109,2025-05-25T13:55:00+02:00,2025-05-25,21:55,1,4,5
4,2025-05-24T17:19:00+02:00,2025-05-25,01:19,0,7,7
109,2025-05-25T14:05:00+02:00,2025-05-25,22:05,1,4,5
5,2025-05-24T17:10:00+02:00,2025-05-25,01:10,2,9,11
117,2025-05-25T14:00:00+02:00,2025-05-25,22:00,4,4,8
5,2025-05-24T17:20:00+02:00,2025-05-25,01:20,2,8,10
137,2025-05-25T13:55:00+02:00,2025-05-25,21:55,1,0,1
6,2025-05-24T17:12:00+02:00,2025-05-25,01:12,7,1,8
141,2025-05-25T13:55:00+02:00,2025-05-25,21:55,2,5,7
6,2025-05-24T17:13:00+02:00,2025-05-25,01:13,12,2,14
141,2025-05-25T14:00:00+02:00,2025-05-25,22:00,4,8,12
6,2025-05-24T17:14:00+02:00,2025-05-25,01:14,9,2,11
142,2025-05-25T14:00:00+02:00,2025-05-25,22:00,2,9,11
6,2025-05-24T17:22:00+02:00,2025-05-25,01:22,1,1,2
3,2025-05-25T13:40:00+02:00,2025-05-25,21:40,1,4,5
8,2025-05-24T17:20:00+02:00,2025-05-25,01:20,2,0,2
3,2025-05-25T13:41:00+02:00,2025-05-25,21:41,1,7,8
28,2025-05-24T17:20:00+02:00,2025-05-25,01:20,0,1,1
3,2025-05-25T13:44:00+02:00,2025-05-25,21:44,5,1,6
29,2025-05-24T17:18:00+02:00,2025-05-25,01:18,0,1,1
3,2025-05-25T13:48:00+02:00,2025-05-25,21:48,3,7,10
31,2025-05-24T17:11:00+02:00,2025-05-25,01:11,1,0,1
3,2025-05-25T13:49:00+02:00,2025-05-25,21:49,15,12,27
31,2025-05-24T17:20:00+02:00,2025-05-25,01:20,0,2,2
4,2025-05-25T13:42:00+02:00,2025-05-25,21:42,10,4,14
36,2025-05-24T17:10:00+02:00,2025-05-25,01:10,0,1,1
4,2025-05-25T13:43:00+02:00,2025-05-25,21:43,5,4,9
36,2025-05-24T17:11:00+02:00,2025-05-25,01:11,0,1,1
4,2025-05-25T13:45:00+02:00,2025-05-25,21:45,24,12,36
36,2025-05-24T17:19:00+02:00,2025-05-25,01:19,0,2,2
4,2025-05-25T13:49:00+02:00,2025-05-25,21:49,14,25,39
36,2025-05-24T17:24:00+02:00,2025-05-25,01:24,4,1,5
4,2025-05-25T13:51:00+02:00,2025-05-25,21:51,11,20,31
37,2025-05-24T17:16:00+02:00,2025-05-25,01:16,0,1,1
4,2025-05-25T13:52:00+02:00,2025-05-25,21:52,12,14,26
39,2025-05-24T17:14:00+02:00,2025-05-25,01:14,0,1,1
6,2025-05-25T13:40:00+02:00,2025-05-25,21:40,5,7,12
40,2025-05-24T17:23:00+02:00,2025-05-25,01:23,1,2,3
6,2025-05-25T13:41:00+02:00,2025-05-25,21:41,6,10,16
41,2025-05-24T17:12:00+02:00,2025-05-25,01:12,1,0,1
6,2025-05-25T13:46:00+02:00,2025-05-25,21:46,18,0,18
41,2025-05-24T17:18:00+02:00,2025-05-25,01:18,2,4,6
6,2025-05-25T13:47:00+02:00,2025-05-25,21:47,5,7,12
41,2025-05-24T17:21:00+02:00,2025-05-25,01:21,4,14,18
6,2025-05-25T13:48:00+02:00,2025-05-25,21:48,4,2,6
45,2025-05-24T17:10:00+02:00,2025-05-25,01:10,5,2,7
6,2025-05-25T13:53:00+02:00,2025-05-25,21:53,1,3,4
45,2025-05-24T17:14:00+02:00,2025-05-25,01:14,0,6,6
6,2025-05-25T13:54:00+02:00,2025-05-25,21:54,7,3,10
45,2025-05-24T17:18:00+02:00,2025-05-25,01:18,3,4,7
8,2025-05-25T13:40:00+02:00,2025-05-25,21:40,0,1,1
45,2025-05-24T17:19:00+02:00,2025-05-25,01:19,0,3,3
21,2025-05-25T13:40:00+02:00,2025-05-25,21:40,8,14,22
45,2025-05-24T17:22:00+02:00,2025-05-25,01:22,1,0,1
28,2025-05-25T13:41:00+02:00,2025-05-25,21:41,5,0,5
45,2025-05-24T17:24:00+02:00,2025-05-25,01:24,0,3,3
28,2025-05-25T13:44:00+02:00,2025-05-25,21:44,12,3,15
47,2025-05-24T17:15:00+02:00,2025-05-25,01:15,0,7,7
28,2025-05-25T13:45:00+02:00,2025-05-25,21:45,4,0,4
47,2025-05-24T17:16:00+02:00,2025-05-25,01:16,4,7,11
28,2025-05-25T13:46:00+02:00,2025-05-25,21:46,2,1,3
47,2025-05-24T17:18:00+02:00,2025-05-25,01:18,0,2,2
28,2025-05-25T13:50:00+02:00,2025-05-25,21:50,0,3,3
47,2025-05-24T17:20:00+02:00,2025-05-25,01:20,0,4,4
29,2025-05-25T13:40:00+02:00,2025-05-25,21:40,2,3,5
47,2025-05-24T17:24:00+02:00,2025-05-25,01:24,1,2,3
29,2025-05-25T13:46:00+02:00,2025-05-25,21:46,0,8,8
50,2025-05-24T17:15:00+02:00,2025-05-25,01:15,1,0,1
29,2025-05-25T13:48:00+02:00,2025-05-25,21:48,0,2,2
54,2025-05-24T17:11:00+02:00,2025-05-25,01:11,0,2,2
29,2025-05-25T13:49:00+02:00,2025-05-25,21:49,1,4,5
54,2025-05-24T17:18:00+02:00,2025-05-25,01:18,2,2,4
29,2025-05-25T13:52:00+02:00,2025-05-25,21:52,1,0,1
66,2025-05-24T17:13:00+02:00,2025-05-25,01:13,3,6,9
29,2025-05-25T13:53:00+02:00,2025-05-25,21:53,2,1,3
66,2025-05-24T17:14:00+02:00,2025-05-25,01:14,1,2,3
31,2025-05-25T13:43:00+02:00,2025-05-25,21:43,0,1,1
66,2025-05-24T17:17:00+02:00,2025-05-25,01:17,0,4,4
31,2025-05-25T13:46:00+02:00,2025-05-25,21:46,4,0,4
66,2025-05-24T17:18:00+02:00,2025-05-25,01:18,4,0,4
31,2025-05-25T13:54:00+02:00,2025-05-25,21:54,1,7,8
66,2025-05-24T17:20:00+02:00,2025-05-25,01:20,6,0,6
36,2025-05-25T13:41:00+02:00,2025-05-25,21:41,2,1,3
66,2025-05-24T17:23:00+02:00,2025-05-25,01:23,2,0,2
36,2025-05-25T13:51:00+02:00,2025-05-25,21:51,3,2,5
69,2025-05-24T17:10:00+02:00,2025-05-25,01:10,2,0,2
39,2025-05-25T13:45:00+02:00,2025-05-25,21:45,1,0,1
70,2025-05-24T17:15:00+02:00,2025-05-25,01:15,0,2,2
40,2025-05-25T13:49:00+02:00,2025-05-25,21:49,2,1,3
84,2025-05-24T17:15:00+02:00,2025-05-25,01:15,21,13,34
40,2025-05-25T13:51:00+02:00,2025-05-25,21:51,6,0,6
107,2025-05-24T17:20:00+02:00,2025-05-25,01:20,1,3,4
41,2025-05-25T13:40:00+02:00,2025-05-25,21:40,1,0,1
108,2025-05-24T17:10:00+02:00,2025-05-25,01:10,3,2,5
41,2025-05-25T13:48:00+02:00,2025-05-25,21:48,2,3,5
108,2025-05-24T17:11:00+02:00,2025-05-25,01:11,2,3,5
41,2025-05-25T13:49:00+02:00,2025-05-25,21:49,10,6,16
108,2025-05-24T17:15:00+02:00,2025-05-25,01:15,0,6,6
41,2025-05-25T13:52:00+02:00,2025-05-25,21:52,1,0,1
108,2025-05-24T17:17:00+02:00,2025-05-25,01:17,2,0,2
43,2025-05-25T13:45:00+02:00,2025-05-25,21:45,2,3,5
131,2025-05-24T17:15:00+02:00,2025-05-25,01:15,14,8,22
44,2025-05-25T13:40:00+02:00,2025-05-25,21:40,2,0,2
131,2025-05-24T17:20:00+02:00,2025-05-25,01:20,18,22,40
45,2025-05-25T13:40:00+02:00,2025-05-25,21:40,7,8,15
132,2025-05-24T17:15:00+02:00,2025-05-25,01:15,1,7,8
45,2025-05-25T13:41:00+02:00,2025-05-25,21:41,2,13,15
133,2025-05-24T17:10:00+02:00,2025-05-25,01:10,7,0,7
45,2025-05-25T13:42:00+02:00,2025-05-25,21:42,15,4,19
133,2025-05-24T17:20:00+02:00,2025-05-25,01:20,2,0,2
45,2025-05-25T13:43:00+02:00,2025-05-25,21:43,7,13,20
135,2025-05-24T17:15:00+02:00,2025-05-25,01:15,0,1,1
45,2025-05-25T13:45:00+02:00,2025-05-25,21:45,7,10,17
162,2025-05-24T17:20:00+02:00,2025-05-25,01:20,5,5,10
45,2025-05-25T13:50:00+02:00,2025-05-25,21:50,12,2,14
167,2025-05-24T17:20:00+02:00,2025-05-25,01:20,0,2,2
45,2025-05-25T13:51:00+02:00,2025-05-25,21:51,12,10,22
179,2025-05-24T17:10:00+02:00,2025-05-25,01:10,0,2,2
47,2025-05-25T13:40:00+02:00,2025-05-25,21:40,7,0,7
179,2025-05-24T17:20:00+02:00,2025-05-25,01:20,4,0,4
47,2025-05-25T13:42:00+02:00,2025-05-25,21:42,9,2,11
1,2025-05-24T17:12:00+02:00,2025-05-25,01:12,1,1,2
47,2025-05-25T13:44:00+02:00,2025-05-25,21:44,5,1,6
1,2025-05-24T17:18:00+02:00,2025-05-25,01:18,1,1,2
47,2025-05-25T13:45:00+02:00,2025-05-25,21:45,0,1,1
1,2025-05-24T17:19:00+02:00,2025-05-25,01:19,1,2,3
50,2025-05-25T13:42:00+02:00,2025-05-25,21:42,1,1,2
1,2025-05-24T17:20:00+02:00,2025-05-25,01:20,1,0,1
50,2025-05-25T13:46:00+02:00,2025-05-25,21:46,4,1,5
1,2025-05-24T17:22:00+02:00,2025-05-25,01:22,0,4,4
50,2025-05-25T13:48:00+02:00,2025-05-25,21:48,1,0,1
1,2025-05-24T17:23:00+02:00,2025-05-25,01:23,0,2,2
54,2025-05-25T13:48:00+02:00,2025-05-25,21:48,0,1,1
2,2025-05-24T17:13:00+02:00,2025-05-25,01:13,0,2,2
54,2025-05-25T13:51:00+02:00,2025-05-25,21:51,0,2,2
2,2025-05-24T17:16:00+02:00,2025-05-25,01:16,0,1,1
54,2025-05-25T13:53:00+02:00,2025-05-25,21:53,6,3,9
2,2025-05-24T17:19:00+02:00,2025-05-25,01:19,1,0,1
61,2025-05-25T13:44:00+02:00,2025-05-25,21:44,1,2,3
9,2025-05-24T17:16:00+02:00,2025-05-25,01:16,0,2,2
61,2025-05-25T13:48:00+02:00,2025-05-25,21:48,1,0,1
9,2025-05-24T17:24:00+02:00,2025-05-25,01:24,1,0,1
61,2025-05-25T13:49:00+02:00,2025-05-25,21:49,3,1,4
11,2025-05-24T17:23:00+02:00,2025-05-25,01:23,0,1,1
61,2025-05-25T13:52:00+02:00,2025-05-25,21:52,0,3,3
12,2025-05-24T17:14:00+02:00,2025-05-25,01:14,1,0,1
66,2025-05-25T13:41:00+02:00,2025-05-25,21:41,16,9,25
12,2025-05-24T17:16:00+02:00,2025-05-25,01:16,0,1,1
66,2025-05-25T13:42:00+02:00,2025-05-25,21:42,14,3,17
12,2025-05-24T17:20:00+02:00,2025-05-25,01:20,2,1,3
66,2025-05-25T13:45:00+02:00,2025-05-25,21:45,15,11,26
17,2025-05-24T17:18:00+02:00,2025-05-25,01:18,0,1,1
66,2025-05-25T13:52:00+02:00,2025-05-25,21:52,15,12,27
17,2025-05-24T17:21:00+02:00,2025-05-25,01:21,2,0,2
69,2025-05-25T13:42:00+02:00,2025-05-25,21:42,0,1,1
19,2025-05-24T17:14:00+02:00,2025-05-25,01:14,1,2,3
70,2025-05-25T13:40:00+02:00,2025-05-25,21:40,3,2,5
19,2025-05-24T17:22:00+02:00,2025-05-25,01:22,1,1,2
70,2025-05-25T13:41:00+02:00,2025-05-25,21:41,5,1,6
19,2025-05-24T17:23:00+02:00,2025-05-25,01:23,0,8,8
77,2025-05-25T13:40:00+02:00,2025-05-25,21:40,6,10,16
20,2025-05-24T17:10:00+02:00,2025-05-25,01:10,4,10,14
77,2025-05-25T13:45:00+02:00,2025-05-25,21:45,3,2,5
20,2025-05-24T17:13:00+02:00,2025-05-25,01:13,17,2,19
78,2025-05-25T13:40:00+02:00,2025-05-25,21:40,0,1,1
20,2025-05-24T17:17:00+02:00,2025-05-25,01:17,6,6,12
78,2025-05-25T13:52:00+02:00,2025-05-25,21:52,1,0,1
20,2025-05-24T17:20:00+02:00,2025-05-25,01:20,1,5,6
84,2025-05-25T13:50:00+02:00,2025-05-25,21:50,35,38,73
20,2025-05-24T17:21:00+02:00,2025-05-25,01:21,0,5,5
87,2025-05-25T13:42:00+02:00,2025-05-25,21:42,0,2,2
20,2025-05-24T17:23:00+02:00,2025-05-25,01:23,2,5,7
107,2025-05-25T13:40:00+02:00,2025-05-25,21:40,5,8,13
23,2025-05-24T17:21:00+02:00,2025-05-25,01:21,0,2,2
108,2025-05-25T13:41:00+02:00,2025-05-25,21:41,2,0,2
23,2025-05-24T17:22:00+02:00,2025-05-25,01:22,0,2,2
108,2025-05-25T13:50:00+02:00,2025-05-25,21:50,1,0,1
23,2025-05-24T17:23:00+02:00,2025-05-25,01:23,0,2,2
108,2025-05-25T13:52:00+02:00,2025-05-25,21:52,2,0,2
24,2025-05-24T17:10:00+02:00,2025-05-25,01:10,1,5,6
108,2025-05-25T13:54:00+02:00,2025-05-25,21:54,1,1,2
24,2025-05-24T17:19:00+02:00,2025-05-25,01:19,2,0,2
118,2025-05-25T13:40:00+02:00,2025-05-25,21:40,2,0,2
24,2025-05-24T17:20:00+02:00,2025-05-25,01:20,0,9,9
118,2025-05-25T13:45:00+02:00,2025-05-25,21:45,2,0,2
27,2025-05-24T17:23:00+02:00,2025-05-25,01:23,0,2,2
131,2025-05-25T13:40:00+02:00,2025-05-25,21:40,1,8,9
30,2025-05-24T17:10:00+02:00,2025-05-25,01:10,2,4,6
131,2025-05-25T13:50:00+02:00,2025-05-25,21:50,4,4,8
30,2025-05-24T17:12:00+02:00,2025-05-25,01:12,2,0,2
132,2025-05-25T13:45:00+02:00,2025-05-25,21:45,15,2,17
30,2025-05-24T17:16:00+02:00,2025-05-25,01:16,8,0,8
132,2025-05-25T13:50:00+02:00,2025-05-25,21:50,9,5,14
35,2025-05-24T17:11:00+02:00,2025-05-25,01:11,6,1,7
133,2025-05-25T13:50:00+02:00,2025-05-25,21:50,11,8,19
35,2025-05-24T17:12:00+02:00,2025-05-25,01:12,6,0,6
134,2025-05-25T13:40:00+02:00,2025-05-25,21:40,14,15,29
35,2025-05-24T17:19:00+02:00,2025-05-25,01:19,3,5,8
134,2025-05-25T13:45:00+02:00,2025-05-25,21:45,20,19,39
35,2025-05-24T17:22:00+02:00,2025-05-25,01:22,1,3,4
135,2025-05-25T13:45:00+02:00,2025-05-25,21:45,2,13,15
49,2025-05-24T17:12:00+02:00,2025-05-25,01:12,0,2,2
135,2025-05-25T13:50:00+02:00,2025-05-25,21:50,3,5,8
49,2025-05-24T17:17:00+02:00,2025-05-25,01:17,1,0,1
165,2025-05-25T13:45:00+02:00,2025-05-25,21:45,4,1,5
51,2025-05-24T17:20:00+02:00,2025-05-25,01:20,1,0,1
179,2025-05-25T13:40:00+02:00,2025-05-25,21:40,5,0,5
51,2025-05-24T17:22:00+02:00,2025-05-25,01:22,1,0,1
179,2025-05-25T13:50:00+02:00,2025-05-25,21:50,1,9,10
52,2025-05-24T17:10:00+02:00,2025-05-25,01:10,8,4,12
1,2025-05-25T13:44:00+02:00,2025-05-25,21:44,0,3,3
52,2025-05-24T17:13:00+02:00,2025-05-25,01:13,11,6,17
1,2025-05-25T13:46:00+02:00,2025-05-25,21:46,2,5,7
52,2025-05-24T17:14:00+02:00,2025-05-25,01:14,12,0,12
1,2025-05-25T13:48:00+02:00,2025-05-25,21:48,1,2,3
52,2025-05-24T17:16:00+02:00,2025-05-25,01:16,1,0,1
2,2025-05-25T13:41:00+02:00,2025-05-25,21:41,0,3,3
52,2025-05-24T17:19:00+02:00,2025-05-25,01:19,1,1,2
2,2025-05-25T13:43:00+02:00,2025-05-25,21:43,1,1,2
52,2025-05-24T17:22:00+02:00,2025-05-25,01:22,2,0,2
2,2025-05-25T13:50:00+02:00,2025-05-25,21:50,0,5,5
52,2025-05-24T17:23:00+02:00,2025-05-25,01:23,8,2,10
2,2025-05-25T13:52:00+02:00,2025-05-25,21:52,0,2,2
56,2025-05-24T17:12:00+02:00,2025-05-25,01:12,0,3,3
2,2025-05-25T13:54:00+02:00,2025-05-25,21:54,0,1,1
56,2025-05-24T17:16:00+02:00,2025-05-25,01:16,3,0,3
9,2025-05-25T13:48:00+02:00,2025-05-25,21:48,0,2,2
56,2025-05-24T17:18:00+02:00,2025-05-25,01:18,1,1,2
9,2025-05-25T13:54:00+02:00,2025-05-25,21:54,0,1,1
56,2025-05-24T17:20:00+02:00,2025-05-25,01:20,0,2,2
10,2025-05-25T13:43:00+02:00,2025-05-25,21:43,1,0,1
56,2025-05-24T17:22:00+02:00,2025-05-25,01:22,1,1,2
10,2025-05-25T13:48:00+02:00,2025-05-25,21:48,0,1,1
58,2025-05-24T17:10:00+02:00,2025-05-25,01:10,0,1,1
12,2025-05-25T13:42:00+02:00,2025-05-25,21:42,3,0,3
58,2025-05-24T17:11:00+02:00,2025-05-25,01:11,3,4,7
12,2025-05-25T13:45:00+02:00,2025-05-25,21:45,2,2,4
58,2025-05-24T17:14:00+02:00,2025-05-25,01:14,2,2,4
12,2025-05-25T13:52:00+02:00,2025-05-25,21:52,6,4,10
58,2025-05-24T17:17:00+02:00,2025-05-25,01:17,1,1,2
17,2025-05-25T13:48:00+02:00,2025-05-25,21:48,0,5,5
58,2025-05-24T17:18:00+02:00,2025-05-25,01:18,0,3,3
17,2025-05-25T13:49:00+02:00,2025-05-25,21:49,0,3,3
58,2025-05-24T17:22:00+02:00,2025-05-25,01:22,5,2,7
18,2025-05-25T13:46:00+02:00,2025-05-25,21:46,1,0,1
62,2025-05-24T17:11:00+02:00,2025-05-25,01:11,1,0,1
18,2025-05-25T13:53:00+02:00,2025-05-25,21:53,1,0,1
62,2025-05-24T17:13:00+02:00,2025-05-25,01:13,4,0,4
19,2025-05-25T13:46:00+02:00,2025-05-25,21:46,2,22,24
62,2025-05-24T17:18:00+02:00,2025-05-25,01:18,0,1,1
20,2025-05-25T13:43:00+02:00,2025-05-25,21:43,1,2,3
63,2025-05-24T17:13:00+02:00,2025-05-25,01:13,0,1,1
20,2025-05-25T13:44:00+02:00,2025-05-25,21:44,0,2,2
63,2025-05-24T17:14:00+02:00,2025-05-25,01:14,0,1,1
20,2025-05-25T13:47:00+02:00,2025-05-25,21:47,5,2,7
63,2025-05-24T17:20:00+02:00,2025-05-25,01:20,0,3,3
20,2025-05-25T13:48:00+02:00,2025-05-25,21:48,0,6,6
63,2025-05-24T17:23:00+02:00,2025-05-25,01:23,0,1,1
20,2025-05-25T13:52:00+02:00,2025-05-25,21:52,2,4,6
67,2025-05-24T17:11:00+02:00,2025-05-25,01:11,0,1,1
23,2025-05-25T13:43:00+02:00,2025-05-25,21:43,0,11,11
67,2025-05-24T17:15:00+02:00,2025-05-25,01:15,0,6,6
23,2025-05-25T13:48:00+02:00,2025-05-25,21:48,0,2,2
67,2025-05-24T17:17:00+02:00,2025-05-25,01:17,0,4,4
23,2025-05-25T13:50:00+02:00,2025-05-25,21:50,0,1,1
67,2025-05-24T17:21:00+02:00,2025-05-25,01:21,0,5,5
23,2025-05-25T13:53:00+02:00,2025-05-25,21:53,1,3,4
67,2025-05-24T17:22:00+02:00,2025-05-25,01:22,0,2,2
24,2025-05-25T13:40:00+02:00,2025-05-25,21:40,3,2,5
67,2025-05-24T17:23:00+02:00,2025-05-25,01:23,4,2,6
24,2025-05-25T13:42:00+02:00,2025-05-25,21:42,8,3,11
67,2025-05-24T17:24:00+02:00,2025-05-25,01:24,1,0,1
24,2025-05-25T13:43:00+02:00,2025-05-25,21:43,0,11,11
68,2025-05-24T17:10:00+02:00,2025-05-25,01:10,1,0,1
24,2025-05-25T13:45:00+02:00,2025-05-25,21:45,1,2,3
72,2025-05-24T17:13:00+02:00,2025-05-25,01:13,0,2,2
24,2025-05-25T13:48:00+02:00,2025-05-25,21:48,5,4,9
72,2025-05-24T17:16:00+02:00,2025-05-25,01:16,0,1,1
24,2025-05-25T13:52:00+02:00,2025-05-25,21:52,1,6,7
79,2025-05-24T17:11:00+02:00,2025-05-25,01:11,1,3,4
27,2025-05-25T13:41:00+02:00,2025-05-25,21:41,0,1,1
79,2025-05-24T17:14:00+02:00,2025-05-25,01:14,3,3,6
27,2025-05-25T13:44:00+02:00,2025-05-25,21:44,0,1,1
79,2025-05-24T17:15:00+02:00,2025-05-25,01:15,0,1,1
27,2025-05-25T13:47:00+02:00,2025-05-25,21:47,2,0,2
79,2025-05-24T17:16:00+02:00,2025-05-25,01:16,1,2,3
27,2025-05-25T13:48:00+02:00,2025-05-25,21:48,2,5,7
79,2025-05-24T17:17:00+02:00,2025-05-25,01:17,3,2,5
30,2025-05-25T13:42:00+02:00,2025-05-25,21:42,1,2,3
79,2025-05-24T17:23:00+02:00,2025-05-25,01:23,0,1,1
30,2025-05-25T13:46:00+02:00,2025-05-25,21:46,0,1,1
86,2025-05-24T17:10:00+02:00,2025-05-25,01:10,0,1,1
35,2025-05-25T13:41:00+02:00,2025-05-25,21:41,2,10,12
86,2025-05-24T17:11:00+02:00,2025-05-25,01:11,0,1,1
35,2025-05-25T13:48:00+02:00,2025-05-25,21:48,2,4,6
109,2025-05-24T17:10:00+02:00,2025-05-25,01:10,2,7,9
35,2025-05-25T13:51:00+02:00,2025-05-25,21:51,0,8,8
109,2025-05-24T17:15:00+02:00,2025-05-25,01:15,4,3,7
35,2025-05-25T13:53:00+02:00,2025-05-25,21:53,4,13,17
141,2025-05-24T17:15:00+02:00,2025-05-25,01:15,7,15,22
48,2025-05-25T13:52:00+02:00,2025-05-25,21:52,0,5,5
141,2025-05-24T17:20:00+02:00,2025-05-25,01:20,1,4,5
49,2025-05-25T13:40:00+02:00,2025-05-25,21:40,11,2,13
164,2025-05-24T17:10:00+02:00,2025-05-25,01:10,0,1,1
49,2025-05-25T13:48:00+02:00,2025-05-25,21:48,5,4,9
3,2025-05-24T16:40:00+02:00,2025-05-25,00:40,5,6,11
49,2025-05-25T13:51:00+02:00,2025-05-25,21:51,5,2,7
3,2025-05-24T16:45:00+02:00,2025-05-25,00:45,3,9,12
51,2025-05-25T13:42:00+02:00,2025-05-25,21:42,1,0,1
3,2025-05-24T16:47:00+02:00,2025-05-25,00:47,6,1,7
51,2025-05-25T13:43:00+02:00,2025-05-25,21:43,2,1,3
3,2025-05-24T16:50:00+02:00,2025-05-25,00:50,5,4,9
51,2025-05-25T13:44:00+02:00,2025-05-25,21:44,2,0,2
3,2025-05-24T16:53:00+02:00,2025-05-25,00:53,0,3,3
51,2025-05-25T13:51:00+02:00,2025-05-25,21:51,1,1,2
4,2025-05-24T16:40:00+02:00,2025-05-25,00:40,0,6,6
52,2025-05-25T13:40:00+02:00,2025-05-25,21:40,1,4,5
4,2025-05-24T16:41:00+02:00,2025-05-25,00:41,1,6,7
52,2025-05-25T13:43:00+02:00,2025-05-25,21:43,3,3,6
4,2025-05-24T16:46:00+02:00,2025-05-25,00:46,0,7,7
56,2025-05-25T13:40:00+02:00,2025-05-25,21:40,0,4,4
4,2025-05-24T16:47:00+02:00,2025-05-25,00:47,1,8,9
56,2025-05-25T13:43:00+02:00,2025-05-25,21:43,4,3,7
4,2025-05-24T16:50:00+02:00,2025-05-25,00:50,0,4,4
56,2025-05-25T13:45:00+02:00,2025-05-25,21:45,5,2,7
4,2025-05-24T16:51:00+02:00,2025-05-25,00:51,6,1,7
56,2025-05-25T13:46:00+02:00,2025-05-25,21:46,4,5,9
4,2025-05-24T16:52:00+02:00,2025-05-25,00:52,3,0,3
56,2025-05-25T13:48:00+02:00,2025-05-25,21:48,2,3,5
5,2025-05-24T16:40:00+02:00,2025-05-25,00:40,15,24,39
56,2025-05-25T13:54:00+02:00,2025-05-25,21:54,1,1,2
5,2025-05-24T16:45:00+02:00,2025-05-25,00:45,9,2,11
58,2025-05-25T13:41:00+02:00,2025-05-25,21:41,2,3,5
5,2025-05-24T16:50:00+02:00,2025-05-25,00:50,5,7,12
58,2025-05-25T13:46:00+02:00,2025-05-25,21:46,1,0,1
6,2025-05-24T16:40:00+02:00,2025-05-25,00:40,6,1,7
58,2025-05-25T13:49:00+02:00,2025-05-25,21:49,5,3,8
6,2025-05-24T16:43:00+02:00,2025-05-25,00:43,9,1,10
58,2025-05-25T13:50:00+02:00,2025-05-25,21:50,2,9,11
6,2025-05-24T16:44:00+02:00,2025-05-25,00:44,5,1,6
58,2025-05-25T13:54:00+02:00,2025-05-25,21:54,4,1,5
6,2025-05-24T16:46:00+02:00,2025-05-25,00:46,3,3,6
62,2025-05-25T13:40:00+02:00,2025-05-25,21:40,2,3,5
6,2025-05-24T16:48:00+02:00,2025-05-25,00:48,2,8,10
62,2025-05-25T13:45:00+02:00,2025-05-25,21:45,3,0,3
6,2025-05-24T16:49:00+02:00,2025-05-25,00:49,3,0,3
62,2025-05-25T13:50:00+02:00,2025-05-25,21:50,4,0,4
6,2025-05-24T16:51:00+02:00,2025-05-25,00:51,3,0,3
63,2025-05-25T13:40:00+02:00,2025-05-25,21:40,1,1,2
6,2025-05-24T16:52:00+02:00,2025-05-25,00:52,4,1,5
63,2025-05-25T13:41:00+02:00,2025-05-25,21:41,0,2,2
28,2025-05-24T16:46:00+02:00,2025-05-25,00:46,2,0,2
63,2025-05-25T13:44:00+02:00,2025-05-25,21:44,0,1,1
28,2025-05-24T16:50:00+02:00,2025-05-25,00:50,0,3,3
63,2025-05-25T13:51:00+02:00,2025-05-25,21:51,0,1,1
29,2025-05-24T16:40:00+02:00,2025-05-25,00:40,0,2,2
67,2025-05-25T13:40:00+02:00,2025-05-25,21:40,4,3,7
29,2025-05-24T16:46:00+02:00,2025-05-25,00:46,1,1,2
67,2025-05-25T13:41:00+02:00,2025-05-25,21:41,0,4,4
29,2025-05-24T16:52:00+02:00,2025-05-25,00:52,2,0,2
67,2025-05-25T13:42:00+02:00,2025-05-25,21:42,0,1,1
31,2025-05-24T16:49:00+02:00,2025-05-25,00:49,2,1,3
67,2025-05-25T13:43:00+02:00,2025-05-25,21:43,3,2,5
31,2025-05-24T16:50:00+02:00,2025-05-25,00:50,0,1,1
67,2025-05-25T13:47:00+02:00,2025-05-25,21:47,0,3,3
31,2025-05-24T16:51:00+02:00,2025-05-25,00:51,1,1,2
67,2025-05-25T13:49:00+02:00,2025-05-25,21:49,0,10,10
36,2025-05-24T16:40:00+02:00,2025-05-25,00:40,2,0,2
67,2025-05-25T13:51:00+02:00,2025-05-25,21:51,0,4,4
36,2025-05-24T16:45:00+02:00,2025-05-25,00:45,6,6,12
67,2025-05-25T13:54:00+02:00,2025-05-25,21:54,1,3,4
36,2025-05-24T16:48:00+02:00,2025-05-25,00:48,5,10,15
68,2025-05-25T13:42:00+02:00,2025-05-25,21:42,0,1,1
36,2025-05-24T16:54:00+02:00,2025-05-25,00:54,2,7,9
68,2025-05-25T13:43:00+02:00,2025-05-25,21:43,1,5,6
37,2025-05-24T16:42:00+02:00,2025-05-25,00:42,0,1,1
68,2025-05-25T13:50:00+02:00,2025-05-25,21:50,4,0,4
37,2025-05-24T16:49:00+02:00,2025-05-25,00:49,1,0,1
68,2025-05-25T13:51:00+02:00,2025-05-25,21:51,0,3,3
41,2025-05-24T16:40:00+02:00,2025-05-25,00:40,0,1,1
68,2025-05-25T13:52:00+02:00,2025-05-25,21:52,0,2,2
41,2025-05-24T16:45:00+02:00,2025-05-25,00:45,5,5,10
68,2025-05-25T13:54:00+02:00,2025-05-25,21:54,1,0,1
41,2025-05-24T16:47:00+02:00,2025-05-25,00:47,4,4,8
72,2025-05-25T13:40:00+02:00,2025-05-25,21:40,9,2,11
41,2025-05-24T16:50:00+02:00,2025-05-25,00:50,1,1,2
72,2025-05-25T13:41:00+02:00,2025-05-25,21:41,3,11,14
41,2025-05-24T16:52:00+02:00,2025-05-25,00:52,2,4,6
72,2025-05-25T13:43:00+02:00,2025-05-25,21:43,3,0,3
41,2025-05-24T16:53:00+02:00,2025-05-25,00:53,1,2,3
72,2025-05-25T13:45:00+02:00,2025-05-25,21:45,0,4,4
45,2025-05-24T16:40:00+02:00,2025-05-25,00:40,1,1,2
72,2025-05-25T13:46:00+02:00,2025-05-25,21:46,4,4,8
45,2025-05-24T16:42:00+02:00,2025-05-25,00:42,5,7,12
72,2025-05-25T13:49:00+02:00,2025-05-25,21:49,0,3,3
45,2025-05-24T16:44:00+02:00,2025-05-25,00:44,14,2,16
72,2025-05-25T13:52:00+02:00,2025-05-25,21:52,1,3,4
45,2025-05-24T16:46:00+02:00,2025-05-25,00:46,7,3,10
76,2025-05-25T13:40:00+02:00,2025-05-25,21:40,1,0,1
45,2025-05-24T16:48:00+02:00,2025-05-25,00:48,2,3,5
76,2025-05-25T13:41:00+02:00,2025-05-25,21:41,0,1,1
47,2025-05-24T16:48:00+02:00,2025-05-25,00:48,0,2,2
76,2025-05-25T13:42:00+02:00,2025-05-25,21:42,0,1,1
47,2025-05-24T16:51:00+02:00,2025-05-25,00:51,6,3,9
79,2025-05-25T13:41:00+02:00,2025-05-25,21:41,5,6,11
47,2025-05-24T16:52:00+02:00,2025-05-25,00:52,1,2,3
79,2025-05-25T13:42:00+02:00,2025-05-25,21:42,0,9,9
54,2025-05-24T16:41:00+02:00,2025-05-25,00:41,9,0,9
79,2025-05-25T13:44:00+02:00,2025-05-25,21:44,2,1,3
54,2025-05-24T16:44:00+02:00,2025-05-25,00:44,3,5,8
86,2025-05-25T13:44:00+02:00,2025-05-25,21:44,0,5,5
59,2025-05-24T16:45:00+02:00,2025-05-25,00:45,5,2,7
109,2025-05-25T13:50:00+02:00,2025-05-25,21:50,3,7,10
61,2025-05-24T16:46:00+02:00,2025-05-25,00:46,3,0,3
117,2025-05-25T13:50:00+02:00,2025-05-25,21:50,22,10,32
61,2025-05-24T16:50:00+02:00,2025-05-25,00:50,4,0,4
130,2025-05-25T13:40:00+02:00,2025-05-25,21:40,2,2,4
61,2025-05-24T16:53:00+02:00,2025-05-25,00:53,0,2,2
139,2025-05-25T13:45:00+02:00,2025-05-25,21:45,2,0,2
61,2025-05-24T16:54:00+02:00,2025-05-25,00:54,1,0,1
142,2025-05-25T13:40:00+02:00,2025-05-25,21:40,0,2,2
66,2025-05-24T16:44:00+02:00,2025-05-25,00:44,5,18,23
164,2025-05-25T13:45:00+02:00,2025-05-25,21:45,1,5,6
66,2025-05-24T16:49:00+02:00,2025-05-25,00:49,1,0,1
164,2025-05-25T13:50:00+02:00,2025-05-25,21:50,7,3,10
66,2025-05-24T16:52:00+02:00,2025-05-25,00:52,6,2,8
69,2025-05-24T16:53:00+02:00,2025-05-25,00:53,1,4,5
70,2025-05-24T16:44:00+02:00,2025-05-25,00:44,0,1,1
70,2025-05-24T16:52:00+02:00,2025-05-25,00:52,2,1,3
77,2025-05-24T16:50:00+02:00,2025-05-25,00:50,0,1,1
87,2025-05-24T16:50:00+02:00,2025-05-25,00:50,0,1,1
107,2025-05-24T16:40:00+02:00,2025-05-25,00:40,3,4,7
108,2025-05-24T16:52:00+02:00,2025-05-25,00:52,1,0,1
181,2025-05-25T13:42:00+02:00,2025-05-25,21:42,21,2,23
131,2025-05-24T16:45:00+02:00,2025-05-25,00:45,7,4,11
181,2025-05-25T13:49:00+02:00,2025-05-25,21:49,10,12,22
131,2025-05-24T16:50:00+02:00,2025-05-25,00:50,9,9,18
181,2025-05-25T13:51:00+02:00,2025-05-25,21:51,17,3,20
133,2025-05-24T16:45:00+02:00,2025-05-25,00:45,8,1,9
181,2025-05-25T13:53:00+02:00,2025-05-25,21:53,14,5,19
134,2025-05-24T16:45:00+02:00,2025-05-25,00:45,10,6,16
134,2025-05-24T16:50:00+02:00,2025-05-25,00:50,16,6,22
135,2025-05-24T16:40:00+02:00,2025-05-25,00:40,5,1,6
135,2025-05-24T16:45:00+02:00,2025-05-25,00:45,0,1,1
162,2025-05-24T16:45:00+02:00,2025-05-25,00:45,5,1,6
1,2025-05-24T16:49:00+02:00,2025-05-25,00:49,0,2,2
1,2025-05-24T16:54:00+02:00,2025-05-25,00:54,1,4,5
181,2025-05-25T13:59:00+02:00,2025-05-25,21:59,1,8,9
2,2025-05-24T16:48:00+02:00,2025-05-25,00:48,0,5,5
181,2025-05-25T14:02:00+02:00,2025-05-25,22:02,8,15,23
9,2025-05-24T16:43:00+02:00,2025-05-25,00:43,2,0,2
181,2025-05-25T14:03:00+02:00,2025-05-25,22:03,9,9,18
10,2025-05-24T16:40:00+02:00,2025-05-25,00:40,0,1,1
181,2025-05-25T14:06:00+02:00,2025-05-25,22:06,12,6,18
12,2025-05-24T16:42:00+02:00,2025-05-25,00:42,1,0,1
181,2025-05-25T14:07:00+02:00,2025-05-25,22:07,11,7,18
12,2025-05-24T16:50:00+02:00,2025-05-25,00:50,0,1,1
181,2025-05-25T14:08:00+02:00,2025-05-25,22:08,4,16,20
18,2025-05-24T16:47:00+02:00,2025-05-25,00:47,1,0,1
181,2025-05-25T14:09:00+02:00,2025-05-25,22:09,6,3,9
19,2025-05-24T16:46:00+02:00,2025-05-25,00:46,7,4,11
182,2025-05-25T13:55:00+02:00,2025-05-25,21:55,10,17,27
19,2025-05-24T16:47:00+02:00,2025-05-25,00:47,10,3,13
182,2025-05-25T14:05:00+02:00,2025-05-25,22:05,7,12,19
19,2025-05-24T16:50:00+02:00,2025-05-25,00:50,2,2,4
20,2025-05-24T16:43:00+02:00,2025-05-25,00:43,4,1,5
20,2025-05-24T16:47:00+02:00,2025-05-25,00:47,0,6,6
20,2025-05-24T16:49:00+02:00,2025-05-25,00:49,6,14,20
20,2025-05-24T16:52:00+02:00,2025-05-25,00:52,9,1,10
20,2025-05-24T16:53:00+02:00,2025-05-25,00:53,2,4,6
23,2025-05-24T16:40:00+02:00,2025-05-25,00:40,0,2,2
24,2025-05-24T16:49:00+02:00,2025-05-25,00:49,4,2,6
24,2025-05-24T16:54:00+02:00,2025-05-25,00:54,4,6,10
25,2025-05-24T16:40:00+02:00,2025-05-25,00:40,10,3,13
27,2025-05-24T16:44:00+02:00,2025-05-25,00:44,2,0,2
27,2025-05-24T16:46:00+02:00,2025-05-25,00:46,0,1,1
27,2025-05-24T16:51:00+02:00,2025-05-25,00:51,1,0,1
27,2025-05-24T16:52:00+02:00,2025-05-25,00:52,2,0,2
27,2025-05-24T16:54:00+02:00,2025-05-25,00:54,1,0,1
30,2025-05-24T16:45:00+02:00,2025-05-25,00:45,0,7,7
30,2025-05-24T16:49:00+02:00,2025-05-25,00:49,11,6,17
30,2025-05-24T16:50:00+02:00,2025-05-25,00:50,22,8,30
30,2025-05-24T16:51:00+02:00,2025-05-25,00:51,4,5,9
35,2025-05-24T16:44:00+02:00,2025-05-25,00:44,4,9,13
35,2025-05-24T16:50:00+02:00,2025-05-25,00:50,3,11,14
35,2025-05-24T16:53:00+02:00,2025-05-25,00:53,1,2,3
35,2025-05-24T16:54:00+02:00,2025-05-25,00:54,2,1,3
49,2025-05-24T16:41:00+02:00,2025-05-25,00:41,3,0,3
49,2025-05-24T16:43:00+02:00,2025-05-25,00:43,2,0,2
49,2025-05-24T16:45:00+02:00,2025-05-25,00:45,1,1,2
49,2025-05-24T16:46:00+02:00,2025-05-25,00:46,9,0,9
49,2025-05-24T16:47:00+02:00,2025-05-25,00:47,0,2,2
51,2025-05-24T16:46:00+02:00,2025-05-25,00:46,0,1,1
52,2025-05-24T16:40:00+02:00,2025-05-25,00:40,0,4,4
52,2025-05-24T16:41:00+02:00,2025-05-25,00:41,5,4,9
52,2025-05-24T16:45:00+02:00,2025-05-25,00:45,0,15,15
52,2025-05-24T16:46:00+02:00,2025-05-25,00:46,5,2,7
52,2025-05-24T16:47:00+02:00,2025-05-25,00:47,1,0,1
52,2025-05-24T16:49:00+02:00,2025-05-25,00:49,0,1,1
52,2025-05-24T16:50:00+02:00,2025-05-25,00:50,2,0,2
52,2025-05-24T16:51:00+02:00,2025-05-25,00:51,3,7,10
52,2025-05-24T16:53:00+02:00,2025-05-25,00:53,8,2,10
52,2025-05-24T16:54:00+02:00,2025-05-25,00:54,1,7,8
53,2025-05-24T16:40:00+02:00,2025-05-25,00:40,0,1,1
53,2025-05-24T16:45:00+02:00,2025-05-25,00:45,0,1,1
53,2025-05-24T16:50:00+02:00,2025-05-25,00:50,0,1,1
56,2025-05-24T16:40:00+02:00,2025-05-25,00:40,1,0,1
56,2025-05-24T16:41:00+02:00,2025-05-25,00:41,0,2,2
56,2025-05-24T16:43:00+02:00,2025-05-25,00:43,1,2,3
56,2025-05-24T16:45:00+02:00,2025-05-25,00:45,1,0,1
56,2025-05-24T16:46:00+02:00,2025-05-25,00:46,0,1,1
56,2025-05-24T16:50:00+02:00,2025-05-25,00:50,0,1,1
58,2025-05-24T16:41:00+02:00,2025-05-25,00:41,2,2,4
58,2025-05-24T16:46:00+02:00,2025-05-25,00:46,0,1,1
58,2025-05-24T16:47:00+02:00,2025-05-25,00:47,0,1,1
58,2025-05-24T16:51:00+02:00,2025-05-25,00:51,1,3,4
58,2025-05-24T16:52:00+02:00,2025-05-25,00:52,1,9,10
62,2025-05-24T16:48:00+02:00,2025-05-25,00:48,2,0,2
62,2025-05-24T16:49:00+02:00,2025-05-25,00:49,3,1,4
62,2025-05-24T16:50:00+02:00,2025-05-25,00:50,1,1,2
63,2025-05-24T16:42:00+02:00,2025-05-25,00:42,0,1,1
63,2025-05-24T16:43:00+02:00,2025-05-25,00:43,0,1,1
63,2025-05-24T16:45:00+02:00,2025-05-25,00:45,1,2,3
63,2025-05-24T16:49:00+02:00,2025-05-25,00:49,0,3,3
63,2025-05-24T16:53:00+02:00,2025-05-25,00:53,0,2,2
67,2025-05-24T16:41:00+02:00,2025-05-25,00:41,0,2,2
67,2025-05-24T16:43:00+02:00,2025-05-25,00:43,0,2,2
67,2025-05-24T16:46:00+02:00,2025-05-25,00:46,0,4,4
67,2025-05-24T16:47:00+02:00,2025-05-25,00:47,1,1,2
67,2025-05-24T16:48:00+02:00,2025-05-25,00:48,1,10,11
68,2025-05-24T16:43:00+02:00,2025-05-25,00:43,1,0,1
72,2025-05-24T16:40:00+02:00,2025-05-25,00:40,1,1,2
72,2025-05-24T16:41:00+02:00,2025-05-25,00:41,0,2,2
72,2025-05-24T16:45:00+02:00,2025-05-25,00:45,0,2,2
72,2025-05-24T16:53:00+02:00,2025-05-25,00:53,0,1,1
79,2025-05-24T16:50:00+02:00,2025-05-25,00:50,2,0,2
79,2025-05-24T16:51:00+02:00,2025-05-25,00:51,2,0,2
79,2025-05-24T16:53:00+02:00,2025-05-25,00:53,5,3,8
86,2025-05-24T16:54:00+02:00,2025-05-25,00:54,0,1,1
109,2025-05-24T16:40:00+02:00,2025-05-25,00:40,1,2,3
109,2025-05-24T16:45:00+02:00,2025-05-25,00:45,0,1,1
117,2025-05-24T16:40:00+02:00,2025-05-25,00:40,5,1,6
141,2025-05-24T16:45:00+02:00,2025-05-25,00:45,4,9,13
142,2025-05-24T16:40:00+02:00,2025-05-25,00:40,2,0,2
142,2025-05-24T16:50:00+02:00,2025-05-25,00:50,2,0,2
181,2025-05-24T16:55:00+02:00,2025-05-25,00:55,8,3,11
181,2025-05-24T16:59:00+02:00,2025-05-25,00:59,8,0,8
181,2025-05-24T17:00:00+02:00,2025-05-25,01:00,6,4,10
181,2025-05-24T17:01:00+02:00,2025-05-25,01:01,1,0,1
181,2025-05-24T17:04:00+02:00,2025-05-25,01:04,4,2,6
181,2025-05-24T17:07:00+02:00,2025-05-25,01:07,2,9,11
182,2025-05-24T16:55:00+02:00,2025-05-25,00:55,12,14,26
182,2025-05-24T17:00:00+02:00,2025-05-25,01:00,15,9,24
3,2025-05-24T16:55:00+02:00,2025-05-25,00:55,2,12,14
3,2025-05-24T16:57:00+02:00,2025-05-25,00:57,8,2,10
3,2025-05-24T17:01:00+02:00,2025-05-25,01:01,0,1,1
3,2025-05-24T17:03:00+02:00,2025-05-25,01:03,0,5,5
3,2025-05-24T17:08:00+02:00,2025-05-25,01:08,1,10,11
3,2025-05-24T17:09:00+02:00,2025-05-25,01:09,0,12,12
4,2025-05-24T16:57:00+02:00,2025-05-25,00:57,3,2,5
4,2025-05-24T17:01:00+02:00,2025-05-25,01:01,2,9,11
4,2025-05-24T17:02:00+02:00,2025-05-25,01:02,0,4,4
4,2025-05-24T17:05:00+02:00,2025-05-25,01:05,3,1,4
4,2025-05-24T17:08:00+02:00,2025-05-25,01:08,3,1,4
5,2025-05-24T16:55:00+02:00,2025-05-25,00:55,8,7,15
6,2025-05-24T16:56:00+02:00,2025-05-25,00:56,5,6,11
6,2025-05-24T16:59:00+02:00,2025-05-25,00:59,3,2,5
6,2025-05-24T17:00:00+02:00,2025-05-25,01:00,3,4,7
6,2025-05-24T17:02:00+02:00,2025-05-25,01:02,1,2,3
6,2025-05-24T17:04:00+02:00,2025-05-25,01:04,1,3,4
6,2025-05-24T17:05:00+02:00,2025-05-25,01:05,2,5,7
6,2025-05-24T17:08:00+02:00,2025-05-25,01:08,5,3,8
29,2025-05-24T16:56:00+02:00,2025-05-25,00:56,0,2,2
29,2025-05-24T16:58:00+02:00,2025-05-25,00:58,5,0,5
29,2025-05-24T17:07:00+02:00,2025-05-25,01:07,0,1,1
31,2025-05-24T16:56:00+02:00,2025-05-25,00:56,3,0,3
31,2025-05-24T17:05:00+02:00,2025-05-25,01:05,0,3,3
36,2025-05-24T16:58:00+02:00,2025-05-25,00:58,0,4,4
36,2025-05-24T17:03:00+02:00,2025-05-25,01:03,0,2,2
37,2025-05-24T17:01:00+02:00,2025-05-25,01:01,3,3,6
39,2025-05-24T17:02:00+02:00,2025-05-25,01:02,0,1,1
40,2025-05-24T16:57:00+02:00,2025-05-25,00:57,3,0,3
40,2025-05-24T16:58:00+02:00,2025-05-25,00:58,5,1,6
41,2025-05-24T17:01:00+02:00,2025-05-25,01:01,0,1,1
41,2025-05-24T17:04:00+02:00,2025-05-25,01:04,1,3,4
41,2025-05-24T17:07:00+02:00,2025-05-25,01:07,0,4,4
41,2025-05-24T17:08:00+02:00,2025-05-25,01:08,1,1,2
43,2025-05-24T17:00:00+02:00,2025-05-25,01:00,5,0,5
43,2025-05-24T17:05:00+02:00,2025-05-25,01:05,1,0,1
44,2025-05-24T17:00:00+02:00,2025-05-25,01:00,3,0,3
45,2025-05-24T16:56:00+02:00,2025-05-25,00:56,2,9,11
45,2025-05-24T16:58:00+02:00,2025-05-25,00:58,1,15,16
45,2025-05-24T16:59:00+02:00,2025-05-25,00:59,0,5,5
45,2025-05-24T17:00:00+02:00,2025-05-25,01:00,0,6,6
45,2025-05-24T17:01:00+02:00,2025-05-25,01:01,6,1,7
45,2025-05-24T17:03:00+02:00,2025-05-25,01:03,2,8,10
45,2025-05-24T17:04:00+02:00,2025-05-25,01:04,4,8,12
45,2025-05-24T17:06:00+02:00,2025-05-25,01:06,2,1,3
47,2025-05-24T16:56:00+02:00,2025-05-25,00:56,0,3,3
47,2025-05-24T16:57:00+02:00,2025-05-25,00:57,1,2,3
47,2025-05-24T17:00:00+02:00,2025-05-25,01:00,2,1,3
47,2025-05-24T17:09:00+02:00,2025-05-25,01:09,2,6,8
50,2025-05-24T16:55:00+02:00,2025-05-25,00:55,0,1,1
50,2025-05-24T17:06:00+02:00,2025-05-25,01:06,0,1,1
54,2025-05-24T16:59:00+02:00,2025-05-25,00:59,0,1,1
54,2025-05-24T17:02:00+02:00,2025-05-25,01:02,2,0,2
59,2025-05-24T16:55:00+02:00,2025-05-25,00:55,10,4,14
61,2025-05-24T17:05:00+02:00,2025-05-25,01:05,1,0,1
66,2025-05-24T16:56:00+02:00,2025-05-25,00:56,4,1,5
66,2025-05-24T16:58:00+02:00,2025-05-25,00:58,0,11,11
66,2025-05-24T17:02:00+02:00,2025-05-25,01:02,9,5,14
66,2025-05-24T17:05:00+02:00,2025-05-25,01:05,11,1,12
66,2025-05-24T17:07:00+02:00,2025-05-25,01:07,9,4,13
66,2025-05-24T17:08:00+02:00,2025-05-25,01:08,2,2,4
69,2025-05-24T17:09:00+02:00,2025-05-25,01:09,0,1,1
78,2025-05-24T16:57:00+02:00,2025-05-25,00:57,0,1,1
78,2025-05-24T17:09:00+02:00,2025-05-25,01:09,0,1,1
84,2025-05-24T16:55:00+02:00,2025-05-25,00:55,10,25,35
84,2025-05-24T17:05:00+02:00,2025-05-25,01:05,14,6,20
108,2025-05-24T17:07:00+02:00,2025-05-25,01:07,2,1,3
118,2025-05-24T17:00:00+02:00,2025-05-25,01:00,1,0,1
131,2025-05-24T17:00:00+02:00,2025-05-25,01:00,3,2,5
134,2025-05-24T17:00:00+02:00,2025-05-25,01:00,11,6,17
135,2025-05-24T17:05:00+02:00,2025-05-25,01:05,1,0,1
162,2025-05-24T17:00:00+02:00,2025-05-25,01:00,4,4,8
162,2025-05-24T17:05:00+02:00,2025-05-25,01:05,4,2,6
167,2025-05-24T17:05:00+02:00,2025-05-25,01:05,0,1,1
179,2025-05-24T17:05:00+02:00,2025-05-25,01:05,0,3,3
1,2025-05-24T17:07:00+02:00,2025-05-25,01:07,1,0,1
2,2025-05-24T17:04:00+02:00,2025-05-25,01:04,0,4,4
2,2025-05-24T17:07:00+02:00,2025-05-25,01:07,0,4,4
2,2025-05-24T17:09:00+02:00,2025-05-25,01:09,5,0,5
9,2025-05-24T17:03:00+02:00,2025-05-25,01:03,2,0,2
11,2025-05-24T17:05:00+02:00,2025-05-25,01:05,0,1,1
12,2025-05-24T17:01:00+02:00,2025-05-25,01:01,0,2,2
12,2025-05-24T17:04:00+02:00,2025-05-25,01:04,0,4,4
18,2025-05-24T16:59:00+02:00,2025-05-25,00:59,1,0,1
18,2025-05-24T17:08:00+02:00,2025-05-25,01:08,0,2,2
19,2025-05-24T16:56:00+02:00,2025-05-25,00:56,2,4,6
19,2025-05-24T16:59:00+02:00,2025-05-25,00:59,0,13,13
19,2025-05-24T17:03:00+02:00,2025-05-25,01:03,4,0,4
19,2025-05-24T17:05:00+02:00,2025-05-25,01:05,0,1,1
19,2025-05-24T17:08:00+02:00,2025-05-25,01:08,7,1,8
19,2025-05-24T17:09:00+02:00,2025-05-25,01:09,2,3,5
20,2025-05-24T16:56:00+02:00,2025-05-25,00:56,1,0,1
20,2025-05-24T16:59:00+02:00,2025-05-25,00:59,0,10,10
20,2025-05-24T17:02:00+02:00,2025-05-25,01:02,5,6,11
20,2025-05-24T17:06:00+02:00,2025-05-25,01:06,1,7,8
20,2025-05-24T17:09:00+02:00,2025-05-25,01:09,1,11,12
23,2025-05-24T17:00:00+02:00,2025-05-25,01:00,1,3,4
24,2025-05-24T16:55:00+02:00,2025-05-25,00:55,4,0,4
24,2025-05-24T16:56:00+02:00,2025-05-25,00:56,2,0,2
24,2025-05-24T16:57:00+02:00,2025-05-25,00:57,1,1,2
24,2025-05-24T16:59:00+02:00,2025-05-25,00:59,5,3,8
24,2025-05-24T17:07:00+02:00,2025-05-25,01:07,3,4,7
30,2025-05-24T17:00:00+02:00,2025-05-25,01:00,10,10,20
30,2025-05-24T17:01:00+02:00,2025-05-25,01:01,6,7,13
30,2025-05-24T17:02:00+02:00,2025-05-25,01:02,2,2,4
30,2025-05-24T17:07:00+02:00,2025-05-25,01:07,8,0,8
30,2025-05-24T17:08:00+02:00,2025-05-25,01:08,18,0,18
35,2025-05-24T16:58:00+02:00,2025-05-25,00:58,0,1,1
35,2025-05-24T17:00:00+02:00,2025-05-25,01:00,2,2,4
35,2025-05-24T17:08:00+02:00,2025-05-25,01:08,2,0,2
35,2025-05-24T17:09:00+02:00,2025-05-25,01:09,0,1,1
49,2025-05-24T16:57:00+02:00,2025-05-25,00:57,2,1,3
49,2025-05-24T17:02:00+02:00,2025-05-25,01:02,0,6,6
49,2025-05-24T17:04:00+02:00,2025-05-25,01:04,0,1,1
49,2025-05-24T17:06:00+02:00,2025-05-25,01:06,1,3,4
49,2025-05-24T17:07:00+02:00,2025-05-25,01:07,3,0,3
49,2025-05-24T17:08:00+02:00,2025-05-25,01:08,1,1,2
51,2025-05-24T17:01:00+02:00,2025-05-25,01:01,0,2,2
52,2025-05-24T16:57:00+02:00,2025-05-25,00:57,0,6,6
52,2025-05-24T16:58:00+02:00,2025-05-25,00:58,2,1,3
52,2025-05-24T17:00:00+02:00,2025-05-25,01:00,12,0,12
52,2025-05-24T17:09:00+02:00,2025-05-25,01:09,5,1,6
53,2025-05-24T16:58:00+02:00,2025-05-25,00:58,1,6,7
53,2025-05-24T17:02:00+02:00,2025-05-25,01:02,0,3,3
53,2025-05-24T17:05:00+02:00,2025-05-25,01:05,2,3,5
56,2025-05-24T16:56:00+02:00,2025-05-25,00:56,0,3,3
58,2025-05-24T16:57:00+02:00,2025-05-25,00:57,1,0,1
58,2025-05-24T16:59:00+02:00,2025-05-25,00:59,2,1,3
58,2025-05-24T17:02:00+02:00,2025-05-25,01:02,2,3,5
58,2025-05-24T17:03:00+02:00,2025-05-25,01:03,0,7,7
58,2025-05-24T17:06:00+02:00,2025-05-25,01:06,9,5,14
62,2025-05-24T17:05:00+02:00,2025-05-25,01:05,1,2,3
62,2025-05-24T17:09:00+02:00,2025-05-25,01:09,3,0,3
63,2025-05-24T17:00:00+02:00,2025-05-25,01:00,1,7,8
63,2025-05-24T17:05:00+02:00,2025-05-25,01:05,0,5,5
63,2025-05-24T17:08:00+02:00,2025-05-25,01:08,0,1,1
67,2025-05-24T16:56:00+02:00,2025-05-25,00:56,1,1,2
67,2025-05-24T16:58:00+02:00,2025-05-25,00:58,1,1,2
67,2025-05-24T17:02:00+02:00,2025-05-25,01:02,1,0,1
67,2025-05-24T17:04:00+02:00,2025-05-25,01:04,1,0,1
67,2025-05-24T17:08:00+02:00,2025-05-25,01:08,1,0,1
68,2025-05-24T16:55:00+02:00,2025-05-25,00:55,2,0,2
68,2025-05-24T17:03:00+02:00,2025-05-25,01:03,1,0,1
68,2025-05-24T17:06:00+02:00,2025-05-25,01:06,3,1,4
72,2025-05-24T16:56:00+02:00,2025-05-25,00:56,0,1,1
79,2025-05-24T16:56:00+02:00,2025-05-25,00:56,1,0,1
79,2025-05-24T16:58:00+02:00,2025-05-25,00:58,4,2,6
79,2025-05-24T16:59:00+02:00,2025-05-25,00:59,3,1,4
79,2025-05-24T17:05:00+02:00,2025-05-25,01:05,1,2,3
117,2025-05-24T17:00:00+02:00,2025-05-25,01:00,4,8,12
130,2025-05-24T17:00:00+02:00,2025-05-25,01:00,1,0,1
141,2025-05-24T16:55:00+02:00,2025-05-25,00:55,19,2,21
141,2025-05-24T17:00:00+02:00,2025-05-25,01:00,9,5,14
141,2025-05-24T17:05:00+02:00,2025-05-25,01:05,3,7,10
181,2025-05-24T17:11:00+02:00,2025-05-25,01:11,2,8,10
181,2025-05-24T17:13:00+02:00,2025-05-25,01:13,0,5,5
181,2025-05-24T17:14:00+02:00,2025-05-25,01:14,3,3,6
181,2025-05-24T17:15:00+02:00,2025-05-25,01:15,1,0,1
181,2025-05-24T17:19:00+02:00,2025-05-25,01:19,5,3,8
181,2025-05-24T17:21:00+02:00,2025-05-25,01:21,2,0,2
182,2025-05-24T17:15:00+02:00,2025-05-25,01:15,5,8,13
3,2025-05-24T18:29:00+02:00,2025-05-25,02:29,5,4,9
3,2025-05-24T18:31:00+02:00,2025-05-25,02:31,5,0,5
3,2025-05-24T18:33:00+02:00,2025-05-25,02:33,3,0,3
3,2025-05-24T18:35:00+02:00,2025-05-25,02:35,3,3,6
3,2025-05-24T18:38:00+02:00,2025-05-25,02:38,1,1,2
3,2025-05-24T18:39:00+02:00,2025-05-25,02:39,5,4,9
4,2025-05-24T18:25:00+02:00,2025-05-25,02:25,0,1,1
4,2025-05-24T18:30:00+02:00,2025-05-25,02:30,1,4,5
4,2025-05-24T18:34:00+02:00,2025-05-25,02:34,0,2,2
4,2025-05-24T18:36:00+02:00,2025-05-25,02:36,4,2,6
4,2025-05-24T18:38:00+02:00,2025-05-25,02:38,0,5,5
4,2025-05-24T18:39:00+02:00,2025-05-25,02:39,0,2,2
5,2025-05-24T18:30:00+02:00,2025-05-25,02:30,1,17,18
6,2025-05-24T18:30:00+02:00,2025-05-25,02:30,0,2,2
6,2025-05-24T18:31:00+02:00,2025-05-25,02:31,3,0,3
6,2025-05-24T18:32:00+02:00,2025-05-25,02:32,1,0,1
6,2025-05-24T18:33:00+02:00,2025-05-25,02:33,3,0,3
6,2025-05-24T18:39:00+02:00,2025-05-25,02:39,0,1,1
28,2025-05-24T18:34:00+02:00,2025-05-25,02:34,0,2,2
29,2025-05-24T18:31:00+02:00,2025-05-25,02:31,0,1,1
36,2025-05-24T18:25:00+02:00,2025-05-25,02:25,3,3,6
36,2025-05-24T18:27:00+02:00,2025-05-25,02:27,1,0,1
36,2025-05-24T18:31:00+02:00,2025-05-25,02:31,2,0,2
36,2025-05-24T18:32:00+02:00,2025-05-25,02:32,2,5,7
36,2025-05-24T18:35:00+02:00,2025-05-25,02:35,7,1,8
36,2025-05-24T18:37:00+02:00,2025-05-25,02:37,0,2,2
36,2025-05-24T18:39:00+02:00,2025-05-25,02:39,1,5,6
41,2025-05-24T18:29:00+02:00,2025-05-25,02:29,4,0,4
41,2025-05-24T18:34:00+02:00,2025-05-25,02:34,4,1,5
41,2025-05-24T18:36:00+02:00,2025-05-25,02:36,5,3,8
41,2025-05-24T18:37:00+02:00,2025-05-25,02:37,5,1,6
41,2025-05-24T18:39:00+02:00,2025-05-25,02:39,0,2,2
45,2025-05-24T18:27:00+02:00,2025-05-25,02:27,3,4,7
45,2025-05-24T18:31:00+02:00,2025-05-25,02:31,1,5,6
45,2025-05-24T18:34:00+02:00,2025-05-25,02:34,0,5,5
47,2025-05-24T18:25:00+02:00,2025-05-25,02:25,5,0,5
47,2025-05-24T18:31:00+02:00,2025-05-25,02:31,2,1,3
47,2025-05-24T18:36:00+02:00,2025-05-25,02:36,1,2,3
54,2025-05-24T18:27:00+02:00,2025-05-25,02:27,1,0,1
54,2025-05-24T18:29:00+02:00,2025-05-25,02:29,2,0,2
54,2025-05-24T18:39:00+02:00,2025-05-25,02:39,3,0,3
66,2025-05-24T18:25:00+02:00,2025-05-25,02:25,0,2,2
66,2025-05-24T18:29:00+02:00,2025-05-25,02:29,2,0,2
66,2025-05-24T18:32:00+02:00,2025-05-25,02:32,1,4,5
66,2025-05-24T18:34:00+02:00,2025-05-25,02:34,0,2,2
66,2025-05-24T18:37:00+02:00,2025-05-25,02:37,3,2,5
66,2025-05-24T18:38:00+02:00,2025-05-25,02:38,1,1,2
69,2025-05-24T18:28:00+02:00,2025-05-25,02:28,0,1,1
69,2025-05-24T18:36:00+02:00,2025-05-25,02:36,0,1,1
69,2025-05-24T18:38:00+02:00,2025-05-25,02:38,1,1,2
77,2025-05-24T18:30:00+02:00,2025-05-25,02:30,1,0,1
84,2025-05-24T18:30:00+02:00,2025-05-25,02:30,4,8,12
84,2025-05-24T18:35:00+02:00,2025-05-25,02:35,7,10,17
107,2025-05-24T18:35:00+02:00,2025-05-25,02:35,3,0,3
108,2025-05-24T18:25:00+02:00,2025-05-25,02:25,2,0,2
108,2025-05-24T18:33:00+02:00,2025-05-25,02:33,1,2,3
132,2025-05-24T18:25:00+02:00,2025-05-25,02:25,8,1,9
132,2025-05-24T18:30:00+02:00,2025-05-25,02:30,6,0,6
132,2025-05-24T18:35:00+02:00,2025-05-25,02:35,7,0,7
133,2025-05-24T18:30:00+02:00,2025-05-25,02:30,2,0,2
135,2025-05-24T18:30:00+02:00,2025-05-25,02:30,4,4,8
165,2025-05-24T18:35:00+02:00,2025-05-25,02:35,1,0,1
166,2025-05-24T18:35:00+02:00,2025-05-25,02:35,0,1,1
1,2025-05-24T18:36:00+02:00,2025-05-25,02:36,1,1,2
1,2025-05-24T18:39:00+02:00,2025-05-25,02:39,0,1,1
2,2025-05-24T18:33:00+02:00,2025-05-25,02:33,0,5,5
2,2025-05-24T18:34:00+02:00,2025-05-25,02:34,0,4,4
10,2025-05-24T18:29:00+02:00,2025-05-25,02:29,0,1,1
10,2025-05-24T18:39:00+02:00,2025-05-25,02:39,0,1,1
17,2025-05-24T18:29:00+02:00,2025-05-25,02:29,1,0,1
19,2025-05-24T18:28:00+02:00,2025-05-25,02:28,0,4,4
19,2025-05-24T18:36:00+02:00,2025-05-25,02:36,5,1,6
20,2025-05-24T18:31:00+02:00,2025-05-25,02:31,1,3,4
20,2025-05-24T18:32:00+02:00,2025-05-25,02:32,2,0,2
23,2025-05-24T18:25:00+02:00,2025-05-25,02:25,0,2,2
24,2025-05-24T18:25:00+02:00,2025-05-25,02:25,1,3,4
24,2025-05-24T18:26:00+02:00,2025-05-25,02:26,0,1,1
24,2025-05-24T18:28:00+02:00,2025-05-25,02:28,3,0,3
24,2025-05-24T18:30:00+02:00,2025-05-25,02:30,1,0,1
24,2025-05-24T18:31:00+02:00,2025-05-25,02:31,1,3,4
24,2025-05-24T18:32:00+02:00,2025-05-25,02:32,1,0,1
24,2025-05-24T18:38:00+02:00,2025-05-25,02:38,1,0,1
25,2025-05-24T18:30:00+02:00,2025-05-25,02:30,1,3,4
27,2025-05-24T18:30:00+02:00,2025-05-25,02:30,0,2,2
30,2025-05-24T18:25:00+02:00,2025-05-25,02:25,9,1,10
30,2025-05-24T18:26:00+02:00,2025-05-25,02:26,1,9,10
30,2025-05-24T18:30:00+02:00,2025-05-25,02:30,2,3,5
30,2025-05-24T18:32:00+02:00,2025-05-25,02:32,1,17,18
30,2025-05-24T18:37:00+02:00,2025-05-25,02:37,2,3,5
49,2025-05-24T18:29:00+02:00,2025-05-25,02:29,2,0,2
49,2025-05-24T18:32:00+02:00,2025-05-25,02:32,2,1,3
52,2025-05-24T18:27:00+02:00,2025-05-25,02:27,8,0,8
52,2025-05-24T18:29:00+02:00,2025-05-25,02:29,1,0,1
52,2025-05-24T18:33:00+02:00,2025-05-25,02:33,2,0,2
52,2025-05-24T18:35:00+02:00,2025-05-25,02:35,0,6,6
53,2025-05-24T18:25:00+02:00,2025-05-25,02:25,2,0,2
53,2025-05-24T18:31:00+02:00,2025-05-25,02:31,3,0,3
56,2025-05-24T18:27:00+02:00,2025-05-25,02:27,0,2,2
56,2025-05-24T18:29:00+02:00,2025-05-25,02:29,5,2,7
56,2025-05-24T18:34:00+02:00,2025-05-25,02:34,0,1,1
56,2025-05-24T18:39:00+02:00,2025-05-25,02:39,2,0,2
58,2025-05-24T18:25:00+02:00,2025-05-25,02:25,0,1,1
58,2025-05-24T18:27:00+02:00,2025-05-25,02:27,0,1,1
58,2025-05-24T18:28:00+02:00,2025-05-25,02:28,0,2,2
58,2025-05-24T18:29:00+02:00,2025-05-25,02:29,0,4,4
58,2025-05-24T18:31:00+02:00,2025-05-25,02:31,3,3,6
58,2025-05-24T18:35:00+02:00,2025-05-25,02:35,4,5,9
62,2025-05-24T18:31:00+02:00,2025-05-25,02:31,0,2,2
62,2025-05-24T18:32:00+02:00,2025-05-25,02:32,0,1,1
63,2025-05-24T18:29:00+02:00,2025-05-25,02:29,0,2,2
63,2025-05-24T18:31:00+02:00,2025-05-25,02:31,0,4,4
63,2025-05-24T18:36:00+02:00,2025-05-25,02:36,0,2,2
67,2025-05-24T18:28:00+02:00,2025-05-25,02:28,0,1,1
67,2025-05-24T18:29:00+02:00,2025-05-25,02:29,1,1,2
68,2025-05-24T18:31:00+02:00,2025-05-25,02:31,1,0,1
68,2025-05-24T18:34:00+02:00,2025-05-25,02:34,1,1,2
72,2025-05-24T18:29:00+02:00,2025-05-25,02:29,4,0,4
72,2025-05-24T18:33:00+02:00,2025-05-25,02:33,2,0,2
72,2025-05-24T18:34:00+02:00,2025-05-25,02:34,0,4,4
79,2025-05-24T18:29:00+02:00,2025-05-25,02:29,0,1,1
79,2025-05-24T18:30:00+02:00,2025-05-25,02:30,2,2,4
79,2025-05-24T18:34:00+02:00,2025-05-25,02:34,3,0,3
79,2025-05-24T18:37:00+02:00,2025-05-25,02:37,2,0,2
109,2025-05-24T18:25:00+02:00,2025-05-25,02:25,0,2,2
139,2025-05-24T18:25:00+02:00,2025-05-25,02:25,4,0,4
181,2025-05-24T18:25:00+02:00,2025-05-25,02:25,0,3,3
181,2025-05-24T18:26:00+02:00,2025-05-25,02:26,1,2,3
181,2025-05-24T18:27:00+02:00,2025-05-25,02:27,1,0,1
181,2025-05-24T18:28:00+02:00,2025-05-25,02:28,3,0,3
181,2025-05-24T18:31:00+02:00,2025-05-25,02:31,1,0,1
181,2025-05-24T18:32:00+02:00,2025-05-25,02:32,3,4,7
181,2025-05-24T18:33:00+02:00,2025-05-25,02:33,4,0,4
181,2025-05-24T18:34:00+02:00,2025-05-25,02:34,2,2,4
181,2025-05-24T18:35:00+02:00,2025-05-25,02:35,0,3,3
181,2025-05-24T18:39:00+02:00,2025-05-25,02:39,1,0,1
182,2025-05-24T18:25:00+02:00,2025-05-25,02:25,15,11,26
181,2025-05-24T18:44:00+02:00,2025-05-25,02:44,8,2,10
181,2025-05-24T18:47:00+02:00,2025-05-25,02:47,4,3,7
181,2025-05-24T18:53:00+02:00,2025-05-25,02:53,0,2,2
181,2025-05-24T18:54:00+02:00,2025-05-25,02:54,1,3,4
182,2025-05-24T18:50:00+02:00,2025-05-25,02:50,13,7,20
3,2025-05-24T18:40:00+02:00,2025-05-25,02:40,3,6,9
3,2025-05-24T18:45:00+02:00,2025-05-25,02:45,2,2,4
3,2025-05-24T18:47:00+02:00,2025-05-25,02:47,1,2,3
3,2025-05-24T18:51:00+02:00,2025-05-25,02:51,0,1,1
3,2025-05-24T18:52:00+02:00,2025-05-25,02:52,1,0,1
3,2025-05-24T18:53:00+02:00,2025-05-25,02:53,1,3,4
3,2025-05-24T18:54:00+02:00,2025-05-25,02:54,0,1,1
4,2025-05-24T18:40:00+02:00,2025-05-25,02:40,3,0,3
4,2025-05-24T18:42:00+02:00,2025-05-25,02:42,0,1,1
4,2025-05-24T18:43:00+02:00,2025-05-25,02:43,1,0,1
4,2025-05-24T18:46:00+02:00,2025-05-25,02:46,1,1,2
4,2025-05-24T18:48:00+02:00,2025-05-25,02:48,1,1,2
4,2025-05-24T18:49:00+02:00,2025-05-25,02:49,3,4,7
4,2025-05-24T18:52:00+02:00,2025-05-25,02:52,1,3,4
6,2025-05-24T18:48:00+02:00,2025-05-25,02:48,4,1,5
6,2025-05-24T18:50:00+02:00,2025-05-25,02:50,0,1,1
6,2025-05-24T18:54:00+02:00,2025-05-25,02:54,2,0,2
28,2025-05-24T18:40:00+02:00,2025-05-25,02:40,1,0,1
28,2025-05-24T18:41:00+02:00,2025-05-25,02:41,1,0,1
28,2025-05-24T18:44:00+02:00,2025-05-25,02:44,0,1,1
28,2025-05-24T18:51:00+02:00,2025-05-25,02:51,0,1,1
29,2025-05-24T18:41:00+02:00,2025-05-25,02:41,0,2,2
29,2025-05-24T18:54:00+02:00,2025-05-25,02:54,0,2,2
31,2025-05-24T18:50:00+02:00,2025-05-25,02:50,1,0,1
36,2025-05-24T18:40:00+02:00,2025-05-25,02:40,3,1,4
36,2025-05-24T18:42:00+02:00,2025-05-25,02:42,6,1,7
36,2025-05-24T18:46:00+02:00,2025-05-25,02:46,2,9,11
36,2025-05-24T18:49:00+02:00,2025-05-25,02:49,10,0,10
40,2025-05-24T18:41:00+02:00,2025-05-25,02:41,0,1,1
40,2025-05-24T18:50:00+02:00,2025-05-25,02:50,2,0,2
40,2025-05-24T18:52:00+02:00,2025-05-25,02:52,2,0,2
41,2025-05-24T18:43:00+02:00,2025-05-25,02:43,0,6,6
41,2025-05-24T18:45:00+02:00,2025-05-25,02:45,2,2,4
41,2025-05-24T18:46:00+02:00,2025-05-25,02:46,1,1,2
45,2025-05-24T18:51:00+02:00,2025-05-25,02:51,0,2,2
45,2025-05-24T18:54:00+02:00,2025-05-25,02:54,1,3,4
47,2025-05-24T18:40:00+02:00,2025-05-25,02:40,3,1,4
47,2025-05-24T18:46:00+02:00,2025-05-25,02:46,7,1,8
47,2025-05-24T18:50:00+02:00,2025-05-25,02:50,4,2,6
47,2025-05-24T18:53:00+02:00,2025-05-25,02:53,0,2,2
47,2025-05-24T18:54:00+02:00,2025-05-25,02:54,0,1,1
54,2025-05-24T18:44:00+02:00,2025-05-25,02:44,0,1,1
54,2025-05-24T18:48:00+02:00,2025-05-25,02:48,1,0,1
54,2025-05-24T18:51:00+02:00,2025-05-25,02:51,0,5,5
54,2025-05-24T18:52:00+02:00,2025-05-25,02:52,0,3,3
59,2025-05-24T18:50:00+02:00,2025-05-25,02:50,3,4,7
61,2025-05-24T18:42:00+02:00,2025-05-25,02:42,1,0,1
61,2025-05-24T18:45:00+02:00,2025-05-25,02:45,1,0,1
61,2025-05-24T18:46:00+02:00,2025-05-25,02:46,0,1,1
66,2025-05-24T18:41:00+02:00,2025-05-25,02:41,1,0,1
66,2025-05-24T18:46:00+02:00,2025-05-25,02:46,2,1,3
66,2025-05-24T18:54:00+02:00,2025-05-25,02:54,0,5,5
69,2025-05-24T18:43:00+02:00,2025-05-25,02:43,1,0,1
69,2025-05-24T18:44:00+02:00,2025-05-25,02:44,2,0,2
71,2025-05-24T18:42:00+02:00,2025-05-25,02:42,0,1,1
77,2025-05-24T18:40:00+02:00,2025-05-25,02:40,2,0,2
77,2025-05-24T18:50:00+02:00,2025-05-25,02:50,1,0,1
87,2025-05-24T18:43:00+02:00,2025-05-25,02:43,1,0,1
107,2025-05-24T18:40:00+02:00,2025-05-25,02:40,2,0,2
107,2025-05-24T18:50:00+02:00,2025-05-25,02:50,3,0,3
108,2025-05-24T18:44:00+02:00,2025-05-25,02:44,1,1,2
108,2025-05-24T18:48:00+02:00,2025-05-25,02:48,1,0,1
108,2025-05-24T18:53:00+02:00,2025-05-25,02:53,0,1,1
132,2025-05-24T18:45:00+02:00,2025-05-25,02:45,6,5,11
133,2025-05-24T18:45:00+02:00,2025-05-25,02:45,0,5,5
135,2025-05-24T18:45:00+02:00,2025-05-25,02:45,0,8,8
135,2025-05-24T18:50:00+02:00,2025-05-25,02:50,3,8,11
162,2025-05-24T18:45:00+02:00,2025-05-25,02:45,2,0,2
162,2025-05-24T18:50:00+02:00,2025-05-25,02:50,5,0,5
1,2025-05-24T18:40:00+02:00,2025-05-25,02:40,0,2,2
1,2025-05-24T18:48:00+02:00,2025-05-25,02:48,1,0,1
2,2025-05-24T18:43:00+02:00,2025-05-25,02:43,1,1,2
2,2025-05-24T18:47:00+02:00,2025-05-25,02:47,0,4,4
2,2025-05-24T18:53:00+02:00,2025-05-25,02:53,0,5,5
9,2025-05-24T18:40:00+02:00,2025-05-25,02:40,1,1,2
10,2025-05-24T18:41:00+02:00,2025-05-25,02:41,0,1,1
17,2025-05-24T18:45:00+02:00,2025-05-25,02:45,0,2,2
17,2025-05-24T18:54:00+02:00,2025-05-25,02:54,0,1,1
19,2025-05-24T18:41:00+02:00,2025-05-25,02:41,1,3,4
19,2025-05-24T18:42:00+02:00,2025-05-25,02:42,2,0,2
19,2025-05-24T18:44:00+02:00,2025-05-25,02:44,0,7,7
19,2025-05-24T18:46:00+02:00,2025-05-25,02:46,0,3,3
20,2025-05-24T18:42:00+02:00,2025-05-25,02:42,0,1,1
20,2025-05-24T18:44:00+02:00,2025-05-25,02:44,6,3,9
23,2025-05-24T18:45:00+02:00,2025-05-25,02:45,6,0,6
24,2025-05-24T18:40:00+02:00,2025-05-25,02:40,0,1,1
24,2025-05-24T18:41:00+02:00,2025-05-25,02:41,0,1,1
24,2025-05-24T18:47:00+02:00,2025-05-25,02:47,0,1,1
24,2025-05-24T18:51:00+02:00,2025-05-25,02:51,2,3,5
25,2025-05-24T18:40:00+02:00,2025-05-25,02:40,5,6,11
25,2025-05-24T18:50:00+02:00,2025-05-25,02:50,1,3,4
30,2025-05-24T18:42:00+02:00,2025-05-25,02:42,0,5,5
30,2025-05-24T18:43:00+02:00,2025-05-25,02:43,2,0,2
30,2025-05-24T18:45:00+02:00,2025-05-25,02:45,1,9,10
30,2025-05-24T18:46:00+02:00,2025-05-25,02:46,2,3,5
30,2025-05-24T18:48:00+02:00,2025-05-25,02:48,3,5,8
30,2025-05-24T18:51:00+02:00,2025-05-25,02:51,5,3,8
30,2025-05-24T18:52:00+02:00,2025-05-25,02:52,1,0,1
30,2025-05-24T18:53:00+02:00,2025-05-25,02:53,0,1,1
35,2025-05-24T18:41:00+02:00,2025-05-25,02:41,0,1,1
35,2025-05-24T18:49:00+02:00,2025-05-25,02:49,1,0,1
35,2025-05-24T18:50:00+02:00,2025-05-25,02:50,1,0,1
49,2025-05-24T18:42:00+02:00,2025-05-25,02:42,2,1,3
49,2025-05-24T18:44:00+02:00,2025-05-25,02:44,0,2,2
49,2025-05-24T18:53:00+02:00,2025-05-25,02:53,0,2,2
52,2025-05-24T18:41:00+02:00,2025-05-25,02:41,1,5,6
52,2025-05-24T18:51:00+02:00,2025-05-25,02:51,2,2,4
53,2025-05-24T18:45:00+02:00,2025-05-25,02:45,0,2,2
53,2025-05-24T18:51:00+02:00,2025-05-25,02:51,1,4,5
56,2025-05-24T18:44:00+02:00,2025-05-25,02:44,1,2,3
56,2025-05-24T18:54:00+02:00,2025-05-25,02:54,2,0,2
58,2025-05-24T18:42:00+02:00,2025-05-25,02:42,1,0,1
58,2025-05-24T18:47:00+02:00,2025-05-25,02:47,1,1,2
58,2025-05-24T18:53:00+02:00,2025-05-25,02:53,1,3,4
58,2025-05-24T18:54:00+02:00,2025-05-25,02:54,1,5,6
62,2025-05-24T18:48:00+02:00,2025-05-25,02:48,1,6,7
62,2025-05-24T18:51:00+02:00,2025-05-25,02:51,1,0,1
62,2025-05-24T18:54:00+02:00,2025-05-25,02:54,2,0,2
63,2025-05-24T18:40:00+02:00,2025-05-25,02:40,0,1,1
63,2025-05-24T18:41:00+02:00,2025-05-25,02:41,0,2,2
63,2025-05-24T18:53:00+02:00,2025-05-25,02:53,0,1,1
67,2025-05-24T18:50:00+02:00,2025-05-25,02:50,1,0,1
79,2025-05-24T18:40:00+02:00,2025-05-25,02:40,1,1,2
79,2025-05-24T18:41:00+02:00,2025-05-25,02:41,0,2,2
79,2025-05-24T18:50:00+02:00,2025-05-25,02:50,2,0,2
109,2025-05-24T18:50:00+02:00,2025-05-25,02:50,4,1,5
117,2025-05-24T18:40:00+02:00,2025-05-25,02:40,1,0,1
136,2025-05-24T18:50:00+02:00,2025-05-25,02:50,1,0,1
142,2025-05-24T18:45:00+02:00,2025-05-25,02:45,0,1,1
3,2025-05-24T19:26:00+02:00,2025-05-25,03:26,4,2,6
3,2025-05-24T19:27:00+02:00,2025-05-25,03:27,1,1,2
3,2025-05-24T19:30:00+02:00,2025-05-25,03:30,0,3,3
3,2025-05-24T19:34:00+02:00,2025-05-25,03:34,8,2,10
3,2025-05-24T19:38:00+02:00,2025-05-25,03:38,1,0,1
4,2025-05-24T19:31:00+02:00,2025-05-25,03:31,0,4,4
4,2025-05-24T19:39:00+02:00,2025-05-25,03:39,1,0,1
5,2025-05-24T19:30:00+02:00,2025-05-25,03:30,2,1,3
6,2025-05-24T19:27:00+02:00,2025-05-25,03:27,2,1,3
6,2025-05-24T19:29:00+02:00,2025-05-25,03:29,3,1,4
6,2025-05-24T19:35:00+02:00,2025-05-25,03:35,0,7,7
6,2025-05-24T19:36:00+02:00,2025-05-25,03:36,0,1,1
28,2025-05-24T19:35:00+02:00,2025-05-25,03:35,0,1,1
28,2025-05-24T19:37:00+02:00,2025-05-25,03:37,0,4,4
31,2025-05-24T19:34:00+02:00,2025-05-25,03:34,1,0,1
36,2025-05-24T19:29:00+02:00,2025-05-25,03:29,10,16,26
36,2025-05-24T19:30:00+02:00,2025-05-25,03:30,7,0,7
36,2025-05-24T19:31:00+02:00,2025-05-25,03:31,0,6,6
36,2025-05-24T19:33:00+02:00,2025-05-25,03:33,7,5,12
36,2025-05-24T19:34:00+02:00,2025-05-25,03:34,4,0,4
36,2025-05-24T19:37:00+02:00,2025-05-25,03:37,1,0,1
36,2025-05-24T19:39:00+02:00,2025-05-25,03:39,3,0,3
37,2025-05-24T19:37:00+02:00,2025-05-25,03:37,0,6,6
41,2025-05-24T19:25:00+02:00,2025-05-25,03:25,0,1,1
41,2025-05-24T19:29:00+02:00,2025-05-25,03:29,0,5,5
41,2025-05-24T19:37:00+02:00,2025-05-25,03:37,0,4,4
45,2025-05-24T19:34:00+02:00,2025-05-25,03:34,0,1,1
45,2025-05-24T19:36:00+02:00,2025-05-25,03:36,1,0,1
45,2025-05-24T19:37:00+02:00,2025-05-25,03:37,0,1,1
45,2025-05-24T19:39:00+02:00,2025-05-25,03:39,0,1,1
47,2025-05-24T19:27:00+02:00,2025-05-25,03:27,0,1,1
47,2025-05-24T19:29:00+02:00,2025-05-25,03:29,2,2,4
47,2025-05-24T19:30:00+02:00,2025-05-25,03:30,1,1,2
47,2025-05-24T19:31:00+02:00,2025-05-25,03:31,0,5,5
47,2025-05-24T19:33:00+02:00,2025-05-25,03:33,1,0,1
47,2025-05-24T19:38:00+02:00,2025-05-25,03:38,0,1,1
54,2025-05-24T19:25:00+02:00,2025-05-25,03:25,6,0,6
54,2025-05-24T19:29:00+02:00,2025-05-25,03:29,2,0,2
54,2025-05-24T19:30:00+02:00,2025-05-25,03:30,0,1,1
54,2025-05-24T19:31:00+02:00,2025-05-25,03:31,3,1,4
59,2025-05-24T19:30:00+02:00,2025-05-25,03:30,4,1,5
61,2025-05-24T19:26:00+02:00,2025-05-25,03:26,1,0,1
61,2025-05-24T19:29:00+02:00,2025-05-25,03:29,1,0,1
61,2025-05-24T19:34:00+02:00,2025-05-25,03:34,1,0,1
61,2025-05-24T19:37:00+02:00,2025-05-25,03:37,3,0,3
66,2025-05-24T19:27:00+02:00,2025-05-25,03:27,3,0,3
66,2025-05-24T19:39:00+02:00,2025-05-25,03:39,1,0,1
77,2025-05-24T19:35:00+02:00,2025-05-25,03:35,1,0,1
132,2025-05-24T19:30:00+02:00,2025-05-25,03:30,1,0,1
134,2025-05-24T19:35:00+02:00,2025-05-25,03:35,5,6,11
162,2025-05-24T19:35:00+02:00,2025-05-25,03:35,2,5,7
165,2025-05-24T19:35:00+02:00,2025-05-25,03:35,1,0,1
167,2025-05-24T19:30:00+02:00,2025-05-25,03:30,0,1,1
179,2025-05-24T19:25:00+02:00,2025-05-25,03:25,2,1,3
179,2025-05-24T19:30:00+02:00,2025-05-25,03:30,1,0,1
1,2025-05-24T19:26:00+02:00,2025-05-25,03:26,3,0,3
1,2025-05-24T19:32:00+02:00,2025-05-25,03:32,2,0,2
1,2025-05-24T19:35:00+02:00,2025-05-25,03:35,0,1,1
1,2025-05-24T19:38:00+02:00,2025-05-25,03:38,0,1,1
2,2025-05-24T19:37:00+02:00,2025-05-25,03:37,1,0,1
9,2025-05-24T19:37:00+02:00,2025-05-25,03:37,1,0,1
18,2025-05-24T19:28:00+02:00,2025-05-25,03:28,1,0,1
19,2025-05-24T19:38:00+02:00,2025-05-25,03:38,5,0,5
20,2025-05-24T19:25:00+02:00,2025-05-25,03:25,6,1,7
20,2025-05-24T19:31:00+02:00,2025-05-25,03:31,0,2,2
20,2025-05-24T19:33:00+02:00,2025-05-25,03:33,3,2,5
23,2025-05-24T19:37:00+02:00,2025-05-25,03:37,1,0,1
24,2025-05-24T19:31:00+02:00,2025-05-25,03:31,2,0,2
24,2025-05-24T19:32:00+02:00,2025-05-25,03:32,4,0,4
24,2025-05-24T19:34:00+02:00,2025-05-25,03:34,1,0,1
25,2025-05-24T19:25:00+02:00,2025-05-25,03:25,2,2,4
25,2025-05-24T19:30:00+02:00,2025-05-25,03:30,1,0,1
27,2025-05-24T19:36:00+02:00,2025-05-25,03:36,1,0,1
30,2025-05-24T19:26:00+02:00,2025-05-25,03:26,3,1,4
30,2025-05-24T19:27:00+02:00,2025-05-25,03:27,5,2,7
30,2025-05-24T19:30:00+02:00,2025-05-25,03:30,0,2,2
30,2025-05-24T19:32:00+02:00,2025-05-25,03:32,5,0,5
30,2025-05-24T19:37:00+02:00,2025-05-25,03:37,8,2,10
30,2025-05-24T19:39:00+02:00,2025-05-25,03:39,7,4,11
35,2025-05-24T19:29:00+02:00,2025-05-25,03:29,1,1,2
49,2025-05-24T19:27:00+02:00,2025-05-25,03:27,0,5,5
49,2025-05-24T19:33:00+02:00,2025-05-25,03:33,3,0,3
49,2025-05-24T19:38:00+02:00,2025-05-25,03:38,4,2,6
49,2025-05-24T19:39:00+02:00,2025-05-25,03:39,1,3,4
52,2025-05-24T19:34:00+02:00,2025-05-25,03:34,0,2,2
53,2025-05-24T19:28:00+02:00,2025-05-25,03:28,1,0,1
56,2025-05-24T19:34:00+02:00,2025-05-25,03:34,2,0,2
58,2025-05-24T19:30:00+02:00,2025-05-25,03:30,1,0,1
58,2025-05-24T19:32:00+02:00,2025-05-25,03:32,0,2,2
58,2025-05-24T19:34:00+02:00,2025-05-25,03:34,1,0,1
58,2025-05-24T19:35:00+02:00,2025-05-25,03:35,2,1,3
62,2025-05-24T19:33:00+02:00,2025-05-25,03:33,1,0,1
63,2025-05-24T19:33:00+02:00,2025-05-25,03:33,0,1,1
79,2025-05-24T19:27:00+02:00,2025-05-25,03:27,0,1,1
79,2025-05-24T19:28:00+02:00,2025-05-25,03:28,0,2,2
79,2025-05-24T19:33:00+02:00,2025-05-25,03:33,1,1,2
79,2025-05-24T19:35:00+02:00,2025-05-25,03:35,1,0,1
79,2025-05-24T19:38:00+02:00,2025-05-25,03:38,0,1,1
181,2025-05-24T19:27:00+02:00,2025-05-25,03:27,12,3,15
181,2025-05-24T19:28:00+02:00,2025-05-25,03:28,5,0,5
181,2025-05-24T19:32:00+02:00,2025-05-25,03:32,2,0,2
181,2025-05-24T19:36:00+02:00,2025-05-25,03:36,1,0,1
182,2025-05-24T19:30:00+02:00,2025-05-25,03:30,17,12,29
3,2025-05-24T18:56:00+02:00,2025-05-25,02:56,2,5,7
3,2025-05-24T19:00:00+02:00,2025-05-25,03:00,9,2,11
3,2025-05-24T19:06:00+02:00,2025-05-25,03:06,5,3,8
3,2025-05-24T19:07:00+02:00,2025-05-25,03:07,4,0,4
4,2025-05-24T18:55:00+02:00,2025-05-25,02:55,1,1,2
4,2025-05-24T18:56:00+02:00,2025-05-25,02:56,0,2,2
4,2025-05-24T19:01:00+02:00,2025-05-25,03:01,4,1,5
4,2025-05-24T19:02:00+02:00,2025-05-25,03:02,0,3,3
4,2025-05-24T19:07:00+02:00,2025-05-25,03:07,1,1,2
4,2025-05-24T19:08:00+02:00,2025-05-25,03:08,5,3,8
6,2025-05-24T18:55:00+02:00,2025-05-25,02:55,0,1,1
6,2025-05-24T18:58:00+02:00,2025-05-25,02:58,0,1,1
6,2025-05-24T19:02:00+02:00,2025-05-25,03:02,3,3,6
6,2025-05-24T19:04:00+02:00,2025-05-25,03:04,5,2,7
28,2025-05-24T18:57:00+02:00,2025-05-25,02:57,1,0,1
28,2025-05-24T19:03:00+02:00,2025-05-25,03:03,0,1,1
28,2025-05-24T19:07:00+02:00,2025-05-25,03:07,1,2,3
29,2025-05-24T18:56:00+02:00,2025-05-25,02:56,0,3,3
29,2025-05-24T18:59:00+02:00,2025-05-25,02:59,0,3,3
36,2025-05-24T18:56:00+02:00,2025-05-25,02:56,2,2,4
36,2025-05-24T18:57:00+02:00,2025-05-25,02:57,6,0,6
36,2025-05-24T18:58:00+02:00,2025-05-25,02:58,2,0,2
36,2025-05-24T19:04:00+02:00,2025-05-25,03:04,9,1,10
36,2025-05-24T19:07:00+02:00,2025-05-25,03:07,6,6,12
36,2025-05-24T19:08:00+02:00,2025-05-25,03:08,15,2,17
36,2025-05-24T19:09:00+02:00,2025-05-25,03:09,4,2,6
40,2025-05-24T18:55:00+02:00,2025-05-25,02:55,2,0,2
40,2025-05-24T19:01:00+02:00,2025-05-25,03:01,1,0,1
41,2025-05-24T18:57:00+02:00,2025-05-25,02:57,4,2,6
45,2025-05-24T18:55:00+02:00,2025-05-25,02:55,0,2,2
45,2025-05-24T18:57:00+02:00,2025-05-25,02:57,0,1,1
45,2025-05-24T19:05:00+02:00,2025-05-25,03:05,2,2,4
45,2025-05-24T19:07:00+02:00,2025-05-25,03:07,0,1,1
47,2025-05-24T19:02:00+02:00,2025-05-25,03:02,0,6,6
47,2025-05-24T19:09:00+02:00,2025-05-25,03:09,0,2,2
50,2025-05-24T18:56:00+02:00,2025-05-25,02:56,1,0,1
50,2025-05-24T19:07:00+02:00,2025-05-25,03:07,0,2,2
59,2025-05-24T19:00:00+02:00,2025-05-25,03:00,4,1,5
59,2025-05-24T19:05:00+02:00,2025-05-25,03:05,13,1,14
61,2025-05-24T18:57:00+02:00,2025-05-25,02:57,1,2,3
61,2025-05-24T18:59:00+02:00,2025-05-25,02:59,1,0,1
61,2025-05-24T19:01:00+02:00,2025-05-25,03:01,1,0,1
61,2025-05-24T19:02:00+02:00,2025-05-25,03:02,2,0,2
66,2025-05-24T19:02:00+02:00,2025-05-25,03:02,6,0,6
69,2025-05-24T19:09:00+02:00,2025-05-25,03:09,1,0,1
84,2025-05-24T18:55:00+02:00,2025-05-25,02:55,3,2,5
84,2025-05-24T19:05:00+02:00,2025-05-25,03:05,2,2,4
107,2025-05-24T18:55:00+02:00,2025-05-25,02:55,1,0,1
108,2025-05-24T18:55:00+02:00,2025-05-25,02:55,2,0,2
108,2025-05-24T18:58:00+02:00,2025-05-25,02:58,0,1,1
131,2025-05-24T18:55:00+02:00,2025-05-25,02:55,1,0,1
131,2025-05-24T19:00:00+02:00,2025-05-25,03:00,4,5,9
132,2025-05-24T19:00:00+02:00,2025-05-25,03:00,2,0,2
132,2025-05-24T19:05:00+02:00,2025-05-25,03:05,3,1,4
134,2025-05-24T19:00:00+02:00,2025-05-25,03:00,0,2,2
134,2025-05-24T19:05:00+02:00,2025-05-25,03:05,4,2,6
162,2025-05-24T19:05:00+02:00,2025-05-25,03:05,5,0,5
167,2025-05-24T19:00:00+02:00,2025-05-25,03:00,1,0,1
179,2025-05-24T18:55:00+02:00,2025-05-25,02:55,0,1,1
179,2025-05-24T19:00:00+02:00,2025-05-25,03:00,0,2,2
2,2025-05-24T19:01:00+02:00,2025-05-25,03:01,0,2,2
2,2025-05-24T19:02:00+02:00,2025-05-25,03:02,3,0,3
9,2025-05-24T18:58:00+02:00,2025-05-25,02:58,0,1,1
17,2025-05-24T18:56:00+02:00,2025-05-25,02:56,2,0,2
19,2025-05-24T18:57:00+02:00,2025-05-25,02:57,0,9,9
19,2025-05-24T19:00:00+02:00,2025-05-25,03:00,5,0,5
19,2025-05-24T19:06:00+02:00,2025-05-25,03:06,2,4,6
20,2025-05-24T18:57:00+02:00,2025-05-25,02:57,2,1,3
20,2025-05-24T19:05:00+02:00,2025-05-25,03:05,2,5,7
20,2025-05-24T19:06:00+02:00,2025-05-25,03:06,2,14,16
20,2025-05-24T19:08:00+02:00,2025-05-25,03:08,7,2,9
20,2025-05-24T19:09:00+02:00,2025-05-25,03:09,4,3,7
23,2025-05-24T19:02:00+02:00,2025-05-25,03:02,0,1,1
23,2025-05-24T19:05:00+02:00,2025-05-25,03:05,0,1,1
24,2025-05-24T18:55:00+02:00,2025-05-25,02:55,0,1,1
24,2025-05-24T18:59:00+02:00,2025-05-25,02:59,4,0,4
24,2025-05-24T19:00:00+02:00,2025-05-25,03:00,0,1,1
24,2025-05-24T19:08:00+02:00,2025-05-25,03:08,2,1,3
30,2025-05-24T18:55:00+02:00,2025-05-25,02:55,3,8,11
30,2025-05-24T18:57:00+02:00,2025-05-25,02:57,0,5,5
30,2025-05-24T18:58:00+02:00,2025-05-25,02:58,2,4,6
30,2025-05-24T18:59:00+02:00,2025-05-25,02:59,3,1,4
30,2025-05-24T19:01:00+02:00,2025-05-25,03:01,0,1,1
30,2025-05-24T19:08:00+02:00,2025-05-25,03:08,5,0,5
35,2025-05-24T19:03:00+02:00,2025-05-25,03:03,1,2,3
35,2025-05-24T19:04:00+02:00,2025-05-25,03:04,0,2,2
49,2025-05-24T19:03:00+02:00,2025-05-25,03:03,0,4,4
49,2025-05-24T19:05:00+02:00,2025-05-25,03:05,2,0,2
52,2025-05-24T18:55:00+02:00,2025-05-25,02:55,2,8,10
52,2025-05-24T18:56:00+02:00,2025-05-25,02:56,0,1,1
52,2025-05-24T18:59:00+02:00,2025-05-25,02:59,7,2,9
52,2025-05-24T19:02:00+02:00,2025-05-25,03:02,7,5,12
52,2025-05-24T19:04:00+02:00,2025-05-25,03:04,0,2,2
52,2025-05-24T19:05:00+02:00,2025-05-25,03:05,9,7,16
52,2025-05-24T19:07:00+02:00,2025-05-25,03:07,0,1,1
58,2025-05-24T18:56:00+02:00,2025-05-25,02:56,2,1,3
58,2025-05-24T19:03:00+02:00,2025-05-25,03:03,1,1,2
58,2025-05-24T19:04:00+02:00,2025-05-25,03:04,0,3,3
58,2025-05-24T19:06:00+02:00,2025-05-25,03:06,0,1,1
62,2025-05-24T19:07:00+02:00,2025-05-25,03:07,1,0,1
63,2025-05-24T18:59:00+02:00,2025-05-25,02:59,0,2,2
63,2025-05-24T19:09:00+02:00,2025-05-25,03:09,0,1,1
67,2025-05-24T19:02:00+02:00,2025-05-25,03:02,0,1,1
67,2025-05-24T19:03:00+02:00,2025-05-25,03:03,0,3,3
68,2025-05-24T19:00:00+02:00,2025-05-25,03:00,1,1,2
72,2025-05-24T19:00:00+02:00,2025-05-25,03:00,1,0,1
72,2025-05-24T19:06:00+02:00,2025-05-25,03:06,0,1,1
79,2025-05-24T18:59:00+02:00,2025-05-25,02:59,3,0,3
79,2025-05-24T19:02:00+02:00,2025-05-25,03:02,0,1,1
79,2025-05-24T19:04:00+02:00,2025-05-25,03:04,0,5,5
109,2025-05-24T18:55:00+02:00,2025-05-25,02:55,2,1,3
109,2025-05-24T19:00:00+02:00,2025-05-25,03:00,5,2,7
117,2025-05-24T18:55:00+02:00,2025-05-25,02:55,2,1,3
117,2025-05-24T19:05:00+02:00,2025-05-25,03:05,0,3,3
123,2025-05-24T19:00:00+02:00,2025-05-25,03:00,1,0,1
139,2025-05-24T18:55:00+02:00,2025-05-25,02:55,4,0,4
164,2025-05-24T18:55:00+02:00,2025-05-25,02:55,0,3,3
181,2025-05-24T18:55:00+02:00,2025-05-25,02:55,2,0,2
181,2025-05-24T18:56:00+02:00,2025-05-25,02:56,0,1,1
181,2025-05-24T18:59:00+02:00,2025-05-25,02:59,1,3,4
181,2025-05-24T19:00:00+02:00,2025-05-25,03:00,0,3,3
181,2025-05-24T19:03:00+02:00,2025-05-25,03:03,0,1,1
181,2025-05-24T19:08:00+02:00,2025-05-25,03:08,1,0,1
181,2025-05-24T19:09:00+02:00,2025-05-25,03:09,2,0,2
182,2025-05-24T18:55:00+02:00,2025-05-25,02:55,7,8,15
181,2025-05-24T19:20:00+02:00,2025-05-25,03:20,2,0,2
181,2025-05-24T19:22:00+02:00,2025-05-25,03:22,2,0,2
181,2025-05-24T19:24:00+02:00,2025-05-25,03:24,7,0,7
3,2025-05-24T19:10:00+02:00,2025-05-25,03:10,3,2,5
3,2025-05-24T19:13:00+02:00,2025-05-25,03:13,1,7,8
3,2025-05-24T19:21:00+02:00,2025-05-25,03:21,0,3,3
3,2025-05-24T19:22:00+02:00,2025-05-25,03:22,6,3,9
3,2025-05-24T19:24:00+02:00,2025-05-25,03:24,1,0,1
4,2025-05-24T19:10:00+02:00,2025-05-25,03:10,0,3,3
4,2025-05-24T19:14:00+02:00,2025-05-25,03:14,2,2,4
5,2025-05-24T19:10:00+02:00,2025-05-25,03:10,0,1,1
5,2025-05-24T19:15:00+02:00,2025-05-25,03:15,0,4,4
6,2025-05-24T19:11:00+02:00,2025-05-25,03:11,1,0,1
6,2025-05-24T19:17:00+02:00,2025-05-25,03:17,0,3,3
6,2025-05-24T19:18:00+02:00,2025-05-25,03:18,2,1,3
6,2025-05-24T19:21:00+02:00,2025-05-25,03:21,0,1,1
6,2025-05-24T19:24:00+02:00,2025-05-25,03:24,0,2,2
28,2025-05-24T19:18:00+02:00,2025-05-25,03:18,1,0,1
28,2025-05-24T19:20:00+02:00,2025-05-25,03:20,1,0,1
28,2025-05-24T19:24:00+02:00,2025-05-25,03:24,0,1,1
29,2025-05-24T19:19:00+02:00,2025-05-25,03:19,0,2,2
29,2025-05-24T19:21:00+02:00,2025-05-25,03:21,0,1,1
31,2025-05-24T19:13:00+02:00,2025-05-25,03:13,0,2,2
36,2025-05-24T19:10:00+02:00,2025-05-25,03:10,6,5,11
36,2025-05-24T19:13:00+02:00,2025-05-25,03:13,0,3,3
36,2025-05-24T19:16:00+02:00,2025-05-25,03:16,5,0,5
36,2025-05-24T19:18:00+02:00,2025-05-25,03:18,1,6,7
37,2025-05-24T19:20:00+02:00,2025-05-25,03:20,1,0,1
40,2025-05-24T19:23:00+02:00,2025-05-25,03:23,0,1,1
41,2025-05-24T19:12:00+02:00,2025-05-25,03:12,0,2,2
41,2025-05-24T19:20:00+02:00,2025-05-25,03:20,1,0,1
45,2025-05-24T19:21:00+02:00,2025-05-25,03:21,0,2,2
47,2025-05-24T19:11:00+02:00,2025-05-25,03:11,2,0,2
47,2025-05-24T19:16:00+02:00,2025-05-25,03:16,0,9,9
47,2025-05-24T19:20:00+02:00,2025-05-25,03:20,3,6,9
47,2025-05-24T19:23:00+02:00,2025-05-25,03:23,1,2,3
50,2025-05-24T19:21:00+02:00,2025-05-25,03:21,1,0,1
54,2025-05-24T19:14:00+02:00,2025-05-25,03:14,1,0,1
54,2025-05-24T19:18:00+02:00,2025-05-25,03:18,4,0,4
54,2025-05-24T19:22:00+02:00,2025-05-25,03:22,1,0,1
59,2025-05-24T19:20:00+02:00,2025-05-25,03:20,11,0,11
61,2025-05-24T19:12:00+02:00,2025-05-25,03:12,1,0,1
61,2025-05-24T19:13:00+02:00,2025-05-25,03:13,1,0,1
61,2025-05-24T19:14:00+02:00,2025-05-25,03:14,4,0,4
61,2025-05-24T19:19:00+02:00,2025-05-25,03:19,1,1,2
61,2025-05-24T19:24:00+02:00,2025-05-25,03:24,0,1,1
66,2025-05-24T19:11:00+02:00,2025-05-25,03:11,2,5,7
66,2025-05-24T19:19:00+02:00,2025-05-25,03:19,6,1,7
66,2025-05-24T19:20:00+02:00,2025-05-25,03:20,0,4,4
69,2025-05-24T19:23:00+02:00,2025-05-25,03:23,0,2,2
69,2025-05-24T19:24:00+02:00,2025-05-25,03:24,1,1,2
71,2025-05-24T19:24:00+02:00,2025-05-25,03:24,0,1,1
77,2025-05-24T19:20:00+02:00,2025-05-25,03:20,0,1,1
84,2025-05-24T19:15:00+02:00,2025-05-25,03:15,3,5,8
84,2025-05-24T19:20:00+02:00,2025-05-25,03:20,8,7,15
108,2025-05-24T19:10:00+02:00,2025-05-25,03:10,5,0,5
108,2025-05-24T19:19:00+02:00,2025-05-25,03:19,0,5,5
108,2025-05-24T19:24:00+02:00,2025-05-25,03:24,1,0,1
131,2025-05-24T19:20:00+02:00,2025-05-25,03:20,2,13,15
132,2025-05-24T19:10:00+02:00,2025-05-25,03:10,0,1,1
132,2025-05-24T19:15:00+02:00,2025-05-25,03:15,0,2,2
133,2025-05-24T19:10:00+02:00,2025-05-25,03:10,3,0,3
133,2025-05-24T19:20:00+02:00,2025-05-25,03:20,4,0,4
134,2025-05-24T19:10:00+02:00,2025-05-25,03:10,5,5,10
135,2025-05-24T19:15:00+02:00,2025-05-25,03:15,2,0,2
135,2025-05-24T19:20:00+02:00,2025-05-25,03:20,3,9,12
162,2025-05-24T19:10:00+02:00,2025-05-25,03:10,17,0,17
1,2025-05-24T19:13:00+02:00,2025-05-25,03:13,0,2,2
1,2025-05-24T19:14:00+02:00,2025-05-25,03:14,0,1,1
1,2025-05-24T19:15:00+02:00,2025-05-25,03:15,3,0,3
1,2025-05-24T19:22:00+02:00,2025-05-25,03:22,1,0,1
1,2025-05-24T19:23:00+02:00,2025-05-25,03:23,1,0,1
2,2025-05-24T19:16:00+02:00,2025-05-25,03:16,0,2,2
2,2025-05-24T19:23:00+02:00,2025-05-25,03:23,0,1,1
10,2025-05-24T19:21:00+02:00,2025-05-25,03:21,0,1,1
17,2025-05-24T19:16:00+02:00,2025-05-25,03:16,1,0,1
17,2025-05-24T19:24:00+02:00,2025-05-25,03:24,1,0,1
19,2025-05-24T19:23:00+02:00,2025-05-25,03:23,0,2,2
19,2025-05-24T19:24:00+02:00,2025-05-25,03:24,2,0,2
20,2025-05-24T19:13:00+02:00,2025-05-25,03:13,0,4,4
20,2025-05-24T19:18:00+02:00,2025-05-25,03:18,1,0,1
20,2025-05-24T19:19:00+02:00,2025-05-25,03:19,1,4,5
20,2025-05-24T19:20:00+02:00,2025-05-25,03:20,1,2,3
20,2025-05-24T19:21:00+02:00,2025-05-25,03:21,2,1,3
23,2025-05-24T19:11:00+02:00,2025-05-25,03:11,0,2,2
23,2025-05-24T19:12:00+02:00,2025-05-25,03:12,0,3,3
24,2025-05-24T19:17:00+02:00,2025-05-25,03:17,3,2,5
25,2025-05-24T19:10:00+02:00,2025-05-25,03:10,1,5,6
30,2025-05-24T19:10:00+02:00,2025-05-25,03:10,5,8,13
30,2025-05-24T19:12:00+02:00,2025-05-25,03:12,3,7,10
30,2025-05-24T19:15:00+02:00,2025-05-25,03:15,0,2,2
30,2025-05-24T19:17:00+02:00,2025-05-25,03:17,5,3,8
30,2025-05-24T19:19:00+02:00,2025-05-25,03:19,3,2,5
30,2025-05-24T19:22:00+02:00,2025-05-25,03:22,0,4,4
30,2025-05-24T19:23:00+02:00,2025-05-25,03:23,0,1,1
35,2025-05-24T19:16:00+02:00,2025-05-25,03:16,3,1,4
49,2025-05-24T19:12:00+02:00,2025-05-25,03:12,4,0,4
49,2025-05-24T19:15:00+02:00,2025-05-25,03:15,0,4,4
49,2025-05-24T19:17:00+02:00,2025-05-25,03:17,1,0,1
49,2025-05-24T19:18:00+02:00,2025-05-25,03:18,3,1,4
49,2025-05-24T19:19:00+02:00,2025-05-25,03:19,1,7,8
51,2025-05-24T19:15:00+02:00,2025-05-25,03:15,2,0,2
52,2025-05-24T19:13:00+02:00,2025-05-25,03:13,0,2,2
52,2025-05-24T19:15:00+02:00,2025-05-25,03:15,0,1,1
52,2025-05-24T19:18:00+02:00,2025-05-25,03:18,1,0,1
52,2025-05-24T19:21:00+02:00,2025-05-25,03:21,0,1,1
53,2025-05-24T19:14:00+02:00,2025-05-25,03:14,1,0,1
53,2025-05-24T19:20:00+02:00,2025-05-25,03:20,1,0,1
56,2025-05-24T19:11:00+02:00,2025-05-25,03:11,0,3,3
56,2025-05-24T19:14:00+02:00,2025-05-25,03:14,2,0,2
56,2025-05-24T19:18:00+02:00,2025-05-25,03:18,0,1,1
56,2025-05-24T19:23:00+02:00,2025-05-25,03:23,1,0,1
58,2025-05-24T19:11:00+02:00,2025-05-25,03:11,1,3,4
58,2025-05-24T19:19:00+02:00,2025-05-25,03:19,0,1,1
62,2025-05-24T19:23:00+02:00,2025-05-25,03:23,1,1,2
63,2025-05-24T19:14:00+02:00,2025-05-25,03:14,0,3,3
63,2025-05-24T19:22:00+02:00,2025-05-25,03:22,0,2,2
79,2025-05-24T19:11:00+02:00,2025-05-25,03:11,4,2,6
79,2025-05-24T19:18:00+02:00,2025-05-25,03:18,1,3,4
79,2025-05-24T19:24:00+02:00,2025-05-25,03:24,0,1,1
117,2025-05-24T19:10:00+02:00,2025-05-25,03:10,0,11,11
117,2025-05-24T19:15:00+02:00,2025-05-25,03:15,0,4,4
141,2025-05-24T19:10:00+02:00,2025-05-25,03:10,5,4,9
141,2025-05-24T19:15:00+02:00,2025-05-25,03:15,4,2,6
141,2025-05-24T19:20:00+02:00,2025-05-25,03:20,2,1,3
3,2025-05-24T19:58:00+02:00,2025-05-25,03:58,3,1,4
3,2025-05-24T20:06:00+02:00,2025-05-25,04:06,11,0,11
4,2025-05-24T19:59:00+02:00,2025-05-25,03:59,3,4,7
4,2025-05-24T20:06:00+02:00,2025-05-25,04:06,2,0,2
4,2025-05-24T20:08:00+02:00,2025-05-25,04:08,0,2,2
4,2025-05-24T20:09:00+02:00,2025-05-25,04:09,1,1,2
5,2025-05-24T19:55:00+02:00,2025-05-25,03:55,3,5,8
5,2025-05-24T20:00:00+02:00,2025-05-25,04:00,4,5,9
5,2025-05-24T20:05:00+02:00,2025-05-25,04:05,1,0,1
6,2025-05-24T19:55:00+02:00,2025-05-25,03:55,2,1,3
6,2025-05-24T19:58:00+02:00,2025-05-25,03:58,8,0,8
6,2025-05-24T19:59:00+02:00,2025-05-25,03:59,2,1,3
6,2025-05-24T20:04:00+02:00,2025-05-25,04:04,2,0,2
6,2025-05-24T20:05:00+02:00,2025-05-25,04:05,1,3,4
6,2025-05-24T20:08:00+02:00,2025-05-25,04:08,3,0,3
6,2025-05-24T20:09:00+02:00,2025-05-25,04:09,1,0,1
28,2025-05-24T19:55:00+02:00,2025-05-25,03:55,1,0,1
28,2025-05-24T20:09:00+02:00,2025-05-25,04:09,0,1,1
36,2025-05-24T19:57:00+02:00,2025-05-25,03:57,0,1,1
36,2025-05-24T20:01:00+02:00,2025-05-25,04:01,3,2,5
36,2025-05-24T20:03:00+02:00,2025-05-25,04:03,0,3,3
36,2025-05-24T20:07:00+02:00,2025-05-25,04:07,6,3,9
3,2025-05-25T14:10:00+02:00,2025-05-25,22:10,8,1,9
40,2025-05-24T20:04:00+02:00,2025-05-25,04:04,1,0,1
3,2025-05-25T14:11:00+02:00,2025-05-25,22:11,12,3,15
41,2025-05-24T20:01:00+02:00,2025-05-25,04:01,0,1,1
3,2025-05-25T14:12:00+02:00,2025-05-25,22:12,8,0,8
41,2025-05-24T20:02:00+02:00,2025-05-25,04:02,3,3,6
3,2025-05-25T14:14:00+02:00,2025-05-25,22:14,8,6,14
45,2025-05-24T19:57:00+02:00,2025-05-25,03:57,0,7,7
3,2025-05-25T14:21:00+02:00,2025-05-25,22:21,2,1,3
45,2025-05-24T20:00:00+02:00,2025-05-25,04:00,0,4,4
3,2025-05-25T14:22:00+02:00,2025-05-25,22:22,4,10,14
45,2025-05-24T20:03:00+02:00,2025-05-25,04:03,0,1,1
3,2025-05-25T14:23:00+02:00,2025-05-25,22:23,7,7,14
45,2025-05-24T20:06:00+02:00,2025-05-25,04:06,1,0,1
4,2025-05-25T14:11:00+02:00,2025-05-25,22:11,4,5,9
47,2025-05-24T19:55:00+02:00,2025-05-25,03:55,0,1,1
4,2025-05-25T14:13:00+02:00,2025-05-25,22:13,9,2,11
47,2025-05-24T19:58:00+02:00,2025-05-25,03:58,0,3,3
4,2025-05-25T14:15:00+02:00,2025-05-25,22:15,8,5,13
47,2025-05-24T20:00:00+02:00,2025-05-25,04:00,0,3,3
4,2025-05-25T14:19:00+02:00,2025-05-25,22:19,3,11,14
47,2025-05-24T20:01:00+02:00,2025-05-25,04:01,1,0,1
4,2025-05-25T14:22:00+02:00,2025-05-25,22:22,7,4,11
54,2025-05-24T19:59:00+02:00,2025-05-25,03:59,0,1,1
5,2025-05-25T14:10:00+02:00,2025-05-25,22:10,26,7,33
54,2025-05-24T20:04:00+02:00,2025-05-25,04:04,0,1,1
5,2025-05-25T14:20:00+02:00,2025-05-25,22:20,7,19,26
54,2025-05-24T20:09:00+02:00,2025-05-25,04:09,0,1,1
6,2025-05-25T14:10:00+02:00,2025-05-25,22:10,11,4,15
59,2025-05-24T20:05:00+02:00,2025-05-25,04:05,3,0,3
6,2025-05-25T14:11:00+02:00,2025-05-25,22:11,2,2,4
61,2025-05-24T19:56:00+02:00,2025-05-25,03:56,1,0,1
6,2025-05-25T14:13:00+02:00,2025-05-25,22:13,9,3,12
61,2025-05-24T19:58:00+02:00,2025-05-25,03:58,1,0,1
6,2025-05-25T14:14:00+02:00,2025-05-25,22:14,6,11,17
66,2025-05-24T20:06:00+02:00,2025-05-25,04:06,1,0,1
6,2025-05-25T14:16:00+02:00,2025-05-25,22:16,4,3,7
77,2025-05-24T20:00:00+02:00,2025-05-25,04:00,1,0,1
6,2025-05-25T14:24:00+02:00,2025-05-25,22:24,8,8,16
84,2025-05-24T19:55:00+02:00,2025-05-25,03:55,0,3,3
28,2025-05-25T14:10:00+02:00,2025-05-25,22:10,16,0,16
84,2025-05-24T20:05:00+02:00,2025-05-25,04:05,0,7,7
28,2025-05-25T14:13:00+02:00,2025-05-25,22:13,8,0,8
108,2025-05-24T20:04:00+02:00,2025-05-25,04:04,0,1,1
28,2025-05-25T14:16:00+02:00,2025-05-25,22:16,5,0,5
131,2025-05-24T19:55:00+02:00,2025-05-25,03:55,3,3,6
28,2025-05-25T14:19:00+02:00,2025-05-25,22:19,11,2,13
132,2025-05-24T20:00:00+02:00,2025-05-25,04:00,6,0,6
28,2025-05-25T14:24:00+02:00,2025-05-25,22:24,4,0,4
133,2025-05-24T20:00:00+02:00,2025-05-25,04:00,3,2,5
29,2025-05-25T14:11:00+02:00,2025-05-25,22:11,0,3,3
134,2025-05-24T20:00:00+02:00,2025-05-25,04:00,8,3,11
29,2025-05-25T14:14:00+02:00,2025-05-25,22:14,0,2,2
134,2025-05-24T20:05:00+02:00,2025-05-25,04:05,3,0,3
29,2025-05-25T14:16:00+02:00,2025-05-25,22:16,0,4,4
135,2025-05-24T20:05:00+02:00,2025-05-25,04:05,1,1,2
29,2025-05-25T14:19:00+02:00,2025-05-25,22:19,1,1,2
179,2025-05-24T19:55:00+02:00,2025-05-25,03:55,4,0,4
29,2025-05-25T14:22:00+02:00,2025-05-25,22:22,0,4,4
2,2025-05-24T20:01:00+02:00,2025-05-25,04:01,2,0,2
31,2025-05-25T14:10:00+02:00,2025-05-25,22:10,2,12,14
9,2025-05-24T20:08:00+02:00,2025-05-25,04:08,2,1,3
31,2025-05-25T14:11:00+02:00,2025-05-25,22:11,1,0,1
10,2025-05-24T20:00:00+02:00,2025-05-25,04:00,1,0,1
31,2025-05-25T14:14:00+02:00,2025-05-25,22:14,5,3,8
12,2025-05-24T19:59:00+02:00,2025-05-25,03:59,0,1,1
31,2025-05-25T14:16:00+02:00,2025-05-25,22:16,5,1,6
19,2025-05-24T19:57:00+02:00,2025-05-25,03:57,0,2,2
31,2025-05-25T14:17:00+02:00,2025-05-25,22:17,0,2,2
19,2025-05-24T20:03:00+02:00,2025-05-25,04:03,0,2,2
31,2025-05-25T14:23:00+02:00,2025-05-25,22:23,1,0,1
19,2025-05-24T20:04:00+02:00,2025-05-25,04:04,0,5,5
36,2025-05-25T14:24:00+02:00,2025-05-25,22:24,0,1,1
19,2025-05-24T20:06:00+02:00,2025-05-25,04:06,1,0,1
40,2025-05-25T14:20:00+02:00,2025-05-25,22:20,1,0,1
19,2025-05-24T20:07:00+02:00,2025-05-25,04:07,4,2,6
40,2025-05-25T14:24:00+02:00,2025-05-25,22:24,0,1,1
20,2025-05-24T19:55:00+02:00,2025-05-25,03:55,0,9,9
43,2025-05-25T14:15:00+02:00,2025-05-25,22:15,2,1,3
20,2025-05-24T20:00:00+02:00,2025-05-25,04:00,0,1,1
43,2025-05-25T14:20:00+02:00,2025-05-25,22:20,4,1,5
20,2025-05-24T20:01:00+02:00,2025-05-25,04:01,0,5,5
45,2025-05-25T14:12:00+02:00,2025-05-25,22:12,1,9,10
20,2025-05-24T20:03:00+02:00,2025-05-25,04:03,0,3,3
45,2025-05-25T14:17:00+02:00,2025-05-25,22:17,2,5,7
23,2025-05-24T20:00:00+02:00,2025-05-25,04:00,0,2,2
47,2025-05-25T14:19:00+02:00,2025-05-25,22:19,5,6,11
24,2025-05-24T19:56:00+02:00,2025-05-25,03:56,0,6,6
47,2025-05-25T14:21:00+02:00,2025-05-25,22:21,2,1,3
24,2025-05-24T19:58:00+02:00,2025-05-25,03:58,1,2,3
50,2025-05-25T14:11:00+02:00,2025-05-25,22:11,6,0,6
24,2025-05-24T20:00:00+02:00,2025-05-25,04:00,1,0,1
54,2025-05-25T14:10:00+02:00,2025-05-25,22:10,5,1,6
24,2025-05-24T20:01:00+02:00,2025-05-25,04:01,2,2,4
54,2025-05-25T14:17:00+02:00,2025-05-25,22:17,3,0,3
24,2025-05-24T20:04:00+02:00,2025-05-25,04:04,0,3,3
54,2025-05-25T14:18:00+02:00,2025-05-25,22:18,0,1,1
24,2025-05-24T20:06:00+02:00,2025-05-25,04:06,0,2,2
54,2025-05-25T14:20:00+02:00,2025-05-25,22:20,0,3,3
24,2025-05-24T20:09:00+02:00,2025-05-25,04:09,4,0,4
54,2025-05-25T14:21:00+02:00,2025-05-25,22:21,2,1,3
25,2025-05-24T19:55:00+02:00,2025-05-25,03:55,0,1,1
54,2025-05-25T14:22:00+02:00,2025-05-25,22:22,2,0,2
27,2025-05-24T20:07:00+02:00,2025-05-25,04:07,1,0,1
59,2025-05-25T14:15:00+02:00,2025-05-25,22:15,9,17,26
27,2025-05-24T20:08:00+02:00,2025-05-25,04:08,0,1,1
61,2025-05-25T14:10:00+02:00,2025-05-25,22:10,8,1,9
30,2025-05-24T19:56:00+02:00,2025-05-25,03:56,5,5,10
61,2025-05-25T14:14:00+02:00,2025-05-25,22:14,3,0,3
30,2025-05-24T20:03:00+02:00,2025-05-25,04:03,0,5,5
61,2025-05-25T14:15:00+02:00,2025-05-25,22:15,1,1,2
30,2025-05-24T20:05:00+02:00,2025-05-25,04:05,1,0,1
61,2025-05-25T14:19:00+02:00,2025-05-25,22:19,0,1,1
30,2025-05-24T20:08:00+02:00,2025-05-25,04:08,0,3,3
61,2025-05-25T14:22:00+02:00,2025-05-25,22:22,1,1,2
35,2025-05-24T19:56:00+02:00,2025-05-25,03:56,3,0,3
66,2025-05-25T14:11:00+02:00,2025-05-25,22:11,4,6,10
35,2025-05-24T20:00:00+02:00,2025-05-25,04:00,1,0,1
66,2025-05-25T14:13:00+02:00,2025-05-25,22:13,6,10,16
35,2025-05-24T20:05:00+02:00,2025-05-25,04:05,0,1,1
66,2025-05-25T14:14:00+02:00,2025-05-25,22:14,4,5,9
49,2025-05-24T19:58:00+02:00,2025-05-25,03:58,1,0,1
66,2025-05-25T14:18:00+02:00,2025-05-25,22:18,5,6,11
49,2025-05-24T20:02:00+02:00,2025-05-25,04:02,1,0,1
66,2025-05-25T14:21:00+02:00,2025-05-25,22:21,16,6,22
49,2025-05-24T20:06:00+02:00,2025-05-25,04:06,1,0,1
66,2025-05-25T14:23:00+02:00,2025-05-25,22:23,0,2,2
49,2025-05-24T20:07:00+02:00,2025-05-25,04:07,0,2,2
70,2025-05-25T14:10:00+02:00,2025-05-25,22:10,4,0,4
51,2025-05-24T20:01:00+02:00,2025-05-25,04:01,1,0,1
70,2025-05-25T14:13:00+02:00,2025-05-25,22:13,3,1,4
52,2025-05-24T19:58:00+02:00,2025-05-25,03:58,3,0,3
70,2025-05-25T14:24:00+02:00,2025-05-25,22:24,0,1,1
52,2025-05-24T20:02:00+02:00,2025-05-25,04:02,1,0,1
78,2025-05-25T14:13:00+02:00,2025-05-25,22:13,0,4,4
52,2025-05-24T20:05:00+02:00,2025-05-25,04:05,2,1,3
78,2025-05-25T14:14:00+02:00,2025-05-25,22:14,0,1,1
56,2025-05-24T19:55:00+02:00,2025-05-25,03:55,2,0,2
78,2025-05-25T14:18:00+02:00,2025-05-25,22:18,0,1,1
56,2025-05-24T20:07:00+02:00,2025-05-25,04:07,3,0,3
78,2025-05-25T14:24:00+02:00,2025-05-25,22:24,0,1,1
58,2025-05-24T20:00:00+02:00,2025-05-25,04:00,1,0,1
84,2025-05-25T14:10:00+02:00,2025-05-25,22:10,27,36,63
58,2025-05-24T20:07:00+02:00,2025-05-25,04:07,0,1,1
87,2025-05-25T14:21:00+02:00,2025-05-25,22:21,0,1,1
58,2025-05-24T20:09:00+02:00,2025-05-25,04:09,1,0,1
108,2025-05-25T14:10:00+02:00,2025-05-25,22:10,0,5,5
62,2025-05-24T19:58:00+02:00,2025-05-25,03:58,0,2,2
108,2025-05-25T14:19:00+02:00,2025-05-25,22:19,2,3,5
62,2025-05-24T19:59:00+02:00,2025-05-25,03:59,1,0,1
108,2025-05-25T14:22:00+02:00,2025-05-25,22:22,1,0,1
62,2025-05-24T20:04:00+02:00,2025-05-25,04:04,0,2,2
108,2025-05-25T14:23:00+02:00,2025-05-25,22:23,0,1,1
62,2025-05-24T20:09:00+02:00,2025-05-25,04:09,1,0,1
131,2025-05-25T14:10:00+02:00,2025-05-25,22:10,4,3,7
67,2025-05-24T19:56:00+02:00,2025-05-25,03:56,0,1,1
131,2025-05-25T14:15:00+02:00,2025-05-25,22:15,11,3,14
67,2025-05-24T20:02:00+02:00,2025-05-25,04:02,0,1,1
131,2025-05-25T14:20:00+02:00,2025-05-25,22:20,8,3,11
67,2025-05-24T20:04:00+02:00,2025-05-25,04:04,0,1,1
132,2025-05-25T14:10:00+02:00,2025-05-25,22:10,7,5,12
67,2025-05-24T20:06:00+02:00,2025-05-25,04:06,0,3,3
132,2025-05-25T14:20:00+02:00,2025-05-25,22:20,7,4,11
79,2025-05-24T20:04:00+02:00,2025-05-25,04:04,1,2,3
133,2025-05-25T14:10:00+02:00,2025-05-25,22:10,17,20,37
79,2025-05-24T20:05:00+02:00,2025-05-25,04:05,0,1,1
133,2025-05-25T14:15:00+02:00,2025-05-25,22:15,27,9,36
79,2025-05-24T20:08:00+02:00,2025-05-25,04:08,0,1,1
135,2025-05-25T14:20:00+02:00,2025-05-25,22:20,7,2,9
79,2025-05-24T20:09:00+02:00,2025-05-25,04:09,1,0,1
162,2025-05-25T14:15:00+02:00,2025-05-25,22:15,7,4,11
85,2025-05-24T19:58:00+02:00,2025-05-25,03:58,0,1,1
162,2025-05-25T14:20:00+02:00,2025-05-25,22:20,4,5,9
136,2025-05-24T20:00:00+02:00,2025-05-25,04:00,0,1,1
179,2025-05-25T14:10:00+02:00,2025-05-25,22:10,3,3,6
139,2025-05-24T20:00:00+02:00,2025-05-25,04:00,0,1,1
179,2025-05-25T14:20:00+02:00,2025-05-25,22:20,3,3,6
141,2025-05-24T19:55:00+02:00,2025-05-25,03:55,8,0,8
1,2025-05-25T14:11:00+02:00,2025-05-25,22:11,0,1,1
142,2025-05-24T19:55:00+02:00,2025-05-25,03:55,1,1,2
1,2025-05-25T14:22:00+02:00,2025-05-25,22:22,1,1,2
3,2025-05-24T19:41:00+02:00,2025-05-25,03:41,1,0,1
1,2025-05-25T14:24:00+02:00,2025-05-25,22:24,1,2,3
3,2025-05-24T19:46:00+02:00,2025-05-25,03:46,3,4,7
2,2025-05-25T14:12:00+02:00,2025-05-25,22:12,1,1,2
4,2025-05-24T19:41:00+02:00,2025-05-25,03:41,0,1,1
2,2025-05-25T14:19:00+02:00,2025-05-25,22:19,2,0,2
4,2025-05-24T19:44:00+02:00,2025-05-25,03:44,0,1,1
2,2025-05-25T14:20:00+02:00,2025-05-25,22:20,0,3,3
4,2025-05-24T19:48:00+02:00,2025-05-25,03:48,3,7,10
2,2025-05-25T14:22:00+02:00,2025-05-25,22:22,0,3,3
4,2025-05-24T19:50:00+02:00,2025-05-25,03:50,1,0,1
2,2025-05-25T14:23:00+02:00,2025-05-25,22:23,3,1,4
4,2025-05-24T19:52:00+02:00,2025-05-25,03:52,0,1,1
9,2025-05-25T14:17:00+02:00,2025-05-25,22:17,1,1,2
5,2025-05-24T19:45:00+02:00,2025-05-25,03:45,4,2,6
10,2025-05-25T14:13:00+02:00,2025-05-25,22:13,0,1,1
6,2025-05-24T19:48:00+02:00,2025-05-25,03:48,2,0,2
11,2025-05-25T14:15:00+02:00,2025-05-25,22:15,3,0,3
28,2025-05-24T19:44:00+02:00,2025-05-25,03:44,1,1,2
11,2025-05-25T14:20:00+02:00,2025-05-25,22:20,5,0,5
28,2025-05-24T19:50:00+02:00,2025-05-25,03:50,0,1,1
12,2025-05-25T14:10:00+02:00,2025-05-25,22:10,0,2,2
29,2025-05-24T19:47:00+02:00,2025-05-25,03:47,1,1,2
12,2025-05-25T14:11:00+02:00,2025-05-25,22:11,2,0,2
31,2025-05-24T19:46:00+02:00,2025-05-25,03:46,2,0,2
12,2025-05-25T14:18:00+02:00,2025-05-25,22:18,2,1,3
31,2025-05-24T19:54:00+02:00,2025-05-25,03:54,0,1,1
12,2025-05-25T14:22:00+02:00,2025-05-25,22:22,2,0,2
36,2025-05-24T19:40:00+02:00,2025-05-25,03:40,3,3,6
17,2025-05-25T14:10:00+02:00,2025-05-25,22:10,1,1,2
36,2025-05-24T19:43:00+02:00,2025-05-25,03:43,0,3,3
17,2025-05-25T14:17:00+02:00,2025-05-25,22:17,0,2,2
36,2025-05-24T19:47:00+02:00,2025-05-25,03:47,3,0,3
19,2025-05-25T14:12:00+02:00,2025-05-25,22:12,0,9,9
36,2025-05-24T19:49:00+02:00,2025-05-25,03:49,2,2,4
19,2025-05-25T14:18:00+02:00,2025-05-25,22:18,7,0,7
36,2025-05-24T19:50:00+02:00,2025-05-25,03:50,1,1,2
19,2025-05-25T14:19:00+02:00,2025-05-25,22:19,7,9,16
37,2025-05-24T19:44:00+02:00,2025-05-25,03:44,0,4,4
19,2025-05-25T14:20:00+02:00,2025-05-25,22:20,3,3,6
37,2025-05-24T19:53:00+02:00,2025-05-25,03:53,1,0,1
20,2025-05-25T14:10:00+02:00,2025-05-25,22:10,0,2,2
40,2025-05-24T19:40:00+02:00,2025-05-25,03:40,0,1,1
20,2025-05-25T14:11:00+02:00,2025-05-25,22:11,2,3,5
40,2025-05-24T19:41:00+02:00,2025-05-25,03:41,2,0,2
20,2025-05-25T14:15:00+02:00,2025-05-25,22:15,1,7,8
40,2025-05-24T19:50:00+02:00,2025-05-25,03:50,1,0,1
20,2025-05-25T14:22:00+02:00,2025-05-25,22:22,0,1,1
41,2025-05-24T19:40:00+02:00,2025-05-25,03:40,0,1,1
20,2025-05-25T14:24:00+02:00,2025-05-25,22:24,1,0,1
41,2025-05-24T19:41:00+02:00,2025-05-25,03:41,0,3,3
23,2025-05-25T14:14:00+02:00,2025-05-25,22:14,3,0,3
41,2025-05-24T19:42:00+02:00,2025-05-25,03:42,0,1,1
23,2025-05-25T14:16:00+02:00,2025-05-25,22:16,0,1,1
41,2025-05-24T19:49:00+02:00,2025-05-25,03:49,0,1,1
23,2025-05-25T14:17:00+02:00,2025-05-25,22:17,0,3,3
45,2025-05-24T19:41:00+02:00,2025-05-25,03:41,0,2,2
24,2025-05-25T14:10:00+02:00,2025-05-25,22:10,3,7,10
45,2025-05-24T19:46:00+02:00,2025-05-25,03:46,0,7,7
24,2025-05-25T14:13:00+02:00,2025-05-25,22:13,5,6,11
45,2025-05-24T19:52:00+02:00,2025-05-25,03:52,0,4,4
24,2025-05-25T14:17:00+02:00,2025-05-25,22:17,2,3,5
47,2025-05-24T19:42:00+02:00,2025-05-25,03:42,1,1,2
24,2025-05-25T14:20:00+02:00,2025-05-25,22:20,7,0,7
47,2025-05-24T19:47:00+02:00,2025-05-25,03:47,6,1,7
24,2025-05-25T14:21:00+02:00,2025-05-25,22:21,2,9,11
47,2025-05-24T19:49:00+02:00,2025-05-25,03:49,0,2,2
25,2025-05-25T14:15:00+02:00,2025-05-25,22:15,2,9,11
47,2025-05-24T19:50:00+02:00,2025-05-25,03:50,0,4,4
25,2025-05-25T14:20:00+02:00,2025-05-25,22:20,9,4,13
47,2025-05-24T19:51:00+02:00,2025-05-25,03:51,0,3,3
27,2025-05-25T14:12:00+02:00,2025-05-25,22:12,1,0,1
54,2025-05-24T19:51:00+02:00,2025-05-25,03:51,1,0,1
27,2025-05-25T14:13:00+02:00,2025-05-25,22:13,2,0,2
61,2025-05-24T19:42:00+02:00,2025-05-25,03:42,0,1,1
27,2025-05-25T14:14:00+02:00,2025-05-25,22:14,2,0,2
66,2025-05-24T19:50:00+02:00,2025-05-25,03:50,4,0,4
27,2025-05-25T14:17:00+02:00,2025-05-25,22:17,1,2,3
66,2025-05-24T19:54:00+02:00,2025-05-25,03:54,0,2,2
30,2025-05-25T14:15:00+02:00,2025-05-25,22:15,1,2,3
71,2025-05-24T19:41:00+02:00,2025-05-25,03:41,2,0,2
30,2025-05-25T14:16:00+02:00,2025-05-25,22:16,2,6,8
77,2025-05-24T19:40:00+02:00,2025-05-25,03:40,2,0,2
30,2025-05-25T14:21:00+02:00,2025-05-25,22:21,6,2,8
84,2025-05-24T19:45:00+02:00,2025-05-25,03:45,5,3,8
30,2025-05-25T14:23:00+02:00,2025-05-25,22:23,6,2,8
108,2025-05-24T19:46:00+02:00,2025-05-25,03:46,2,0,2
30,2025-05-25T14:24:00+02:00,2025-05-25,22:24,0,2,2
108,2025-05-24T19:47:00+02:00,2025-05-25,03:47,5,0,5
35,2025-05-25T14:13:00+02:00,2025-05-25,22:13,2,4,6
108,2025-05-24T19:52:00+02:00,2025-05-25,03:52,1,0,1
35,2025-05-25T14:14:00+02:00,2025-05-25,22:14,3,3,6
131,2025-05-24T19:45:00+02:00,2025-05-25,03:45,2,4,6
35,2025-05-25T14:15:00+02:00,2025-05-25,22:15,1,4,5
132,2025-05-24T19:40:00+02:00,2025-05-25,03:40,0,3,3
35,2025-05-25T14:16:00+02:00,2025-05-25,22:16,5,4,9
133,2025-05-24T19:40:00+02:00,2025-05-25,03:40,1,3,4
35,2025-05-25T14:20:00+02:00,2025-05-25,22:20,7,3,10
133,2025-05-24T19:45:00+02:00,2025-05-25,03:45,3,8,11
35,2025-05-25T14:23:00+02:00,2025-05-25,22:23,4,1,5
134,2025-05-24T19:40:00+02:00,2025-05-25,03:40,6,0,6
48,2025-05-25T14:12:00+02:00,2025-05-25,22:12,2,1,3
134,2025-05-24T19:50:00+02:00,2025-05-25,03:50,12,4,16
48,2025-05-25T14:13:00+02:00,2025-05-25,22:13,0,5,5
135,2025-05-24T19:40:00+02:00,2025-05-25,03:40,5,1,6
48,2025-05-25T14:15:00+02:00,2025-05-25,22:15,0,3,3
162,2025-05-24T19:40:00+02:00,2025-05-25,03:40,3,4,7
48,2025-05-25T14:16:00+02:00,2025-05-25,22:16,0,2,2
162,2025-05-24T19:45:00+02:00,2025-05-25,03:45,3,5,8
48,2025-05-25T14:20:00+02:00,2025-05-25,22:20,1,0,1
167,2025-05-24T19:50:00+02:00,2025-05-25,03:50,1,0,1
48,2025-05-25T14:24:00+02:00,2025-05-25,22:24,3,1,4
1,2025-05-24T19:47:00+02:00,2025-05-25,03:47,1,0,1
49,2025-05-25T14:10:00+02:00,2025-05-25,22:10,0,5,5
1,2025-05-24T19:53:00+02:00,2025-05-25,03:53,0,1,1
49,2025-05-25T14:13:00+02:00,2025-05-25,22:13,0,1,1
2,2025-05-24T19:47:00+02:00,2025-05-25,03:47,1,0,1
49,2025-05-25T14:14:00+02:00,2025-05-25,22:14,2,1,3
17,2025-05-24T19:51:00+02:00,2025-05-25,03:51,0,1,1
49,2025-05-25T14:15:00+02:00,2025-05-25,22:15,5,0,5
19,2025-05-24T19:40:00+02:00,2025-05-25,03:40,0,7,7
49,2025-05-25T14:18:00+02:00,2025-05-25,22:18,3,0,3
19,2025-05-24T19:48:00+02:00,2025-05-25,03:48,2,0,2
49,2025-05-25T14:22:00+02:00,2025-05-25,22:22,7,3,10
20,2025-05-24T19:44:00+02:00,2025-05-25,03:44,2,3,5
49,2025-05-25T14:24:00+02:00,2025-05-25,22:24,1,0,1
20,2025-05-24T19:52:00+02:00,2025-05-25,03:52,2,0,2
51,2025-05-25T14:14:00+02:00,2025-05-25,22:14,2,3,5
24,2025-05-24T19:43:00+02:00,2025-05-25,03:43,2,3,5
52,2025-05-25T14:11:00+02:00,2025-05-25,22:11,3,3,6
24,2025-05-24T19:47:00+02:00,2025-05-25,03:47,4,0,4
52,2025-05-25T14:12:00+02:00,2025-05-25,22:12,1,0,1
24,2025-05-24T19:49:00+02:00,2025-05-25,03:49,1,0,1
52,2025-05-25T14:13:00+02:00,2025-05-25,22:13,0,1,1
24,2025-05-24T19:50:00+02:00,2025-05-25,03:50,1,1,2
52,2025-05-25T14:16:00+02:00,2025-05-25,22:16,2,1,3
24,2025-05-24T19:54:00+02:00,2025-05-25,03:54,0,4,4
52,2025-05-25T14:17:00+02:00,2025-05-25,22:17,1,1,2
25,2025-05-24T19:40:00+02:00,2025-05-25,03:40,2,0,2
52,2025-05-25T14:21:00+02:00,2025-05-25,22:21,1,3,4
27,2025-05-24T19:54:00+02:00,2025-05-25,03:54,3,0,3
53,2025-05-25T14:12:00+02:00,2025-05-25,22:12,3,4,7
30,2025-05-24T19:41:00+02:00,2025-05-25,03:41,2,0,2
53,2025-05-25T14:13:00+02:00,2025-05-25,22:13,2,0,2
30,2025-05-24T19:50:00+02:00,2025-05-25,03:50,4,0,4
53,2025-05-25T14:23:00+02:00,2025-05-25,22:23,0,2,2
35,2025-05-24T19:51:00+02:00,2025-05-25,03:51,0,2,2
56,2025-05-25T14:10:00+02:00,2025-05-25,22:10,5,5,10
35,2025-05-24T19:53:00+02:00,2025-05-25,03:53,0,1,1
56,2025-05-25T14:18:00+02:00,2025-05-25,22:18,0,2,2
49,2025-05-24T19:45:00+02:00,2025-05-25,03:45,3,0,3
56,2025-05-25T14:20:00+02:00,2025-05-25,22:20,0,4,4
49,2025-05-24T19:51:00+02:00,2025-05-25,03:51,1,0,1
58,2025-05-25T14:12:00+02:00,2025-05-25,22:12,1,4,5
49,2025-05-24T19:54:00+02:00,2025-05-25,03:54,0,2,2
58,2025-05-25T14:15:00+02:00,2025-05-25,22:15,3,1,4
51,2025-05-24T19:53:00+02:00,2025-05-25,03:53,0,1,1
58,2025-05-25T14:16:00+02:00,2025-05-25,22:16,1,1,2
52,2025-05-24T19:41:00+02:00,2025-05-25,03:41,4,1,5
58,2025-05-25T14:21:00+02:00,2025-05-25,22:21,2,0,2
52,2025-05-24T19:43:00+02:00,2025-05-25,03:43,3,1,4
62,2025-05-25T14:11:00+02:00,2025-05-25,22:11,3,2,5
52,2025-05-24T19:44:00+02:00,2025-05-25,03:44,0,7,7
62,2025-05-25T14:12:00+02:00,2025-05-25,22:12,1,2,3
52,2025-05-24T19:52:00+02:00,2025-05-25,03:52,0,7,7
62,2025-05-25T14:15:00+02:00,2025-05-25,22:15,4,4,8
53,2025-05-24T19:45:00+02:00,2025-05-25,03:45,1,0,1
62,2025-05-25T14:24:00+02:00,2025-05-25,22:24,2,1,3
56,2025-05-24T19:43:00+02:00,2025-05-25,03:43,1,2,3
63,2025-05-25T14:12:00+02:00,2025-05-25,22:12,0,5,5
58,2025-05-24T19:40:00+02:00,2025-05-25,03:40,1,0,1
63,2025-05-25T14:13:00+02:00,2025-05-25,22:13,0,3,3
58,2025-05-24T19:41:00+02:00,2025-05-25,03:41,0,1,1
63,2025-05-25T14:15:00+02:00,2025-05-25,22:15,0,2,2
62,2025-05-24T19:51:00+02:00,2025-05-25,03:51,0,1,1
67,2025-05-25T14:11:00+02:00,2025-05-25,22:11,3,0,3
63,2025-05-24T19:42:00+02:00,2025-05-25,03:42,0,1,1
67,2025-05-25T14:15:00+02:00,2025-05-25,22:15,0,2,2
63,2025-05-24T19:53:00+02:00,2025-05-25,03:53,0,1,1
67,2025-05-25T14:16:00+02:00,2025-05-25,22:16,0,2,2
67,2025-05-24T19:42:00+02:00,2025-05-25,03:42,0,1,1
67,2025-05-25T14:20:00+02:00,2025-05-25,22:20,1,0,1
67,2025-05-24T19:47:00+02:00,2025-05-25,03:47,0,1,1
67,2025-05-25T14:23:00+02:00,2025-05-25,22:23,0,1,1
67,2025-05-24T19:50:00+02:00,2025-05-25,03:50,0,1,1
68,2025-05-25T14:24:00+02:00,2025-05-25,22:24,1,1,2
67,2025-05-24T19:51:00+02:00,2025-05-25,03:51,0,2,2
72,2025-05-25T14:15:00+02:00,2025-05-25,22:15,0,4,4
76,2025-05-24T19:51:00+02:00,2025-05-25,03:51,1,1,2
72,2025-05-25T14:21:00+02:00,2025-05-25,22:21,0,1,1
79,2025-05-24T19:42:00+02:00,2025-05-25,03:42,3,2,5
79,2025-05-25T14:10:00+02:00,2025-05-25,22:10,2,5,7
79,2025-05-24T19:51:00+02:00,2025-05-25,03:51,0,2,2
79,2025-05-25T14:11:00+02:00,2025-05-25,22:11,0,1,1
79,2025-05-24T19:54:00+02:00,2025-05-25,03:54,2,0,2
79,2025-05-25T14:16:00+02:00,2025-05-25,22:16,2,1,3
109,2025-05-24T19:50:00+02:00,2025-05-25,03:50,3,3,6
86,2025-05-25T14:19:00+02:00,2025-05-25,22:19,0,2,2
117,2025-05-24T19:40:00+02:00,2025-05-25,03:40,1,0,1
109,2025-05-25T14:15:00+02:00,2025-05-25,22:15,7,7,14
130,2025-05-24T19:40:00+02:00,2025-05-25,03:40,0,3,3
109,2025-05-25T14:20:00+02:00,2025-05-25,22:20,5,5,10
130,2025-05-24T19:50:00+02:00,2025-05-25,03:50,0,2,2
117,2025-05-25T14:10:00+02:00,2025-05-25,22:10,16,1,17
141,2025-05-24T19:45:00+02:00,2025-05-25,03:45,6,2,8
139,2025-05-25T14:20:00+02:00,2025-05-25,22:20,0,1,1
141,2025-05-25T14:15:00+02:00,2025-05-25,22:15,4,6,10
181,2025-05-25T14:10:00+02:00,2025-05-25,22:10,16,6,22
181,2025-05-24T19:43:00+02:00,2025-05-25,03:43,3,0,3
181,2025-05-25T14:16:00+02:00,2025-05-25,22:16,10,6,16
181,2025-05-24T19:45:00+02:00,2025-05-25,03:45,4,0,4
181,2025-05-25T14:19:00+02:00,2025-05-25,22:19,16,3,19
181,2025-05-24T19:46:00+02:00,2025-05-25,03:46,2,1,3
181,2025-05-25T14:22:00+02:00,2025-05-25,22:22,2,7,9
181,2025-05-24T19:49:00+02:00,2025-05-25,03:49,1,2,3
181,2025-05-25T14:24:00+02:00,2025-05-25,22:24,5,6,11
182,2025-05-24T19:40:00+02:00,2025-05-25,03:40,7,7,14
182,2025-05-25T14:10:00+02:00,2025-05-25,22:10,10,16,26
182,2025-05-24T19:45:00+02:00,2025-05-25,03:45,13,4,17
3,2025-05-25T13:14:00+02:00,2025-05-25,21:14,10,14,24
3,2025-05-25T13:21:00+02:00,2025-05-25,21:21,11,1,12
3,2025-05-25T13:22:00+02:00,2025-05-25,21:22,1,5,6
3,2025-05-25T13:24:00+02:00,2025-05-25,21:24,5,7,12
4,2025-05-25T13:10:00+02:00,2025-05-25,21:10,7,12,19
4,2025-05-25T13:11:00+02:00,2025-05-25,21:11,19,10,29
4,2025-05-25T13:12:00+02:00,2025-05-25,21:12,15,10,25
4,2025-05-25T13:14:00+02:00,2025-05-25,21:14,18,3,21
4,2025-05-25T13:15:00+02:00,2025-05-25,21:15,5,6,11
181,2025-05-24T19:58:00+02:00,2025-05-25,03:58,3,0,3
4,2025-05-25T13:20:00+02:00,2025-05-25,21:20,3,4,7
181,2025-05-24T20:06:00+02:00,2025-05-25,04:06,2,2,4
4,2025-05-25T13:23:00+02:00,2025-05-25,21:23,18,5,23
4,2025-05-25T13:24:00+02:00,2025-05-25,21:24,7,5,12
6,2025-05-25T13:10:00+02:00,2025-05-25,21:10,7,14,21
6,2025-05-25T13:16:00+02:00,2025-05-25,21:16,9,7,16
6,2025-05-25T13:18:00+02:00,2025-05-25,21:18,3,10,13
6,2025-05-25T13:20:00+02:00,2025-05-25,21:20,18,17,35
3,2025-05-24T20:29:00+02:00,2025-05-25,04:29,0,1,1
28,2025-05-25T13:13:00+02:00,2025-05-25,21:13,0,1,1
3,2025-05-24T20:32:00+02:00,2025-05-25,04:32,5,0,5
28,2025-05-25T13:21:00+02:00,2025-05-25,21:21,2,0,2
3,2025-05-24T20:39:00+02:00,2025-05-25,04:39,1,0,1
28,2025-05-25T13:24:00+02:00,2025-05-25,21:24,1,0,1
4,2025-05-24T20:27:00+02:00,2025-05-25,04:27,0,1,1
29,2025-05-25T13:12:00+02:00,2025-05-25,21:12,0,3,3
4,2025-05-24T20:28:00+02:00,2025-05-25,04:28,1,0,1
29,2025-05-25T13:15:00+02:00,2025-05-25,21:15,2,4,6
4,2025-05-24T20:35:00+02:00,2025-05-25,04:35,0,1,1
29,2025-05-25T13:16:00+02:00,2025-05-25,21:16,0,3,3
36,2025-05-24T20:36:00+02:00,2025-05-25,04:36,1,0,1
29,2025-05-25T13:17:00+02:00,2025-05-25,21:17,2,4,6
36,2025-05-24T20:39:00+02:00,2025-05-25,04:39,0,1,1
29,2025-05-25T13:18:00+02:00,2025-05-25,21:18,0,2,2
37,2025-05-24T20:35:00+02:00,2025-05-25,04:35,0,1,1
29,2025-05-25T13:23:00+02:00,2025-05-25,21:23,1,5,6
41,2025-05-24T20:26:00+02:00,2025-05-25,04:26,0,5,5
29,2025-05-25T13:24:00+02:00,2025-05-25,21:24,0,3,3
41,2025-05-24T20:34:00+02:00,2025-05-25,04:34,0,3,3
31,2025-05-25T13:12:00+02:00,2025-05-25,21:12,1,1,2
45,2025-05-24T20:32:00+02:00,2025-05-25,04:32,0,2,2
31,2025-05-25T13:15:00+02:00,2025-05-25,21:15,7,6,13
47,2025-05-24T20:26:00+02:00,2025-05-25,04:26,1,0,1
31,2025-05-25T13:16:00+02:00,2025-05-25,21:16,3,6,9
47,2025-05-24T20:30:00+02:00,2025-05-25,04:30,2,1,3
31,2025-05-25T13:21:00+02:00,2025-05-25,21:21,21,3,24
47,2025-05-24T20:33:00+02:00,2025-05-25,04:33,1,2,3
31,2025-05-25T13:22:00+02:00,2025-05-25,21:22,2,20,22
61,2025-05-24T20:25:00+02:00,2025-05-25,04:25,2,0,2
31,2025-05-25T13:24:00+02:00,2025-05-25,21:24,4,2,6
66,2025-05-24T20:29:00+02:00,2025-05-25,04:29,1,0,1
36,2025-05-25T13:12:00+02:00,2025-05-25,21:12,0,1,1
70,2025-05-24T20:35:00+02:00,2025-05-25,04:35,0,1,1
36,2025-05-25T13:16:00+02:00,2025-05-25,21:16,0,2,2
84,2025-05-24T20:25:00+02:00,2025-05-25,04:25,1,11,12
40,2025-05-25T13:23:00+02:00,2025-05-25,21:23,4,0,4
131,2025-05-24T20:25:00+02:00,2025-05-25,04:25,4,5,9
41,2025-05-25T13:11:00+02:00,2025-05-25,21:11,3,6,9
131,2025-05-24T20:35:00+02:00,2025-05-25,04:35,3,6,9
41,2025-05-25T13:13:00+02:00,2025-05-25,21:13,0,1,1
132,2025-05-24T20:25:00+02:00,2025-05-25,04:25,2,0,2
41,2025-05-25T13:17:00+02:00,2025-05-25,21:17,6,2,8
134,2025-05-24T20:25:00+02:00,2025-05-25,04:25,3,3,6
41,2025-05-25T13:20:00+02:00,2025-05-25,21:20,12,3,15
134,2025-05-24T20:35:00+02:00,2025-05-25,04:35,10,2,12
43,2025-05-25T13:15:00+02:00,2025-05-25,21:15,0,3,3
167,2025-05-24T20:25:00+02:00,2025-05-25,04:25,1,0,1
44,2025-05-25T13:10:00+02:00,2025-05-25,21:10,6,1,7
167,2025-05-24T20:35:00+02:00,2025-05-25,04:35,0,1,1
45,2025-05-25T13:14:00+02:00,2025-05-25,21:14,7,4,11
1,2025-05-24T20:29:00+02:00,2025-05-25,04:29,0,4,4
45,2025-05-25T13:16:00+02:00,2025-05-25,21:16,10,2,12
1,2025-05-24T20:31:00+02:00,2025-05-25,04:31,2,0,2
45,2025-05-25T13:19:00+02:00,2025-05-25,21:19,19,3,22
19,2025-05-24T20:31:00+02:00,2025-05-25,04:31,0,2,2
45,2025-05-25T13:20:00+02:00,2025-05-25,21:20,5,4,9
20,2025-05-24T20:28:00+02:00,2025-05-25,04:28,2,1,3
47,2025-05-25T13:15:00+02:00,2025-05-25,21:15,9,0,9
20,2025-05-24T20:30:00+02:00,2025-05-25,04:30,1,1,2
47,2025-05-25T13:21:00+02:00,2025-05-25,21:21,10,5,15
20,2025-05-24T20:31:00+02:00,2025-05-25,04:31,3,6,9
47,2025-05-25T13:22:00+02:00,2025-05-25,21:22,19,2,21
20,2025-05-24T20:32:00+02:00,2025-05-25,04:32,0,5,5
50,2025-05-25T13:15:00+02:00,2025-05-25,21:15,1,0,1
20,2025-05-24T20:34:00+02:00,2025-05-25,04:34,0,2,2
50,2025-05-25T13:19:00+02:00,2025-05-25,21:19,4,2,6
20,2025-05-24T20:35:00+02:00,2025-05-25,04:35,0,2,2
54,2025-05-25T13:11:00+02:00,2025-05-25,21:11,4,0,4
20,2025-05-24T20:36:00+02:00,2025-05-25,04:36,0,1,1
54,2025-05-25T13:15:00+02:00,2025-05-25,21:15,2,3,5
20,2025-05-24T20:37:00+02:00,2025-05-25,04:37,0,3,3
54,2025-05-25T13:19:00+02:00,2025-05-25,21:19,4,5,9
23,2025-05-24T20:27:00+02:00,2025-05-25,04:27,0,2,2
59,2025-05-25T13:15:00+02:00,2025-05-25,21:15,13,10,23
23,2025-05-24T20:28:00+02:00,2025-05-25,04:28,0,2,2
59,2025-05-25T13:20:00+02:00,2025-05-25,21:20,11,15,26
23,2025-05-24T20:36:00+02:00,2025-05-25,04:36,0,1,1
61,2025-05-25T13:12:00+02:00,2025-05-25,21:12,6,2,8
24,2025-05-24T20:29:00+02:00,2025-05-25,04:29,1,4,5
61,2025-05-25T13:19:00+02:00,2025-05-25,21:19,1,3,4
25,2025-05-24T20:25:00+02:00,2025-05-25,04:25,1,0,1
61,2025-05-25T13:21:00+02:00,2025-05-25,21:21,3,2,5
30,2025-05-24T20:26:00+02:00,2025-05-25,04:26,11,1,12
61,2025-05-25T13:22:00+02:00,2025-05-25,21:22,9,1,10
30,2025-05-24T20:28:00+02:00,2025-05-25,04:28,2,3,5
66,2025-05-25T13:12:00+02:00,2025-05-25,21:12,16,8,24
30,2025-05-24T20:32:00+02:00,2025-05-25,04:32,1,0,1
66,2025-05-25T13:18:00+02:00,2025-05-25,21:18,15,5,20
30,2025-05-24T20:33:00+02:00,2025-05-25,04:33,0,2,2
66,2025-05-25T13:19:00+02:00,2025-05-25,21:19,19,7,26
30,2025-05-24T20:34:00+02:00,2025-05-25,04:34,1,1,2
66,2025-05-25T13:20:00+02:00,2025-05-25,21:20,14,17,31
30,2025-05-24T20:38:00+02:00,2025-05-25,04:38,1,0,1
66,2025-05-25T13:21:00+02:00,2025-05-25,21:21,22,9,31
49,2025-05-24T20:33:00+02:00,2025-05-25,04:33,2,1,3
66,2025-05-25T13:23:00+02:00,2025-05-25,21:23,22,24,46
49,2025-05-24T20:37:00+02:00,2025-05-25,04:37,0,3,3
69,2025-05-25T13:10:00+02:00,2025-05-25,21:10,0,1,1
49,2025-05-24T20:38:00+02:00,2025-05-25,04:38,1,2,3
69,2025-05-25T13:14:00+02:00,2025-05-25,21:14,0,1,1
51,2025-05-24T20:35:00+02:00,2025-05-25,04:35,0,1,1
69,2025-05-25T13:15:00+02:00,2025-05-25,21:15,0,1,1
52,2025-05-24T20:25:00+02:00,2025-05-25,04:25,0,2,2
70,2025-05-25T13:12:00+02:00,2025-05-25,21:12,1,0,1
52,2025-05-24T20:29:00+02:00,2025-05-25,04:29,10,0,10
70,2025-05-25T13:21:00+02:00,2025-05-25,21:21,0,2,2
52,2025-05-24T20:39:00+02:00,2025-05-25,04:39,0,1,1
70,2025-05-25T13:23:00+02:00,2025-05-25,21:23,1,2,3
56,2025-05-24T20:25:00+02:00,2025-05-25,04:25,1,0,1
77,2025-05-25T13:15:00+02:00,2025-05-25,21:15,20,5,25
56,2025-05-24T20:37:00+02:00,2025-05-25,04:37,0,4,4
77,2025-05-25T13:20:00+02:00,2025-05-25,21:20,3,5,8
56,2025-05-24T20:38:00+02:00,2025-05-25,04:38,2,0,2
84,2025-05-25T13:20:00+02:00,2025-05-25,21:20,21,43,64
62,2025-05-24T20:31:00+02:00,2025-05-25,04:31,0,1,1
87,2025-05-25T13:14:00+02:00,2025-05-25,21:14,2,0,2
62,2025-05-24T20:39:00+02:00,2025-05-25,04:39,1,0,1
87,2025-05-25T13:23:00+02:00,2025-05-25,21:23,1,3,4
63,2025-05-24T20:29:00+02:00,2025-05-25,04:29,0,1,1
87,2025-05-25T13:24:00+02:00,2025-05-25,21:24,1,0,1
72,2025-05-24T20:36:00+02:00,2025-05-25,04:36,0,2,2
107,2025-05-25T13:10:00+02:00,2025-05-25,21:10,0,3,3
79,2025-05-24T20:28:00+02:00,2025-05-25,04:28,0,1,1
107,2025-05-25T13:20:00+02:00,2025-05-25,21:20,12,6,18
79,2025-05-24T20:39:00+02:00,2025-05-25,04:39,0,3,3
108,2025-05-25T13:11:00+02:00,2025-05-25,21:11,0,5,5
109,2025-05-24T20:25:00+02:00,2025-05-25,04:25,6,0,6
108,2025-05-25T13:14:00+02:00,2025-05-25,21:14,1,2,3
117,2025-05-24T20:25:00+02:00,2025-05-25,04:25,0,1,1
108,2025-05-25T13:16:00+02:00,2025-05-25,21:16,1,6,7
139,2025-05-24T20:30:00+02:00,2025-05-25,04:30,1,0,1
108,2025-05-25T13:17:00+02:00,2025-05-25,21:17,4,0,4
3,2025-05-24T20:11:00+02:00,2025-05-25,04:11,0,5,5
108,2025-05-25T13:18:00+02:00,2025-05-25,21:18,4,1,5
3,2025-05-24T20:13:00+02:00,2025-05-25,04:13,1,0,1
108,2025-05-25T13:22:00+02:00,2025-05-25,21:22,1,3,4
3,2025-05-24T20:15:00+02:00,2025-05-25,04:15,0,4,4
108,2025-05-25T13:23:00+02:00,2025-05-25,21:23,1,0,1
3,2025-05-24T20:16:00+02:00,2025-05-25,04:16,0,1,1
131,2025-05-25T13:15:00+02:00,2025-05-25,21:15,4,4,8
3,2025-05-24T20:22:00+02:00,2025-05-25,04:22,2,0,2
131,2025-05-25T13:20:00+02:00,2025-05-25,21:20,12,12,24
5,2025-05-24T20:10:00+02:00,2025-05-25,04:10,2,2,4
132,2025-05-25T13:10:00+02:00,2025-05-25,21:10,13,14,27
6,2025-05-24T20:12:00+02:00,2025-05-25,04:12,6,3,9
132,2025-05-25T13:20:00+02:00,2025-05-25,21:20,6,16,22
6,2025-05-24T20:16:00+02:00,2025-05-25,04:16,0,7,7
134,2025-05-25T13:20:00+02:00,2025-05-25,21:20,16,12,28
6,2025-05-24T20:22:00+02:00,2025-05-25,04:22,0,1,1
135,2025-05-25T13:10:00+02:00,2025-05-25,21:10,6,7,13
6,2025-05-24T20:23:00+02:00,2025-05-25,04:23,1,1,2
135,2025-05-25T13:20:00+02:00,2025-05-25,21:20,3,8,11
28,2025-05-24T20:18:00+02:00,2025-05-25,04:18,0,1,1
166,2025-05-25T13:15:00+02:00,2025-05-25,21:15,0,1,1
28,2025-05-24T20:19:00+02:00,2025-05-25,04:19,1,1,2
167,2025-05-25T13:20:00+02:00,2025-05-25,21:20,0,1,1
36,2025-05-24T20:10:00+02:00,2025-05-25,04:10,0,5,5
179,2025-05-25T13:15:00+02:00,2025-05-25,21:15,0,8,8
36,2025-05-24T20:11:00+02:00,2025-05-25,04:11,0,3,3
1,2025-05-25T13:11:00+02:00,2025-05-25,21:11,10,8,18
36,2025-05-24T20:12:00+02:00,2025-05-25,04:12,0,1,1
1,2025-05-25T13:13:00+02:00,2025-05-25,21:13,5,3,8
36,2025-05-24T20:17:00+02:00,2025-05-25,04:17,0,3,3
1,2025-05-25T13:16:00+02:00,2025-05-25,21:16,1,3,4
36,2025-05-24T20:21:00+02:00,2025-05-25,04:21,0,3,3
1,2025-05-25T13:20:00+02:00,2025-05-25,21:20,5,3,8
41,2025-05-24T20:24:00+02:00,2025-05-25,04:24,3,0,3
1,2025-05-25T13:21:00+02:00,2025-05-25,21:21,2,0,2
45,2025-05-24T20:10:00+02:00,2025-05-25,04:10,1,0,1
2,2025-05-25T13:10:00+02:00,2025-05-25,21:10,2,1,3
45,2025-05-24T20:12:00+02:00,2025-05-25,04:12,0,3,3
2,2025-05-25T13:12:00+02:00,2025-05-25,21:12,0,2,2
47,2025-05-24T20:10:00+02:00,2025-05-25,04:10,2,0,2
2,2025-05-25T13:13:00+02:00,2025-05-25,21:13,1,0,1
47,2025-05-24T20:11:00+02:00,2025-05-25,04:11,4,4,8
2,2025-05-25T13:14:00+02:00,2025-05-25,21:14,0,4,4
47,2025-05-24T20:14:00+02:00,2025-05-25,04:14,1,0,1
2,2025-05-25T13:15:00+02:00,2025-05-25,21:15,1,1,2
47,2025-05-24T20:15:00+02:00,2025-05-25,04:15,0,1,1
2,2025-05-25T13:17:00+02:00,2025-05-25,21:17,0,6,6
47,2025-05-24T20:17:00+02:00,2025-05-25,04:17,1,0,1
2,2025-05-25T13:22:00+02:00,2025-05-25,21:22,1,4,5
47,2025-05-24T20:19:00+02:00,2025-05-25,04:19,0,1,1
9,2025-05-25T13:10:00+02:00,2025-05-25,21:10,1,0,1
47,2025-05-24T20:23:00+02:00,2025-05-25,04:23,0,1,1
9,2025-05-25T13:11:00+02:00,2025-05-25,21:11,0,1,1
47,2025-05-24T20:24:00+02:00,2025-05-25,04:24,2,4,6
9,2025-05-25T13:20:00+02:00,2025-05-25,21:20,0,1,1
54,2025-05-24T20:21:00+02:00,2025-05-25,04:21,0,1,1
10,2025-05-25T13:11:00+02:00,2025-05-25,21:11,0,1,1
59,2025-05-24T20:10:00+02:00,2025-05-25,04:10,1,0,1
10,2025-05-25T13:14:00+02:00,2025-05-25,21:14,0,3,3
66,2025-05-24T20:23:00+02:00,2025-05-25,04:23,4,0,4
11,2025-05-25T13:10:00+02:00,2025-05-25,21:10,3,0,3
71,2025-05-24T20:13:00+02:00,2025-05-25,04:13,1,0,1
12,2025-05-25T13:11:00+02:00,2025-05-25,21:11,0,3,3
71,2025-05-24T20:15:00+02:00,2025-05-25,04:15,0,1,1
12,2025-05-25T13:12:00+02:00,2025-05-25,21:12,5,0,5
77,2025-05-24T20:10:00+02:00,2025-05-25,04:10,3,1,4
12,2025-05-25T13:13:00+02:00,2025-05-25,21:13,2,0,2
108,2025-05-24T20:10:00+02:00,2025-05-25,04:10,0,1,1
12,2025-05-25T13:14:00+02:00,2025-05-25,21:14,1,0,1
108,2025-05-24T20:12:00+02:00,2025-05-25,04:12,1,0,1
12,2025-05-25T13:17:00+02:00,2025-05-25,21:17,8,3,11
132,2025-05-24T20:20:00+02:00,2025-05-25,04:20,1,0,1
12,2025-05-25T13:19:00+02:00,2025-05-25,21:19,0,2,2
134,2025-05-24T20:10:00+02:00,2025-05-25,04:10,6,3,9
12,2025-05-25T13:21:00+02:00,2025-05-25,21:21,3,8,11
135,2025-05-24T20:10:00+02:00,2025-05-25,04:10,0,1,1
17,2025-05-25T13:10:00+02:00,2025-05-25,21:10,3,2,5
165,2025-05-24T20:10:00+02:00,2025-05-25,04:10,3,0,3
17,2025-05-25T13:14:00+02:00,2025-05-25,21:14,0,4,4
179,2025-05-24T20:20:00+02:00,2025-05-25,04:20,2,2,4
17,2025-05-25T13:15:00+02:00,2025-05-25,21:15,2,0,2
1,2025-05-24T20:10:00+02:00,2025-05-25,04:10,0,1,1
17,2025-05-25T13:16:00+02:00,2025-05-25,21:16,4,2,6
1,2025-05-24T20:15:00+02:00,2025-05-25,04:15,4,0,4
17,2025-05-25T13:17:00+02:00,2025-05-25,21:17,5,4,9
1,2025-05-24T20:23:00+02:00,2025-05-25,04:23,6,0,6
17,2025-05-25T13:24:00+02:00,2025-05-25,21:24,0,5,5
2,2025-05-24T20:17:00+02:00,2025-05-25,04:17,0,1,1
18,2025-05-25T13:15:00+02:00,2025-05-25,21:15,1,0,1
2,2025-05-24T20:21:00+02:00,2025-05-25,04:21,0,1,1
19,2025-05-25T13:12:00+02:00,2025-05-25,21:12,9,7,16
12,2025-05-24T20:17:00+02:00,2025-05-25,04:17,0,2,2
19,2025-05-25T13:14:00+02:00,2025-05-25,21:14,5,3,8
20,2025-05-24T20:10:00+02:00,2025-05-25,04:10,4,2,6
19,2025-05-25T13:15:00+02:00,2025-05-25,21:15,4,5,9
20,2025-05-24T20:11:00+02:00,2025-05-25,04:11,2,2,4
19,2025-05-25T13:17:00+02:00,2025-05-25,21:17,6,7,13
20,2025-05-24T20:17:00+02:00,2025-05-25,04:17,0,1,1
19,2025-05-25T13:19:00+02:00,2025-05-25,21:19,9,8,17
20,2025-05-24T20:20:00+02:00,2025-05-25,04:20,0,2,2
19,2025-05-25T13:24:00+02:00,2025-05-25,21:24,2,4,6
23,2025-05-24T20:14:00+02:00,2025-05-25,04:14,2,0,2
20,2025-05-25T13:10:00+02:00,2025-05-25,21:10,3,0,3
24,2025-05-24T20:17:00+02:00,2025-05-25,04:17,0,1,1
20,2025-05-25T13:19:00+02:00,2025-05-25,21:19,1,8,9
24,2025-05-24T20:19:00+02:00,2025-05-25,04:19,1,0,1
20,2025-05-25T13:20:00+02:00,2025-05-25,21:20,2,12,14
24,2025-05-24T20:22:00+02:00,2025-05-25,04:22,1,1,2
20,2025-05-25T13:21:00+02:00,2025-05-25,21:21,4,4,8
27,2025-05-24T20:23:00+02:00,2025-05-25,04:23,1,0,1
20,2025-05-25T13:24:00+02:00,2025-05-25,21:24,1,6,7
30,2025-05-24T20:10:00+02:00,2025-05-25,04:10,5,2,7
23,2025-05-25T13:19:00+02:00,2025-05-25,21:19,0,5,5
30,2025-05-24T20:19:00+02:00,2025-05-25,04:19,12,3,15
23,2025-05-25T13:21:00+02:00,2025-05-25,21:21,0,1,1
30,2025-05-24T20:20:00+02:00,2025-05-25,04:20,2,1,3
23,2025-05-25T13:23:00+02:00,2025-05-25,21:23,1,3,4
35,2025-05-24T20:12:00+02:00,2025-05-25,04:12,0,1,1
23,2025-05-25T13:24:00+02:00,2025-05-25,21:24,2,12,14
35,2025-05-24T20:15:00+02:00,2025-05-25,04:15,0,2,2
24,2025-05-25T13:11:00+02:00,2025-05-25,21:11,5,1,6
49,2025-05-24T20:13:00+02:00,2025-05-25,04:13,0,1,1
24,2025-05-25T13:15:00+02:00,2025-05-25,21:15,0,6,6
49,2025-05-24T20:16:00+02:00,2025-05-25,04:16,2,1,3
24,2025-05-25T13:17:00+02:00,2025-05-25,21:17,6,3,9
49,2025-05-24T20:17:00+02:00,2025-05-25,04:17,1,0,1
24,2025-05-25T13:23:00+02:00,2025-05-25,21:23,0,10,10
51,2025-05-24T20:18:00+02:00,2025-05-25,04:18,0,1,1
25,2025-05-25T13:10:00+02:00,2025-05-25,21:10,10,19,29
52,2025-05-24T20:11:00+02:00,2025-05-25,04:11,3,0,3
25,2025-05-25T13:20:00+02:00,2025-05-25,21:20,10,10,20
52,2025-05-24T20:16:00+02:00,2025-05-25,04:16,2,0,2
27,2025-05-25T13:15:00+02:00,2025-05-25,21:15,4,0,4
52,2025-05-24T20:18:00+02:00,2025-05-25,04:18,2,0,2
27,2025-05-25T13:17:00+02:00,2025-05-25,21:17,4,0,4
52,2025-05-24T20:22:00+02:00,2025-05-25,04:22,1,0,1
27,2025-05-25T13:21:00+02:00,2025-05-25,21:21,2,4,6
53,2025-05-24T20:20:00+02:00,2025-05-25,04:20,2,0,2
30,2025-05-25T13:11:00+02:00,2025-05-25,21:11,2,3,5
56,2025-05-24T20:15:00+02:00,2025-05-25,04:15,1,0,1
30,2025-05-25T13:13:00+02:00,2025-05-25,21:13,9,5,14
56,2025-05-24T20:17:00+02:00,2025-05-25,04:17,1,1,2
30,2025-05-25T13:18:00+02:00,2025-05-25,21:18,5,6,11
56,2025-05-24T20:18:00+02:00,2025-05-25,04:18,0,3,3
30,2025-05-25T13:22:00+02:00,2025-05-25,21:22,1,13,14
56,2025-05-24T20:20:00+02:00,2025-05-25,04:20,0,1,1
35,2025-05-25T13:14:00+02:00,2025-05-25,21:14,5,10,15
58,2025-05-24T20:19:00+02:00,2025-05-25,04:19,0,2,2
35,2025-05-25T13:18:00+02:00,2025-05-25,21:18,3,18,21
62,2025-05-24T20:17:00+02:00,2025-05-25,04:17,0,2,2
48,2025-05-25T13:13:00+02:00,2025-05-25,21:13,2,0,2
67,2025-05-24T20:19:00+02:00,2025-05-25,04:19,0,1,1
48,2025-05-25T13:19:00+02:00,2025-05-25,21:19,3,0,3
79,2025-05-24T20:11:00+02:00,2025-05-25,04:11,0,2,2
48,2025-05-25T13:20:00+02:00,2025-05-25,21:20,1,1,2
79,2025-05-24T20:13:00+02:00,2025-05-25,04:13,0,1,1
48,2025-05-25T13:22:00+02:00,2025-05-25,21:22,0,1,1
79,2025-05-24T20:20:00+02:00,2025-05-25,04:20,1,0,1
49,2025-05-25T13:13:00+02:00,2025-05-25,21:13,1,2,3
86,2025-05-24T20:12:00+02:00,2025-05-25,04:12,0,1,1
49,2025-05-25T13:14:00+02:00,2025-05-25,21:14,6,2,8
109,2025-05-24T20:10:00+02:00,2025-05-25,04:10,2,0,2
49,2025-05-25T13:20:00+02:00,2025-05-25,21:20,6,5,11
141,2025-05-24T20:20:00+02:00,2025-05-25,04:20,3,1,4
49,2025-05-25T13:24:00+02:00,2025-05-25,21:24,4,0,4
51,2025-05-25T13:15:00+02:00,2025-05-25,21:15,0,2,2
51,2025-05-25T13:20:00+02:00,2025-05-25,21:20,4,0,4
51,2025-05-25T13:22:00+02:00,2025-05-25,21:22,0,1,1
52,2025-05-25T13:14:00+02:00,2025-05-25,21:14,5,3,8
52,2025-05-25T13:17:00+02:00,2025-05-25,21:17,2,0,2
52,2025-05-25T13:18:00+02:00,2025-05-25,21:18,2,5,7
52,2025-05-25T13:19:00+02:00,2025-05-25,21:19,1,5,6
52,2025-05-25T13:21:00+02:00,2025-05-25,21:21,2,0,2
52,2025-05-25T13:22:00+02:00,2025-05-25,21:22,1,4,5
181,2025-05-24T20:11:00+02:00,2025-05-25,04:11,2,6,8
52,2025-05-25T13:23:00+02:00,2025-05-25,21:23,1,0,1
181,2025-05-24T20:17:00+02:00,2025-05-25,04:17,3,1,4
52,2025-05-25T13:24:00+02:00,2025-05-25,21:24,2,3,5
181,2025-05-24T20:21:00+02:00,2025-05-25,04:21,0,1,1
53,2025-05-25T13:11:00+02:00,2025-05-25,21:11,0,1,1
181,2025-05-24T20:22:00+02:00,2025-05-25,04:22,0,1,1
53,2025-05-25T13:14:00+02:00,2025-05-25,21:14,1,14,15
53,2025-05-25T13:16:00+02:00,2025-05-25,21:16,1,2,3
53,2025-05-25T13:21:00+02:00,2025-05-25,21:21,2,0,2
56,2025-05-25T13:11:00+02:00,2025-05-25,21:11,7,7,14
56,2025-05-25T13:14:00+02:00,2025-05-25,21:14,4,13,17
56,2025-05-25T13:15:00+02:00,2025-05-25,21:15,10,4,14
56,2025-05-25T13:17:00+02:00,2025-05-25,21:17,4,6,10
56,2025-05-25T13:22:00+02:00,2025-05-25,21:22,4,4,8
58,2025-05-25T13:10:00+02:00,2025-05-25,21:10,2,3,5
58,2025-05-25T13:15:00+02:00,2025-05-25,21:15,4,2,6
58,2025-05-25T13:16:00+02:00,2025-05-25,21:16,4,3,7
58,2025-05-25T13:18:00+02:00,2025-05-25,21:18,0,6,6
181,2025-05-24T20:26:00+02:00,2025-05-25,04:26,2,5,7
58,2025-05-25T13:22:00+02:00,2025-05-25,21:22,4,1,5
181,2025-05-24T20:29:00+02:00,2025-05-25,04:29,2,0,2
62,2025-05-25T13:12:00+02:00,2025-05-25,21:12,1,0,1
181,2025-05-24T20:33:00+02:00,2025-05-25,04:33,1,0,1
62,2025-05-25T13:15:00+02:00,2025-05-25,21:15,3,2,5
181,2025-05-24T20:37:00+02:00,2025-05-25,04:37,0,1,1
62,2025-05-25T13:17:00+02:00,2025-05-25,21:17,0,3,3
182,2025-05-24T20:25:00+02:00,2025-05-25,04:25,1,4,5
62,2025-05-25T13:19:00+02:00,2025-05-25,21:19,4,1,5
62,2025-05-25T13:21:00+02:00,2025-05-25,21:21,0,5,5
62,2025-05-25T13:23:00+02:00,2025-05-25,21:23,10,1,11
63,2025-05-25T13:14:00+02:00,2025-05-25,21:14,3,3,6
63,2025-05-25T13:17:00+02:00,2025-05-25,21:17,0,3,3
63,2025-05-25T13:18:00+02:00,2025-05-25,21:18,2,2,4
63,2025-05-25T13:20:00+02:00,2025-05-25,21:20,0,3,3
63,2025-05-25T13:22:00+02:00,2025-05-25,21:22,0,5,5
67,2025-05-25T13:18:00+02:00,2025-05-25,21:18,0,4,4
67,2025-05-25T13:19:00+02:00,2025-05-25,21:19,0,3,3
67,2025-05-25T13:23:00+02:00,2025-05-25,21:23,1,0,1
67,2025-05-25T13:24:00+02:00,2025-05-25,21:24,0,5,5
68,2025-05-25T13:10:00+02:00,2025-05-25,21:10,1,3,4
68,2025-05-25T13:13:00+02:00,2025-05-25,21:13,0,2,2
68,2025-05-25T13:20:00+02:00,2025-05-25,21:20,1,0,1
68,2025-05-25T13:21:00+02:00,2025-05-25,21:21,0,3,3
68,2025-05-25T13:23:00+02:00,2025-05-25,21:23,1,0,1
72,2025-05-25T13:14:00+02:00,2025-05-25,21:14,0,1,1
72,2025-05-25T13:17:00+02:00,2025-05-25,21:17,0,5,5
72,2025-05-25T13:18:00+02:00,2025-05-25,21:18,0,3,3
72,2025-05-25T13:24:00+02:00,2025-05-25,21:24,1,1,2
76,2025-05-25T13:19:00+02:00,2025-05-25,21:19,1,0,1
79,2025-05-25T13:14:00+02:00,2025-05-25,21:14,2,3,5
79,2025-05-25T13:16:00+02:00,2025-05-25,21:16,1,1,2
79,2025-05-25T13:19:00+02:00,2025-05-25,21:19,4,3,7
79,2025-05-25T13:22:00+02:00,2025-05-25,21:22,3,2,5
86,2025-05-25T13:12:00+02:00,2025-05-25,21:12,0,1,1
86,2025-05-25T13:13:00+02:00,2025-05-25,21:13,0,2,2
109,2025-05-25T13:20:00+02:00,2025-05-25,21:20,3,16,19
117,2025-05-25T13:10:00+02:00,2025-05-25,21:10,12,5,17
117,2025-05-25T13:15:00+02:00,2025-05-25,21:15,13,3,16
117,2025-05-25T13:20:00+02:00,2025-05-25,21:20,12,1,13
130,2025-05-25T13:10:00+02:00,2025-05-25,21:10,0,3,3
137,2025-05-25T13:15:00+02:00,2025-05-25,21:15,0,2,2
142,2025-05-25T13:15:00+02:00,2025-05-25,21:15,5,2,7
3,2025-05-25T12:55:00+02:00,2025-05-25,20:55,15,9,24
3,2025-05-25T13:00:00+02:00,2025-05-25,21:00,9,11,20
3,2025-05-25T13:01:00+02:00,2025-05-25,21:01,5,9,14
3,2025-05-25T13:02:00+02:00,2025-05-25,21:02,7,16,23
3,2025-05-25T13:03:00+02:00,2025-05-25,21:03,16,3,19
3,2025-05-25T13:05:00+02:00,2025-05-25,21:05,16,12,28
3,2025-05-25T13:07:00+02:00,2025-05-25,21:07,11,18,29
4,2025-05-25T12:56:00+02:00,2025-05-25,20:56,7,7,14
4,2025-05-25T12:59:00+02:00,2025-05-25,20:59,10,8,18
4,2025-05-25T13:06:00+02:00,2025-05-25,21:06,8,4,12
5,2025-05-25T12:55:00+02:00,2025-05-25,20:55,23,29,52
5,2025-05-25T13:00:00+02:00,2025-05-25,21:00,18,19,37
5,2025-05-25T13:05:00+02:00,2025-05-25,21:05,25,45,70
6,2025-05-25T12:58:00+02:00,2025-05-25,20:58,4,5,9
6,2025-05-25T12:59:00+02:00,2025-05-25,20:59,4,1,5
6,2025-05-25T13:02:00+02:00,2025-05-25,21:02,13,7,20
6,2025-05-25T13:09:00+02:00,2025-05-25,21:09,8,2,10
8,2025-05-25T13:04:00+02:00,2025-05-25,21:04,1,0,1
8,2025-05-25T13:05:00+02:00,2025-05-25,21:05,1,0,1
28,2025-05-25T12:56:00+02:00,2025-05-25,20:56,2,0,2
28,2025-05-25T13:00:00+02:00,2025-05-25,21:00,2,1,3
28,2025-05-25T13:05:00+02:00,2025-05-25,21:05,2,1,3
28,2025-05-25T13:07:00+02:00,2025-05-25,21:07,4,0,4
28,2025-05-25T13:08:00+02:00,2025-05-25,21:08,3,0,3
29,2025-05-25T13:03:00+02:00,2025-05-25,21:03,2,0,2
29,2025-05-25T13:05:00+02:00,2025-05-25,21:05,2,4,6
31,2025-05-25T12:56:00+02:00,2025-05-25,20:56,5,1,6
31,2025-05-25T12:58:00+02:00,2025-05-25,20:58,2,4,6
31,2025-05-25T13:00:00+02:00,2025-05-25,21:00,8,5,13
31,2025-05-25T13:06:00+02:00,2025-05-25,21:06,1,4,5
31,2025-05-25T13:09:00+02:00,2025-05-25,21:09,1,0,1
36,2025-05-25T12:58:00+02:00,2025-05-25,20:58,4,2,6
36,2025-05-25T13:07:00+02:00,2025-05-25,21:07,3,0,3
36,2025-05-25T13:08:00+02:00,2025-05-25,21:08,3,0,3
39,2025-05-25T13:01:00+02:00,2025-05-25,21:01,0,3,3
39,2025-05-25T13:09:00+02:00,2025-05-25,21:09,0,3,3
40,2025-05-25T12:58:00+02:00,2025-05-25,20:58,2,0,2
40,2025-05-25T13:00:00+02:00,2025-05-25,21:00,3,0,3
40,2025-05-25T13:03:00+02:00,2025-05-25,21:03,3,0,3
40,2025-05-25T13:05:00+02:00,2025-05-25,21:05,1,0,1
41,2025-05-25T12:58:00+02:00,2025-05-25,20:58,2,0,2
41,2025-05-25T12:59:00+02:00,2025-05-25,20:59,3,2,5
41,2025-05-25T13:01:00+02:00,2025-05-25,21:01,2,4,6
41,2025-05-25T13:02:00+02:00,2025-05-25,21:02,6,0,6
41,2025-05-25T13:05:00+02:00,2025-05-25,21:05,1,2,3
41,2025-05-25T13:08:00+02:00,2025-05-25,21:08,0,1,1
43,2025-05-25T13:00:00+02:00,2025-05-25,21:00,2,2,4
45,2025-05-25T12:57:00+02:00,2025-05-25,20:57,3,9,12
45,2025-05-25T12:59:00+02:00,2025-05-25,20:59,10,6,16
45,2025-05-25T13:00:00+02:00,2025-05-25,21:00,5,7,12
45,2025-05-25T13:02:00+02:00,2025-05-25,21:02,12,10,22
45,2025-05-25T13:06:00+02:00,2025-05-25,21:06,10,6,16
45,2025-05-25T13:07:00+02:00,2025-05-25,21:07,4,5,9
47,2025-05-25T12:56:00+02:00,2025-05-25,20:56,1,0,1
47,2025-05-25T12:58:00+02:00,2025-05-25,20:58,4,19,23
47,2025-05-25T12:59:00+02:00,2025-05-25,20:59,14,15,29
47,2025-05-25T13:01:00+02:00,2025-05-25,21:01,3,12,15
47,2025-05-25T13:05:00+02:00,2025-05-25,21:05,4,5,9
50,2025-05-25T12:59:00+02:00,2025-05-25,20:59,2,0,2
50,2025-05-25T13:03:00+02:00,2025-05-25,21:03,6,0,6
50,2025-05-25T13:07:00+02:00,2025-05-25,21:07,2,0,2
54,2025-05-25T13:00:00+02:00,2025-05-25,21:00,8,1,9
54,2025-05-25T13:02:00+02:00,2025-05-25,21:02,0,5,5
54,2025-05-25T13:04:00+02:00,2025-05-25,21:04,2,1,3
54,2025-05-25T13:06:00+02:00,2025-05-25,21:06,0,3,3
59,2025-05-25T13:00:00+02:00,2025-05-25,21:00,9,17,26
61,2025-05-25T12:56:00+02:00,2025-05-25,20:56,8,0,8
61,2025-05-25T13:00:00+02:00,2025-05-25,21:00,2,0,2
61,2025-05-25T13:04:00+02:00,2025-05-25,21:04,3,1,4
61,2025-05-25T13:06:00+02:00,2025-05-25,21:06,3,6,9
66,2025-05-25T12:57:00+02:00,2025-05-25,20:57,9,16,25
66,2025-05-25T13:00:00+02:00,2025-05-25,21:00,13,12,25
66,2025-05-25T13:01:00+02:00,2025-05-25,21:01,6,11,17
66,2025-05-25T13:08:00+02:00,2025-05-25,21:08,15,12,27
69,2025-05-25T13:09:00+02:00,2025-05-25,21:09,1,1,2
70,2025-05-25T13:04:00+02:00,2025-05-25,21:04,2,1,3
70,2025-05-25T13:07:00+02:00,2025-05-25,21:07,3,0,3
70,2025-05-25T13:09:00+02:00,2025-05-25,21:09,0,2,2
71,2025-05-25T13:03:00+02:00,2025-05-25,21:03,1,0,1
75,2025-05-25T12:59:00+02:00,2025-05-25,20:59,1,0,1
75,2025-05-25T13:08:00+02:00,2025-05-25,21:08,0,1,1
78,2025-05-25T13:01:00+02:00,2025-05-25,21:01,1,0,1
78,2025-05-25T13:06:00+02:00,2025-05-25,21:06,0,1,1
78,2025-05-25T13:09:00+02:00,2025-05-25,21:09,2,0,2
84,2025-05-25T13:05:00+02:00,2025-05-25,21:05,48,69,117
87,2025-05-25T13:02:00+02:00,2025-05-25,21:02,2,0,2
107,2025-05-25T12:55:00+02:00,2025-05-25,20:55,6,4,10
107,2025-05-25T13:00:00+02:00,2025-05-25,21:00,8,6,14
108,2025-05-25T12:58:00+02:00,2025-05-25,20:58,1,0,1
108,2025-05-25T13:00:00+02:00,2025-05-25,21:00,1,0,1
108,2025-05-25T13:01:00+02:00,2025-05-25,21:01,1,0,1
108,2025-05-25T13:02:00+02:00,2025-05-25,21:02,0,5,5
108,2025-05-25T13:03:00+02:00,2025-05-25,21:03,1,1,2
108,2025-05-25T13:05:00+02:00,2025-05-25,21:05,0,2,2
108,2025-05-25T13:06:00+02:00,2025-05-25,21:06,4,2,6
131,2025-05-25T12:55:00+02:00,2025-05-25,20:55,8,7,15
131,2025-05-25T13:05:00+02:00,2025-05-25,21:05,5,2,7
134,2025-05-25T13:05:00+02:00,2025-05-25,21:05,13,12,25
135,2025-05-25T12:55:00+02:00,2025-05-25,20:55,11,7,18
135,2025-05-25T13:00:00+02:00,2025-05-25,21:00,1,17,18
165,2025-05-25T12:55:00+02:00,2025-05-25,20:55,1,0,1
179,2025-05-25T13:00:00+02:00,2025-05-25,21:00,3,4,7
1,2025-05-25T12:56:00+02:00,2025-05-25,20:56,3,4,7
1,2025-05-25T12:58:00+02:00,2025-05-25,20:58,2,9,11
1,2025-05-25T13:00:00+02:00,2025-05-25,21:00,2,6,8
1,2025-05-25T13:02:00+02:00,2025-05-25,21:02,6,6,12
1,2025-05-25T13:08:00+02:00,2025-05-25,21:08,6,1,7
2,2025-05-25T12:55:00+02:00,2025-05-25,20:55,4,5,9
2,2025-05-25T13:01:00+02:00,2025-05-25,21:01,0,2,2
2,2025-05-25T13:02:00+02:00,2025-05-25,21:02,0,3,3
2,2025-05-25T13:07:00+02:00,2025-05-25,21:07,1,3,4
2,2025-05-25T13:09:00+02:00,2025-05-25,21:09,1,4,5
9,2025-05-25T12:58:00+02:00,2025-05-25,20:58,2,0,2
11,2025-05-25T12:55:00+02:00,2025-05-25,20:55,7,1,8
11,2025-05-25T13:00:00+02:00,2025-05-25,21:00,8,1,9
12,2025-05-25T13:01:00+02:00,2025-05-25,21:01,2,0,2
12,2025-05-25T13:02:00+02:00,2025-05-25,21:02,3,2,5
12,2025-05-25T13:05:00+02:00,2025-05-25,21:05,5,4,9
12,2025-05-25T13:06:00+02:00,2025-05-25,21:06,3,3,6
12,2025-05-25T13:08:00+02:00,2025-05-25,21:08,0,1,1
17,2025-05-25T12:59:00+02:00,2025-05-25,20:59,3,3,6
17,2025-05-25T13:00:00+02:00,2025-05-25,21:00,7,0,7
17,2025-05-25T13:06:00+02:00,2025-05-25,21:06,5,2,7
18,2025-05-25T12:56:00+02:00,2025-05-25,20:56,0,1,1
18,2025-05-25T12:58:00+02:00,2025-05-25,20:58,0,1,1
19,2025-05-25T12:55:00+02:00,2025-05-25,20:55,4,4,8
19,2025-05-25T12:59:00+02:00,2025-05-25,20:59,5,9,14
19,2025-05-25T13:01:00+02:00,2025-05-25,21:01,7,9,16
19,2025-05-25T13:02:00+02:00,2025-05-25,21:02,6,5,11
19,2025-05-25T13:09:00+02:00,2025-05-25,21:09,4,11,15
20,2025-05-25T12:58:00+02:00,2025-05-25,20:58,2,2,4
20,2025-05-25T13:01:00+02:00,2025-05-25,21:01,0,7,7
20,2025-05-25T13:03:00+02:00,2025-05-25,21:03,5,5,10
20,2025-05-25T13:08:00+02:00,2025-05-25,21:08,3,1,4
23,2025-05-25T12:56:00+02:00,2025-05-25,20:56,0,2,2
23,2025-05-25T13:02:00+02:00,2025-05-25,21:02,2,0,2
23,2025-05-25T13:05:00+02:00,2025-05-25,21:05,0,6,6
23,2025-05-25T13:06:00+02:00,2025-05-25,21:06,0,2,2
23,2025-05-25T13:08:00+02:00,2025-05-25,21:08,0,3,3
24,2025-05-25T12:55:00+02:00,2025-05-25,20:55,5,2,7
24,2025-05-25T12:57:00+02:00,2025-05-25,20:57,1,8,9
24,2025-05-25T12:58:00+02:00,2025-05-25,20:58,7,5,12
24,2025-05-25T13:00:00+02:00,2025-05-25,21:00,2,7,9
24,2025-05-25T13:01:00+02:00,2025-05-25,21:01,5,1,6
24,2025-05-25T13:02:00+02:00,2025-05-25,21:02,5,4,9
24,2025-05-25T13:06:00+02:00,2025-05-25,21:06,5,3,8
24,2025-05-25T13:09:00+02:00,2025-05-25,21:09,6,0,6
25,2025-05-25T13:00:00+02:00,2025-05-25,21:00,19,4,23
27,2025-05-25T12:58:00+02:00,2025-05-25,20:58,3,0,3
27,2025-05-25T13:01:00+02:00,2025-05-25,21:01,3,0,3
27,2025-05-25T13:09:00+02:00,2025-05-25,21:09,0,7,7
30,2025-05-25T12:59:00+02:00,2025-05-25,20:59,3,3,6
30,2025-05-25T13:04:00+02:00,2025-05-25,21:04,1,7,8
30,2025-05-25T13:07:00+02:00,2025-05-25,21:07,7,7,14
30,2025-05-25T13:09:00+02:00,2025-05-25,21:09,5,11,16
35,2025-05-25T12:56:00+02:00,2025-05-25,20:56,10,6,16
35,2025-05-25T12:57:00+02:00,2025-05-25,20:57,5,5,10
35,2025-05-25T12:59:00+02:00,2025-05-25,20:59,4,8,12
35,2025-05-25T13:04:00+02:00,2025-05-25,21:04,4,6,10
48,2025-05-25T12:55:00+02:00,2025-05-25,20:55,0,1,1
48,2025-05-25T13:00:00+02:00,2025-05-25,21:00,0,2,2
48,2025-05-25T13:08:00+02:00,2025-05-25,21:08,0,9,9
49,2025-05-25T13:02:00+02:00,2025-05-25,21:02,4,5,9
49,2025-05-25T13:05:00+02:00,2025-05-25,21:05,2,5,7
51,2025-05-25T12:58:00+02:00,2025-05-25,20:58,1,0,1
51,2025-05-25T12:59:00+02:00,2025-05-25,20:59,1,1,2
51,2025-05-25T13:01:00+02:00,2025-05-25,21:01,0,3,3
51,2025-05-25T13:09:00+02:00,2025-05-25,21:09,4,0,4
52,2025-05-25T12:59:00+02:00,2025-05-25,20:59,2,1,3
52,2025-05-25T13:02:00+02:00,2025-05-25,21:02,7,3,10
52,2025-05-25T13:03:00+02:00,2025-05-25,21:03,0,4,4
52,2025-05-25T13:04:00+02:00,2025-05-25,21:04,4,6,10
53,2025-05-25T12:58:00+02:00,2025-05-25,20:58,0,9,9
53,2025-05-25T13:06:00+02:00,2025-05-25,21:06,0,9,9
56,2025-05-25T12:56:00+02:00,2025-05-25,20:56,4,4,8
56,2025-05-25T12:57:00+02:00,2025-05-25,20:57,5,5,10
56,2025-05-25T12:58:00+02:00,2025-05-25,20:58,4,9,13
56,2025-05-25T12:59:00+02:00,2025-05-25,20:59,0,5,5
56,2025-05-25T13:05:00+02:00,2025-05-25,21:05,5,3,8
56,2025-05-25T13:06:00+02:00,2025-05-25,21:06,4,3,7
58,2025-05-25T12:55:00+02:00,2025-05-25,20:55,6,1,7
58,2025-05-25T13:05:00+02:00,2025-05-25,21:05,5,1,6
58,2025-05-25T13:09:00+02:00,2025-05-25,21:09,1,2,3
62,2025-05-25T12:58:00+02:00,2025-05-25,20:58,1,0,1
62,2025-05-25T13:02:00+02:00,2025-05-25,21:02,2,0,2
62,2025-05-25T13:05:00+02:00,2025-05-25,21:05,1,1,2
63,2025-05-25T12:55:00+02:00,2025-05-25,20:55,0,3,3
63,2025-05-25T12:59:00+02:00,2025-05-25,20:59,0,1,1
63,2025-05-25T13:00:00+02:00,2025-05-25,21:00,0,1,1
63,2025-05-25T13:07:00+02:00,2025-05-25,21:07,3,1,4
67,2025-05-25T12:55:00+02:00,2025-05-25,20:55,8,3,11
67,2025-05-25T13:00:00+02:00,2025-05-25,21:00,3,1,4
67,2025-05-25T13:01:00+02:00,2025-05-25,21:01,0,7,7
67,2025-05-25T13:02:00+02:00,2025-05-25,21:02,0,5,5
67,2025-05-25T13:07:00+02:00,2025-05-25,21:07,0,7,7
68,2025-05-25T12:58:00+02:00,2025-05-25,20:58,2,0,2
68,2025-05-25T13:07:00+02:00,2025-05-25,21:07,1,0,1
72,2025-05-25T12:56:00+02:00,2025-05-25,20:56,3,0,3
72,2025-05-25T12:59:00+02:00,2025-05-25,20:59,11,1,12
72,2025-05-25T13:05:00+02:00,2025-05-25,21:05,2,1,3
76,2025-05-25T12:59:00+02:00,2025-05-25,20:59,0,1,1
79,2025-05-25T12:56:00+02:00,2025-05-25,20:56,5,2,7
79,2025-05-25T12:57:00+02:00,2025-05-25,20:57,3,5,8
79,2025-05-25T12:58:00+02:00,2025-05-25,20:58,0,2,2
79,2025-05-25T12:59:00+02:00,2025-05-25,20:59,1,3,4
79,2025-05-25T13:02:00+02:00,2025-05-25,21:02,1,2,3
181,2025-05-24T20:40:00+02:00,2025-05-25,04:40,2,0,2
79,2025-05-25T13:06:00+02:00,2025-05-25,21:06,2,1,3
181,2025-05-24T20:41:00+02:00,2025-05-25,04:41,2,1,3
79,2025-05-25T13:07:00+02:00,2025-05-25,21:07,1,7,8
181,2025-05-24T20:48:00+02:00,2025-05-25,04:48,2,1,3
79,2025-05-25T13:09:00+02:00,2025-05-25,21:09,10,1,11
181,2025-05-24T20:51:00+02:00,2025-05-25,04:51,2,1,3
85,2025-05-25T13:00:00+02:00,2025-05-25,21:00,1,0,1
181,2025-05-24T20:52:00+02:00,2025-05-25,04:52,0,1,1
109,2025-05-25T12:55:00+02:00,2025-05-25,20:55,2,14,16
182,2025-05-24T20:40:00+02:00,2025-05-25,04:40,0,6,6
117,2025-05-25T12:55:00+02:00,2025-05-25,20:55,8,4,12
182,2025-05-24T20:50:00+02:00,2025-05-25,04:50,2,3,5
117,2025-05-25T13:05:00+02:00,2025-05-25,21:05,20,7,27
130,2025-05-25T13:00:00+02:00,2025-05-25,21:00,0,1,1
139,2025-05-25T13:05:00+02:00,2025-05-25,21:05,1,0,1
141,2025-05-25T13:05:00+02:00,2025-05-25,21:05,1,17,18
3,2025-05-24T20:43:00+02:00,2025-05-25,04:43,0,4,4
142,2025-05-25T13:00:00+02:00,2025-05-25,21:00,0,2,2
3,2025-05-24T20:50:00+02:00,2025-05-25,04:50,0,2,2
142,2025-05-25T13:05:00+02:00,2025-05-25,21:05,4,1,5
4,2025-05-24T20:44:00+02:00,2025-05-25,04:44,0,1,1
164,2025-05-25T12:55:00+02:00,2025-05-25,20:55,0,6,6
4,2025-05-24T20:46:00+02:00,2025-05-25,04:46,3,3,6
164,2025-05-25T13:00:00+02:00,2025-05-25,21:00,0,3,3
4,2025-05-24T20:50:00+02:00,2025-05-25,04:50,1,0,1
4,2025-05-24T20:52:00+02:00,2025-05-25,04:52,0,1,1
5,2025-05-24T20:45:00+02:00,2025-05-25,04:45,1,1,2
5,2025-05-24T20:50:00+02:00,2025-05-25,04:50,1,2,3
6,2025-05-24T20:45:00+02:00,2025-05-25,04:45,1,1,2
6,2025-05-24T20:49:00+02:00,2025-05-25,04:49,4,0,4
28,2025-05-24T20:42:00+02:00,2025-05-25,04:42,0,1,1
28,2025-05-24T20:46:00+02:00,2025-05-25,04:46,0,1,1
181,2025-05-25T13:18:00+02:00,2025-05-25,21:18,7,8,15
28,2025-05-24T20:50:00+02:00,2025-05-25,04:50,2,1,3
181,2025-05-25T13:21:00+02:00,2025-05-25,21:21,13,5,18
28,2025-05-24T20:53:00+02:00,2025-05-25,04:53,0,1,1
181,2025-05-25T13:23:00+02:00,2025-05-25,21:23,16,4,20
31,2025-05-24T20:49:00+02:00,2025-05-25,04:49,1,0,1
31,2025-05-24T20:50:00+02:00,2025-05-25,04:50,7,0,7
36,2025-05-24T20:47:00+02:00,2025-05-25,04:47,0,1,1
36,2025-05-24T20:53:00+02:00,2025-05-25,04:53,1,0,1
41,2025-05-24T20:47:00+02:00,2025-05-25,04:47,0,2,2
41,2025-05-24T20:52:00+02:00,2025-05-25,04:52,0,3,3
45,2025-05-24T20:42:00+02:00,2025-05-25,04:42,0,2,2
47,2025-05-24T20:43:00+02:00,2025-05-25,04:43,0,1,1
47,2025-05-24T20:45:00+02:00,2025-05-25,04:45,0,2,2
47,2025-05-24T20:50:00+02:00,2025-05-25,04:50,0,5,5
66,2025-05-24T20:51:00+02:00,2025-05-25,04:51,3,0,3
71,2025-05-24T20:49:00+02:00,2025-05-25,04:49,0,1,1
84,2025-05-24T20:50:00+02:00,2025-05-25,04:50,1,3,4
107,2025-05-24T20:45:00+02:00,2025-05-25,04:45,2,0,2
108,2025-05-24T20:47:00+02:00,2025-05-25,04:47,1,0,1
108,2025-05-24T20:48:00+02:00,2025-05-25,04:48,0,2,2
133,2025-05-24T20:40:00+02:00,2025-05-25,04:40,0,1,1
133,2025-05-24T20:45:00+02:00,2025-05-25,04:45,1,4,5
135,2025-05-24T20:50:00+02:00,2025-05-25,04:50,1,1,2
162,2025-05-24T20:40:00+02:00,2025-05-25,04:40,1,0,1
162,2025-05-24T20:45:00+02:00,2025-05-25,04:45,2,7,9
162,2025-05-24T20:50:00+02:00,2025-05-25,04:50,1,0,1
167,2025-05-24T20:45:00+02:00,2025-05-25,04:45,1,1,2
1,2025-05-24T20:45:00+02:00,2025-05-25,04:45,0,1,1
10,2025-05-24T20:50:00+02:00,2025-05-25,04:50,1,0,1
17,2025-05-24T20:52:00+02:00,2025-05-25,04:52,0,1,1
19,2025-05-24T20:42:00+02:00,2025-05-25,04:42,0,2,2
20,2025-05-24T20:40:00+02:00,2025-05-25,04:40,2,0,2
20,2025-05-24T20:41:00+02:00,2025-05-25,04:41,0,2,2
20,2025-05-24T20:42:00+02:00,2025-05-25,04:42,0,2,2
20,2025-05-24T20:50:00+02:00,2025-05-25,04:50,0,4,4
20,2025-05-24T20:51:00+02:00,2025-05-25,04:51,0,3,3
23,2025-05-24T20:40:00+02:00,2025-05-25,04:40,0,2,2
24,2025-05-24T20:47:00+02:00,2025-05-25,04:47,1,0,1
24,2025-05-24T20:49:00+02:00,2025-05-25,04:49,0,2,2
24,2025-05-24T20:51:00+02:00,2025-05-25,04:51,1,1,2
25,2025-05-24T20:40:00+02:00,2025-05-25,04:40,0,1,1
25,2025-05-24T20:45:00+02:00,2025-05-25,04:45,0,1,1
30,2025-05-24T20:44:00+02:00,2025-05-25,04:44,1,1,2
30,2025-05-24T20:45:00+02:00,2025-05-25,04:45,3,4,7
30,2025-05-24T20:46:00+02:00,2025-05-25,04:46,1,3,4
30,2025-05-24T20:48:00+02:00,2025-05-25,04:48,1,0,1
35,2025-05-24T20:43:00+02:00,2025-05-25,04:43,1,0,1
35,2025-05-24T20:46:00+02:00,2025-05-25,04:46,0,1,1
49,2025-05-24T20:47:00+02:00,2025-05-25,04:47,0,2,2
52,2025-05-24T20:40:00+02:00,2025-05-25,04:40,3,0,3
52,2025-05-24T20:43:00+02:00,2025-05-25,04:43,1,0,1
181,2025-05-25T13:35:00+02:00,2025-05-25,21:35,6,8,14
52,2025-05-24T20:47:00+02:00,2025-05-25,04:47,1,0,1
182,2025-05-25T13:30:00+02:00,2025-05-25,21:30,17,18,35
52,2025-05-24T20:49:00+02:00,2025-05-25,04:49,1,0,1
182,2025-05-25T13:35:00+02:00,2025-05-25,21:35,10,13,23
52,2025-05-24T20:52:00+02:00,2025-05-25,04:52,1,0,1
3,2025-05-25T12:42:00+02:00,2025-05-25,20:42,21,5,26
52,2025-05-24T20:53:00+02:00,2025-05-25,04:53,2,0,2
3,2025-05-25T12:48:00+02:00,2025-05-25,20:48,13,2,15
56,2025-05-24T20:52:00+02:00,2025-05-25,04:52,3,0,3
4,2025-05-25T12:40:00+02:00,2025-05-25,20:40,6,6,12
58,2025-05-24T20:46:00+02:00,2025-05-25,04:46,0,1,1
4,2025-05-25T12:45:00+02:00,2025-05-25,20:45,9,11,20
58,2025-05-24T20:51:00+02:00,2025-05-25,04:51,0,1,1
4,2025-05-25T12:46:00+02:00,2025-05-25,20:46,25,9,34
62,2025-05-24T20:51:00+02:00,2025-05-25,04:51,1,0,1
4,2025-05-25T12:47:00+02:00,2025-05-25,20:47,7,13,20
68,2025-05-24T20:49:00+02:00,2025-05-25,04:49,2,0,2
4,2025-05-25T12:51:00+02:00,2025-05-25,20:51,9,27,36
79,2025-05-24T20:46:00+02:00,2025-05-25,04:46,1,1,2
5,2025-05-25T12:50:00+02:00,2025-05-25,20:50,13,48,61
79,2025-05-24T20:51:00+02:00,2025-05-25,04:51,0,3,3
6,2025-05-25T12:47:00+02:00,2025-05-25,20:47,6,5,11
141,2025-05-24T20:45:00+02:00,2025-05-25,04:45,7,1,8
6,2025-05-25T12:49:00+02:00,2025-05-25,20:49,12,7,19
6,2025-05-25T12:50:00+02:00,2025-05-25,20:50,4,10,14
6,2025-05-25T12:53:00+02:00,2025-05-25,20:53,3,13,16
6,2025-05-25T12:54:00+02:00,2025-05-25,20:54,7,3,10
8,2025-05-25T12:43:00+02:00,2025-05-25,20:43,1,1,2
21,2025-05-25T12:45:00+02:00,2025-05-25,20:45,11,30,41
28,2025-05-25T12:43:00+02:00,2025-05-25,20:43,0,1,1
28,2025-05-25T12:47:00+02:00,2025-05-25,20:47,4,1,5
28,2025-05-25T12:53:00+02:00,2025-05-25,20:53,1,3,4
29,2025-05-25T12:40:00+02:00,2025-05-25,20:40,0,5,5
29,2025-05-25T12:43:00+02:00,2025-05-25,20:43,0,3,3
29,2025-05-25T12:46:00+02:00,2025-05-25,20:46,5,3,8
29,2025-05-25T12:48:00+02:00,2025-05-25,20:48,0,4,4
29,2025-05-25T12:52:00+02:00,2025-05-25,20:52,0,6,6
31,2025-05-25T12:40:00+02:00,2025-05-25,20:40,7,4,11
31,2025-05-25T12:41:00+02:00,2025-05-25,20:41,3,1,4
31,2025-05-25T12:44:00+02:00,2025-05-25,20:44,6,2,8
31,2025-05-25T12:45:00+02:00,2025-05-25,20:45,0,5,5
31,2025-05-25T12:48:00+02:00,2025-05-25,20:48,1,5,6
31,2025-05-25T12:51:00+02:00,2025-05-25,20:51,7,2,9
36,2025-05-25T12:46:00+02:00,2025-05-25,20:46,1,4,5
36,2025-05-25T12:48:00+02:00,2025-05-25,20:48,1,0,1
36,2025-05-25T12:49:00+02:00,2025-05-25,20:49,0,5,5
36,2025-05-25T12:52:00+02:00,2025-05-25,20:52,6,1,7
36,2025-05-25T12:53:00+02:00,2025-05-25,20:53,1,0,1
40,2025-05-25T12:44:00+02:00,2025-05-25,20:44,1,0,1
40,2025-05-25T12:46:00+02:00,2025-05-25,20:46,2,0,2
40,2025-05-25T12:47:00+02:00,2025-05-25,20:47,1,1,2
40,2025-05-25T12:49:00+02:00,2025-05-25,20:49,1,0,1
40,2025-05-25T12:51:00+02:00,2025-05-25,20:51,1,0,1
41,2025-05-25T12:40:00+02:00,2025-05-25,20:40,2,0,2
41,2025-05-25T12:45:00+02:00,2025-05-25,20:45,3,0,3
41,2025-05-25T12:47:00+02:00,2025-05-25,20:47,0,1,1
41,2025-05-25T12:50:00+02:00,2025-05-25,20:50,0,1,1
41,2025-05-25T12:52:00+02:00,2025-05-25,20:52,2,2,4
41,2025-05-25T12:53:00+02:00,2025-05-25,20:53,1,8,9
43,2025-05-25T12:45:00+02:00,2025-05-25,20:45,2,1,3
45,2025-05-25T12:41:00+02:00,2025-05-25,20:41,3,8,11
45,2025-05-25T12:42:00+02:00,2025-05-25,20:42,6,21,27
45,2025-05-25T12:43:00+02:00,2025-05-25,20:43,5,8,13
45,2025-05-25T12:49:00+02:00,2025-05-25,20:49,9,7,16
45,2025-05-25T12:53:00+02:00,2025-05-25,20:53,5,9,14
47,2025-05-25T12:40:00+02:00,2025-05-25,20:40,4,20,24
47,2025-05-25T12:41:00+02:00,2025-05-25,20:41,9,2,11
47,2025-05-25T12:42:00+02:00,2025-05-25,20:42,11,17,28
47,2025-05-25T12:44:00+02:00,2025-05-25,20:44,11,1,12
47,2025-05-25T12:47:00+02:00,2025-05-25,20:47,3,4,7
47,2025-05-25T12:50:00+02:00,2025-05-25,20:50,2,3,5
47,2025-05-25T12:53:00+02:00,2025-05-25,20:53,5,6,11
47,2025-05-25T12:54:00+02:00,2025-05-25,20:54,11,4,15
50,2025-05-25T12:40:00+02:00,2025-05-25,20:40,2,3,5
50,2025-05-25T12:42:00+02:00,2025-05-25,20:42,2,0,2
50,2025-05-25T12:43:00+02:00,2025-05-25,20:43,0,3,3
50,2025-05-25T12:44:00+02:00,2025-05-25,20:44,5,5,10
50,2025-05-25T12:46:00+02:00,2025-05-25,20:46,4,0,4
50,2025-05-25T12:48:00+02:00,2025-05-25,20:48,5,0,5
50,2025-05-25T12:51:00+02:00,2025-05-25,20:51,3,3,6
50,2025-05-25T12:54:00+02:00,2025-05-25,20:54,2,6,8
54,2025-05-25T12:46:00+02:00,2025-05-25,20:46,4,1,5
54,2025-05-25T12:50:00+02:00,2025-05-25,20:50,3,1,4
59,2025-05-25T12:40:00+02:00,2025-05-25,20:40,19,25,44
61,2025-05-25T12:41:00+02:00,2025-05-25,20:41,5,1,6
61,2025-05-25T12:42:00+02:00,2025-05-25,20:42,2,0,2
61,2025-05-25T12:53:00+02:00,2025-05-25,20:53,1,3,4
61,2025-05-25T12:54:00+02:00,2025-05-25,20:54,10,2,12
66,2025-05-25T12:43:00+02:00,2025-05-25,20:43,13,5,18
66,2025-05-25T12:50:00+02:00,2025-05-25,20:50,31,4,35
69,2025-05-25T12:40:00+02:00,2025-05-25,20:40,2,1,3
69,2025-05-25T12:46:00+02:00,2025-05-25,20:46,1,1,2
69,2025-05-25T12:48:00+02:00,2025-05-25,20:48,0,1,1
70,2025-05-25T12:40:00+02:00,2025-05-25,20:40,1,3,4
70,2025-05-25T12:46:00+02:00,2025-05-25,20:46,1,0,1
77,2025-05-25T12:40:00+02:00,2025-05-25,20:40,15,12,27
77,2025-05-25T12:45:00+02:00,2025-05-25,20:45,12,12,24
78,2025-05-25T12:49:00+02:00,2025-05-25,20:49,0,1,1
84,2025-05-25T12:40:00+02:00,2025-05-25,20:40,36,42,78
87,2025-05-25T12:43:00+02:00,2025-05-25,20:43,0,1,1
107,2025-05-25T12:45:00+02:00,2025-05-25,20:45,3,3,6
108,2025-05-25T12:42:00+02:00,2025-05-25,20:42,2,0,2
108,2025-05-25T12:44:00+02:00,2025-05-25,20:44,3,0,3
108,2025-05-25T12:45:00+02:00,2025-05-25,20:45,1,3,4
108,2025-05-25T12:51:00+02:00,2025-05-25,20:51,0,1,1
118,2025-05-25T12:40:00+02:00,2025-05-25,20:40,1,0,1
131,2025-05-25T12:45:00+02:00,2025-05-25,20:45,2,1,3
131,2025-05-25T12:50:00+02:00,2025-05-25,20:50,1,5,6
133,2025-05-25T12:40:00+02:00,2025-05-25,20:40,27,15,42
134,2025-05-25T12:40:00+02:00,2025-05-25,20:40,21,17,38
135,2025-05-25T12:45:00+02:00,2025-05-25,20:45,2,10,12
162,2025-05-25T12:45:00+02:00,2025-05-25,20:45,9,9,18
162,2025-05-25T12:50:00+02:00,2025-05-25,20:50,12,7,19
165,2025-05-25T12:50:00+02:00,2025-05-25,20:50,2,0,2
166,2025-05-25T12:45:00+02:00,2025-05-25,20:45,0,1,1
167,2025-05-25T12:40:00+02:00,2025-05-25,20:40,1,1,2
167,2025-05-25T12:45:00+02:00,2025-05-25,20:45,1,3,4
179,2025-05-25T12:45:00+02:00,2025-05-25,20:45,7,3,10
1,2025-05-25T12:40:00+02:00,2025-05-25,20:40,4,3,7
1,2025-05-25T12:43:00+02:00,2025-05-25,20:43,9,10,19
1,2025-05-25T12:46:00+02:00,2025-05-25,20:46,7,3,10
1,2025-05-25T12:49:00+02:00,2025-05-25,20:49,2,4,6
2,2025-05-25T12:49:00+02:00,2025-05-25,20:49,0,2,2
9,2025-05-25T12:40:00+02:00,2025-05-25,20:40,1,0,1
9,2025-05-25T12:43:00+02:00,2025-05-25,20:43,1,0,1
9,2025-05-25T12:45:00+02:00,2025-05-25,20:45,2,0,2
9,2025-05-25T12:47:00+02:00,2025-05-25,20:47,0,1,1
9,2025-05-25T12:50:00+02:00,2025-05-25,20:50,1,0,1
10,2025-05-25T12:44:00+02:00,2025-05-25,20:44,2,0,2
10,2025-05-25T12:49:00+02:00,2025-05-25,20:49,2,0,2
11,2025-05-25T12:45:00+02:00,2025-05-25,20:45,1,2,3
11,2025-05-25T12:50:00+02:00,2025-05-25,20:50,3,1,4
12,2025-05-25T12:40:00+02:00,2025-05-25,20:40,0,3,3
12,2025-05-25T12:44:00+02:00,2025-05-25,20:44,0,2,2
12,2025-05-25T12:53:00+02:00,2025-05-25,20:53,1,0,1
12,2025-05-25T12:54:00+02:00,2025-05-25,20:54,0,4,4
17,2025-05-25T12:46:00+02:00,2025-05-25,20:46,2,0,2
18,2025-05-25T12:43:00+02:00,2025-05-25,20:43,2,0,2
18,2025-05-25T12:48:00+02:00,2025-05-25,20:48,1,0,1
18,2025-05-25T12:54:00+02:00,2025-05-25,20:54,0,2,2
19,2025-05-25T12:47:00+02:00,2025-05-25,20:47,4,4,8
19,2025-05-25T12:48:00+02:00,2025-05-25,20:48,1,16,17
19,2025-05-25T12:54:00+02:00,2025-05-25,20:54,1,8,9
20,2025-05-25T12:41:00+02:00,2025-05-25,20:41,2,7,9
20,2025-05-25T12:42:00+02:00,2025-05-25,20:42,6,13,19
20,2025-05-25T12:43:00+02:00,2025-05-25,20:43,4,10,14
20,2025-05-25T12:46:00+02:00,2025-05-25,20:46,7,3,10
20,2025-05-25T12:48:00+02:00,2025-05-25,20:48,1,9,10
20,2025-05-25T12:51:00+02:00,2025-05-25,20:51,6,3,9
23,2025-05-25T12:40:00+02:00,2025-05-25,20:40,1,0,1
23,2025-05-25T12:43:00+02:00,2025-05-25,20:43,4,1,5
23,2025-05-25T12:45:00+02:00,2025-05-25,20:45,4,0,4
23,2025-05-25T12:51:00+02:00,2025-05-25,20:51,5,2,7
23,2025-05-25T12:52:00+02:00,2025-05-25,20:52,4,1,5
24,2025-05-25T12:40:00+02:00,2025-05-25,20:40,0,8,8
24,2025-05-25T12:43:00+02:00,2025-05-25,20:43,1,9,10
24,2025-05-25T12:45:00+02:00,2025-05-25,20:45,5,1,6
25,2025-05-25T12:40:00+02:00,2025-05-25,20:40,15,17,32
25,2025-05-25T12:45:00+02:00,2025-05-25,20:45,14,16,30
27,2025-05-25T12:41:00+02:00,2025-05-25,20:41,2,0,2
27,2025-05-25T12:42:00+02:00,2025-05-25,20:42,1,0,1
27,2025-05-25T12:46:00+02:00,2025-05-25,20:46,0,1,1
27,2025-05-25T12:47:00+02:00,2025-05-25,20:47,0,3,3
27,2025-05-25T12:50:00+02:00,2025-05-25,20:50,5,0,5
30,2025-05-25T12:40:00+02:00,2025-05-25,20:40,3,14,17
30,2025-05-25T12:41:00+02:00,2025-05-25,20:41,5,9,14
30,2025-05-25T12:45:00+02:00,2025-05-25,20:45,0,3,3
35,2025-05-25T12:48:00+02:00,2025-05-25,20:48,2,4,6
35,2025-05-25T12:54:00+02:00,2025-05-25,20:54,7,12,19
48,2025-05-25T12:49:00+02:00,2025-05-25,20:49,1,0,1
48,2025-05-25T12:50:00+02:00,2025-05-25,20:50,4,2,6
48,2025-05-25T12:51:00+02:00,2025-05-25,20:51,0,2,2
48,2025-05-25T12:54:00+02:00,2025-05-25,20:54,1,4,5
49,2025-05-25T12:40:00+02:00,2025-05-25,20:40,1,3,4
49,2025-05-25T12:43:00+02:00,2025-05-25,20:43,0,4,4
49,2025-05-25T12:45:00+02:00,2025-05-25,20:45,1,3,4
49,2025-05-25T12:53:00+02:00,2025-05-25,20:53,2,3,5
51,2025-05-25T12:41:00+02:00,2025-05-25,20:41,0,1,1
51,2025-05-25T12:44:00+02:00,2025-05-25,20:44,1,5,6
51,2025-05-25T12:51:00+02:00,2025-05-25,20:51,1,0,1
51,2025-05-25T12:54:00+02:00,2025-05-25,20:54,2,0,2
52,2025-05-25T12:41:00+02:00,2025-05-25,20:41,4,4,8
52,2025-05-25T12:42:00+02:00,2025-05-25,20:42,2,5,7
52,2025-05-25T12:48:00+02:00,2025-05-25,20:48,0,7,7
52,2025-05-25T12:53:00+02:00,2025-05-25,20:53,4,10,14
53,2025-05-25T12:40:00+02:00,2025-05-25,20:40,0,2,2
53,2025-05-25T12:41:00+02:00,2025-05-25,20:41,1,0,1
53,2025-05-25T12:44:00+02:00,2025-05-25,20:44,1,2,3
53,2025-05-25T12:47:00+02:00,2025-05-25,20:47,3,1,4
53,2025-05-25T12:53:00+02:00,2025-05-25,20:53,0,5,5
56,2025-05-25T12:42:00+02:00,2025-05-25,20:42,4,13,17
56,2025-05-25T12:46:00+02:00,2025-05-25,20:46,2,4,6
56,2025-05-25T12:47:00+02:00,2025-05-25,20:47,1,3,4
56,2025-05-25T12:48:00+02:00,2025-05-25,20:48,6,0,6
56,2025-05-25T12:49:00+02:00,2025-05-25,20:49,5,5,10
56,2025-05-25T12:50:00+02:00,2025-05-25,20:50,2,9,11
56,2025-05-25T12:51:00+02:00,2025-05-25,20:51,1,15,16
58,2025-05-25T12:46:00+02:00,2025-05-25,20:46,5,1,6
58,2025-05-25T12:50:00+02:00,2025-05-25,20:50,1,0,1
58,2025-05-25T12:51:00+02:00,2025-05-25,20:51,1,3,4
58,2025-05-25T12:52:00+02:00,2025-05-25,20:52,6,2,8
58,2025-05-25T12:53:00+02:00,2025-05-25,20:53,0,8,8
3,2025-05-24T20:56:00+02:00,2025-05-25,04:56,0,1,1
62,2025-05-25T12:40:00+02:00,2025-05-25,20:40,0,1,1
3,2025-05-24T20:59:00+02:00,2025-05-25,04:59,0,1,1
62,2025-05-25T12:41:00+02:00,2025-05-25,20:41,2,2,4
3,2025-05-24T21:01:00+02:00,2025-05-25,05:01,0,4,4
62,2025-05-25T12:48:00+02:00,2025-05-25,20:48,3,1,4
3,2025-05-24T21:03:00+02:00,2025-05-25,05:03,4,0,4
62,2025-05-25T12:54:00+02:00,2025-05-25,20:54,5,0,5
3,2025-05-24T21:08:00+02:00,2025-05-25,05:08,0,2,2
63,2025-05-25T12:40:00+02:00,2025-05-25,20:40,1,3,4
4,2025-05-24T21:02:00+02:00,2025-05-25,05:02,0,1,1
63,2025-05-25T12:46:00+02:00,2025-05-25,20:46,0,2,2
4,2025-05-24T21:04:00+02:00,2025-05-25,05:04,4,0,4
63,2025-05-25T12:48:00+02:00,2025-05-25,20:48,0,2,2
4,2025-05-24T21:07:00+02:00,2025-05-25,05:07,0,3,3
63,2025-05-25T12:50:00+02:00,2025-05-25,20:50,0,3,3
6,2025-05-24T20:55:00+02:00,2025-05-25,04:55,0,4,4
63,2025-05-25T12:54:00+02:00,2025-05-25,20:54,0,2,2
6,2025-05-24T20:56:00+02:00,2025-05-25,04:56,0,1,1
67,2025-05-25T12:41:00+02:00,2025-05-25,20:41,2,2,4
6,2025-05-24T20:57:00+02:00,2025-05-25,04:57,2,0,2
67,2025-05-25T12:43:00+02:00,2025-05-25,20:43,2,4,6
6,2025-05-24T21:00:00+02:00,2025-05-25,05:00,2,2,4
67,2025-05-25T12:45:00+02:00,2025-05-25,20:45,4,1,5
6,2025-05-24T21:08:00+02:00,2025-05-25,05:08,2,0,2
67,2025-05-25T12:46:00+02:00,2025-05-25,20:46,0,3,3
29,2025-05-24T20:57:00+02:00,2025-05-25,04:57,0,2,2
68,2025-05-25T12:40:00+02:00,2025-05-25,20:40,1,0,1
36,2025-05-24T20:57:00+02:00,2025-05-25,04:57,2,0,2
68,2025-05-25T12:41:00+02:00,2025-05-25,20:41,1,0,1
36,2025-05-24T21:04:00+02:00,2025-05-25,05:04,0,1,1
68,2025-05-25T12:43:00+02:00,2025-05-25,20:43,1,0,1
37,2025-05-24T21:09:00+02:00,2025-05-25,05:09,0,3,3
68,2025-05-25T12:47:00+02:00,2025-05-25,20:47,4,7,11
40,2025-05-24T21:07:00+02:00,2025-05-25,05:07,1,0,1
72,2025-05-25T12:42:00+02:00,2025-05-25,20:42,2,3,5
41,2025-05-24T20:56:00+02:00,2025-05-25,04:56,2,4,6
72,2025-05-25T12:43:00+02:00,2025-05-25,20:43,3,1,4
41,2025-05-24T20:57:00+02:00,2025-05-25,04:57,3,0,3
72,2025-05-25T12:47:00+02:00,2025-05-25,20:47,0,1,1
41,2025-05-24T21:02:00+02:00,2025-05-25,05:02,1,1,2
72,2025-05-25T12:49:00+02:00,2025-05-25,20:49,6,3,9
41,2025-05-24T21:05:00+02:00,2025-05-25,05:05,2,3,5
72,2025-05-25T12:52:00+02:00,2025-05-25,20:52,4,1,5
45,2025-05-24T20:57:00+02:00,2025-05-25,04:57,1,0,1
79,2025-05-25T12:40:00+02:00,2025-05-25,20:40,4,2,6
54,2025-05-24T20:55:00+02:00,2025-05-25,04:55,0,1,1
79,2025-05-25T12:44:00+02:00,2025-05-25,20:44,6,1,7
54,2025-05-24T20:56:00+02:00,2025-05-25,04:56,1,0,1
79,2025-05-25T12:47:00+02:00,2025-05-25,20:47,2,2,4
59,2025-05-24T20:55:00+02:00,2025-05-25,04:55,6,0,6
79,2025-05-25T12:49:00+02:00,2025-05-25,20:49,2,5,7
66,2025-05-24T20:58:00+02:00,2025-05-25,04:58,2,0,2
79,2025-05-25T12:50:00+02:00,2025-05-25,20:50,5,2,7
66,2025-05-24T21:03:00+02:00,2025-05-25,05:03,0,1,1
85,2025-05-25T12:50:00+02:00,2025-05-25,20:50,1,0,1
84,2025-05-24T20:55:00+02:00,2025-05-25,04:55,3,12,15
86,2025-05-25T12:43:00+02:00,2025-05-25,20:43,1,0,1
87,2025-05-24T21:03:00+02:00,2025-05-25,05:03,0,1,1
86,2025-05-25T12:49:00+02:00,2025-05-25,20:49,0,1,1
108,2025-05-24T20:59:00+02:00,2025-05-25,04:59,2,2,4
117,2025-05-25T12:45:00+02:00,2025-05-25,20:45,12,5,17
131,2025-05-24T21:05:00+02:00,2025-05-25,05:05,1,3,4
117,2025-05-25T12:50:00+02:00,2025-05-25,20:50,8,1,9
132,2025-05-24T21:00:00+02:00,2025-05-25,05:00,1,0,1
137,2025-05-25T12:50:00+02:00,2025-05-25,20:50,0,1,1
133,2025-05-24T20:55:00+02:00,2025-05-25,04:55,1,5,6
139,2025-05-25T12:45:00+02:00,2025-05-25,20:45,3,0,3
133,2025-05-24T21:00:00+02:00,2025-05-25,05:00,3,1,4
141,2025-05-25T12:40:00+02:00,2025-05-25,20:40,0,2,2
133,2025-05-24T21:05:00+02:00,2025-05-25,05:05,3,5,8
134,2025-05-24T20:55:00+02:00,2025-05-25,04:55,3,1,4
135,2025-05-24T20:55:00+02:00,2025-05-25,04:55,5,1,6
162,2025-05-24T21:00:00+02:00,2025-05-25,05:00,2,2,4
162,2025-05-24T21:05:00+02:00,2025-05-25,05:05,3,0,3
167,2025-05-24T20:55:00+02:00,2025-05-25,04:55,0,1,1
167,2025-05-24T21:00:00+02:00,2025-05-25,05:00,1,3,4
1,2025-05-24T21:09:00+02:00,2025-05-25,05:09,0,2,2
19,2025-05-24T21:01:00+02:00,2025-05-25,05:01,1,3,4
20,2025-05-24T20:55:00+02:00,2025-05-25,04:55,2,7,9
20,2025-05-24T20:58:00+02:00,2025-05-25,04:58,1,2,3
20,2025-05-24T21:00:00+02:00,2025-05-25,05:00,2,0,2
24,2025-05-24T21:05:00+02:00,2025-05-25,05:05,1,0,1
181,2025-05-25T12:40:00+02:00,2025-05-25,20:40,6,8,14
25,2025-05-24T20:55:00+02:00,2025-05-25,04:55,2,0,2
181,2025-05-25T12:43:00+02:00,2025-05-25,20:43,3,14,17
27,2025-05-24T21:06:00+02:00,2025-05-25,05:06,7,0,7
181,2025-05-25T12:44:00+02:00,2025-05-25,20:44,10,17,27
30,2025-05-24T20:55:00+02:00,2025-05-25,04:55,0,5,5
181,2025-05-25T12:46:00+02:00,2025-05-25,20:46,10,5,15
30,2025-05-24T21:00:00+02:00,2025-05-25,05:00,1,8,9
181,2025-05-25T12:48:00+02:00,2025-05-25,20:48,7,14,21
30,2025-05-24T21:03:00+02:00,2025-05-25,05:03,1,6,7
182,2025-05-25T12:40:00+02:00,2025-05-25,20:40,35,19,54
35,2025-05-24T20:58:00+02:00,2025-05-25,04:58,0,1,1
182,2025-05-25T12:45:00+02:00,2025-05-25,20:45,9,11,20
35,2025-05-24T20:59:00+02:00,2025-05-25,04:59,0,3,3
182,2025-05-25T12:50:00+02:00,2025-05-25,20:50,17,7,24
35,2025-05-24T21:02:00+02:00,2025-05-25,05:02,0,2,2
49,2025-05-24T20:56:00+02:00,2025-05-25,04:56,0,2,2
49,2025-05-24T20:59:00+02:00,2025-05-25,04:59,2,0,2
181,2025-05-25T12:56:00+02:00,2025-05-25,20:56,10,5,15
49,2025-05-24T21:00:00+02:00,2025-05-25,05:00,2,3,5
181,2025-05-25T13:02:00+02:00,2025-05-25,21:02,3,9,12
49,2025-05-24T21:02:00+02:00,2025-05-25,05:02,3,1,4
181,2025-05-25T13:05:00+02:00,2025-05-25,21:05,9,12,21
49,2025-05-24T21:04:00+02:00,2025-05-25,05:04,2,2,4
181,2025-05-25T13:07:00+02:00,2025-05-25,21:07,5,14,19
49,2025-05-24T21:07:00+02:00,2025-05-25,05:07,0,1,1
181,2025-05-25T13:09:00+02:00,2025-05-25,21:09,9,9,18
51,2025-05-24T20:55:00+02:00,2025-05-25,04:55,2,0,2
182,2025-05-25T12:55:00+02:00,2025-05-25,20:55,14,29,43
51,2025-05-24T20:57:00+02:00,2025-05-25,04:57,1,0,1
3,2025-05-25T12:26:00+02:00,2025-05-25,20:26,12,16,28
52,2025-05-24T20:57:00+02:00,2025-05-25,04:57,0,2,2
3,2025-05-25T12:27:00+02:00,2025-05-25,20:27,10,18,28
52,2025-05-24T20:59:00+02:00,2025-05-25,04:59,0,6,6
3,2025-05-25T12:29:00+02:00,2025-05-25,20:29,6,6,12
52,2025-05-24T21:01:00+02:00,2025-05-25,05:01,2,0,2
3,2025-05-25T12:30:00+02:00,2025-05-25,20:30,6,7,13
56,2025-05-24T20:59:00+02:00,2025-05-25,04:59,0,1,1
3,2025-05-25T12:33:00+02:00,2025-05-25,20:33,16,17,33
72,2025-05-24T21:03:00+02:00,2025-05-25,05:03,0,2,2
3,2025-05-25T12:37:00+02:00,2025-05-25,20:37,19,5,24
72,2025-05-24T21:05:00+02:00,2025-05-25,05:05,0,1,1
3,2025-05-25T12:39:00+02:00,2025-05-25,20:39,5,16,21
79,2025-05-24T20:57:00+02:00,2025-05-25,04:57,0,1,1
4,2025-05-25T12:26:00+02:00,2025-05-25,20:26,5,18,23
79,2025-05-24T21:00:00+02:00,2025-05-25,05:00,0,1,1
4,2025-05-25T12:28:00+02:00,2025-05-25,20:28,6,9,15
79,2025-05-24T21:08:00+02:00,2025-05-25,05:08,0,2,2
4,2025-05-25T12:32:00+02:00,2025-05-25,20:32,14,12,26
142,2025-05-24T20:55:00+02:00,2025-05-25,04:55,0,1,1
5,2025-05-25T12:25:00+02:00,2025-05-25,20:25,33,50,83
5,2025-05-25T12:35:00+02:00,2025-05-25,20:35,13,41,54
6,2025-05-25T12:26:00+02:00,2025-05-25,20:26,4,8,12
6,2025-05-25T12:27:00+02:00,2025-05-25,20:27,16,3,19
6,2025-05-25T12:29:00+02:00,2025-05-25,20:29,2,3,5
6,2025-05-25T12:33:00+02:00,2025-05-25,20:33,3,3,6
6,2025-05-25T12:35:00+02:00,2025-05-25,20:35,6,11,17
8,2025-05-25T12:38:00+02:00,2025-05-25,20:38,1,0,1
21,2025-05-25T12:35:00+02:00,2025-05-25,20:35,23,30,53
181,2025-05-24T20:55:00+02:00,2025-05-25,04:55,1,0,1
28,2025-05-25T12:26:00+02:00,2025-05-25,20:26,3,1,4
181,2025-05-24T21:02:00+02:00,2025-05-25,05:02,0,1,1
28,2025-05-25T12:30:00+02:00,2025-05-25,20:30,4,1,5
181,2025-05-24T21:06:00+02:00,2025-05-25,05:06,0,2,2
28,2025-05-25T12:32:00+02:00,2025-05-25,20:32,4,2,6
181,2025-05-24T21:09:00+02:00,2025-05-25,05:09,1,0,1
28,2025-05-25T12:34:00+02:00,2025-05-25,20:34,1,1,2
182,2025-05-24T21:00:00+02:00,2025-05-25,05:00,3,5,8
28,2025-05-25T12:35:00+02:00,2025-05-25,20:35,2,1,3
182,2025-05-24T21:05:00+02:00,2025-05-25,05:05,4,9,13
28,2025-05-25T12:36:00+02:00,2025-05-25,20:36,1,2,3
28,2025-05-25T12:39:00+02:00,2025-05-25,20:39,1,2,3
29,2025-05-25T12:27:00+02:00,2025-05-25,20:27,4,4,8
29,2025-05-25T12:28:00+02:00,2025-05-25,20:28,0,4,4
29,2025-05-25T12:30:00+02:00,2025-05-25,20:30,3,1,4
29,2025-05-25T12:35:00+02:00,2025-05-25,20:35,2,0,2
29,2025-05-25T12:36:00+02:00,2025-05-25,20:36,3,2,5
31,2025-05-25T12:25:00+02:00,2025-05-25,20:25,4,3,7
31,2025-05-25T12:28:00+02:00,2025-05-25,20:28,5,2,7
31,2025-05-25T12:33:00+02:00,2025-05-25,20:33,3,0,3
31,2025-05-25T12:34:00+02:00,2025-05-25,20:34,0,1,1
31,2025-05-25T12:35:00+02:00,2025-05-25,20:35,4,4,8
31,2025-05-25T12:36:00+02:00,2025-05-25,20:36,2,7,9
181,2025-05-24T21:12:00+02:00,2025-05-25,05:12,0,1,1
31,2025-05-25T12:37:00+02:00,2025-05-25,20:37,3,2,5
181,2025-05-24T21:15:00+02:00,2025-05-25,05:15,1,3,4
39,2025-05-25T12:25:00+02:00,2025-05-25,20:25,1,0,1
181,2025-05-24T21:16:00+02:00,2025-05-25,05:16,1,0,1
39,2025-05-25T12:37:00+02:00,2025-05-25,20:37,1,0,1
181,2025-05-24T21:18:00+02:00,2025-05-25,05:18,2,0,2
40,2025-05-25T12:27:00+02:00,2025-05-25,20:27,0,2,2
181,2025-05-24T21:19:00+02:00,2025-05-25,05:19,3,0,3
40,2025-05-25T12:33:00+02:00,2025-05-25,20:33,1,0,1
181,2025-05-24T21:21:00+02:00,2025-05-25,05:21,8,0,8
40,2025-05-25T12:35:00+02:00,2025-05-25,20:35,1,2,3
182,2025-05-24T21:20:00+02:00,2025-05-25,05:20,3,6,9
41,2025-05-25T12:27:00+02:00,2025-05-25,20:27,7,0,7
3,2025-05-24T21:10:00+02:00,2025-05-25,05:10,1,1,2
41,2025-05-25T12:29:00+02:00,2025-05-25,20:29,0,1,1
3,2025-05-24T21:15:00+02:00,2025-05-25,05:15,3,0,3
41,2025-05-25T12:34:00+02:00,2025-05-25,20:34,0,2,2
3,2025-05-24T21:18:00+02:00,2025-05-25,05:18,1,0,1
41,2025-05-25T12:35:00+02:00,2025-05-25,20:35,0,1,1
3,2025-05-24T21:24:00+02:00,2025-05-25,05:24,1,1,2
41,2025-05-25T12:36:00+02:00,2025-05-25,20:36,2,0,2
4,2025-05-24T21:11:00+02:00,2025-05-25,05:11,1,1,2
41,2025-05-25T12:39:00+02:00,2025-05-25,20:39,2,1,3
4,2025-05-24T21:19:00+02:00,2025-05-25,05:19,0,1,1
43,2025-05-25T12:25:00+02:00,2025-05-25,20:25,0,1,1
4,2025-05-24T21:21:00+02:00,2025-05-25,05:21,1,0,1
44,2025-05-25T12:30:00+02:00,2025-05-25,20:30,5,0,5
4,2025-05-24T21:23:00+02:00,2025-05-25,05:23,0,2,2
45,2025-05-25T12:25:00+02:00,2025-05-25,20:25,1,2,3
5,2025-05-24T21:10:00+02:00,2025-05-25,05:10,2,1,3
45,2025-05-25T12:26:00+02:00,2025-05-25,20:26,1,10,11
6,2025-05-24T21:11:00+02:00,2025-05-25,05:11,2,1,3
45,2025-05-25T12:29:00+02:00,2025-05-25,20:29,8,10,18
6,2025-05-24T21:15:00+02:00,2025-05-25,05:15,3,0,3
45,2025-05-25T12:37:00+02:00,2025-05-25,20:37,8,13,21
6,2025-05-24T21:18:00+02:00,2025-05-25,05:18,1,0,1
45,2025-05-25T12:39:00+02:00,2025-05-25,20:39,3,17,20
6,2025-05-24T21:20:00+02:00,2025-05-25,05:20,0,2,2
47,2025-05-25T12:25:00+02:00,2025-05-25,20:25,21,4,25
8,2025-05-24T21:14:00+02:00,2025-05-25,05:14,1,0,1
47,2025-05-25T12:28:00+02:00,2025-05-25,20:28,5,9,14
28,2025-05-24T21:10:00+02:00,2025-05-25,05:10,1,1,2
47,2025-05-25T12:35:00+02:00,2025-05-25,20:35,7,4,11
28,2025-05-24T21:17:00+02:00,2025-05-25,05:17,0,2,2
47,2025-05-25T12:38:00+02:00,2025-05-25,20:38,9,3,12
31,2025-05-24T21:22:00+02:00,2025-05-25,05:22,1,0,1
47,2025-05-25T12:39:00+02:00,2025-05-25,20:39,19,8,27
36,2025-05-24T21:24:00+02:00,2025-05-25,05:24,0,5,5
50,2025-05-25T12:32:00+02:00,2025-05-25,20:32,4,1,5
41,2025-05-24T21:14:00+02:00,2025-05-25,05:14,1,3,4
50,2025-05-25T12:35:00+02:00,2025-05-25,20:35,2,1,3
41,2025-05-24T21:15:00+02:00,2025-05-25,05:15,1,0,1
50,2025-05-25T12:38:00+02:00,2025-05-25,20:38,2,2,4
41,2025-05-24T21:17:00+02:00,2025-05-25,05:17,1,0,1
54,2025-05-25T12:35:00+02:00,2025-05-25,20:35,3,1,4
41,2025-05-24T21:18:00+02:00,2025-05-25,05:18,0,1,1
61,2025-05-25T12:27:00+02:00,2025-05-25,20:27,0,4,4
41,2025-05-24T21:23:00+02:00,2025-05-25,05:23,0,1,1
61,2025-05-25T12:29:00+02:00,2025-05-25,20:29,3,4,7
43,2025-05-24T21:10:00+02:00,2025-05-25,05:10,1,0,1
61,2025-05-25T12:30:00+02:00,2025-05-25,20:30,4,0,4
45,2025-05-24T21:14:00+02:00,2025-05-25,05:14,0,1,1
61,2025-05-25T12:34:00+02:00,2025-05-25,20:34,4,3,7
45,2025-05-24T21:15:00+02:00,2025-05-25,05:15,0,1,1
61,2025-05-25T12:37:00+02:00,2025-05-25,20:37,7,2,9
45,2025-05-24T21:17:00+02:00,2025-05-25,05:17,0,1,1
66,2025-05-25T12:25:00+02:00,2025-05-25,20:25,11,8,19
45,2025-05-24T21:21:00+02:00,2025-05-25,05:21,0,1,1
66,2025-05-25T12:30:00+02:00,2025-05-25,20:30,13,9,22
45,2025-05-24T21:24:00+02:00,2025-05-25,05:24,0,1,1
66,2025-05-25T12:34:00+02:00,2025-05-25,20:34,18,8,26
54,2025-05-24T21:15:00+02:00,2025-05-25,05:15,1,0,1
66,2025-05-25T12:37:00+02:00,2025-05-25,20:37,20,5,25
59,2025-05-24T21:10:00+02:00,2025-05-25,05:10,0,3,3
66,2025-05-25T12:39:00+02:00,2025-05-25,20:39,7,12,19
61,2025-05-24T21:16:00+02:00,2025-05-25,05:16,0,1,1
69,2025-05-25T12:29:00+02:00,2025-05-25,20:29,2,4,6
61,2025-05-24T21:17:00+02:00,2025-05-25,05:17,1,0,1
70,2025-05-25T12:28:00+02:00,2025-05-25,20:28,0,4,4
66,2025-05-24T21:10:00+02:00,2025-05-25,05:10,3,0,3
70,2025-05-25T12:29:00+02:00,2025-05-25,20:29,2,2,4
66,2025-05-24T21:13:00+02:00,2025-05-25,05:13,5,1,6
75,2025-05-25T12:35:00+02:00,2025-05-25,20:35,1,0,1
70,2025-05-24T21:18:00+02:00,2025-05-25,05:18,0,2,2
77,2025-05-25T12:25:00+02:00,2025-05-25,20:25,8,8,16
131,2025-05-24T21:10:00+02:00,2025-05-25,05:10,2,3,5
77,2025-05-25T12:35:00+02:00,2025-05-25,20:35,16,4,20
131,2025-05-24T21:20:00+02:00,2025-05-25,05:20,0,6,6
78,2025-05-25T12:27:00+02:00,2025-05-25,20:27,0,1,1
132,2025-05-24T21:20:00+02:00,2025-05-25,05:20,3,2,5
78,2025-05-25T12:36:00+02:00,2025-05-25,20:36,0,1,1
133,2025-05-24T21:20:00+02:00,2025-05-25,05:20,1,2,3
84,2025-05-25T12:25:00+02:00,2025-05-25,20:25,54,41,95
134,2025-05-24T21:20:00+02:00,2025-05-25,05:20,5,6,11
84,2025-05-25T12:30:00+02:00,2025-05-25,20:30,34,54,88
162,2025-05-24T21:15:00+02:00,2025-05-25,05:15,1,3,4
84,2025-05-25T12:35:00+02:00,2025-05-25,20:35,32,62,94
2,2025-05-24T21:14:00+02:00,2025-05-25,05:14,1,0,1
87,2025-05-25T12:26:00+02:00,2025-05-25,20:26,1,0,1
2,2025-05-24T21:17:00+02:00,2025-05-25,05:17,1,0,1
87,2025-05-25T12:39:00+02:00,2025-05-25,20:39,0,2,2
9,2025-05-24T21:18:00+02:00,2025-05-25,05:18,1,0,1
107,2025-05-25T12:30:00+02:00,2025-05-25,20:30,3,2,5
17,2025-05-24T21:19:00+02:00,2025-05-25,05:19,0,1,1
107,2025-05-25T12:35:00+02:00,2025-05-25,20:35,0,3,3
20,2025-05-24T21:10:00+02:00,2025-05-25,05:10,0,1,1
108,2025-05-25T12:25:00+02:00,2025-05-25,20:25,2,0,2
20,2025-05-24T21:13:00+02:00,2025-05-25,05:13,0,1,1
108,2025-05-25T12:28:00+02:00,2025-05-25,20:28,1,2,3
20,2025-05-24T21:15:00+02:00,2025-05-25,05:15,0,1,1
108,2025-05-25T12:32:00+02:00,2025-05-25,20:32,0,1,1
20,2025-05-24T21:16:00+02:00,2025-05-25,05:16,3,0,3
108,2025-05-25T12:37:00+02:00,2025-05-25,20:37,0,1,1
20,2025-05-24T21:17:00+02:00,2025-05-25,05:17,0,1,1
118,2025-05-25T12:25:00+02:00,2025-05-25,20:25,2,0,2
20,2025-05-24T21:18:00+02:00,2025-05-25,05:18,0,3,3
133,2025-05-25T12:25:00+02:00,2025-05-25,20:25,18,21,39
20,2025-05-24T21:19:00+02:00,2025-05-25,05:19,3,1,4
135,2025-05-25T12:30:00+02:00,2025-05-25,20:30,12,14,26
20,2025-05-24T21:23:00+02:00,2025-05-25,05:23,3,0,3
135,2025-05-25T12:35:00+02:00,2025-05-25,20:35,12,9,21
23,2025-05-24T21:18:00+02:00,2025-05-25,05:18,0,2,2
162,2025-05-25T12:25:00+02:00,2025-05-25,20:25,2,3,5
23,2025-05-24T21:22:00+02:00,2025-05-25,05:22,0,5,5
166,2025-05-25T12:25:00+02:00,2025-05-25,20:25,1,2,3
23,2025-05-24T21:24:00+02:00,2025-05-25,05:24,0,3,3
167,2025-05-25T12:35:00+02:00,2025-05-25,20:35,0,3,3
25,2025-05-24T21:10:00+02:00,2025-05-25,05:10,3,0,3
179,2025-05-25T12:35:00+02:00,2025-05-25,20:35,0,4,4
27,2025-05-24T21:17:00+02:00,2025-05-25,05:17,0,1,1
1,2025-05-25T12:25:00+02:00,2025-05-25,20:25,9,9,18
30,2025-05-24T21:16:00+02:00,2025-05-25,05:16,0,2,2
1,2025-05-25T12:32:00+02:00,2025-05-25,20:32,9,2,11
30,2025-05-24T21:18:00+02:00,2025-05-25,05:18,4,4,8
1,2025-05-25T12:33:00+02:00,2025-05-25,20:33,2,7,9
30,2025-05-24T21:20:00+02:00,2025-05-25,05:20,3,0,3
1,2025-05-25T12:34:00+02:00,2025-05-25,20:34,1,3,4
30,2025-05-24T21:21:00+02:00,2025-05-25,05:21,2,1,3
1,2025-05-25T12:37:00+02:00,2025-05-25,20:37,5,5,10
35,2025-05-24T21:11:00+02:00,2025-05-25,05:11,0,2,2
2,2025-05-25T12:27:00+02:00,2025-05-25,20:27,0,9,9
35,2025-05-24T21:15:00+02:00,2025-05-25,05:15,1,1,2
2,2025-05-25T12:32:00+02:00,2025-05-25,20:32,0,1,1
49,2025-05-24T21:14:00+02:00,2025-05-25,05:14,0,2,2
2,2025-05-25T12:35:00+02:00,2025-05-25,20:35,0,3,3
52,2025-05-24T21:13:00+02:00,2025-05-25,05:13,1,0,1
9,2025-05-25T12:28:00+02:00,2025-05-25,20:28,0,2,2
52,2025-05-24T21:18:00+02:00,2025-05-25,05:18,1,1,2
9,2025-05-25T12:35:00+02:00,2025-05-25,20:35,0,1,1
52,2025-05-24T21:23:00+02:00,2025-05-25,05:23,1,0,1
9,2025-05-25T12:39:00+02:00,2025-05-25,20:39,0,2,2
56,2025-05-24T21:17:00+02:00,2025-05-25,05:17,1,0,1
10,2025-05-25T12:26:00+02:00,2025-05-25,20:26,0,5,5
56,2025-05-24T21:18:00+02:00,2025-05-25,05:18,1,0,1
10,2025-05-25T12:27:00+02:00,2025-05-25,20:27,1,0,1
58,2025-05-24T21:24:00+02:00,2025-05-25,05:24,2,1,3
10,2025-05-25T12:30:00+02:00,2025-05-25,20:30,0,2,2
63,2025-05-24T21:20:00+02:00,2025-05-25,05:20,0,2,2
10,2025-05-25T12:34:00+02:00,2025-05-25,20:34,3,0,3
79,2025-05-24T21:11:00+02:00,2025-05-25,05:11,1,1,2
10,2025-05-25T12:37:00+02:00,2025-05-25,20:37,0,1,1
79,2025-05-24T21:17:00+02:00,2025-05-25,05:17,1,0,1
11,2025-05-25T12:25:00+02:00,2025-05-25,20:25,1,11,12
79,2025-05-24T21:20:00+02:00,2025-05-25,05:20,0,1,1
11,2025-05-25T12:35:00+02:00,2025-05-25,20:35,3,6,9
109,2025-05-24T21:20:00+02:00,2025-05-25,05:20,1,0,1
12,2025-05-25T12:26:00+02:00,2025-05-25,20:26,2,7,9
117,2025-05-24T21:20:00+02:00,2025-05-25,05:20,4,0,4
12,2025-05-25T12:28:00+02:00,2025-05-25,20:28,0,1,1
138,2025-05-24T21:20:00+02:00,2025-05-25,05:20,1,0,1
12,2025-05-25T12:30:00+02:00,2025-05-25,20:30,1,0,1
141,2025-05-24T21:15:00+02:00,2025-05-25,05:15,0,2,2
12,2025-05-25T12:32:00+02:00,2025-05-25,20:32,0,3,3
12,2025-05-25T12:34:00+02:00,2025-05-25,20:34,4,1,5
12,2025-05-25T12:35:00+02:00,2025-05-25,20:35,0,2,2
12,2025-05-25T12:38:00+02:00,2025-05-25,20:38,3,2,5
17,2025-05-25T12:35:00+02:00,2025-05-25,20:35,0,2,2
17,2025-05-25T12:38:00+02:00,2025-05-25,20:38,0,1,1
3,2025-05-24T21:26:00+02:00,2025-05-25,05:26,6,5,11
17,2025-05-25T12:39:00+02:00,2025-05-25,20:39,4,1,5
3,2025-05-24T21:27:00+02:00,2025-05-25,05:27,0,1,1
18,2025-05-25T12:37:00+02:00,2025-05-25,20:37,2,0,2
3,2025-05-24T21:31:00+02:00,2025-05-25,05:31,0,4,4
19,2025-05-25T12:25:00+02:00,2025-05-25,20:25,4,8,12
3,2025-05-24T21:39:00+02:00,2025-05-25,05:39,0,2,2
19,2025-05-25T12:32:00+02:00,2025-05-25,20:32,7,13,20
4,2025-05-24T21:26:00+02:00,2025-05-25,05:26,0,3,3
19,2025-05-25T12:39:00+02:00,2025-05-25,20:39,8,12,20
4,2025-05-24T21:32:00+02:00,2025-05-25,05:32,2,0,2
20,2025-05-25T12:30:00+02:00,2025-05-25,20:30,1,5,6
4,2025-05-24T21:36:00+02:00,2025-05-25,05:36,0,1,1
20,2025-05-25T12:31:00+02:00,2025-05-25,20:31,2,4,6
4,2025-05-24T21:38:00+02:00,2025-05-25,05:38,2,0,2
20,2025-05-25T12:32:00+02:00,2025-05-25,20:32,9,11,20
5,2025-05-24T21:25:00+02:00,2025-05-25,05:25,1,3,4
20,2025-05-25T12:36:00+02:00,2025-05-25,20:36,3,12,15
5,2025-05-24T21:35:00+02:00,2025-05-25,05:35,0,1,1
20,2025-05-25T12:39:00+02:00,2025-05-25,20:39,4,4,8
6,2025-05-24T21:36:00+02:00,2025-05-25,05:36,1,0,1
23,2025-05-25T12:25:00+02:00,2025-05-25,20:25,0,4,4
6,2025-05-24T21:37:00+02:00,2025-05-25,05:37,1,0,1
24,2025-05-25T12:25:00+02:00,2025-05-25,20:25,0,6,6
28,2025-05-24T21:27:00+02:00,2025-05-25,05:27,0,1,1
24,2025-05-25T12:28:00+02:00,2025-05-25,20:28,2,3,5
28,2025-05-24T21:32:00+02:00,2025-05-25,05:32,0,1,1
24,2025-05-25T12:29:00+02:00,2025-05-25,20:29,3,4,7
28,2025-05-24T21:35:00+02:00,2025-05-25,05:35,1,0,1
24,2025-05-25T12:34:00+02:00,2025-05-25,20:34,8,20,28
29,2025-05-24T21:31:00+02:00,2025-05-25,05:31,1,0,1
24,2025-05-25T12:35:00+02:00,2025-05-25,20:35,0,11,11
29,2025-05-24T21:32:00+02:00,2025-05-25,05:32,0,1,1
24,2025-05-25T12:37:00+02:00,2025-05-25,20:37,6,12,18
29,2025-05-24T21:34:00+02:00,2025-05-25,05:34,1,0,1
24,2025-05-25T12:39:00+02:00,2025-05-25,20:39,6,2,8
36,2025-05-24T21:28:00+02:00,2025-05-25,05:28,0,4,4
27,2025-05-25T12:33:00+02:00,2025-05-25,20:33,3,0,3
36,2025-05-24T21:34:00+02:00,2025-05-25,05:34,0,4,4
27,2025-05-25T12:34:00+02:00,2025-05-25,20:34,2,0,2
36,2025-05-24T21:35:00+02:00,2025-05-25,05:35,0,1,1
30,2025-05-25T12:28:00+02:00,2025-05-25,20:28,3,17,20
36,2025-05-24T21:36:00+02:00,2025-05-25,05:36,0,1,1
30,2025-05-25T12:29:00+02:00,2025-05-25,20:29,2,8,10
41,2025-05-24T21:32:00+02:00,2025-05-25,05:32,0,1,1
30,2025-05-25T12:34:00+02:00,2025-05-25,20:34,5,3,8
41,2025-05-24T21:34:00+02:00,2025-05-25,05:34,2,0,2
30,2025-05-25T12:35:00+02:00,2025-05-25,20:35,2,4,6
41,2025-05-24T21:36:00+02:00,2025-05-25,05:36,1,0,1
35,2025-05-25T12:26:00+02:00,2025-05-25,20:26,4,8,12
45,2025-05-24T21:26:00+02:00,2025-05-25,05:26,1,0,1
35,2025-05-25T12:29:00+02:00,2025-05-25,20:29,4,11,15
45,2025-05-24T21:27:00+02:00,2025-05-25,05:27,2,0,2
35,2025-05-25T12:30:00+02:00,2025-05-25,20:30,5,2,7
45,2025-05-24T21:29:00+02:00,2025-05-25,05:29,0,1,1
35,2025-05-25T12:32:00+02:00,2025-05-25,20:32,2,4,6
47,2025-05-24T21:25:00+02:00,2025-05-25,05:25,1,0,1
35,2025-05-25T12:34:00+02:00,2025-05-25,20:34,2,10,12
47,2025-05-24T21:27:00+02:00,2025-05-25,05:27,0,5,5
35,2025-05-25T12:35:00+02:00,2025-05-25,20:35,8,4,12
47,2025-05-24T21:28:00+02:00,2025-05-25,05:28,1,0,1
35,2025-05-25T12:39:00+02:00,2025-05-25,20:39,4,14,18
47,2025-05-24T21:30:00+02:00,2025-05-25,05:30,0,1,1
48,2025-05-25T12:27:00+02:00,2025-05-25,20:27,0,3,3
47,2025-05-24T21:33:00+02:00,2025-05-25,05:33,0,1,1
48,2025-05-25T12:29:00+02:00,2025-05-25,20:29,0,1,1
50,2025-05-24T21:28:00+02:00,2025-05-25,05:28,1,0,1
49,2025-05-25T12:26:00+02:00,2025-05-25,20:26,7,0,7
61,2025-05-24T21:39:00+02:00,2025-05-25,05:39,2,0,2
49,2025-05-25T12:29:00+02:00,2025-05-25,20:29,0,1,1
66,2025-05-24T21:27:00+02:00,2025-05-25,05:27,0,2,2
49,2025-05-25T12:30:00+02:00,2025-05-25,20:30,4,6,10
66,2025-05-24T21:37:00+02:00,2025-05-25,05:37,1,0,1
49,2025-05-25T12:32:00+02:00,2025-05-25,20:32,3,6,9
66,2025-05-24T21:39:00+02:00,2025-05-25,05:39,0,1,1
49,2025-05-25T12:33:00+02:00,2025-05-25,20:33,4,5,9
77,2025-05-24T21:30:00+02:00,2025-05-25,05:30,2,0,2
49,2025-05-25T12:34:00+02:00,2025-05-25,20:34,2,0,2
77,2025-05-24T21:35:00+02:00,2025-05-25,05:35,0,2,2
51,2025-05-25T12:28:00+02:00,2025-05-25,20:28,1,0,1
84,2025-05-24T21:30:00+02:00,2025-05-25,05:30,0,4,4
51,2025-05-25T12:29:00+02:00,2025-05-25,20:29,4,7,11
107,2025-05-24T21:25:00+02:00,2025-05-25,05:25,1,0,1
51,2025-05-25T12:38:00+02:00,2025-05-25,20:38,1,1,2
131,2025-05-24T21:25:00+02:00,2025-05-25,05:25,2,1,3
52,2025-05-25T12:26:00+02:00,2025-05-25,20:26,0,4,4
133,2025-05-24T21:25:00+02:00,2025-05-25,05:25,0,7,7
52,2025-05-25T12:29:00+02:00,2025-05-25,20:29,2,5,7
134,2025-05-24T21:30:00+02:00,2025-05-25,05:30,3,1,4
52,2025-05-25T12:30:00+02:00,2025-05-25,20:30,4,4,8
135,2025-05-24T21:25:00+02:00,2025-05-25,05:25,6,1,7
52,2025-05-25T12:31:00+02:00,2025-05-25,20:31,2,0,2
135,2025-05-24T21:30:00+02:00,2025-05-25,05:30,4,1,5
52,2025-05-25T12:32:00+02:00,2025-05-25,20:32,4,2,6
135,2025-05-24T21:35:00+02:00,2025-05-25,05:35,2,9,11
52,2025-05-25T12:33:00+02:00,2025-05-25,20:33,3,5,8
162,2025-05-24T21:30:00+02:00,2025-05-25,05:30,3,0,3
52,2025-05-25T12:35:00+02:00,2025-05-25,20:35,3,0,3
2,2025-05-24T21:27:00+02:00,2025-05-25,05:27,0,1,1
53,2025-05-25T12:28:00+02:00,2025-05-25,20:28,0,7,7
2,2025-05-24T21:33:00+02:00,2025-05-25,05:33,1,0,1
53,2025-05-25T12:30:00+02:00,2025-05-25,20:30,2,1,3
2,2025-05-24T21:38:00+02:00,2025-05-25,05:38,2,0,2
53,2025-05-25T12:37:00+02:00,2025-05-25,20:37,1,1,2
9,2025-05-24T21:28:00+02:00,2025-05-25,05:28,0,1,1
53,2025-05-25T12:39:00+02:00,2025-05-25,20:39,3,0,3
19,2025-05-24T21:29:00+02:00,2025-05-25,05:29,0,1,1
56,2025-05-25T12:26:00+02:00,2025-05-25,20:26,10,3,13
20,2025-05-24T21:25:00+02:00,2025-05-25,05:25,3,1,4
56,2025-05-25T12:27:00+02:00,2025-05-25,20:27,8,9,17
20,2025-05-24T21:26:00+02:00,2025-05-25,05:26,1,1,2
56,2025-05-25T12:28:00+02:00,2025-05-25,20:28,3,8,11
20,2025-05-24T21:28:00+02:00,2025-05-25,05:28,0,2,2
56,2025-05-25T12:29:00+02:00,2025-05-25,20:29,8,1,9
23,2025-05-24T21:30:00+02:00,2025-05-25,05:30,0,8,8
56,2025-05-25T12:31:00+02:00,2025-05-25,20:31,2,13,15
23,2025-05-24T21:35:00+02:00,2025-05-25,05:35,0,3,3
56,2025-05-25T12:35:00+02:00,2025-05-25,20:35,6,1,7
23,2025-05-24T21:38:00+02:00,2025-05-25,05:38,1,1,2
56,2025-05-25T12:38:00+02:00,2025-05-25,20:38,3,8,11
24,2025-05-24T21:36:00+02:00,2025-05-25,05:36,0,1,1
56,2025-05-25T12:39:00+02:00,2025-05-25,20:39,5,4,9
24,2025-05-24T21:38:00+02:00,2025-05-25,05:38,0,1,1
58,2025-05-25T12:33:00+02:00,2025-05-25,20:33,2,4,6
25,2025-05-24T21:25:00+02:00,2025-05-25,05:25,1,0,1
58,2025-05-25T12:37:00+02:00,2025-05-25,20:37,1,0,1
25,2025-05-24T21:30:00+02:00,2025-05-25,05:30,3,0,3
58,2025-05-25T12:39:00+02:00,2025-05-25,20:39,9,4,13
27,2025-05-24T21:34:00+02:00,2025-05-25,05:34,2,2,4
62,2025-05-25T12:25:00+02:00,2025-05-25,20:25,0,3,3
30,2025-05-24T21:26:00+02:00,2025-05-25,05:26,4,1,5
62,2025-05-25T12:28:00+02:00,2025-05-25,20:28,5,0,5
30,2025-05-24T21:27:00+02:00,2025-05-25,05:27,1,10,11
63,2025-05-25T12:27:00+02:00,2025-05-25,20:27,1,6,7
30,2025-05-24T21:31:00+02:00,2025-05-25,05:31,1,4,5
63,2025-05-25T12:28:00+02:00,2025-05-25,20:28,1,1,2
30,2025-05-24T21:38:00+02:00,2025-05-25,05:38,0,1,1
63,2025-05-25T12:29:00+02:00,2025-05-25,20:29,0,2,2
35,2025-05-24T21:25:00+02:00,2025-05-25,05:25,0,1,1
63,2025-05-25T12:32:00+02:00,2025-05-25,20:32,0,4,4
35,2025-05-24T21:26:00+02:00,2025-05-25,05:26,0,1,1
63,2025-05-25T12:33:00+02:00,2025-05-25,20:33,0,8,8
35,2025-05-24T21:28:00+02:00,2025-05-25,05:28,0,1,1
63,2025-05-25T12:34:00+02:00,2025-05-25,20:34,0,3,3
35,2025-05-24T21:34:00+02:00,2025-05-25,05:34,1,1,2
67,2025-05-25T12:37:00+02:00,2025-05-25,20:37,2,3,5
49,2025-05-24T21:28:00+02:00,2025-05-25,05:28,2,2,4
67,2025-05-25T12:39:00+02:00,2025-05-25,20:39,3,2,5
51,2025-05-24T21:26:00+02:00,2025-05-25,05:26,0,1,1
68,2025-05-25T12:26:00+02:00,2025-05-25,20:26,3,3,6
51,2025-05-24T21:28:00+02:00,2025-05-25,05:28,1,0,1
68,2025-05-25T12:29:00+02:00,2025-05-25,20:29,2,5,7
52,2025-05-24T21:33:00+02:00,2025-05-25,05:33,0,5,5
68,2025-05-25T12:30:00+02:00,2025-05-25,20:30,4,1,5
52,2025-05-24T21:38:00+02:00,2025-05-25,05:38,2,0,2
68,2025-05-25T12:32:00+02:00,2025-05-25,20:32,3,1,4
53,2025-05-24T21:39:00+02:00,2025-05-25,05:39,1,0,1
72,2025-05-25T12:25:00+02:00,2025-05-25,20:25,3,0,3
56,2025-05-24T21:28:00+02:00,2025-05-25,05:28,3,0,3
72,2025-05-25T12:26:00+02:00,2025-05-25,20:26,0,5,5
56,2025-05-24T21:30:00+02:00,2025-05-25,05:30,8,0,8
72,2025-05-25T12:27:00+02:00,2025-05-25,20:27,6,0,6
58,2025-05-24T21:27:00+02:00,2025-05-25,05:27,1,0,1
72,2025-05-25T12:29:00+02:00,2025-05-25,20:29,1,4,5
58,2025-05-24T21:35:00+02:00,2025-05-25,05:35,0,1,1
72,2025-05-25T12:32:00+02:00,2025-05-25,20:32,0,3,3
58,2025-05-24T21:37:00+02:00,2025-05-25,05:37,6,0,6
72,2025-05-25T12:37:00+02:00,2025-05-25,20:37,6,2,8
58,2025-05-24T21:38:00+02:00,2025-05-25,05:38,1,0,1
76,2025-05-25T12:31:00+02:00,2025-05-25,20:31,0,1,1
62,2025-05-24T21:37:00+02:00,2025-05-25,05:37,0,1,1
76,2025-05-25T12:32:00+02:00,2025-05-25,20:32,0,1,1
62,2025-05-24T21:38:00+02:00,2025-05-25,05:38,0,1,1
79,2025-05-25T12:25:00+02:00,2025-05-25,20:25,0,4,4
67,2025-05-24T21:30:00+02:00,2025-05-25,05:30,2,0,2
79,2025-05-25T12:30:00+02:00,2025-05-25,20:30,0,2,2
68,2025-05-24T21:36:00+02:00,2025-05-25,05:36,0,1,1
79,2025-05-25T12:32:00+02:00,2025-05-25,20:32,3,2,5
72,2025-05-24T21:33:00+02:00,2025-05-25,05:33,0,4,4
79,2025-05-25T12:33:00+02:00,2025-05-25,20:33,2,3,5
79,2025-05-24T21:30:00+02:00,2025-05-25,05:30,0,1,1
79,2025-05-25T12:35:00+02:00,2025-05-25,20:35,3,0,3
79,2025-05-24T21:33:00+02:00,2025-05-25,05:33,1,0,1
79,2025-05-25T12:37:00+02:00,2025-05-25,20:37,4,1,5
85,2025-05-25T12:31:00+02:00,2025-05-25,20:31,0,1,1
86,2025-05-25T12:33:00+02:00,2025-05-25,20:33,1,0,1
86,2025-05-25T12:39:00+02:00,2025-05-25,20:39,0,1,1
117,2025-05-25T12:25:00+02:00,2025-05-25,20:25,12,8,20
130,2025-05-25T12:30:00+02:00,2025-05-25,20:30,0,1,1
130,2025-05-25T12:35:00+02:00,2025-05-25,20:35,0,1,1
136,2025-05-25T12:30:00+02:00,2025-05-25,20:30,4,0,4
139,2025-05-25T12:30:00+02:00,2025-05-25,20:30,0,2,2
142,2025-05-25T12:35:00+02:00,2025-05-25,20:35,1,3,4
181,2025-05-24T21:28:00+02:00,2025-05-25,05:28,1,0,1
181,2025-05-24T21:29:00+02:00,2025-05-25,05:29,0,1,1
181,2025-05-24T21:30:00+02:00,2025-05-25,05:30,1,1,2
181,2025-05-24T21:35:00+02:00,2025-05-25,05:35,0,3,3
181,2025-05-24T21:37:00+02:00,2025-05-25,05:37,1,4,5
181,2025-05-24T21:39:00+02:00,2025-05-25,05:39,1,0,1
182,2025-05-24T21:30:00+02:00,2025-05-25,05:30,0,3,3
3,2025-05-24T22:00:00+02:00,2025-05-25,06:00,0,3,3
4,2025-05-24T21:56:00+02:00,2025-05-25,05:56,1,1,2
4,2025-05-24T22:04:00+02:00,2025-05-25,06:04,0,1,1
4,2025-05-24T22:06:00+02:00,2025-05-25,06:06,0,1,1
4,2025-05-24T22:08:00+02:00,2025-05-25,06:08,0,1,1
5,2025-05-24T21:55:00+02:00,2025-05-25,05:55,3,0,3
5,2025-05-24T22:00:00+02:00,2025-05-25,06:00,2,0,2
6,2025-05-24T22:00:00+02:00,2025-05-25,06:00,4,1,5
6,2025-05-24T22:01:00+02:00,2025-05-25,06:01,1,0,1
6,2025-05-24T22:02:00+02:00,2025-05-25,06:02,0,1,1
6,2025-05-24T22:08:00+02:00,2025-05-25,06:08,0,3,3
6,2025-05-24T22:09:00+02:00,2025-05-25,06:09,1,1,2
28,2025-05-24T22:00:00+02:00,2025-05-25,06:00,0,2,2
29,2025-05-24T22:01:00+02:00,2025-05-25,06:01,1,0,1
29,2025-05-24T22:06:00+02:00,2025-05-25,06:06,0,1,1
29,2025-05-24T22:08:00+02:00,2025-05-25,06:08,0,2,2
40,2025-05-24T21:57:00+02:00,2025-05-25,05:57,1,0,1
41,2025-05-24T22:00:00+02:00,2025-05-25,06:00,0,1,1
45,2025-05-24T22:05:00+02:00,2025-05-25,06:05,1,0,1
47,2025-05-24T21:55:00+02:00,2025-05-25,05:55,3,0,3
47,2025-05-24T21:58:00+02:00,2025-05-25,05:58,0,2,2
47,2025-05-24T22:04:00+02:00,2025-05-25,06:04,0,2,2
66,2025-05-24T21:58:00+02:00,2025-05-25,05:58,0,4,4
66,2025-05-24T22:02:00+02:00,2025-05-25,06:02,2,0,2
66,2025-05-24T22:06:00+02:00,2025-05-25,06:06,0,1,1
66,2025-05-24T22:07:00+02:00,2025-05-25,06:07,0,2,2
77,2025-05-24T22:05:00+02:00,2025-05-25,06:05,0,1,1
87,2025-05-24T22:09:00+02:00,2025-05-25,06:09,1,0,1
107,2025-05-24T22:00:00+02:00,2025-05-25,06:00,0,1,1
108,2025-05-24T21:56:00+02:00,2025-05-25,05:56,1,0,1
131,2025-05-24T22:00:00+02:00,2025-05-25,06:00,9,5,14
132,2025-05-24T22:05:00+02:00,2025-05-25,06:05,3,0,3
133,2025-05-24T22:00:00+02:00,2025-05-25,06:00,5,4,9
134,2025-05-24T22:00:00+02:00,2025-05-25,06:00,5,5,10
134,2025-05-24T22:05:00+02:00,2025-05-25,06:05,6,1,7
135,2025-05-24T21:55:00+02:00,2025-05-25,05:55,4,4,8
162,2025-05-24T22:00:00+02:00,2025-05-25,06:00,2,0,2
162,2025-05-24T22:05:00+02:00,2025-05-25,06:05,3,1,4
165,2025-05-24T22:00:00+02:00,2025-05-25,06:00,1,0,1
167,2025-05-24T22:05:00+02:00,2025-05-25,06:05,1,0,1
179,2025-05-24T22:05:00+02:00,2025-05-25,06:05,0,1,1
2,2025-05-24T22:00:00+02:00,2025-05-25,06:00,0,2,2
9,2025-05-24T22:03:00+02:00,2025-05-25,06:03,1,0,1
9,2025-05-24T22:05:00+02:00,2025-05-25,06:05,1,0,1
10,2025-05-24T22:00:00+02:00,2025-05-25,06:00,0,1,1
10,2025-05-24T22:04:00+02:00,2025-05-25,06:04,1,0,1
12,2025-05-24T22:02:00+02:00,2025-05-25,06:02,1,0,1
17,2025-05-24T21:56:00+02:00,2025-05-25,05:56,1,1,2
17,2025-05-24T21:57:00+02:00,2025-05-25,05:57,2,0,2
19,2025-05-24T21:56:00+02:00,2025-05-25,05:56,0,1,1
19,2025-05-24T21:57:00+02:00,2025-05-25,05:57,0,1,1
20,2025-05-24T21:58:00+02:00,2025-05-25,05:58,0,1,1
20,2025-05-24T21:59:00+02:00,2025-05-25,05:59,0,2,2
20,2025-05-24T22:04:00+02:00,2025-05-25,06:04,1,0,1
24,2025-05-24T21:55:00+02:00,2025-05-25,05:55,1,3,4
24,2025-05-24T21:58:00+02:00,2025-05-25,05:58,1,0,1
24,2025-05-24T21:59:00+02:00,2025-05-25,05:59,1,0,1
24,2025-05-24T22:02:00+02:00,2025-05-25,06:02,1,0,1
24,2025-05-24T22:05:00+02:00,2025-05-25,06:05,0,1,1
24,2025-05-24T22:07:00+02:00,2025-05-25,06:07,1,1,2
25,2025-05-24T22:05:00+02:00,2025-05-25,06:05,1,2,3
27,2025-05-24T22:06:00+02:00,2025-05-25,06:06,3,0,3
30,2025-05-24T21:57:00+02:00,2025-05-25,05:57,0,2,2
30,2025-05-24T21:58:00+02:00,2025-05-25,05:58,4,1,5
30,2025-05-24T21:59:00+02:00,2025-05-25,05:59,0,4,4
35,2025-05-24T22:01:00+02:00,2025-05-25,06:01,2,0,2
35,2025-05-24T22:08:00+02:00,2025-05-25,06:08,2,1,3
49,2025-05-24T22:01:00+02:00,2025-05-25,06:01,1,0,1
49,2025-05-24T22:02:00+02:00,2025-05-25,06:02,0,2,2
49,2025-05-24T22:07:00+02:00,2025-05-25,06:07,1,1,2
51,2025-05-24T21:57:00+02:00,2025-05-25,05:57,0,1,1
51,2025-05-24T22:00:00+02:00,2025-05-25,06:00,1,0,1
52,2025-05-24T22:06:00+02:00,2025-05-25,06:06,1,0,1
53,2025-05-24T22:02:00+02:00,2025-05-25,06:02,0,1,1
53,2025-05-24T22:05:00+02:00,2025-05-25,06:05,0,1,1
56,2025-05-24T21:58:00+02:00,2025-05-25,05:58,2,0,2
56,2025-05-24T22:07:00+02:00,2025-05-25,06:07,1,0,1
58,2025-05-24T22:02:00+02:00,2025-05-25,06:02,1,1,2
58,2025-05-24T22:06:00+02:00,2025-05-25,06:06,0,1,1
63,2025-05-24T21:57:00+02:00,2025-05-25,05:57,0,1,1
68,2025-05-24T22:09:00+02:00,2025-05-25,06:09,1,0,1
79,2025-05-24T22:07:00+02:00,2025-05-25,06:07,5,0,5
79,2025-05-24T22:09:00+02:00,2025-05-25,06:09,1,0,1
86,2025-05-24T22:03:00+02:00,2025-05-25,06:03,0,1,1
117,2025-05-24T21:55:00+02:00,2025-05-25,05:55,2,0,2
137,2025-05-24T22:00:00+02:00,2025-05-25,06:00,0,1,1
139,2025-05-24T22:00:00+02:00,2025-05-25,06:00,2,0,2
141,2025-05-24T22:05:00+02:00,2025-05-25,06:05,2,2,4
142,2025-05-24T22:05:00+02:00,2025-05-25,06:05,1,0,1
164,2025-05-24T22:05:00+02:00,2025-05-25,06:05,1,0,1
3,2025-05-24T21:40:00+02:00,2025-05-25,05:40,2,0,2
3,2025-05-24T21:41:00+02:00,2025-05-25,05:41,1,0,1
3,2025-05-24T21:53:00+02:00,2025-05-25,05:53,1,0,1
3,2025-05-24T21:54:00+02:00,2025-05-25,05:54,0,1,1
4,2025-05-24T21:41:00+02:00,2025-05-25,05:41,2,0,2
4,2025-05-24T21:42:00+02:00,2025-05-25,05:42,2,0,2
4,2025-05-24T21:44:00+02:00,2025-05-25,05:44,1,1,2
4,2025-05-24T21:54:00+02:00,2025-05-25,05:54,0,4,4
5,2025-05-24T21:40:00+02:00,2025-05-25,05:40,0,1,1
5,2025-05-24T21:50:00+02:00,2025-05-25,05:50,2,3,5
6,2025-05-24T21:40:00+02:00,2025-05-25,05:40,0,2,2
6,2025-05-24T21:43:00+02:00,2025-05-25,05:43,0,3,3
6,2025-05-24T21:46:00+02:00,2025-05-25,05:46,1,0,1
6,2025-05-24T21:47:00+02:00,2025-05-25,05:47,2,1,3
6,2025-05-24T21:52:00+02:00,2025-05-25,05:52,0,1,1
6,2025-05-24T21:54:00+02:00,2025-05-25,05:54,2,2,4
28,2025-05-24T21:46:00+02:00,2025-05-25,05:46,0,1,1
28,2025-05-24T21:48:00+02:00,2025-05-25,05:48,0,1,1
28,2025-05-24T21:49:00+02:00,2025-05-25,05:49,1,0,1
29,2025-05-24T21:54:00+02:00,2025-05-25,05:54,0,1,1
36,2025-05-24T21:41:00+02:00,2025-05-25,05:41,1,2,3
36,2025-05-24T21:43:00+02:00,2025-05-25,05:43,1,0,1
36,2025-05-24T21:49:00+02:00,2025-05-25,05:49,0,3,3
36,2025-05-24T21:53:00+02:00,2025-05-25,05:53,7,0,7
37,2025-05-24T21:54:00+02:00,2025-05-25,05:54,0,1,1
39,2025-05-24T21:49:00+02:00,2025-05-25,05:49,1,1,2
40,2025-05-24T21:43:00+02:00,2025-05-25,05:43,0,2,2
41,2025-05-24T21:48:00+02:00,2025-05-25,05:48,2,0,2
41,2025-05-24T21:49:00+02:00,2025-05-25,05:49,0,1,1
45,2025-05-24T21:44:00+02:00,2025-05-25,05:44,3,3,6
45,2025-05-24T21:47:00+02:00,2025-05-25,05:47,1,0,1
47,2025-05-24T21:43:00+02:00,2025-05-25,05:43,0,4,4
47,2025-05-24T21:46:00+02:00,2025-05-25,05:46,3,0,3
54,2025-05-24T21:48:00+02:00,2025-05-25,05:48,0,1,1
61,2025-05-24T21:54:00+02:00,2025-05-25,05:54,2,0,2
84,2025-05-24T21:45:00+02:00,2025-05-25,05:45,1,4,5
107,2025-05-24T21:50:00+02:00,2025-05-25,05:50,1,0,1
108,2025-05-24T21:43:00+02:00,2025-05-25,05:43,1,0,1
108,2025-05-24T21:47:00+02:00,2025-05-25,05:47,1,0,1
108,2025-05-24T21:48:00+02:00,2025-05-25,05:48,1,0,1
132,2025-05-24T21:45:00+02:00,2025-05-25,05:45,1,0,1
133,2025-05-24T21:40:00+02:00,2025-05-25,05:40,2,13,15
133,2025-05-24T21:50:00+02:00,2025-05-25,05:50,2,4,6
135,2025-05-24T21:45:00+02:00,2025-05-25,05:45,1,3,4
135,2025-05-24T21:50:00+02:00,2025-05-25,05:50,0,1,1
165,2025-05-24T21:45:00+02:00,2025-05-25,05:45,0,1,1
165,2025-05-24T21:50:00+02:00,2025-05-25,05:50,1,0,1
167,2025-05-24T21:40:00+02:00,2025-05-25,05:40,1,0,1
179,2025-05-24T21:50:00+02:00,2025-05-25,05:50,0,2,2
1,2025-05-24T21:43:00+02:00,2025-05-25,05:43,1,0,1
1,2025-05-24T21:48:00+02:00,2025-05-25,05:48,1,1,2
2,2025-05-24T21:40:00+02:00,2025-05-25,05:40,1,0,1
9,2025-05-24T21:44:00+02:00,2025-05-25,05:44,0,2,2
10,2025-05-24T21:43:00+02:00,2025-05-25,05:43,1,1,2
17,2025-05-24T21:40:00+02:00,2025-05-25,05:40,0,1,1
19,2025-05-24T21:44:00+02:00,2025-05-25,05:44,0,1,1
19,2025-05-24T21:53:00+02:00,2025-05-25,05:53,0,2,2
20,2025-05-24T21:51:00+02:00,2025-05-25,05:51,1,0,1
23,2025-05-24T21:41:00+02:00,2025-05-25,05:41,0,1,1
23,2025-05-24T21:43:00+02:00,2025-05-25,05:43,4,0,4
24,2025-05-24T21:41:00+02:00,2025-05-25,05:41,9,0,9
24,2025-05-24T21:42:00+02:00,2025-05-25,05:42,0,1,1
24,2025-05-24T21:43:00+02:00,2025-05-25,05:43,0,1,1
24,2025-05-24T21:50:00+02:00,2025-05-25,05:50,1,4,5
24,2025-05-24T21:54:00+02:00,2025-05-25,05:54,1,11,12
25,2025-05-24T21:45:00+02:00,2025-05-25,05:45,0,1,1
27,2025-05-24T21:40:00+02:00,2025-05-25,05:40,2,1,3
30,2025-05-24T21:42:00+02:00,2025-05-25,05:42,1,2,3
30,2025-05-24T21:49:00+02:00,2025-05-25,05:49,0,3,3
30,2025-05-24T21:50:00+02:00,2025-05-25,05:50,1,0,1
35,2025-05-24T21:53:00+02:00,2025-05-25,05:53,1,1,2
49,2025-05-24T21:44:00+02:00,2025-05-25,05:44,2,0,2
49,2025-05-24T21:46:00+02:00,2025-05-25,05:46,0,1,1
49,2025-05-24T21:50:00+02:00,2025-05-25,05:50,2,0,2
49,2025-05-24T21:51:00+02:00,2025-05-25,05:51,2,4,6
49,2025-05-24T21:53:00+02:00,2025-05-25,05:53,0,2,2
52,2025-05-24T21:49:00+02:00,2025-05-25,05:49,1,0,1
53,2025-05-24T21:44:00+02:00,2025-05-25,05:44,1,0,1
56,2025-05-24T21:43:00+02:00,2025-05-25,05:43,0,1,1
56,2025-05-24T21:51:00+02:00,2025-05-25,05:51,1,0,1
58,2025-05-24T21:41:00+02:00,2025-05-25,05:41,2,1,3
62,2025-05-24T21:51:00+02:00,2025-05-25,05:51,0,1,1
62,2025-05-24T21:52:00+02:00,2025-05-25,05:52,2,0,2
63,2025-05-24T21:49:00+02:00,2025-05-25,05:49,0,1,1
67,2025-05-24T21:42:00+02:00,2025-05-25,05:42,0,1,1
67,2025-05-24T21:53:00+02:00,2025-05-25,05:53,1,0,1
72,2025-05-24T21:44:00+02:00,2025-05-25,05:44,1,0,1
79,2025-05-24T21:40:00+02:00,2025-05-25,05:40,0,5,5
79,2025-05-24T21:43:00+02:00,2025-05-25,05:43,0,1,1
79,2025-05-24T21:46:00+02:00,2025-05-25,05:46,0,2,2
79,2025-05-24T21:51:00+02:00,2025-05-25,05:51,0,1,1
86,2025-05-24T21:48:00+02:00,2025-05-25,05:48,0,1,1
109,2025-05-24T21:50:00+02:00,2025-05-25,05:50,1,0,1
117,2025-05-24T21:45:00+02:00,2025-05-25,05:45,0,2,2
137,2025-05-24T21:50:00+02:00,2025-05-25,05:50,0,1,1
141,2025-05-24T21:40:00+02:00,2025-05-25,05:40,0,3,3
181,2025-05-24T21:40:00+02:00,2025-05-25,05:40,0,1,1
181,2025-05-24T21:46:00+02:00,2025-05-25,05:46,1,0,1
181,2025-05-24T21:49:00+02:00,2025-05-25,05:49,0,1,1
181,2025-05-24T21:50:00+02:00,2025-05-25,05:50,1,1,2
182,2025-05-24T21:50:00+02:00,2025-05-25,05:50,2,3,5
180,2025-05-24T21:42:00+02:00,2025-05-25,05:42,0,2,2
181,2025-05-24T22:01:00+02:00,2025-05-25,06:01,1,1,2
181,2025-05-24T22:06:00+02:00,2025-05-25,06:06,0,1,1
181,2025-05-24T22:09:00+02:00,2025-05-25,06:09,1,1,2
3,2025-05-25T14:26:00+02:00,2025-05-25,22:26,4,2,6
3,2025-05-25T14:28:00+02:00,2025-05-25,22:28,10,4,14
3,2025-05-25T14:33:00+02:00,2025-05-25,22:33,4,7,11
3,2025-05-25T14:36:00+02:00,2025-05-25,22:36,7,9,16
3,2025-05-25T14:39:00+02:00,2025-05-25,22:39,3,3,6
4,2025-05-25T14:27:00+02:00,2025-05-25,22:27,16,0,16
4,2025-05-25T14:28:00+02:00,2025-05-25,22:28,2,3,5
4,2025-05-25T14:35:00+02:00,2025-05-25,22:35,0,2,2
4,2025-05-25T14:36:00+02:00,2025-05-25,22:36,0,14,14
4,2025-05-25T14:37:00+02:00,2025-05-25,22:37,0,4,4
4,2025-05-25T14:38:00+02:00,2025-05-25,22:38,3,6,9
4,2025-05-25T14:39:00+02:00,2025-05-25,22:39,2,4,6
5,2025-05-25T14:30:00+02:00,2025-05-25,22:30,7,12,19
6,2025-05-25T14:25:00+02:00,2025-05-25,22:25,9,3,12
6,2025-05-25T14:26:00+02:00,2025-05-25,22:26,1,4,5
6,2025-05-25T14:28:00+02:00,2025-05-25,22:28,3,0,3
6,2025-05-25T14:34:00+02:00,2025-05-25,22:34,6,8,14
6,2025-05-25T14:35:00+02:00,2025-05-25,22:35,3,5,8
6,2025-05-25T14:37:00+02:00,2025-05-25,22:37,2,0,2
8,2025-05-25T14:28:00+02:00,2025-05-25,22:28,1,0,1
21,2025-05-25T14:30:00+02:00,2025-05-25,22:30,13,0,13
28,2025-05-25T14:25:00+02:00,2025-05-25,22:25,3,1,4
28,2025-05-25T14:26:00+02:00,2025-05-25,22:26,6,0,6
28,2025-05-25T14:27:00+02:00,2025-05-25,22:27,5,1,6
28,2025-05-25T14:28:00+02:00,2025-05-25,22:28,1,0,1
28,2025-05-25T14:31:00+02:00,2025-05-25,22:31,1,1,2
28,2025-05-25T14:37:00+02:00,2025-05-25,22:37,1,0,1
28,2025-05-25T14:38:00+02:00,2025-05-25,22:38,1,0,1
29,2025-05-25T14:26:00+02:00,2025-05-25,22:26,0,3,3
29,2025-05-25T14:27:00+02:00,2025-05-25,22:27,0,4,4
29,2025-05-25T14:32:00+02:00,2025-05-25,22:32,2,0,2
31,2025-05-25T14:25:00+02:00,2025-05-25,22:25,4,3,7
31,2025-05-25T14:31:00+02:00,2025-05-25,22:31,3,7,10
31,2025-05-25T14:33:00+02:00,2025-05-25,22:33,2,6,8
31,2025-05-25T14:39:00+02:00,2025-05-25,22:39,1,2,3
36,2025-05-25T14:25:00+02:00,2025-05-25,22:25,1,0,1
36,2025-05-25T14:27:00+02:00,2025-05-25,22:27,2,0,2
36,2025-05-25T14:34:00+02:00,2025-05-25,22:34,0,1,1
36,2025-05-25T14:38:00+02:00,2025-05-25,22:38,2,0,2
37,2025-05-25T14:26:00+02:00,2025-05-25,22:26,0,10,10
37,2025-05-25T14:33:00+02:00,2025-05-25,22:33,1,3,4
37,2025-05-25T14:36:00+02:00,2025-05-25,22:36,0,1,1
3,2025-05-24T22:26:00+02:00,2025-05-25,06:26,1,0,1
37,2025-05-25T14:38:00+02:00,2025-05-25,22:38,0,6,6
3,2025-05-24T22:33:00+02:00,2025-05-25,06:33,1,0,1
39,2025-05-25T14:33:00+02:00,2025-05-25,22:33,0,1,1
3,2025-05-24T22:34:00+02:00,2025-05-25,06:34,0,1,1
40,2025-05-25T14:30:00+02:00,2025-05-25,22:30,0,2,2
4,2025-05-24T22:26:00+02:00,2025-05-25,06:26,3,0,3
40,2025-05-25T14:31:00+02:00,2025-05-25,22:31,1,2,3
4,2025-05-24T22:27:00+02:00,2025-05-25,06:27,1,3,4
40,2025-05-25T14:34:00+02:00,2025-05-25,22:34,1,2,3
4,2025-05-24T22:28:00+02:00,2025-05-25,06:28,2,0,2
41,2025-05-25T14:27:00+02:00,2025-05-25,22:27,0,2,2
4,2025-05-24T22:30:00+02:00,2025-05-25,06:30,1,2,3
41,2025-05-25T14:33:00+02:00,2025-05-25,22:33,0,4,4
4,2025-05-24T22:31:00+02:00,2025-05-25,06:31,1,3,4
41,2025-05-25T14:37:00+02:00,2025-05-25,22:37,5,0,5
5,2025-05-24T22:35:00+02:00,2025-05-25,06:35,0,3,3
41,2025-05-25T14:38:00+02:00,2025-05-25,22:38,2,0,2
6,2025-05-24T22:33:00+02:00,2025-05-25,06:33,1,1,2
43,2025-05-25T14:35:00+02:00,2025-05-25,22:35,1,2,3
28,2025-05-24T22:27:00+02:00,2025-05-25,06:27,1,0,1
45,2025-05-25T14:35:00+02:00,2025-05-25,22:35,2,3,5
28,2025-05-24T22:37:00+02:00,2025-05-25,06:37,0,3,3
47,2025-05-25T14:25:00+02:00,2025-05-25,22:25,5,0,5
28,2025-05-24T22:38:00+02:00,2025-05-25,06:38,0,2,2
47,2025-05-25T14:33:00+02:00,2025-05-25,22:33,1,1,2
29,2025-05-24T22:26:00+02:00,2025-05-25,06:26,1,1,2
47,2025-05-25T14:34:00+02:00,2025-05-25,22:34,6,2,8
36,2025-05-24T22:27:00+02:00,2025-05-25,06:27,0,1,1
47,2025-05-25T14:35:00+02:00,2025-05-25,22:35,6,6,12
36,2025-05-24T22:31:00+02:00,2025-05-25,06:31,1,0,1
47,2025-05-25T14:36:00+02:00,2025-05-25,22:36,7,3,10
40,2025-05-24T22:34:00+02:00,2025-05-25,06:34,0,1,1
50,2025-05-25T14:27:00+02:00,2025-05-25,22:27,1,0,1
41,2025-05-24T22:26:00+02:00,2025-05-25,06:26,2,2,4
50,2025-05-25T14:34:00+02:00,2025-05-25,22:34,2,0,2
41,2025-05-24T22:27:00+02:00,2025-05-25,06:27,1,4,5
54,2025-05-25T14:26:00+02:00,2025-05-25,22:26,4,0,4
45,2025-05-24T22:32:00+02:00,2025-05-25,06:32,1,3,4
54,2025-05-25T14:27:00+02:00,2025-05-25,22:27,1,0,1
47,2025-05-24T22:27:00+02:00,2025-05-25,06:27,0,2,2
54,2025-05-25T14:32:00+02:00,2025-05-25,22:32,4,2,6
47,2025-05-24T22:29:00+02:00,2025-05-25,06:29,0,2,2
54,2025-05-25T14:33:00+02:00,2025-05-25,22:33,2,1,3
47,2025-05-24T22:31:00+02:00,2025-05-25,06:31,0,1,1
54,2025-05-25T14:35:00+02:00,2025-05-25,22:35,0,1,1
47,2025-05-24T22:39:00+02:00,2025-05-25,06:39,0,5,5
54,2025-05-25T14:39:00+02:00,2025-05-25,22:39,3,0,3
50,2025-05-24T22:32:00+02:00,2025-05-25,06:32,6,0,6
59,2025-05-25T14:30:00+02:00,2025-05-25,22:30,11,9,20
66,2025-05-24T22:27:00+02:00,2025-05-25,06:27,0,1,1
61,2025-05-25T14:32:00+02:00,2025-05-25,22:32,1,0,1
66,2025-05-24T22:28:00+02:00,2025-05-25,06:28,0,1,1
61,2025-05-25T14:36:00+02:00,2025-05-25,22:36,3,2,5
66,2025-05-24T22:29:00+02:00,2025-05-25,06:29,0,2,2
66,2025-05-25T14:25:00+02:00,2025-05-25,22:25,4,1,5
77,2025-05-24T22:30:00+02:00,2025-05-25,06:30,4,0,4
66,2025-05-25T14:26:00+02:00,2025-05-25,22:26,4,4,8
108,2025-05-24T22:28:00+02:00,2025-05-25,06:28,0,1,1
66,2025-05-25T14:31:00+02:00,2025-05-25,22:31,3,4,7
108,2025-05-24T22:38:00+02:00,2025-05-25,06:38,1,1,2
66,2025-05-25T14:32:00+02:00,2025-05-25,22:32,3,4,7
131,2025-05-24T22:30:00+02:00,2025-05-25,06:30,1,2,3
66,2025-05-25T14:34:00+02:00,2025-05-25,22:34,2,6,8
132,2025-05-24T22:35:00+02:00,2025-05-25,06:35,4,1,5
66,2025-05-25T14:39:00+02:00,2025-05-25,22:39,3,3,6
133,2025-05-24T22:30:00+02:00,2025-05-25,06:30,4,5,9
70,2025-05-25T14:25:00+02:00,2025-05-25,22:25,1,0,1
133,2025-05-24T22:35:00+02:00,2025-05-25,06:35,11,15,26
75,2025-05-25T14:25:00+02:00,2025-05-25,22:25,0,1,1
134,2025-05-24T22:35:00+02:00,2025-05-25,06:35,14,9,23
84,2025-05-25T14:25:00+02:00,2025-05-25,22:25,19,31,50
162,2025-05-24T22:25:00+02:00,2025-05-25,06:25,2,0,2
87,2025-05-25T14:25:00+02:00,2025-05-25,22:25,0,1,1
1,2025-05-24T22:25:00+02:00,2025-05-25,06:25,1,0,1
87,2025-05-25T14:33:00+02:00,2025-05-25,22:33,1,0,1
1,2025-05-24T22:32:00+02:00,2025-05-25,06:32,0,1,1
107,2025-05-25T14:25:00+02:00,2025-05-25,22:25,7,3,10
1,2025-05-24T22:33:00+02:00,2025-05-25,06:33,0,1,1
108,2025-05-25T14:25:00+02:00,2025-05-25,22:25,1,0,1
2,2025-05-24T22:31:00+02:00,2025-05-25,06:31,1,0,1
108,2025-05-25T14:32:00+02:00,2025-05-25,22:32,1,0,1
2,2025-05-24T22:35:00+02:00,2025-05-25,06:35,0,2,2
131,2025-05-25T14:35:00+02:00,2025-05-25,22:35,1,2,3
9,2025-05-24T22:27:00+02:00,2025-05-25,06:27,1,0,1
132,2025-05-25T14:35:00+02:00,2025-05-25,22:35,6,1,7
9,2025-05-24T22:28:00+02:00,2025-05-25,06:28,1,0,1
133,2025-05-25T14:25:00+02:00,2025-05-25,22:25,10,9,19
9,2025-05-24T22:32:00+02:00,2025-05-25,06:32,1,0,1
133,2025-05-25T14:30:00+02:00,2025-05-25,22:30,22,12,34
9,2025-05-24T22:38:00+02:00,2025-05-25,06:38,1,1,2
133,2025-05-25T14:35:00+02:00,2025-05-25,22:35,22,12,34
11,2025-05-24T22:32:00+02:00,2025-05-25,06:32,0,1,1
134,2025-05-25T14:25:00+02:00,2025-05-25,22:25,14,7,21
12,2025-05-24T22:33:00+02:00,2025-05-25,06:33,0,1,1
134,2025-05-25T14:35:00+02:00,2025-05-25,22:35,28,17,45
17,2025-05-24T22:32:00+02:00,2025-05-25,06:32,1,0,1
135,2025-05-25T14:25:00+02:00,2025-05-25,22:25,1,8,9
17,2025-05-24T22:38:00+02:00,2025-05-25,06:38,1,1,2
135,2025-05-25T14:35:00+02:00,2025-05-25,22:35,15,17,32
19,2025-05-24T22:35:00+02:00,2025-05-25,06:35,0,1,1
167,2025-05-25T14:30:00+02:00,2025-05-25,22:30,1,1,2
23,2025-05-24T22:29:00+02:00,2025-05-25,06:29,1,0,1
1,2025-05-25T14:26:00+02:00,2025-05-25,22:26,3,1,4
23,2025-05-24T22:31:00+02:00,2025-05-25,06:31,1,0,1
1,2025-05-25T14:27:00+02:00,2025-05-25,22:27,3,0,3
23,2025-05-24T22:33:00+02:00,2025-05-25,06:33,0,1,1
1,2025-05-25T14:28:00+02:00,2025-05-25,22:28,1,1,2
23,2025-05-24T22:35:00+02:00,2025-05-25,06:35,0,1,1
1,2025-05-25T14:32:00+02:00,2025-05-25,22:32,1,3,4
24,2025-05-24T22:33:00+02:00,2025-05-25,06:33,1,3,4
2,2025-05-25T14:28:00+02:00,2025-05-25,22:28,0,2,2
24,2025-05-24T22:35:00+02:00,2025-05-25,06:35,1,3,4
2,2025-05-25T14:39:00+02:00,2025-05-25,22:39,0,1,1
24,2025-05-24T22:37:00+02:00,2025-05-25,06:37,5,3,8
9,2025-05-25T14:29:00+02:00,2025-05-25,22:29,1,0,1
24,2025-05-24T22:38:00+02:00,2025-05-25,06:38,1,0,1
9,2025-05-25T14:32:00+02:00,2025-05-25,22:32,2,1,3
25,2025-05-24T22:30:00+02:00,2025-05-25,06:30,3,0,3
9,2025-05-25T14:38:00+02:00,2025-05-25,22:38,0,2,2
25,2025-05-24T22:35:00+02:00,2025-05-25,06:35,3,4,7
10,2025-05-25T14:25:00+02:00,2025-05-25,22:25,0,2,2
27,2025-05-24T22:28:00+02:00,2025-05-25,06:28,0,1,1
10,2025-05-25T14:32:00+02:00,2025-05-25,22:32,0,2,2
27,2025-05-24T22:39:00+02:00,2025-05-25,06:39,0,1,1
10,2025-05-25T14:35:00+02:00,2025-05-25,22:35,1,0,1
30,2025-05-24T22:29:00+02:00,2025-05-25,06:29,0,1,1
11,2025-05-25T14:25:00+02:00,2025-05-25,22:25,1,0,1
35,2025-05-24T22:25:00+02:00,2025-05-25,06:25,2,1,3
12,2025-05-25T14:36:00+02:00,2025-05-25,22:36,1,0,1
35,2025-05-24T22:39:00+02:00,2025-05-25,06:39,0,2,2
19,2025-05-25T14:26:00+02:00,2025-05-25,22:26,6,6,12
48,2025-05-24T22:33:00+02:00,2025-05-25,06:33,1,0,1
19,2025-05-25T14:30:00+02:00,2025-05-25,22:30,2,1,3
49,2025-05-24T22:29:00+02:00,2025-05-25,06:29,0,1,1
19,2025-05-25T14:33:00+02:00,2025-05-25,22:33,4,1,5
49,2025-05-24T22:30:00+02:00,2025-05-25,06:30,2,0,2
19,2025-05-25T14:34:00+02:00,2025-05-25,22:34,4,3,7
49,2025-05-24T22:37:00+02:00,2025-05-25,06:37,0,1,1
19,2025-05-25T14:36:00+02:00,2025-05-25,22:36,5,3,8
51,2025-05-24T22:37:00+02:00,2025-05-25,06:37,0,1,1
20,2025-05-25T14:26:00+02:00,2025-05-25,22:26,1,7,8
52,2025-05-24T22:28:00+02:00,2025-05-25,06:28,1,0,1
20,2025-05-25T14:29:00+02:00,2025-05-25,22:29,3,10,13
53,2025-05-24T22:30:00+02:00,2025-05-25,06:30,0,2,2
20,2025-05-25T14:32:00+02:00,2025-05-25,22:32,2,6,8
53,2025-05-24T22:36:00+02:00,2025-05-25,06:36,1,2,3
20,2025-05-25T14:35:00+02:00,2025-05-25,22:35,5,0,5
56,2025-05-24T22:27:00+02:00,2025-05-25,06:27,2,0,2
20,2025-05-25T14:38:00+02:00,2025-05-25,22:38,2,8,10
58,2025-05-24T22:28:00+02:00,2025-05-25,06:28,1,1,2
23,2025-05-25T14:35:00+02:00,2025-05-25,22:35,1,0,1
58,2025-05-24T22:38:00+02:00,2025-05-25,06:38,3,2,5
24,2025-05-25T14:25:00+02:00,2025-05-25,22:25,2,2,4
62,2025-05-24T22:33:00+02:00,2025-05-25,06:33,0,1,1
24,2025-05-25T14:26:00+02:00,2025-05-25,22:26,0,1,1
62,2025-05-24T22:37:00+02:00,2025-05-25,06:37,2,0,2
24,2025-05-25T14:29:00+02:00,2025-05-25,22:29,4,0,4
62,2025-05-24T22:38:00+02:00,2025-05-25,06:38,1,2,3
24,2025-05-25T14:33:00+02:00,2025-05-25,22:33,3,15,18
67,2025-05-24T22:31:00+02:00,2025-05-25,06:31,0,1,1
24,2025-05-25T14:35:00+02:00,2025-05-25,22:35,3,2,5
67,2025-05-24T22:37:00+02:00,2025-05-25,06:37,2,0,2
24,2025-05-25T14:37:00+02:00,2025-05-25,22:37,1,1,2
68,2025-05-24T22:25:00+02:00,2025-05-25,06:25,1,0,1
25,2025-05-25T14:25:00+02:00,2025-05-25,22:25,3,12,15
72,2025-05-24T22:26:00+02:00,2025-05-25,06:26,0,2,2
27,2025-05-25T14:26:00+02:00,2025-05-25,22:26,0,4,4
76,2025-05-24T22:28:00+02:00,2025-05-25,06:28,1,0,1
27,2025-05-25T14:29:00+02:00,2025-05-25,22:29,1,0,1
79,2025-05-24T22:31:00+02:00,2025-05-25,06:31,0,2,2
27,2025-05-25T14:31:00+02:00,2025-05-25,22:31,0,4,4
79,2025-05-24T22:34:00+02:00,2025-05-25,06:34,1,2,3
27,2025-05-25T14:36:00+02:00,2025-05-25,22:36,5,0,5
86,2025-05-24T22:29:00+02:00,2025-05-25,06:29,0,1,1
30,2025-05-25T14:28:00+02:00,2025-05-25,22:28,3,2,5
109,2025-05-24T22:35:00+02:00,2025-05-25,06:35,1,0,1
30,2025-05-25T14:35:00+02:00,2025-05-25,22:35,0,5,5
117,2025-05-24T22:35:00+02:00,2025-05-25,06:35,0,1,1
35,2025-05-25T14:31:00+02:00,2025-05-25,22:31,5,15,20
136,2025-05-24T22:25:00+02:00,2025-05-25,06:25,1,0,1
35,2025-05-25T14:32:00+02:00,2025-05-25,22:32,0,3,3
139,2025-05-24T22:30:00+02:00,2025-05-25,06:30,1,1,2
35,2025-05-25T14:34:00+02:00,2025-05-25,22:34,1,0,1
141,2025-05-24T22:30:00+02:00,2025-05-25,06:30,2,0,2
35,2025-05-25T14:36:00+02:00,2025-05-25,22:36,3,2,5
164,2025-05-24T22:30:00+02:00,2025-05-25,06:30,1,0,1
35,2025-05-25T14:38:00+02:00,2025-05-25,22:38,2,0,2
3,2025-05-24T22:14:00+02:00,2025-05-25,06:14,2,0,2
35,2025-05-25T14:39:00+02:00,2025-05-25,22:39,1,1,2
3,2025-05-24T22:20:00+02:00,2025-05-25,06:20,0,2,2
48,2025-05-25T14:38:00+02:00,2025-05-25,22:38,1,1,2
3,2025-05-24T22:21:00+02:00,2025-05-25,06:21,0,2,2
51,2025-05-25T14:27:00+02:00,2025-05-25,22:27,1,1,2
3,2025-05-24T22:23:00+02:00,2025-05-25,06:23,1,0,1
51,2025-05-25T14:28:00+02:00,2025-05-25,22:28,0,1,1
4,2025-05-24T22:14:00+02:00,2025-05-25,06:14,1,0,1
51,2025-05-25T14:35:00+02:00,2025-05-25,22:35,4,0,4
4,2025-05-24T22:22:00+02:00,2025-05-25,06:22,1,0,1
51,2025-05-25T14:38:00+02:00,2025-05-25,22:38,0,1,1
4,2025-05-24T22:23:00+02:00,2025-05-25,06:23,1,1,2
51,2025-05-25T14:39:00+02:00,2025-05-25,22:39,0,1,1
6,2025-05-24T22:12:00+02:00,2025-05-25,06:12,0,1,1
52,2025-05-25T14:26:00+02:00,2025-05-25,22:26,1,1,2
6,2025-05-24T22:13:00+02:00,2025-05-25,06:13,1,0,1
52,2025-05-25T14:29:00+02:00,2025-05-25,22:29,0,1,1
6,2025-05-24T22:16:00+02:00,2025-05-25,06:16,1,1,2
52,2025-05-25T14:31:00+02:00,2025-05-25,22:31,1,0,1
6,2025-05-24T22:22:00+02:00,2025-05-25,06:22,1,8,9
52,2025-05-25T14:32:00+02:00,2025-05-25,22:32,2,0,2
28,2025-05-24T22:10:00+02:00,2025-05-25,06:10,2,0,2
52,2025-05-25T14:33:00+02:00,2025-05-25,22:33,3,5,8
28,2025-05-24T22:19:00+02:00,2025-05-25,06:19,0,1,1
52,2025-05-25T14:38:00+02:00,2025-05-25,22:38,6,1,7
28,2025-05-24T22:24:00+02:00,2025-05-25,06:24,1,0,1
52,2025-05-25T14:39:00+02:00,2025-05-25,22:39,0,5,5
29,2025-05-24T22:18:00+02:00,2025-05-25,06:18,0,3,3
53,2025-05-25T14:37:00+02:00,2025-05-25,22:37,0,1,1
31,2025-05-24T22:14:00+02:00,2025-05-25,06:14,1,0,1
53,2025-05-25T14:38:00+02:00,2025-05-25,22:38,0,3,3
31,2025-05-24T22:22:00+02:00,2025-05-25,06:22,1,0,1
56,2025-05-25T14:25:00+02:00,2025-05-25,22:25,2,0,2
36,2025-05-24T22:15:00+02:00,2025-05-25,06:15,1,0,1
56,2025-05-25T14:26:00+02:00,2025-05-25,22:26,3,1,4
40,2025-05-24T22:15:00+02:00,2025-05-25,06:15,1,0,1
56,2025-05-25T14:32:00+02:00,2025-05-25,22:32,1,1,2
41,2025-05-24T22:11:00+02:00,2025-05-25,06:11,2,0,2
56,2025-05-25T14:34:00+02:00,2025-05-25,22:34,1,1,2
41,2025-05-24T22:13:00+02:00,2025-05-25,06:13,0,1,1
58,2025-05-25T14:30:00+02:00,2025-05-25,22:30,0,2,2
41,2025-05-24T22:14:00+02:00,2025-05-25,06:14,1,0,1
58,2025-05-25T14:31:00+02:00,2025-05-25,22:31,2,0,2
41,2025-05-24T22:19:00+02:00,2025-05-25,06:19,2,0,2
58,2025-05-25T14:33:00+02:00,2025-05-25,22:33,1,7,8
43,2025-05-24T22:10:00+02:00,2025-05-25,06:10,1,0,1
62,2025-05-25T14:30:00+02:00,2025-05-25,22:30,1,2,3
45,2025-05-24T22:16:00+02:00,2025-05-25,06:16,1,0,1
62,2025-05-25T14:31:00+02:00,2025-05-25,22:31,5,2,7
45,2025-05-24T22:17:00+02:00,2025-05-25,06:17,0,4,4
62,2025-05-25T14:39:00+02:00,2025-05-25,22:39,1,3,4
45,2025-05-24T22:18:00+02:00,2025-05-25,06:18,1,1,2
63,2025-05-25T14:28:00+02:00,2025-05-25,22:28,2,0,2
45,2025-05-24T22:19:00+02:00,2025-05-25,06:19,1,1,2
63,2025-05-25T14:31:00+02:00,2025-05-25,22:31,2,0,2
45,2025-05-24T22:21:00+02:00,2025-05-25,06:21,1,1,2
67,2025-05-25T14:25:00+02:00,2025-05-25,22:25,1,3,4
47,2025-05-24T22:14:00+02:00,2025-05-25,06:14,0,1,1
67,2025-05-25T14:26:00+02:00,2025-05-25,22:26,1,2,3
47,2025-05-24T22:17:00+02:00,2025-05-25,06:17,2,1,3
67,2025-05-25T14:29:00+02:00,2025-05-25,22:29,0,1,1
47,2025-05-24T22:18:00+02:00,2025-05-25,06:18,0,5,5
67,2025-05-25T14:30:00+02:00,2025-05-25,22:30,0,1,1
47,2025-05-24T22:21:00+02:00,2025-05-25,06:21,3,1,4
67,2025-05-25T14:31:00+02:00,2025-05-25,22:31,1,0,1
47,2025-05-24T22:24:00+02:00,2025-05-25,06:24,0,2,2
67,2025-05-25T14:34:00+02:00,2025-05-25,22:34,1,1,2
54,2025-05-24T22:22:00+02:00,2025-05-25,06:22,0,2,2
67,2025-05-25T14:35:00+02:00,2025-05-25,22:35,0,1,1
59,2025-05-24T22:15:00+02:00,2025-05-25,06:15,0,1,1
68,2025-05-25T14:25:00+02:00,2025-05-25,22:25,2,0,2
66,2025-05-24T22:15:00+02:00,2025-05-25,06:15,0,2,2
68,2025-05-25T14:29:00+02:00,2025-05-25,22:29,1,1,2
66,2025-05-24T22:17:00+02:00,2025-05-25,06:17,1,0,1
68,2025-05-25T14:31:00+02:00,2025-05-25,22:31,4,6,10
66,2025-05-24T22:20:00+02:00,2025-05-25,06:20,1,0,1
72,2025-05-25T14:26:00+02:00,2025-05-25,22:26,0,1,1
66,2025-05-24T22:23:00+02:00,2025-05-25,06:23,1,0,1
72,2025-05-25T14:34:00+02:00,2025-05-25,22:34,1,0,1
69,2025-05-24T22:10:00+02:00,2025-05-25,06:10,1,1,2
72,2025-05-25T14:39:00+02:00,2025-05-25,22:39,0,2,2
107,2025-05-24T22:20:00+02:00,2025-05-25,06:20,0,1,1
76,2025-05-25T14:39:00+02:00,2025-05-25,22:39,0,1,1
108,2025-05-24T22:10:00+02:00,2025-05-25,06:10,1,0,1
79,2025-05-25T14:33:00+02:00,2025-05-25,22:33,0,1,1
108,2025-05-24T22:14:00+02:00,2025-05-25,06:14,1,0,1
109,2025-05-25T14:25:00+02:00,2025-05-25,22:25,2,13,15
108,2025-05-24T22:17:00+02:00,2025-05-25,06:17,1,0,1
117,2025-05-25T14:25:00+02:00,2025-05-25,22:25,5,0,5
165,2025-05-24T22:15:00+02:00,2025-05-25,06:15,1,0,1
117,2025-05-25T14:30:00+02:00,2025-05-25,22:30,2,1,3
167,2025-05-24T22:15:00+02:00,2025-05-25,06:15,0,2,2
137,2025-05-25T14:30:00+02:00,2025-05-25,22:30,1,1,2
167,2025-05-24T22:20:00+02:00,2025-05-25,06:20,2,2,4
179,2025-05-24T22:10:00+02:00,2025-05-25,06:10,0,3,3
179,2025-05-24T22:15:00+02:00,2025-05-25,06:15,1,1,2
1,2025-05-24T22:19:00+02:00,2025-05-25,06:19,1,0,1
1,2025-05-24T22:21:00+02:00,2025-05-25,06:21,0,1,1
9,2025-05-24T22:22:00+02:00,2025-05-25,06:22,2,0,2
18,2025-05-24T22:11:00+02:00,2025-05-25,06:11,0,2,2
20,2025-05-24T22:18:00+02:00,2025-05-25,06:18,0,1,1
23,2025-05-24T22:11:00+02:00,2025-05-25,06:11,2,0,2
23,2025-05-24T22:15:00+02:00,2025-05-25,06:15,1,0,1
23,2025-05-24T22:16:00+02:00,2025-05-25,06:16,1,0,1
23,2025-05-24T22:20:00+02:00,2025-05-25,06:20,1,0,1
24,2025-05-24T22:14:00+02:00,2025-05-25,06:14,0,1,1
24,2025-05-24T22:15:00+02:00,2025-05-25,06:15,0,1,1
24,2025-05-24T22:17:00+02:00,2025-05-25,06:17,1,0,1
24,2025-05-24T22:18:00+02:00,2025-05-25,06:18,1,2,3
24,2025-05-24T22:23:00+02:00,2025-05-25,06:23,0,2,2
25,2025-05-24T22:10:00+02:00,2025-05-25,06:10,3,1,4
25,2025-05-24T22:20:00+02:00,2025-05-25,06:20,1,1,2
27,2025-05-24T22:16:00+02:00,2025-05-25,06:16,0,1,1
30,2025-05-24T22:10:00+02:00,2025-05-25,06:10,0,4,4
30,2025-05-24T22:13:00+02:00,2025-05-25,06:13,3,0,3
30,2025-05-24T22:14:00+02:00,2025-05-25,06:14,0,2,2
30,2025-05-24T22:16:00+02:00,2025-05-25,06:16,0,1,1
35,2025-05-24T22:10:00+02:00,2025-05-25,06:10,0,1,1
35,2025-05-24T22:13:00+02:00,2025-05-25,06:13,1,0,1
35,2025-05-24T22:14:00+02:00,2025-05-25,06:14,1,0,1
35,2025-05-24T22:21:00+02:00,2025-05-25,06:21,0,1,1
48,2025-05-24T22:15:00+02:00,2025-05-25,06:15,0,1,1
48,2025-05-24T22:20:00+02:00,2025-05-25,06:20,0,1,1
49,2025-05-24T22:17:00+02:00,2025-05-25,06:17,0,1,1
49,2025-05-24T22:23:00+02:00,2025-05-25,06:23,1,2,3
52,2025-05-24T22:12:00+02:00,2025-05-25,06:12,1,0,1
52,2025-05-24T22:18:00+02:00,2025-05-25,06:18,1,0,1
53,2025-05-24T22:20:00+02:00,2025-05-25,06:20,3,0,3
56,2025-05-24T22:10:00+02:00,2025-05-25,06:10,2,0,2
56,2025-05-24T22:19:00+02:00,2025-05-25,06:19,1,0,1
56,2025-05-24T22:22:00+02:00,2025-05-25,06:22,0,1,1
58,2025-05-24T22:10:00+02:00,2025-05-25,06:10,2,3,5
58,2025-05-24T22:19:00+02:00,2025-05-25,06:19,0,1,1
62,2025-05-24T22:17:00+02:00,2025-05-25,06:17,1,0,1
63,2025-05-24T22:17:00+02:00,2025-05-25,06:17,0,2,2
68,2025-05-24T22:15:00+02:00,2025-05-25,06:15,1,1,2
72,2025-05-24T22:24:00+02:00,2025-05-25,06:24,0,1,1
79,2025-05-24T22:13:00+02:00,2025-05-25,06:13,2,0,2
79,2025-05-24T22:14:00+02:00,2025-05-25,06:14,1,1,2
79,2025-05-24T22:23:00+02:00,2025-05-25,06:23,4,1,5
109,2025-05-24T22:20:00+02:00,2025-05-25,06:20,0,2,2
117,2025-05-24T22:10:00+02:00,2025-05-25,06:10,1,0,1
139,2025-05-24T22:20:00+02:00,2025-05-25,06:20,0,1,1
141,2025-05-24T22:20:00+02:00,2025-05-25,06:20,2,0,2
181,2025-05-24T22:28:00+02:00,2025-05-25,06:28,0,1,1
181,2025-05-24T22:30:00+02:00,2025-05-25,06:30,0,1,1
181,2025-05-24T22:35:00+02:00,2025-05-25,06:35,1,3,4
181,2025-05-24T22:36:00+02:00,2025-05-25,06:36,1,3,4
181,2025-05-24T22:39:00+02:00,2025-05-25,06:39,1,0,1
181,2025-05-24T22:10:00+02:00,2025-05-25,06:10,1,1,2
181,2025-05-24T22:12:00+02:00,2025-05-25,06:12,0,1,1
3,2025-05-24T23:26:00+02:00,2025-05-25,07:26,1,0,1
3,2025-05-24T23:31:00+02:00,2025-05-25,07:31,1,1,2
3,2025-05-24T23:39:00+02:00,2025-05-25,07:39,2,0,2
4,2025-05-24T23:25:00+02:00,2025-05-25,07:25,0,1,1
5,2025-05-24T23:35:00+02:00,2025-05-25,07:35,6,6,12
6,2025-05-24T23:26:00+02:00,2025-05-25,07:26,3,5,8
6,2025-05-24T23:27:00+02:00,2025-05-25,07:27,2,1,3
6,2025-05-24T23:32:00+02:00,2025-05-25,07:32,1,0,1
6,2025-05-24T23:34:00+02:00,2025-05-25,07:34,4,1,5
6,2025-05-24T23:39:00+02:00,2025-05-25,07:39,4,5,9
8,2025-05-24T23:26:00+02:00,2025-05-25,07:26,0,1,1
8,2025-05-24T23:35:00+02:00,2025-05-25,07:35,0,1,1
8,2025-05-24T23:36:00+02:00,2025-05-25,07:36,2,0,2
8,2025-05-24T23:38:00+02:00,2025-05-25,07:38,1,0,1
28,2025-05-24T23:28:00+02:00,2025-05-25,07:28,1,0,1
28,2025-05-24T23:31:00+02:00,2025-05-25,07:31,0,1,1
28,2025-05-24T23:32:00+02:00,2025-05-25,07:32,0,2,2
28,2025-05-24T23:34:00+02:00,2025-05-25,07:34,0,3,3
181,2025-05-25T14:28:00+02:00,2025-05-25,22:28,7,5,12
28,2025-05-24T23:39:00+02:00,2025-05-25,07:39,0,1,1
181,2025-05-25T14:31:00+02:00,2025-05-25,22:31,6,7,13
29,2025-05-24T23:29:00+02:00,2025-05-25,07:29,0,3,3
181,2025-05-25T14:32:00+02:00,2025-05-25,22:32,5,6,11
29,2025-05-24T23:35:00+02:00,2025-05-25,07:35,0,1,1
29,2025-05-24T23:37:00+02:00,2025-05-25,07:37,2,1,3
31,2025-05-24T23:32:00+02:00,2025-05-25,07:32,0,1,1
31,2025-05-24T23:33:00+02:00,2025-05-25,07:33,1,0,1
36,2025-05-24T23:28:00+02:00,2025-05-25,07:28,1,0,1
39,2025-05-24T23:32:00+02:00,2025-05-25,07:32,0,1,1
40,2025-05-24T23:30:00+02:00,2025-05-25,07:30,1,0,1
40,2025-05-24T23:31:00+02:00,2025-05-25,07:31,1,0,1
41,2025-05-24T23:29:00+02:00,2025-05-25,07:29,1,0,1
41,2025-05-24T23:39:00+02:00,2025-05-25,07:39,0,1,1
43,2025-05-24T23:30:00+02:00,2025-05-25,07:30,0,1,1
44,2025-05-24T23:25:00+02:00,2025-05-25,07:25,2,1,3
44,2025-05-24T23:35:00+02:00,2025-05-25,07:35,1,0,1
45,2025-05-24T23:25:00+02:00,2025-05-25,07:25,1,1,2
45,2025-05-24T23:27:00+02:00,2025-05-25,07:27,2,1,3
45,2025-05-24T23:30:00+02:00,2025-05-25,07:30,1,0,1
45,2025-05-24T23:34:00+02:00,2025-05-25,07:34,1,0,1
45,2025-05-24T23:36:00+02:00,2025-05-25,07:36,1,2,3
47,2025-05-24T23:28:00+02:00,2025-05-25,07:28,0,3,3
47,2025-05-24T23:30:00+02:00,2025-05-25,07:30,3,4,7
47,2025-05-24T23:37:00+02:00,2025-05-25,07:37,2,2,4
47,2025-05-24T23:38:00+02:00,2025-05-25,07:38,2,2,4
50,2025-05-24T23:28:00+02:00,2025-05-25,07:28,0,1,1
54,2025-05-24T23:32:00+02:00,2025-05-25,07:32,0,1,1
61,2025-05-24T23:28:00+02:00,2025-05-25,07:28,1,1,2
61,2025-05-24T23:29:00+02:00,2025-05-25,07:29,0,1,1
61,2025-05-24T23:36:00+02:00,2025-05-25,07:36,3,2,5
66,2025-05-24T23:25:00+02:00,2025-05-25,07:25,2,0,2
66,2025-05-24T23:32:00+02:00,2025-05-25,07:32,0,3,3
66,2025-05-24T23:35:00+02:00,2025-05-25,07:35,1,0,1
66,2025-05-24T23:37:00+02:00,2025-05-25,07:37,2,0,2
69,2025-05-24T23:29:00+02:00,2025-05-25,07:29,1,0,1
70,2025-05-24T23:37:00+02:00,2025-05-25,07:37,1,0,1
78,2025-05-24T23:33:00+02:00,2025-05-25,07:33,0,1,1
84,2025-05-24T23:30:00+02:00,2025-05-25,07:30,13,10,23
87,2025-05-24T23:26:00+02:00,2025-05-25,07:26,0,1,1
87,2025-05-24T23:38:00+02:00,2025-05-25,07:38,0,1,1
107,2025-05-24T23:30:00+02:00,2025-05-25,07:30,1,1,2
107,2025-05-24T23:35:00+02:00,2025-05-25,07:35,1,5,6
108,2025-05-24T23:32:00+02:00,2025-05-25,07:32,2,1,3
108,2025-05-24T23:36:00+02:00,2025-05-25,07:36,1,0,1
131,2025-05-24T23:30:00+02:00,2025-05-25,07:30,4,5,9
131,2025-05-24T23:35:00+02:00,2025-05-25,07:35,1,6,7
132,2025-05-24T23:25:00+02:00,2025-05-25,07:25,3,1,4
135,2025-05-24T23:25:00+02:00,2025-05-25,07:25,9,7,16
140,2025-05-24T23:35:00+02:00,2025-05-25,07:35,2,0,2
162,2025-05-24T23:25:00+02:00,2025-05-25,07:25,9,8,17
166,2025-05-24T23:30:00+02:00,2025-05-25,07:30,0,4,4
167,2025-05-24T23:30:00+02:00,2025-05-25,07:30,2,1,3
167,2025-05-24T23:35:00+02:00,2025-05-25,07:35,0,4,4
1,2025-05-24T23:25:00+02:00,2025-05-25,07:25,2,0,2
1,2025-05-24T23:32:00+02:00,2025-05-25,07:32,2,2,4
1,2025-05-24T23:33:00+02:00,2025-05-25,07:33,2,0,2
1,2025-05-24T23:35:00+02:00,2025-05-25,07:35,3,0,3
1,2025-05-24T23:36:00+02:00,2025-05-25,07:36,2,5,7
1,2025-05-24T23:39:00+02:00,2025-05-25,07:39,0,1,1
2,2025-05-24T23:27:00+02:00,2025-05-25,07:27,1,0,1
2,2025-05-24T23:30:00+02:00,2025-05-25,07:30,0,1,1
2,2025-05-24T23:37:00+02:00,2025-05-25,07:37,1,1,2
9,2025-05-24T23:25:00+02:00,2025-05-25,07:25,1,0,1
9,2025-05-24T23:28:00+02:00,2025-05-25,07:28,0,1,1
9,2025-05-24T23:29:00+02:00,2025-05-25,07:29,1,0,1
9,2025-05-24T23:38:00+02:00,2025-05-25,07:38,1,0,1
10,2025-05-24T23:39:00+02:00,2025-05-25,07:39,1,0,1
11,2025-05-24T23:28:00+02:00,2025-05-25,07:28,2,0,2
11,2025-05-24T23:34:00+02:00,2025-05-25,07:34,1,0,1
11,2025-05-24T23:35:00+02:00,2025-05-25,07:35,0,2,2
12,2025-05-24T23:27:00+02:00,2025-05-25,07:27,1,0,1
12,2025-05-24T23:32:00+02:00,2025-05-25,07:32,0,3,3
17,2025-05-24T23:25:00+02:00,2025-05-25,07:25,1,0,1
17,2025-05-24T23:30:00+02:00,2025-05-25,07:30,0,1,1
17,2025-05-24T23:35:00+02:00,2025-05-25,07:35,1,1,2
17,2025-05-24T23:36:00+02:00,2025-05-25,07:36,1,0,1
19,2025-05-24T23:27:00+02:00,2025-05-25,07:27,0,1,1
23,2025-05-24T23:30:00+02:00,2025-05-25,07:30,0,1,1
23,2025-05-24T23:33:00+02:00,2025-05-25,07:33,2,0,2
23,2025-05-24T23:34:00+02:00,2025-05-25,07:34,1,1,2
24,2025-05-24T23:30:00+02:00,2025-05-25,07:30,1,9,10
24,2025-05-24T23:31:00+02:00,2025-05-25,07:31,1,2,3
24,2025-05-24T23:32:00+02:00,2025-05-25,07:32,0,1,1
25,2025-05-24T23:25:00+02:00,2025-05-25,07:25,10,7,17
27,2025-05-24T23:29:00+02:00,2025-05-25,07:29,0,2,2
27,2025-05-24T23:34:00+02:00,2025-05-25,07:34,5,1,6
30,2025-05-24T23:29:00+02:00,2025-05-25,07:29,3,0,3
30,2025-05-24T23:37:00+02:00,2025-05-25,07:37,0,2,2
30,2025-05-24T23:38:00+02:00,2025-05-25,07:38,2,2,4
35,2025-05-24T23:25:00+02:00,2025-05-25,07:25,6,1,7
35,2025-05-24T23:30:00+02:00,2025-05-25,07:30,4,3,7
35,2025-05-24T23:31:00+02:00,2025-05-25,07:31,0,2,2
35,2025-05-24T23:32:00+02:00,2025-05-25,07:32,4,4,8
35,2025-05-24T23:36:00+02:00,2025-05-25,07:36,4,3,7
35,2025-05-24T23:39:00+02:00,2025-05-25,07:39,1,6,7
46,2025-05-24T23:30:00+02:00,2025-05-25,07:30,0,2,2
48,2025-05-24T23:25:00+02:00,2025-05-25,07:25,0,1,1
48,2025-05-24T23:27:00+02:00,2025-05-25,07:27,2,0,2
48,2025-05-24T23:30:00+02:00,2025-05-25,07:30,1,1,2
48,2025-05-24T23:31:00+02:00,2025-05-25,07:31,0,1,1
48,2025-05-24T23:32:00+02:00,2025-05-25,07:32,0,4,4
48,2025-05-24T23:34:00+02:00,2025-05-25,07:34,0,1,1
48,2025-05-24T23:35:00+02:00,2025-05-25,07:35,2,0,2
48,2025-05-24T23:36:00+02:00,2025-05-25,07:36,1,0,1
48,2025-05-24T23:37:00+02:00,2025-05-25,07:37,0,1,1
49,2025-05-24T23:26:00+02:00,2025-05-25,07:26,2,3,5
49,2025-05-24T23:27:00+02:00,2025-05-25,07:27,1,0,1
49,2025-05-24T23:38:00+02:00,2025-05-25,07:38,2,0,2
51,2025-05-24T23:28:00+02:00,2025-05-25,07:28,0,1,1
52,2025-05-24T23:27:00+02:00,2025-05-25,07:27,3,0,3
52,2025-05-24T23:32:00+02:00,2025-05-25,07:32,1,0,1
56,2025-05-24T23:25:00+02:00,2025-05-25,07:25,1,0,1
56,2025-05-24T23:34:00+02:00,2025-05-25,07:34,1,0,1
56,2025-05-24T23:35:00+02:00,2025-05-25,07:35,0,3,3
56,2025-05-24T23:36:00+02:00,2025-05-25,07:36,1,2,3
58,2025-05-24T23:28:00+02:00,2025-05-25,07:28,2,2,4
58,2025-05-24T23:32:00+02:00,2025-05-25,07:32,4,2,6
58,2025-05-24T23:33:00+02:00,2025-05-25,07:33,3,3,6
62,2025-05-24T23:25:00+02:00,2025-05-25,07:25,0,1,1
67,2025-05-24T23:27:00+02:00,2025-05-25,07:27,0,4,4
67,2025-05-24T23:29:00+02:00,2025-05-25,07:29,0,2,2
67,2025-05-24T23:35:00+02:00,2025-05-25,07:35,2,1,3
67,2025-05-24T23:39:00+02:00,2025-05-25,07:39,2,0,2
68,2025-05-24T23:25:00+02:00,2025-05-25,07:25,1,1,2
68,2025-05-24T23:29:00+02:00,2025-05-25,07:29,1,0,1
68,2025-05-24T23:30:00+02:00,2025-05-25,07:30,0,1,1
68,2025-05-24T23:34:00+02:00,2025-05-25,07:34,1,0,1
68,2025-05-24T23:36:00+02:00,2025-05-25,07:36,1,1,2
68,2025-05-24T23:38:00+02:00,2025-05-25,07:38,1,0,1
72,2025-05-24T23:26:00+02:00,2025-05-25,07:26,0,1,1
72,2025-05-24T23:28:00+02:00,2025-05-25,07:28,1,1,2
72,2025-05-24T23:36:00+02:00,2025-05-25,07:36,1,0,1
79,2025-05-24T23:33:00+02:00,2025-05-25,07:33,0,2,2
109,2025-05-24T23:35:00+02:00,2025-05-25,07:35,2,3,5
117,2025-05-24T23:30:00+02:00,2025-05-25,07:30,0,1,1
136,2025-05-24T23:30:00+02:00,2025-05-25,07:30,2,3,5
136,2025-05-24T23:35:00+02:00,2025-05-25,07:35,2,7,9
138,2025-05-24T23:25:00+02:00,2025-05-25,07:25,0,2,2
141,2025-05-24T23:25:00+02:00,2025-05-25,07:25,2,0,2
142,2025-05-24T23:35:00+02:00,2025-05-25,07:35,12,15,27
161,2025-05-24T23:30:00+02:00,2025-05-25,07:30,3,5,8
164,2025-05-24T23:30:00+02:00,2025-05-25,07:30,2,1,3
4,2025-05-24T22:40:00+02:00,2025-05-25,06:40,1,1,2
4,2025-05-24T22:47:00+02:00,2025-05-25,06:47,1,0,1
4,2025-05-24T22:48:00+02:00,2025-05-25,06:48,1,2,3
4,2025-05-24T22:53:00+02:00,2025-05-25,06:53,2,0,2
5,2025-05-24T22:40:00+02:00,2025-05-25,06:40,3,4,7
5,2025-05-24T22:50:00+02:00,2025-05-25,06:50,2,4,6
6,2025-05-24T22:42:00+02:00,2025-05-25,06:42,1,0,1
6,2025-05-24T22:46:00+02:00,2025-05-25,06:46,3,2,5
6,2025-05-24T22:49:00+02:00,2025-05-25,06:49,2,1,3
6,2025-05-24T22:52:00+02:00,2025-05-25,06:52,0,1,1
6,2025-05-24T22:53:00+02:00,2025-05-25,06:53,0,1,1
6,2025-05-24T22:54:00+02:00,2025-05-25,06:54,0,2,2
28,2025-05-24T22:43:00+02:00,2025-05-25,06:43,3,2,5
28,2025-05-24T22:44:00+02:00,2025-05-25,06:44,0,1,1
29,2025-05-24T22:47:00+02:00,2025-05-25,06:47,0,1,1
29,2025-05-24T22:49:00+02:00,2025-05-25,06:49,1,1,2
31,2025-05-24T22:45:00+02:00,2025-05-25,06:45,1,1,2
31,2025-05-24T22:46:00+02:00,2025-05-25,06:46,0,1,1
31,2025-05-24T22:47:00+02:00,2025-05-25,06:47,0,1,1
36,2025-05-24T22:44:00+02:00,2025-05-25,06:44,2,0,2
40,2025-05-24T22:44:00+02:00,2025-05-25,06:44,1,0,1
45,2025-05-24T22:43:00+02:00,2025-05-25,06:43,1,2,3
45,2025-05-24T22:44:00+02:00,2025-05-25,06:44,0,1,1
47,2025-05-24T22:42:00+02:00,2025-05-25,06:42,2,1,3
47,2025-05-24T22:44:00+02:00,2025-05-25,06:44,0,2,2
47,2025-05-24T22:45:00+02:00,2025-05-25,06:45,0,8,8
47,2025-05-24T22:50:00+02:00,2025-05-25,06:50,0,1,1
47,2025-05-24T22:53:00+02:00,2025-05-25,06:53,1,1,2
54,2025-05-24T22:53:00+02:00,2025-05-25,06:53,1,0,1
59,2025-05-24T22:40:00+02:00,2025-05-25,06:40,0,2,2
61,2025-05-24T22:40:00+02:00,2025-05-25,06:40,1,0,1
61,2025-05-24T22:46:00+02:00,2025-05-25,06:46,1,0,1
61,2025-05-24T22:48:00+02:00,2025-05-25,06:48,0,1,1
66,2025-05-24T22:53:00+02:00,2025-05-25,06:53,0,3,3
70,2025-05-24T22:51:00+02:00,2025-05-25,06:51,1,1,2
77,2025-05-24T22:50:00+02:00,2025-05-25,06:50,2,1,3
107,2025-05-24T22:45:00+02:00,2025-05-25,06:45,2,1,3
108,2025-05-24T22:41:00+02:00,2025-05-25,06:41,1,0,1
108,2025-05-24T22:42:00+02:00,2025-05-25,06:42,1,0,1
131,2025-05-24T22:40:00+02:00,2025-05-25,06:40,1,2,3
132,2025-05-24T22:40:00+02:00,2025-05-25,06:40,0,2,2
132,2025-05-24T22:50:00+02:00,2025-05-25,06:50,4,2,6
133,2025-05-24T22:40:00+02:00,2025-05-25,06:40,12,6,18
133,2025-05-24T22:45:00+02:00,2025-05-25,06:45,6,9,15
133,2025-05-24T22:50:00+02:00,2025-05-25,06:50,7,13,20
134,2025-05-24T22:45:00+02:00,2025-05-25,06:45,8,4,12
134,2025-05-24T22:50:00+02:00,2025-05-25,06:50,15,17,32
135,2025-05-24T22:50:00+02:00,2025-05-25,06:50,1,3,4
167,2025-05-24T22:40:00+02:00,2025-05-25,06:40,0,4,4
1,2025-05-24T22:40:00+02:00,2025-05-25,06:40,0,1,1
1,2025-05-24T22:47:00+02:00,2025-05-25,06:47,1,0,1
2,2025-05-24T22:44:00+02:00,2025-05-25,06:44,1,2,3
9,2025-05-24T22:44:00+02:00,2025-05-25,06:44,1,0,1
9,2025-05-24T22:47:00+02:00,2025-05-25,06:47,1,0,1
9,2025-05-24T22:48:00+02:00,2025-05-25,06:48,1,1,2
12,2025-05-24T22:40:00+02:00,2025-05-25,06:40,1,0,1
12,2025-05-24T22:45:00+02:00,2025-05-25,06:45,0,2,2
12,2025-05-24T22:51:00+02:00,2025-05-25,06:51,0,2,2
17,2025-05-24T22:42:00+02:00,2025-05-25,06:42,0,2,2
17,2025-05-24T22:52:00+02:00,2025-05-25,06:52,0,1,1
19,2025-05-24T22:49:00+02:00,2025-05-25,06:49,1,0,1
23,2025-05-24T22:42:00+02:00,2025-05-25,06:42,2,1,3
23,2025-05-24T22:51:00+02:00,2025-05-25,06:51,0,1,1
23,2025-05-24T22:53:00+02:00,2025-05-25,06:53,0,1,1
23,2025-05-24T22:54:00+02:00,2025-05-25,06:54,1,0,1
24,2025-05-24T22:40:00+02:00,2025-05-25,06:40,1,4,5
24,2025-05-24T22:41:00+02:00,2025-05-25,06:41,2,1,3
24,2025-05-24T22:49:00+02:00,2025-05-25,06:49,0,3,3
24,2025-05-24T22:50:00+02:00,2025-05-25,06:50,2,0,2
27,2025-05-24T22:44:00+02:00,2025-05-25,06:44,2,0,2
27,2025-05-24T22:51:00+02:00,2025-05-25,06:51,2,0,2
30,2025-05-24T22:42:00+02:00,2025-05-25,06:42,1,2,3
35,2025-05-24T22:41:00+02:00,2025-05-25,06:41,1,0,1
35,2025-05-24T22:49:00+02:00,2025-05-25,06:49,0,4,4
35,2025-05-24T22:51:00+02:00,2025-05-25,06:51,0,1,1
48,2025-05-24T22:44:00+02:00,2025-05-25,06:44,1,0,1
48,2025-05-24T22:45:00+02:00,2025-05-25,06:45,2,0,2
48,2025-05-24T22:48:00+02:00,2025-05-25,06:48,0,2,2
48,2025-05-24T22:53:00+02:00,2025-05-25,06:53,1,2,3
49,2025-05-24T22:48:00+02:00,2025-05-25,06:48,4,1,5
51,2025-05-24T22:50:00+02:00,2025-05-25,06:50,1,0,1
52,2025-05-24T22:45:00+02:00,2025-05-25,06:45,0,3,3
53,2025-05-24T22:50:00+02:00,2025-05-25,06:50,0,1,1
56,2025-05-24T22:48:00+02:00,2025-05-25,06:48,2,0,2
56,2025-05-24T22:50:00+02:00,2025-05-25,06:50,2,0,2
58,2025-05-24T22:40:00+02:00,2025-05-25,06:40,1,0,1
58,2025-05-24T22:45:00+02:00,2025-05-25,06:45,0,3,3
58,2025-05-24T22:47:00+02:00,2025-05-25,06:47,1,0,1
58,2025-05-24T22:54:00+02:00,2025-05-25,06:54,0,1,1
62,2025-05-24T22:40:00+02:00,2025-05-25,06:40,1,0,1
63,2025-05-24T22:42:00+02:00,2025-05-25,06:42,0,1,1
67,2025-05-24T22:42:00+02:00,2025-05-25,06:42,0,1,1
67,2025-05-24T22:48:00+02:00,2025-05-25,06:48,1,3,4
79,2025-05-24T22:46:00+02:00,2025-05-25,06:46,2,1,3
79,2025-05-24T22:49:00+02:00,2025-05-25,06:49,1,1,2
85,2025-05-24T22:50:00+02:00,2025-05-25,06:50,1,0,1
109,2025-05-24T22:40:00+02:00,2025-05-25,06:40,0,1,1
109,2025-05-24T22:50:00+02:00,2025-05-25,06:50,0,4,4
117,2025-05-24T22:40:00+02:00,2025-05-25,06:40,1,0,1
136,2025-05-24T22:40:00+02:00,2025-05-25,06:40,1,0,1
141,2025-05-24T22:45:00+02:00,2025-05-25,06:45,2,3,5
164,2025-05-24T22:40:00+02:00,2025-05-25,06:40,0,3,3
181,2025-05-24T22:40:00+02:00,2025-05-25,06:40,0,3,3
181,2025-05-24T22:41:00+02:00,2025-05-25,06:41,1,2,3
181,2025-05-24T22:50:00+02:00,2025-05-25,06:50,0,2,2
181,2025-05-24T22:53:00+02:00,2025-05-25,06:53,0,2,2
182,2025-05-24T22:45:00+02:00,2025-05-25,06:45,3,3,6
180,2025-05-24T22:50:00+02:00,2025-05-25,06:50,0,1,1
181,2025-05-24T22:55:00+02:00,2025-05-25,06:55,1,2,3
181,2025-05-24T23:05:00+02:00,2025-05-25,07:05,0,2,2
181,2025-05-24T23:09:00+02:00,2025-05-25,07:09,1,2,3
180,2025-05-24T22:57:00+02:00,2025-05-25,06:57,1,0,1
3,2025-05-24T22:56:00+02:00,2025-05-25,06:56,0,1,1
3,2025-05-24T23:01:00+02:00,2025-05-25,07:01,1,1,2
3,2025-05-24T23:09:00+02:00,2025-05-25,07:09,1,0,1
4,2025-05-24T23:00:00+02:00,2025-05-25,07:00,3,2,5
4,2025-05-24T23:04:00+02:00,2025-05-25,07:04,0,3,3
4,2025-05-24T23:06:00+02:00,2025-05-25,07:06,1,2,3
6,2025-05-24T22:56:00+02:00,2025-05-25,06:56,1,4,5
6,2025-05-24T22:59:00+02:00,2025-05-25,06:59,0,2,2
6,2025-05-24T23:02:00+02:00,2025-05-25,07:02,4,1,5
6,2025-05-24T23:04:00+02:00,2025-05-25,07:04,2,1,3
6,2025-05-24T23:07:00+02:00,2025-05-25,07:07,0,4,4
28,2025-05-24T23:02:00+02:00,2025-05-25,07:02,1,1,2
29,2025-05-24T22:57:00+02:00,2025-05-25,06:57,0,3,3
29,2025-05-24T23:00:00+02:00,2025-05-25,07:00,0,2,2
29,2025-05-24T23:06:00+02:00,2025-05-25,07:06,0,6,6
29,2025-05-24T23:07:00+02:00,2025-05-25,07:07,1,0,1
31,2025-05-24T23:03:00+02:00,2025-05-25,07:03,0,1,1
36,2025-05-24T23:06:00+02:00,2025-05-25,07:06,0,2,2
36,2025-05-24T23:07:00+02:00,2025-05-25,07:07,1,0,1
37,2025-05-24T23:06:00+02:00,2025-05-25,07:06,1,0,1
40,2025-05-24T22:57:00+02:00,2025-05-25,06:57,2,0,2
41,2025-05-24T22:55:00+02:00,2025-05-25,06:55,2,0,2
41,2025-05-24T23:00:00+02:00,2025-05-25,07:00,2,0,2
41,2025-05-24T23:03:00+02:00,2025-05-25,07:03,1,1,2
41,2025-05-24T23:06:00+02:00,2025-05-25,07:06,2,0,2
45,2025-05-24T23:02:00+02:00,2025-05-25,07:02,2,5,7
45,2025-05-24T23:05:00+02:00,2025-05-25,07:05,0,3,3
45,2025-05-24T23:07:00+02:00,2025-05-25,07:07,0,1,1
47,2025-05-24T22:59:00+02:00,2025-05-25,06:59,0,1,1
47,2025-05-24T23:01:00+02:00,2025-05-25,07:01,1,0,1
47,2025-05-24T23:03:00+02:00,2025-05-25,07:03,1,0,1
47,2025-05-24T23:04:00+02:00,2025-05-25,07:04,0,6,6
47,2025-05-24T23:06:00+02:00,2025-05-25,07:06,2,0,2
47,2025-05-24T23:09:00+02:00,2025-05-25,07:09,2,1,3
50,2025-05-24T22:58:00+02:00,2025-05-25,06:58,0,1,1
50,2025-05-24T22:59:00+02:00,2025-05-25,06:59,1,0,1
59,2025-05-24T23:00:00+02:00,2025-05-25,07:00,1,1,2
61,2025-05-24T22:57:00+02:00,2025-05-25,06:57,2,0,2
61,2025-05-24T22:59:00+02:00,2025-05-25,06:59,1,0,1
61,2025-05-24T23:02:00+02:00,2025-05-25,07:02,2,0,2
61,2025-05-24T23:07:00+02:00,2025-05-25,07:07,1,1,2
61,2025-05-24T23:08:00+02:00,2025-05-25,07:08,1,0,1
66,2025-05-24T22:55:00+02:00,2025-05-25,06:55,0,1,1
66,2025-05-24T22:56:00+02:00,2025-05-25,06:56,0,1,1
66,2025-05-24T23:00:00+02:00,2025-05-25,07:00,0,1,1
66,2025-05-24T23:01:00+02:00,2025-05-25,07:01,2,1,3
66,2025-05-24T23:07:00+02:00,2025-05-25,07:07,2,0,2
66,2025-05-24T23:08:00+02:00,2025-05-25,07:08,4,0,4
84,2025-05-24T22:55:00+02:00,2025-05-25,06:55,4,3,7
84,2025-05-24T23:00:00+02:00,2025-05-25,07:00,11,8,19
84,2025-05-24T23:05:00+02:00,2025-05-25,07:05,6,7,13
108,2025-05-24T23:01:00+02:00,2025-05-25,07:01,1,0,1
108,2025-05-24T23:09:00+02:00,2025-05-25,07:09,2,0,2
131,2025-05-24T22:55:00+02:00,2025-05-25,06:55,4,3,7
132,2025-05-24T22:55:00+02:00,2025-05-25,06:55,3,1,4
134,2025-05-24T22:55:00+02:00,2025-05-25,06:55,15,4,19
162,2025-05-24T22:55:00+02:00,2025-05-25,06:55,2,3,5
162,2025-05-24T23:00:00+02:00,2025-05-25,07:00,1,6,7
162,2025-05-24T23:05:00+02:00,2025-05-25,07:05,5,0,5
166,2025-05-24T23:00:00+02:00,2025-05-25,07:00,0,4,4
167,2025-05-24T22:55:00+02:00,2025-05-25,06:55,0,3,3
1,2025-05-24T22:58:00+02:00,2025-05-25,06:58,0,1,1
1,2025-05-24T23:02:00+02:00,2025-05-25,07:02,2,0,2
1,2025-05-24T23:09:00+02:00,2025-05-25,07:09,1,0,1
2,2025-05-24T23:00:00+02:00,2025-05-25,07:00,1,0,1
2,2025-05-24T23:01:00+02:00,2025-05-25,07:01,4,0,4
2,2025-05-24T23:04:00+02:00,2025-05-25,07:04,1,0,1
9,2025-05-24T23:00:00+02:00,2025-05-25,07:00,0,1,1
9,2025-05-24T23:04:00+02:00,2025-05-25,07:04,0,1,1
9,2025-05-24T23:05:00+02:00,2025-05-25,07:05,1,1,2
17,2025-05-24T23:00:00+02:00,2025-05-25,07:00,0,1,1
17,2025-05-24T23:03:00+02:00,2025-05-25,07:03,1,1,2
17,2025-05-24T23:05:00+02:00,2025-05-25,07:05,0,1,1
17,2025-05-24T23:06:00+02:00,2025-05-25,07:06,1,0,1
20,2025-05-24T22:55:00+02:00,2025-05-25,06:55,0,1,1
23,2025-05-24T22:57:00+02:00,2025-05-25,06:57,0,1,1
23,2025-05-24T23:00:00+02:00,2025-05-25,07:00,0,1,1
23,2025-05-24T23:05:00+02:00,2025-05-25,07:05,1,0,1
24,2025-05-24T23:02:00+02:00,2025-05-25,07:02,1,1,2
24,2025-05-24T23:04:00+02:00,2025-05-25,07:04,5,1,6
25,2025-05-24T23:00:00+02:00,2025-05-25,07:00,3,8,11
27,2025-05-24T22:56:00+02:00,2025-05-25,06:56,0,3,3
27,2025-05-24T22:57:00+02:00,2025-05-25,06:57,4,3,7
30,2025-05-24T22:56:00+02:00,2025-05-25,06:56,0,3,3
30,2025-05-24T22:57:00+02:00,2025-05-25,06:57,0,6,6
30,2025-05-24T22:58:00+02:00,2025-05-25,06:58,0,1,1
30,2025-05-24T23:00:00+02:00,2025-05-25,07:00,4,0,4
30,2025-05-24T23:07:00+02:00,2025-05-25,07:07,0,2,2
35,2025-05-24T22:56:00+02:00,2025-05-25,06:56,1,0,1
35,2025-05-24T22:59:00+02:00,2025-05-25,06:59,0,2,2
35,2025-05-24T23:03:00+02:00,2025-05-25,07:03,5,0,5
35,2025-05-24T23:04:00+02:00,2025-05-25,07:04,2,0,2
48,2025-05-24T22:59:00+02:00,2025-05-25,06:59,1,1,2
48,2025-05-24T23:04:00+02:00,2025-05-25,07:04,1,2,3
49,2025-05-24T23:01:00+02:00,2025-05-25,07:01,1,0,1
49,2025-05-24T23:07:00+02:00,2025-05-25,07:07,1,0,1
52,2025-05-24T22:55:00+02:00,2025-05-25,06:55,1,0,1
52,2025-05-24T23:05:00+02:00,2025-05-25,07:05,1,0,1
53,2025-05-24T22:55:00+02:00,2025-05-25,06:55,1,0,1
53,2025-05-24T22:56:00+02:00,2025-05-25,06:56,2,0,2
56,2025-05-24T22:58:00+02:00,2025-05-25,06:58,0,1,1
56,2025-05-24T22:59:00+02:00,2025-05-25,06:59,0,1,1
58,2025-05-24T23:02:00+02:00,2025-05-25,07:02,0,1,1
62,2025-05-24T22:58:00+02:00,2025-05-25,06:58,1,0,1
62,2025-05-24T23:03:00+02:00,2025-05-25,07:03,1,0,1
63,2025-05-24T22:57:00+02:00,2025-05-25,06:57,0,3,3
67,2025-05-24T23:06:00+02:00,2025-05-25,07:06,1,0,1
67,2025-05-24T23:08:00+02:00,2025-05-25,07:08,0,1,1
67,2025-05-24T23:09:00+02:00,2025-05-25,07:09,1,0,1
72,2025-05-24T23:00:00+02:00,2025-05-25,07:00,0,1,1
76,2025-05-24T23:00:00+02:00,2025-05-25,07:00,1,0,1
76,2025-05-24T23:05:00+02:00,2025-05-25,07:05,1,0,1
79,2025-05-24T23:04:00+02:00,2025-05-25,07:04,1,0,1
79,2025-05-24T23:06:00+02:00,2025-05-25,07:06,3,0,3
85,2025-05-24T22:57:00+02:00,2025-05-25,06:57,1,0,1
86,2025-05-24T23:07:00+02:00,2025-05-25,07:07,1,0,1
109,2025-05-24T22:55:00+02:00,2025-05-25,06:55,0,2,2
117,2025-05-24T22:55:00+02:00,2025-05-25,06:55,0,1,1
117,2025-05-24T23:00:00+02:00,2025-05-25,07:00,1,0,1
139,2025-05-24T23:05:00+02:00,2025-05-25,07:05,2,0,2
141,2025-05-24T23:05:00+02:00,2025-05-25,07:05,3,0,3
161,2025-05-24T23:00:00+02:00,2025-05-25,07:00,0,2,2
164,2025-05-24T22:55:00+02:00,2025-05-25,06:55,1,3,4
181,2025-05-24T23:10:00+02:00,2025-05-25,07:10,0,2,2
181,2025-05-24T23:13:00+02:00,2025-05-25,07:13,1,0,1
181,2025-05-24T23:14:00+02:00,2025-05-25,07:14,0,1,1
181,2025-05-24T23:17:00+02:00,2025-05-25,07:17,0,3,3
181,2025-05-24T23:23:00+02:00,2025-05-25,07:23,2,2,4
182,2025-05-24T23:15:00+02:00,2025-05-25,07:15,0,1,1
182,2025-05-24T23:20:00+02:00,2025-05-25,07:20,1,5,6
3,2025-05-24T23:13:00+02:00,2025-05-25,07:13,1,1,2
3,2025-05-24T23:18:00+02:00,2025-05-25,07:18,0,1,1
3,2025-05-24T23:24:00+02:00,2025-05-25,07:24,1,2,3
4,2025-05-24T23:10:00+02:00,2025-05-25,07:10,4,1,5
5,2025-05-24T23:10:00+02:00,2025-05-25,07:10,1,1,2
6,2025-05-24T23:12:00+02:00,2025-05-25,07:12,4,2,6
6,2025-05-24T23:13:00+02:00,2025-05-25,07:13,2,2,4
6,2025-05-24T23:17:00+02:00,2025-05-25,07:17,3,0,3
6,2025-05-24T23:18:00+02:00,2025-05-25,07:18,5,3,8
6,2025-05-24T23:20:00+02:00,2025-05-25,07:20,1,6,7
8,2025-05-24T23:11:00+02:00,2025-05-25,07:11,1,1,2
8,2025-05-24T23:19:00+02:00,2025-05-25,07:19,1,1,2
8,2025-05-24T23:23:00+02:00,2025-05-25,07:23,0,2,2
28,2025-05-24T23:10:00+02:00,2025-05-25,07:10,1,0,1
28,2025-05-24T23:23:00+02:00,2025-05-25,07:23,3,0,3
28,2025-05-24T23:24:00+02:00,2025-05-25,07:24,0,3,3
29,2025-05-24T23:10:00+02:00,2025-05-25,07:10,0,1,1
29,2025-05-24T23:16:00+02:00,2025-05-25,07:16,0,2,2
29,2025-05-24T23:18:00+02:00,2025-05-25,07:18,1,2,3
29,2025-05-24T23:23:00+02:00,2025-05-25,07:23,3,1,4
31,2025-05-24T23:20:00+02:00,2025-05-25,07:20,0,1,1
36,2025-05-24T23:13:00+02:00,2025-05-25,07:13,1,0,1
36,2025-05-24T23:20:00+02:00,2025-05-25,07:20,0,1,1
37,2025-05-24T23:24:00+02:00,2025-05-25,07:24,2,0,2
41,2025-05-24T23:20:00+02:00,2025-05-25,07:20,9,2,11
43,2025-05-24T23:10:00+02:00,2025-05-25,07:10,1,0,1
45,2025-05-24T23:10:00+02:00,2025-05-25,07:10,0,1,1
45,2025-05-24T23:11:00+02:00,2025-05-25,07:11,2,11,13
45,2025-05-24T23:16:00+02:00,2025-05-25,07:16,0,2,2
45,2025-05-24T23:19:00+02:00,2025-05-25,07:19,1,0,1
47,2025-05-24T23:11:00+02:00,2025-05-25,07:11,0,2,2
47,2025-05-24T23:12:00+02:00,2025-05-25,07:12,0,1,1
47,2025-05-24T23:18:00+02:00,2025-05-25,07:18,0,2,2
47,2025-05-24T23:21:00+02:00,2025-05-25,07:21,1,2,3
54,2025-05-24T23:10:00+02:00,2025-05-25,07:10,0,1,1
54,2025-05-24T23:11:00+02:00,2025-05-25,07:11,2,0,2
59,2025-05-24T23:10:00+02:00,2025-05-25,07:10,1,2,3
59,2025-05-24T23:15:00+02:00,2025-05-25,07:15,3,2,5
59,2025-05-24T23:20:00+02:00,2025-05-25,07:20,3,2,5
61,2025-05-24T23:12:00+02:00,2025-05-25,07:12,1,1,2
61,2025-05-24T23:16:00+02:00,2025-05-25,07:16,0,3,3
61,2025-05-24T23:22:00+02:00,2025-05-25,07:22,1,0,1
66,2025-05-24T23:11:00+02:00,2025-05-25,07:11,0,1,1
66,2025-05-24T23:14:00+02:00,2025-05-25,07:14,0,1,1
66,2025-05-24T23:20:00+02:00,2025-05-25,07:20,0,2,2
66,2025-05-24T23:22:00+02:00,2025-05-25,07:22,0,4,4
66,2025-05-24T23:23:00+02:00,2025-05-25,07:23,1,1,2
70,2025-05-24T23:14:00+02:00,2025-05-25,07:14,1,0,1
70,2025-05-24T23:24:00+02:00,2025-05-25,07:24,0,2,2
77,2025-05-24T23:20:00+02:00,2025-05-25,07:20,0,3,3
78,2025-05-24T23:14:00+02:00,2025-05-25,07:14,0,1,1
78,2025-05-24T23:18:00+02:00,2025-05-25,07:18,0,1,1
78,2025-05-24T23:20:00+02:00,2025-05-25,07:20,0,1,1
84,2025-05-24T23:10:00+02:00,2025-05-25,07:10,3,11,14
107,2025-05-24T23:15:00+02:00,2025-05-25,07:15,0,2,2
108,2025-05-24T23:17:00+02:00,2025-05-25,07:17,0,1,1
108,2025-05-24T23:18:00+02:00,2025-05-25,07:18,1,0,1
118,2025-05-24T23:20:00+02:00,2025-05-25,07:20,1,0,1
131,2025-05-24T23:15:00+02:00,2025-05-25,07:15,1,4,5
131,2025-05-24T23:20:00+02:00,2025-05-25,07:20,3,6,9
132,2025-05-24T23:10:00+02:00,2025-05-25,07:10,2,0,2
133,2025-05-24T23:10:00+02:00,2025-05-25,07:10,9,5,14
133,2025-05-24T23:15:00+02:00,2025-05-25,07:15,17,19,36
134,2025-05-24T23:10:00+02:00,2025-05-25,07:10,7,6,13
135,2025-05-24T23:15:00+02:00,2025-05-25,07:15,8,11,19
140,2025-05-24T23:10:00+02:00,2025-05-25,07:10,1,0,1
140,2025-05-24T23:15:00+02:00,2025-05-25,07:15,1,0,1
165,2025-05-24T23:15:00+02:00,2025-05-25,07:15,1,0,1
165,2025-05-24T23:20:00+02:00,2025-05-25,07:20,1,2,3
166,2025-05-24T23:10:00+02:00,2025-05-25,07:10,1,2,3
179,2025-05-24T23:10:00+02:00,2025-05-25,07:10,2,1,3
1,2025-05-24T23:17:00+02:00,2025-05-25,07:17,1,1,2
1,2025-05-24T23:19:00+02:00,2025-05-25,07:19,0,1,1
2,2025-05-24T23:16:00+02:00,2025-05-25,07:16,1,0,1
2,2025-05-24T23:18:00+02:00,2025-05-25,07:18,0,2,2
9,2025-05-24T23:13:00+02:00,2025-05-25,07:13,0,1,1
9,2025-05-24T23:18:00+02:00,2025-05-25,07:18,0,1,1
12,2025-05-24T23:15:00+02:00,2025-05-25,07:15,0,1,1
12,2025-05-24T23:22:00+02:00,2025-05-25,07:22,1,0,1
17,2025-05-24T23:12:00+02:00,2025-05-25,07:12,0,1,1
17,2025-05-24T23:13:00+02:00,2025-05-25,07:13,1,0,1
17,2025-05-24T23:19:00+02:00,2025-05-25,07:19,0,1,1
17,2025-05-24T23:21:00+02:00,2025-05-25,07:21,1,1,2
17,2025-05-24T23:22:00+02:00,2025-05-25,07:22,1,1,2
19,2025-05-24T23:12:00+02:00,2025-05-25,07:12,0,1,1
19,2025-05-24T23:22:00+02:00,2025-05-25,07:22,0,1,1
20,2025-05-24T23:16:00+02:00,2025-05-25,07:16,4,0,4
20,2025-05-24T23:19:00+02:00,2025-05-25,07:19,1,1,2
23,2025-05-24T23:22:00+02:00,2025-05-25,07:22,3,0,3
23,2025-05-24T23:24:00+02:00,2025-05-25,07:24,2,0,2
24,2025-05-24T23:10:00+02:00,2025-05-25,07:10,1,2,3
24,2025-05-24T23:11:00+02:00,2025-05-25,07:11,2,0,2
24,2025-05-24T23:13:00+02:00,2025-05-25,07:13,1,1,2
24,2025-05-24T23:22:00+02:00,2025-05-25,07:22,2,1,3
24,2025-05-24T23:23:00+02:00,2025-05-25,07:23,7,1,8
24,2025-05-24T23:24:00+02:00,2025-05-25,07:24,4,0,4
25,2025-05-24T23:10:00+02:00,2025-05-25,07:10,5,6,11
27,2025-05-24T23:18:00+02:00,2025-05-25,07:18,0,1,1
27,2025-05-24T23:22:00+02:00,2025-05-25,07:22,0,1,1
30,2025-05-24T23:14:00+02:00,2025-05-25,07:14,0,6,6
35,2025-05-24T23:11:00+02:00,2025-05-25,07:11,3,3,6
35,2025-05-24T23:12:00+02:00,2025-05-25,07:12,2,1,3
35,2025-05-24T23:15:00+02:00,2025-05-25,07:15,3,1,4
35,2025-05-24T23:17:00+02:00,2025-05-25,07:17,4,5,9
35,2025-05-24T23:19:00+02:00,2025-05-25,07:19,3,4,7
35,2025-05-24T23:23:00+02:00,2025-05-25,07:23,8,2,10
48,2025-05-24T23:11:00+02:00,2025-05-25,07:11,1,0,1
48,2025-05-24T23:18:00+02:00,2025-05-25,07:18,0,2,2
48,2025-05-24T23:19:00+02:00,2025-05-25,07:19,0,2,2
48,2025-05-24T23:23:00+02:00,2025-05-25,07:23,2,0,2
48,2025-05-24T23:24:00+02:00,2025-05-25,07:24,1,0,1
49,2025-05-24T23:17:00+02:00,2025-05-25,07:17,1,2,3
49,2025-05-24T23:21:00+02:00,2025-05-25,07:21,4,3,7
49,2025-05-24T23:23:00+02:00,2025-05-25,07:23,4,0,4
49,2025-05-24T23:24:00+02:00,2025-05-25,07:24,3,1,4
51,2025-05-24T23:11:00+02:00,2025-05-25,07:11,1,1,2
51,2025-05-24T23:17:00+02:00,2025-05-25,07:17,1,2,3
51,2025-05-24T23:21:00+02:00,2025-05-25,07:21,6,0,6
52,2025-05-24T23:10:00+02:00,2025-05-25,07:10,0,1,1
52,2025-05-24T23:14:00+02:00,2025-05-25,07:14,1,1,2
52,2025-05-24T23:16:00+02:00,2025-05-25,07:16,0,1,1
52,2025-05-24T23:17:00+02:00,2025-05-25,07:17,0,1,1
52,2025-05-24T23:24:00+02:00,2025-05-25,07:24,0,1,1
56,2025-05-24T23:16:00+02:00,2025-05-25,07:16,1,0,1
56,2025-05-24T23:19:00+02:00,2025-05-25,07:19,0,1,1
56,2025-05-24T23:23:00+02:00,2025-05-25,07:23,3,0,3
58,2025-05-24T23:11:00+02:00,2025-05-25,07:11,0,2,2
58,2025-05-24T23:13:00+02:00,2025-05-25,07:13,3,0,3
58,2025-05-24T23:14:00+02:00,2025-05-25,07:14,3,1,4
58,2025-05-24T23:24:00+02:00,2025-05-25,07:24,2,0,2
62,2025-05-24T23:10:00+02:00,2025-05-25,07:10,1,2,3
62,2025-05-24T23:12:00+02:00,2025-05-25,07:12,5,0,5
62,2025-05-24T23:14:00+02:00,2025-05-25,07:14,2,0,2
62,2025-05-24T23:18:00+02:00,2025-05-25,07:18,0,1,1
67,2025-05-24T23:11:00+02:00,2025-05-25,07:11,1,1,2
67,2025-05-24T23:18:00+02:00,2025-05-25,07:18,0,1,1
67,2025-05-24T23:20:00+02:00,2025-05-25,07:20,2,0,2
68,2025-05-24T23:22:00+02:00,2025-05-25,07:22,1,0,1
72,2025-05-24T23:18:00+02:00,2025-05-25,07:18,0,2,2
72,2025-05-24T23:19:00+02:00,2025-05-25,07:19,1,0,1
76,2025-05-24T23:12:00+02:00,2025-05-25,07:12,1,0,1
79,2025-05-24T23:17:00+02:00,2025-05-25,07:17,4,2,6
79,2025-05-24T23:19:00+02:00,2025-05-25,07:19,0,1,1
79,2025-05-24T23:23:00+02:00,2025-05-25,07:23,1,0,1
86,2025-05-24T23:18:00+02:00,2025-05-25,07:18,1,0,1
109,2025-05-24T23:10:00+02:00,2025-05-25,07:10,6,3,9
109,2025-05-24T23:15:00+02:00,2025-05-25,07:15,1,1,2
123,2025-05-24T23:10:00+02:00,2025-05-25,07:10,3,1,4
123,2025-05-24T23:20:00+02:00,2025-05-25,07:20,2,0,2
136,2025-05-24T23:10:00+02:00,2025-05-25,07:10,2,2,4
141,2025-05-24T23:15:00+02:00,2025-05-25,07:15,5,4,9
142,2025-05-24T23:20:00+02:00,2025-05-25,07:20,11,4,15
161,2025-05-24T23:15:00+02:00,2025-05-25,07:15,3,6,9
161,2025-05-24T23:20:00+02:00,2025-05-25,07:20,23,4,27
164,2025-05-24T23:15:00+02:00,2025-05-25,07:15,1,0,1
181,2025-05-24T23:26:00+02:00,2025-05-25,07:26,0,2,2
181,2025-05-24T23:27:00+02:00,2025-05-25,07:27,0,3,3
181,2025-05-24T23:29:00+02:00,2025-05-25,07:29,1,0,1
181,2025-05-24T23:34:00+02:00,2025-05-25,07:34,3,4,7
181,2025-05-24T23:36:00+02:00,2025-05-25,07:36,2,1,3
180,2025-05-24T23:39:00+02:00,2025-05-25,07:39,1,0,1
3,2025-05-24T23:46:00+02:00,2025-05-25,07:46,2,0,2
3,2025-05-24T23:51:00+02:00,2025-05-25,07:51,2,0,2
3,2025-05-24T23:54:00+02:00,2025-05-25,07:54,2,0,2
4,2025-05-24T23:42:00+02:00,2025-05-25,07:42,1,4,5
4,2025-05-24T23:47:00+02:00,2025-05-25,07:47,0,3,3
4,2025-05-24T23:48:00+02:00,2025-05-25,07:48,2,2,4
3,2025-05-25T14:40:00+02:00,2025-05-25,22:40,3,1,4
4,2025-05-24T23:49:00+02:00,2025-05-25,07:49,0,1,1
3,2025-05-25T14:43:00+02:00,2025-05-25,22:43,0,3,3
4,2025-05-24T23:53:00+02:00,2025-05-25,07:53,2,0,2
3,2025-05-25T14:44:00+02:00,2025-05-25,22:44,3,10,13
6,2025-05-24T23:43:00+02:00,2025-05-25,07:43,1,4,5
3,2025-05-25T14:46:00+02:00,2025-05-25,22:46,5,4,9
6,2025-05-24T23:45:00+02:00,2025-05-25,07:45,3,1,4
3,2025-05-25T14:50:00+02:00,2025-05-25,22:50,13,5,18
6,2025-05-24T23:47:00+02:00,2025-05-25,07:47,1,0,1
6,2025-05-24T23:50:00+02:00,2025-05-25,07:50,4,1,5
6,2025-05-24T23:53:00+02:00,2025-05-25,07:53,3,2,5
8,2025-05-24T23:40:00+02:00,2025-05-25,07:40,1,3,4
8,2025-05-24T23:46:00+02:00,2025-05-25,07:46,1,1,2
28,2025-05-24T23:41:00+02:00,2025-05-25,07:41,0,1,1
28,2025-05-24T23:46:00+02:00,2025-05-25,07:46,2,1,3
28,2025-05-24T23:47:00+02:00,2025-05-25,07:47,1,0,1
28,2025-05-24T23:48:00+02:00,2025-05-25,07:48,0,1,1
28,2025-05-24T23:54:00+02:00,2025-05-25,07:54,2,1,3
29,2025-05-24T23:41:00+02:00,2025-05-25,07:41,1,2,3
29,2025-05-24T23:42:00+02:00,2025-05-25,07:42,3,9,12
29,2025-05-24T23:48:00+02:00,2025-05-25,07:48,0,3,3
29,2025-05-24T23:50:00+02:00,2025-05-25,07:50,3,5,8
4,2025-05-25T14:43:00+02:00,2025-05-25,22:43,1,5,6
36,2025-05-24T23:41:00+02:00,2025-05-25,07:41,1,0,1
4,2025-05-25T14:47:00+02:00,2025-05-25,22:47,3,0,3
36,2025-05-24T23:46:00+02:00,2025-05-25,07:46,1,1,2
4,2025-05-25T14:48:00+02:00,2025-05-25,22:48,1,0,1
37,2025-05-24T23:52:00+02:00,2025-05-25,07:52,0,2,2
4,2025-05-25T14:51:00+02:00,2025-05-25,22:51,0,1,1
40,2025-05-24T23:46:00+02:00,2025-05-25,07:46,0,1,1
4,2025-05-25T14:52:00+02:00,2025-05-25,22:52,0,6,6
40,2025-05-24T23:51:00+02:00,2025-05-25,07:51,0,1,1
4,2025-05-25T14:53:00+02:00,2025-05-25,22:53,1,6,7
41,2025-05-24T23:40:00+02:00,2025-05-25,07:40,1,0,1
41,2025-05-24T23:45:00+02:00,2025-05-25,07:45,3,0,3
41,2025-05-24T23:52:00+02:00,2025-05-25,07:52,0,1,1
43,2025-05-24T23:40:00+02:00,2025-05-25,07:40,0,2,2
43,2025-05-24T23:45:00+02:00,2025-05-25,07:45,1,0,1
44,2025-05-24T23:40:00+02:00,2025-05-25,07:40,0,2,2
45,2025-05-24T23:40:00+02:00,2025-05-25,07:40,5,1,6
45,2025-05-24T23:50:00+02:00,2025-05-25,07:50,4,0,4
47,2025-05-24T23:41:00+02:00,2025-05-25,07:41,1,1,2
47,2025-05-24T23:42:00+02:00,2025-05-25,07:42,2,2,4
47,2025-05-24T23:49:00+02:00,2025-05-25,07:49,1,6,7
47,2025-05-24T23:50:00+02:00,2025-05-25,07:50,0,1,1
47,2025-05-24T23:51:00+02:00,2025-05-25,07:51,4,2,6
47,2025-05-24T23:52:00+02:00,2025-05-25,07:52,1,3,4
50,2025-05-24T23:47:00+02:00,2025-05-25,07:47,0,1,1
50,2025-05-24T23:54:00+02:00,2025-05-25,07:54,1,0,1
54,2025-05-24T23:43:00+02:00,2025-05-25,07:43,2,1,3
54,2025-05-24T23:45:00+02:00,2025-05-25,07:45,0,1,1
54,2025-05-24T23:50:00+02:00,2025-05-25,07:50,2,0,2
6,2025-05-25T14:41:00+02:00,2025-05-25,22:41,6,0,6
59,2025-05-24T23:45:00+02:00,2025-05-25,07:45,2,2,4
6,2025-05-25T14:43:00+02:00,2025-05-25,22:43,7,4,11
61,2025-05-24T23:40:00+02:00,2025-05-25,07:40,1,1,2
6,2025-05-25T14:45:00+02:00,2025-05-25,22:45,4,2,6
61,2025-05-24T23:53:00+02:00,2025-05-25,07:53,1,0,1
6,2025-05-25T14:47:00+02:00,2025-05-25,22:47,7,3,10
66,2025-05-24T23:40:00+02:00,2025-05-25,07:40,0,2,2
6,2025-05-25T14:51:00+02:00,2025-05-25,22:51,8,4,12
66,2025-05-24T23:42:00+02:00,2025-05-25,07:42,0,1,1
66,2025-05-24T23:47:00+02:00,2025-05-25,07:47,0,1,1
66,2025-05-24T23:50:00+02:00,2025-05-25,07:50,1,1,2
66,2025-05-24T23:53:00+02:00,2025-05-25,07:53,0,3,3
66,2025-05-24T23:54:00+02:00,2025-05-25,07:54,0,2,2
69,2025-05-24T23:41:00+02:00,2025-05-25,07:41,2,0,2
69,2025-05-24T23:46:00+02:00,2025-05-25,07:46,0,2,2
69,2025-05-24T23:49:00+02:00,2025-05-25,07:49,1,0,1
70,2025-05-24T23:43:00+02:00,2025-05-25,07:43,0,2,2
70,2025-05-24T23:45:00+02:00,2025-05-25,07:45,1,0,1
70,2025-05-24T23:46:00+02:00,2025-05-25,07:46,2,0,2
70,2025-05-24T23:49:00+02:00,2025-05-25,07:49,0,2,2
71,2025-05-24T23:48:00+02:00,2025-05-25,07:48,1,0,1
75,2025-05-24T23:45:00+02:00,2025-05-25,07:45,2,1,3
75,2025-05-24T23:51:00+02:00,2025-05-25,07:51,2,0,2
77,2025-05-24T23:45:00+02:00,2025-05-25,07:45,2,5,7
78,2025-05-24T23:42:00+02:00,2025-05-25,07:42,0,1,1
78,2025-05-24T23:43:00+02:00,2025-05-25,07:43,0,1,1
21,2025-05-25T14:40:00+02:00,2025-05-25,22:40,2,4,6
78,2025-05-24T23:47:00+02:00,2025-05-25,07:47,0,2,2
78,2025-05-24T23:54:00+02:00,2025-05-25,07:54,0,1,1
84,2025-05-24T23:40:00+02:00,2025-05-25,07:40,10,16,26
87,2025-05-24T23:47:00+02:00,2025-05-25,07:47,1,0,1
28,2025-05-25T14:44:00+02:00,2025-05-25,22:44,0,2,2
87,2025-05-24T23:51:00+02:00,2025-05-25,07:51,1,0,1
28,2025-05-25T14:49:00+02:00,2025-05-25,22:49,2,0,2
87,2025-05-24T23:53:00+02:00,2025-05-25,07:53,1,0,1
107,2025-05-24T23:40:00+02:00,2025-05-25,07:40,0,1,1
107,2025-05-24T23:50:00+02:00,2025-05-25,07:50,4,4,8
108,2025-05-24T23:47:00+02:00,2025-05-25,07:47,1,2,3
131,2025-05-24T23:45:00+02:00,2025-05-25,07:45,0,7,7
131,2025-05-24T23:50:00+02:00,2025-05-25,07:50,2,0,2
132,2025-05-24T23:45:00+02:00,2025-05-25,07:45,1,0,1
132,2025-05-24T23:50:00+02:00,2025-05-25,07:50,6,2,8
133,2025-05-24T23:40:00+02:00,2025-05-25,07:40,28,30,58
29,2025-05-25T14:44:00+02:00,2025-05-25,22:44,2,2,4
134,2025-05-24T23:40:00+02:00,2025-05-25,07:40,3,12,15
29,2025-05-25T14:45:00+02:00,2025-05-25,22:45,3,0,3
135,2025-05-24T23:45:00+02:00,2025-05-25,07:45,6,2,8
29,2025-05-25T14:48:00+02:00,2025-05-25,22:48,0,3,3
140,2025-05-24T23:50:00+02:00,2025-05-25,07:50,1,1,2
29,2025-05-25T14:53:00+02:00,2025-05-25,22:53,1,1,2
162,2025-05-24T23:45:00+02:00,2025-05-25,07:45,9,5,14
29,2025-05-25T14:54:00+02:00,2025-05-25,22:54,1,0,1
165,2025-05-24T23:50:00+02:00,2025-05-25,07:50,0,2,2
166,2025-05-24T23:40:00+02:00,2025-05-25,07:40,0,1,1
167,2025-05-24T23:40:00+02:00,2025-05-25,07:40,0,2,2
167,2025-05-24T23:45:00+02:00,2025-05-25,07:45,0,3,3
31,2025-05-25T14:45:00+02:00,2025-05-25,22:45,1,5,6
167,2025-05-24T23:50:00+02:00,2025-05-25,07:50,1,3,4
31,2025-05-25T14:50:00+02:00,2025-05-25,22:50,1,2,3
1,2025-05-24T23:50:00+02:00,2025-05-25,07:50,2,0,2
31,2025-05-25T14:52:00+02:00,2025-05-25,22:52,1,0,1
1,2025-05-24T23:51:00+02:00,2025-05-25,07:51,5,2,7
9,2025-05-24T23:44:00+02:00,2025-05-25,07:44,1,0,1
9,2025-05-24T23:48:00+02:00,2025-05-25,07:48,0,3,3
9,2025-05-24T23:50:00+02:00,2025-05-25,07:50,2,0,2
11,2025-05-24T23:45:00+02:00,2025-05-25,07:45,2,0,2
11,2025-05-24T23:50:00+02:00,2025-05-25,07:50,0,2,2
12,2025-05-24T23:40:00+02:00,2025-05-25,07:40,1,0,1
36,2025-05-25T14:43:00+02:00,2025-05-25,22:43,1,2,3
12,2025-05-24T23:42:00+02:00,2025-05-25,07:42,0,1,1
36,2025-05-25T14:44:00+02:00,2025-05-25,22:44,1,0,1
12,2025-05-24T23:43:00+02:00,2025-05-25,07:43,0,1,1
36,2025-05-25T14:46:00+02:00,2025-05-25,22:46,2,0,2
12,2025-05-24T23:46:00+02:00,2025-05-25,07:46,1,0,1
36,2025-05-25T14:50:00+02:00,2025-05-25,22:50,1,0,1
12,2025-05-24T23:47:00+02:00,2025-05-25,07:47,1,1,2
36,2025-05-25T14:51:00+02:00,2025-05-25,22:51,4,0,4
17,2025-05-24T23:40:00+02:00,2025-05-25,07:40,0,2,2
17,2025-05-24T23:41:00+02:00,2025-05-25,07:41,1,0,1
17,2025-05-24T23:45:00+02:00,2025-05-25,07:45,1,0,1
17,2025-05-24T23:51:00+02:00,2025-05-25,07:51,1,0,1
17,2025-05-24T23:53:00+02:00,2025-05-25,07:53,0,1,1
19,2025-05-24T23:41:00+02:00,2025-05-25,07:41,1,0,1
20,2025-05-24T23:42:00+02:00,2025-05-25,07:42,1,0,1
37,2025-05-25T14:45:00+02:00,2025-05-25,22:45,0,2,2
20,2025-05-24T23:45:00+02:00,2025-05-25,07:45,0,2,2
37,2025-05-25T14:46:00+02:00,2025-05-25,22:46,2,0,2
23,2025-05-24T23:49:00+02:00,2025-05-25,07:49,2,0,2
37,2025-05-25T14:53:00+02:00,2025-05-25,22:53,0,3,3
23,2025-05-24T23:51:00+02:00,2025-05-25,07:51,0,1,1
23,2025-05-24T23:54:00+02:00,2025-05-25,07:54,2,0,2
24,2025-05-24T23:43:00+02:00,2025-05-25,07:43,1,2,3
24,2025-05-24T23:48:00+02:00,2025-05-25,07:48,3,3,6
24,2025-05-24T23:50:00+02:00,2025-05-25,07:50,0,2,2
24,2025-05-24T23:51:00+02:00,2025-05-25,07:51,1,2,3
24,2025-05-24T23:52:00+02:00,2025-05-25,07:52,0,2,2
24,2025-05-24T23:53:00+02:00,2025-05-25,07:53,0,1,1
24,2025-05-24T23:54:00+02:00,2025-05-25,07:54,1,4,5
25,2025-05-24T23:40:00+02:00,2025-05-25,07:40,9,28,37
27,2025-05-24T23:45:00+02:00,2025-05-25,07:45,1,0,1
40,2025-05-25T14:41:00+02:00,2025-05-25,22:41,0,1,1
27,2025-05-24T23:48:00+02:00,2025-05-25,07:48,0,3,3
40,2025-05-25T14:45:00+02:00,2025-05-25,22:45,0,2,2
27,2025-05-24T23:50:00+02:00,2025-05-25,07:50,0,1,1
40,2025-05-25T14:46:00+02:00,2025-05-25,22:46,0,1,1
27,2025-05-24T23:51:00+02:00,2025-05-25,07:51,0,1,1
40,2025-05-25T14:47:00+02:00,2025-05-25,22:47,0,1,1
30,2025-05-24T23:41:00+02:00,2025-05-25,07:41,0,1,1
40,2025-05-25T14:48:00+02:00,2025-05-25,22:48,1,0,1
30,2025-05-24T23:48:00+02:00,2025-05-25,07:48,1,0,1
35,2025-05-24T23:40:00+02:00,2025-05-25,07:40,3,6,9
35,2025-05-24T23:46:00+02:00,2025-05-25,07:46,3,2,5
46,2025-05-24T23:40:00+02:00,2025-05-25,07:40,0,2,2
41,2025-05-25T14:43:00+02:00,2025-05-25,22:43,0,4,4
48,2025-05-24T23:42:00+02:00,2025-05-25,07:42,1,4,5
41,2025-05-25T14:44:00+02:00,2025-05-25,22:44,0,1,1
48,2025-05-24T23:53:00+02:00,2025-05-25,07:53,0,1,1
41,2025-05-25T14:47:00+02:00,2025-05-25,22:47,0,2,2
49,2025-05-24T23:42:00+02:00,2025-05-25,07:42,0,5,5
41,2025-05-25T14:51:00+02:00,2025-05-25,22:51,0,1,1
49,2025-05-24T23:43:00+02:00,2025-05-25,07:43,1,0,1
41,2025-05-25T14:54:00+02:00,2025-05-25,22:54,1,0,1
49,2025-05-24T23:48:00+02:00,2025-05-25,07:48,0,2,2
51,2025-05-24T23:45:00+02:00,2025-05-25,07:45,0,5,5
51,2025-05-24T23:47:00+02:00,2025-05-25,07:47,0,1,1
52,2025-05-24T23:48:00+02:00,2025-05-25,07:48,0,1,1
52,2025-05-24T23:52:00+02:00,2025-05-25,07:52,1,0,1
53,2025-05-24T23:45:00+02:00,2025-05-25,07:45,5,0,5
53,2025-05-24T23:48:00+02:00,2025-05-25,07:48,2,0,2
53,2025-05-24T23:49:00+02:00,2025-05-25,07:49,1,1,2
56,2025-05-24T23:46:00+02:00,2025-05-25,07:46,2,0,2
56,2025-05-24T23:48:00+02:00,2025-05-25,07:48,4,0,4
58,2025-05-24T23:40:00+02:00,2025-05-25,07:40,5,0,5
58,2025-05-24T23:46:00+02:00,2025-05-25,07:46,1,0,1
58,2025-05-24T23:47:00+02:00,2025-05-25,07:47,2,0,2
45,2025-05-25T14:43:00+02:00,2025-05-25,22:43,6,2,8
58,2025-05-24T23:50:00+02:00,2025-05-25,07:50,1,1,2
45,2025-05-25T14:49:00+02:00,2025-05-25,22:49,2,0,2
58,2025-05-24T23:53:00+02:00,2025-05-25,07:53,3,3,6
45,2025-05-25T14:50:00+02:00,2025-05-25,22:50,4,1,5
63,2025-05-24T23:41:00+02:00,2025-05-25,07:41,4,0,4
45,2025-05-25T14:51:00+02:00,2025-05-25,22:51,1,3,4
63,2025-05-24T23:43:00+02:00,2025-05-25,07:43,0,2,2
45,2025-05-25T14:52:00+02:00,2025-05-25,22:52,1,4,5
63,2025-05-24T23:45:00+02:00,2025-05-25,07:45,2,0,2
67,2025-05-24T23:41:00+02:00,2025-05-25,07:41,0,1,1
67,2025-05-24T23:42:00+02:00,2025-05-25,07:42,0,3,3
67,2025-05-24T23:43:00+02:00,2025-05-25,07:43,1,1,2
67,2025-05-24T23:47:00+02:00,2025-05-25,07:47,0,4,4
67,2025-05-24T23:51:00+02:00,2025-05-25,07:51,1,0,1
67,2025-05-24T23:53:00+02:00,2025-05-25,07:53,2,1,3
68,2025-05-24T23:40:00+02:00,2025-05-25,07:40,0,2,2
68,2025-05-24T23:41:00+02:00,2025-05-25,07:41,0,2,2
68,2025-05-24T23:51:00+02:00,2025-05-25,07:51,1,0,1
68,2025-05-24T23:53:00+02:00,2025-05-25,07:53,3,0,3
72,2025-05-24T23:41:00+02:00,2025-05-25,07:41,2,0,2
47,2025-05-25T14:41:00+02:00,2025-05-25,22:41,0,1,1
72,2025-05-24T23:48:00+02:00,2025-05-25,07:48,0,1,1
47,2025-05-25T14:44:00+02:00,2025-05-25,22:44,3,2,5
72,2025-05-24T23:53:00+02:00,2025-05-25,07:53,0,9,9
47,2025-05-25T14:46:00+02:00,2025-05-25,22:46,3,1,4
76,2025-05-24T23:46:00+02:00,2025-05-25,07:46,2,0,2
47,2025-05-25T14:52:00+02:00,2025-05-25,22:52,5,0,5
79,2025-05-24T23:41:00+02:00,2025-05-25,07:41,1,0,1
79,2025-05-24T23:45:00+02:00,2025-05-25,07:45,0,1,1
79,2025-05-24T23:49:00+02:00,2025-05-25,07:49,3,0,3
79,2025-05-24T23:50:00+02:00,2025-05-25,07:50,2,0,2
79,2025-05-24T23:53:00+02:00,2025-05-25,07:53,1,0,1
86,2025-05-24T23:44:00+02:00,2025-05-25,07:44,1,0,1
109,2025-05-24T23:50:00+02:00,2025-05-25,07:50,4,1,5
117,2025-05-24T23:45:00+02:00,2025-05-25,07:45,0,1,1
136,2025-05-24T23:50:00+02:00,2025-05-25,07:50,0,3,3
137,2025-05-24T23:40:00+02:00,2025-05-25,07:40,0,2,2
139,2025-05-24T23:40:00+02:00,2025-05-25,07:40,0,1,1
139,2025-05-24T23:45:00+02:00,2025-05-25,07:45,0,2,2
139,2025-05-24T23:50:00+02:00,2025-05-25,07:50,2,2,4
141,2025-05-24T23:45:00+02:00,2025-05-25,07:45,6,0,6
142,2025-05-24T23:50:00+02:00,2025-05-25,07:50,13,10,23
50,2025-05-25T14:54:00+02:00,2025-05-25,22:54,3,0,3
54,2025-05-25T14:46:00+02:00,2025-05-25,22:46,0,3,3
181,2025-05-24T23:41:00+02:00,2025-05-25,07:41,0,1,1
54,2025-05-25T14:47:00+02:00,2025-05-25,22:47,1,3,4
181,2025-05-24T23:42:00+02:00,2025-05-25,07:42,0,2,2
54,2025-05-25T14:48:00+02:00,2025-05-25,22:48,1,0,1
181,2025-05-24T23:43:00+02:00,2025-05-25,07:43,0,2,2
54,2025-05-25T14:51:00+02:00,2025-05-25,22:51,1,4,5
181,2025-05-24T23:44:00+02:00,2025-05-25,07:44,0,1,1
54,2025-05-25T14:52:00+02:00,2025-05-25,22:52,2,3,5
181,2025-05-24T23:45:00+02:00,2025-05-25,07:45,0,2,2
181,2025-05-24T23:47:00+02:00,2025-05-25,07:47,1,2,3
180,2025-05-24T23:43:00+02:00,2025-05-25,07:43,1,0,1
180,2025-05-24T23:54:00+02:00,2025-05-25,07:54,2,0,2
59,2025-05-25T14:40:00+02:00,2025-05-25,22:40,10,3,13
61,2025-05-25T14:42:00+02:00,2025-05-25,22:42,6,0,6
61,2025-05-25T14:49:00+02:00,2025-05-25,22:49,0,1,1
61,2025-05-25T14:52:00+02:00,2025-05-25,22:52,2,2,4
61,2025-05-25T14:54:00+02:00,2025-05-25,22:54,1,1,2
181,2025-05-24T23:56:00+02:00,2025-05-25,07:56,1,5,6
181,2025-05-25T00:00:00+02:00,2025-05-25,08:00,1,3,4
181,2025-05-25T00:01:00+02:00,2025-05-25,08:01,0,4,4
181,2025-05-25T00:06:00+02:00,2025-05-25,08:06,2,2,4
66,2025-05-25T14:41:00+02:00,2025-05-25,22:41,10,6,16
66,2025-05-25T14:51:00+02:00,2025-05-25,22:51,4,7,11
3,2025-05-25T00:03:00+02:00,2025-05-25,08:03,0,1,1
4,2025-05-24T23:57:00+02:00,2025-05-25,07:57,2,2,4
4,2025-05-25T00:00:00+02:00,2025-05-25,08:00,1,0,1
4,2025-05-25T00:07:00+02:00,2025-05-25,08:07,3,1,4
5,2025-05-25T00:05:00+02:00,2025-05-25,08:05,9,13,22
6,2025-05-24T23:55:00+02:00,2025-05-25,07:55,0,1,1
6,2025-05-25T00:02:00+02:00,2025-05-25,08:02,0,3,3
6,2025-05-25T00:04:00+02:00,2025-05-25,08:04,2,3,5
6,2025-05-25T00:06:00+02:00,2025-05-25,08:06,5,4,9
6,2025-05-25T00:08:00+02:00,2025-05-25,08:08,1,2,3
6,2025-05-25T00:09:00+02:00,2025-05-25,08:09,7,1,8
8,2025-05-25T00:00:00+02:00,2025-05-25,08:00,0,1,1
8,2025-05-25T00:02:00+02:00,2025-05-25,08:02,0,3,3
8,2025-05-25T00:03:00+02:00,2025-05-25,08:03,0,4,4
8,2025-05-25T00:04:00+02:00,2025-05-25,08:04,1,5,6
70,2025-05-25T14:45:00+02:00,2025-05-25,22:45,0,1,1
8,2025-05-25T00:06:00+02:00,2025-05-25,08:06,2,1,3
8,2025-05-25T00:08:00+02:00,2025-05-25,08:08,0,2,2
8,2025-05-25T00:09:00+02:00,2025-05-25,08:09,1,1,2
71,2025-05-25T14:51:00+02:00,2025-05-25,22:51,0,2,2
28,2025-05-25T00:03:00+02:00,2025-05-25,08:03,1,0,1
28,2025-05-25T00:04:00+02:00,2025-05-25,08:04,2,2,4
29,2025-05-24T23:55:00+02:00,2025-05-25,07:55,0,11,11
29,2025-05-25T00:06:00+02:00,2025-05-25,08:06,3,3,6
75,2025-05-25T14:42:00+02:00,2025-05-25,22:42,0,1,1
29,2025-05-25T00:08:00+02:00,2025-05-25,08:08,1,2,3
75,2025-05-25T14:49:00+02:00,2025-05-25,22:49,0,1,1
31,2025-05-24T23:55:00+02:00,2025-05-25,07:55,1,0,1
31,2025-05-25T00:00:00+02:00,2025-05-25,08:00,1,1,2
31,2025-05-25T00:03:00+02:00,2025-05-25,08:03,0,1,1
31,2025-05-25T00:08:00+02:00,2025-05-25,08:08,1,1,2
36,2025-05-24T23:55:00+02:00,2025-05-25,07:55,3,0,3
37,2025-05-25T00:01:00+02:00,2025-05-25,08:01,2,0,2
39,2025-05-25T00:04:00+02:00,2025-05-25,08:04,2,0,2
84,2025-05-25T14:40:00+02:00,2025-05-25,22:40,20,36,56
39,2025-05-25T00:08:00+02:00,2025-05-25,08:08,1,0,1
40,2025-05-25T00:03:00+02:00,2025-05-25,08:03,0,1,1
40,2025-05-25T00:08:00+02:00,2025-05-25,08:08,1,0,1
41,2025-05-24T23:58:00+02:00,2025-05-25,07:58,0,2,2
41,2025-05-24T23:59:00+02:00,2025-05-25,07:59,1,0,1
41,2025-05-25T00:05:00+02:00,2025-05-25,08:05,1,0,1
107,2025-05-25T14:50:00+02:00,2025-05-25,22:50,1,2,3
41,2025-05-25T00:08:00+02:00,2025-05-25,08:08,4,1,5
43,2025-05-24T23:55:00+02:00,2025-05-25,07:55,1,3,4
44,2025-05-24T23:55:00+02:00,2025-05-25,07:55,0,3,3
45,2025-05-24T23:58:00+02:00,2025-05-25,07:58,3,1,4
45,2025-05-25T00:03:00+02:00,2025-05-25,08:03,0,4,4
108,2025-05-25T14:44:00+02:00,2025-05-25,22:44,0,3,3
45,2025-05-25T00:05:00+02:00,2025-05-25,08:05,2,0,2
108,2025-05-25T14:48:00+02:00,2025-05-25,22:48,1,2,3
45,2025-05-25T00:07:00+02:00,2025-05-25,08:07,0,1,1
108,2025-05-25T14:53:00+02:00,2025-05-25,22:53,5,1,6
47,2025-05-24T23:56:00+02:00,2025-05-25,07:56,1,2,3
47,2025-05-24T23:57:00+02:00,2025-05-25,07:57,6,8,14
47,2025-05-24T23:58:00+02:00,2025-05-25,07:58,6,4,10
47,2025-05-24T23:59:00+02:00,2025-05-25,07:59,0,3,3
47,2025-05-25T00:04:00+02:00,2025-05-25,08:04,0,1,1
47,2025-05-25T00:05:00+02:00,2025-05-25,08:05,0,2,2
47,2025-05-25T00:06:00+02:00,2025-05-25,08:06,0,1,1
61,2025-05-24T23:57:00+02:00,2025-05-25,07:57,2,3,5
61,2025-05-25T00:01:00+02:00,2025-05-25,08:01,0,1,1
118,2025-05-25T14:50:00+02:00,2025-05-25,22:50,2,2,4
61,2025-05-25T00:02:00+02:00,2025-05-25,08:02,2,1,3
131,2025-05-25T14:50:00+02:00,2025-05-25,22:50,2,1,3
61,2025-05-25T00:06:00+02:00,2025-05-25,08:06,1,4,5
61,2025-05-25T00:07:00+02:00,2025-05-25,08:07,2,0,2
61,2025-05-25T00:08:00+02:00,2025-05-25,08:08,0,2,2
66,2025-05-25T00:00:00+02:00,2025-05-25,08:00,0,1,1
66,2025-05-25T00:04:00+02:00,2025-05-25,08:04,1,1,2
66,2025-05-25T00:08:00+02:00,2025-05-25,08:08,0,3,3
66,2025-05-25T00:09:00+02:00,2025-05-25,08:09,0,1,1
133,2025-05-25T14:50:00+02:00,2025-05-25,22:50,4,6,10
69,2025-05-25T00:09:00+02:00,2025-05-25,08:09,0,4,4
70,2025-05-25T00:01:00+02:00,2025-05-25,08:01,1,0,1
75,2025-05-25T00:09:00+02:00,2025-05-25,08:09,1,1,2
77,2025-05-24T23:55:00+02:00,2025-05-25,07:55,4,3,7
78,2025-05-24T23:57:00+02:00,2025-05-25,07:57,0,1,1
78,2025-05-24T23:58:00+02:00,2025-05-25,07:58,0,2,2
134,2025-05-25T14:45:00+02:00,2025-05-25,22:45,6,2,8
78,2025-05-25T00:00:00+02:00,2025-05-25,08:00,0,1,1
134,2025-05-25T14:50:00+02:00,2025-05-25,22:50,9,6,15
78,2025-05-25T00:02:00+02:00,2025-05-25,08:02,0,2,2
78,2025-05-25T00:06:00+02:00,2025-05-25,08:06,0,2,2
84,2025-05-25T00:00:00+02:00,2025-05-25,08:00,12,18,30
84,2025-05-25T00:05:00+02:00,2025-05-25,08:05,27,15,42
87,2025-05-24T23:57:00+02:00,2025-05-25,07:57,0,1,1
87,2025-05-25T00:02:00+02:00,2025-05-25,08:02,0,2,2
135,2025-05-25T14:45:00+02:00,2025-05-25,22:45,2,13,15
108,2025-05-25T00:00:00+02:00,2025-05-25,08:00,0,1,1
108,2025-05-25T00:08:00+02:00,2025-05-25,08:08,0,1,1
108,2025-05-25T00:09:00+02:00,2025-05-25,08:09,1,3,4
162,2025-05-25T14:50:00+02:00,2025-05-25,22:50,2,1,3
118,2025-05-25T00:05:00+02:00,2025-05-25,08:05,0,1,1
131,2025-05-25T00:05:00+02:00,2025-05-25,08:05,3,2,5
132,2025-05-24T23:55:00+02:00,2025-05-25,07:55,3,2,5
132,2025-05-25T00:00:00+02:00,2025-05-25,08:00,1,1,2
133,2025-05-25T00:05:00+02:00,2025-05-25,08:05,19,24,43
165,2025-05-25T14:40:00+02:00,2025-05-25,22:40,1,0,1
134,2025-05-25T00:05:00+02:00,2025-05-25,08:05,29,21,50
162,2025-05-25T00:00:00+02:00,2025-05-25,08:00,13,4,17
165,2025-05-24T23:55:00+02:00,2025-05-25,07:55,4,0,4
166,2025-05-24T23:55:00+02:00,2025-05-25,07:55,0,2,2
167,2025-05-25T00:00:00+02:00,2025-05-25,08:00,1,2,3
167,2025-05-25T00:05:00+02:00,2025-05-25,08:05,2,3,5
179,2025-05-24T23:55:00+02:00,2025-05-25,07:55,3,1,4
179,2025-05-25T00:00:00+02:00,2025-05-25,08:00,1,1,2
179,2025-05-25T00:05:00+02:00,2025-05-25,08:05,2,2,4
1,2025-05-24T23:58:00+02:00,2025-05-25,07:58,1,2,3
1,2025-05-25T00:09:00+02:00,2025-05-25,08:09,1,1,2
1,2025-05-25T14:42:00+02:00,2025-05-25,22:42,3,0,3
2,2025-05-25T00:02:00+02:00,2025-05-25,08:02,1,1,2
1,2025-05-25T14:47:00+02:00,2025-05-25,22:47,7,0,7
9,2025-05-24T23:57:00+02:00,2025-05-25,07:57,0,1,1
1,2025-05-25T14:53:00+02:00,2025-05-25,22:53,0,2,2
9,2025-05-25T00:00:00+02:00,2025-05-25,08:00,1,0,1
9,2025-05-25T00:06:00+02:00,2025-05-25,08:06,2,2,4
9,2025-05-25T00:08:00+02:00,2025-05-25,08:08,2,0,2
11,2025-05-24T23:56:00+02:00,2025-05-25,07:56,0,1,1
11,2025-05-25T00:03:00+02:00,2025-05-25,08:03,0,1,1
11,2025-05-25T00:07:00+02:00,2025-05-25,08:07,1,2,3
12,2025-05-25T00:02:00+02:00,2025-05-25,08:02,1,0,1
17,2025-05-24T23:55:00+02:00,2025-05-25,07:55,2,1,3
17,2025-05-24T23:59:00+02:00,2025-05-25,07:59,0,1,1
17,2025-05-25T00:03:00+02:00,2025-05-25,08:03,0,1,1
18,2025-05-24T23:55:00+02:00,2025-05-25,07:55,1,0,1
18,2025-05-25T00:03:00+02:00,2025-05-25,08:03,0,1,1
19,2025-05-25T00:02:00+02:00,2025-05-25,08:02,1,1,2
20,2025-05-25T00:05:00+02:00,2025-05-25,08:05,0,2,2
20,2025-05-25T00:08:00+02:00,2025-05-25,08:08,3,0,3
23,2025-05-24T23:56:00+02:00,2025-05-25,07:56,1,0,1
23,2025-05-24T23:59:00+02:00,2025-05-25,07:59,2,0,2
23,2025-05-25T00:00:00+02:00,2025-05-25,08:00,0,2,2
23,2025-05-25T00:03:00+02:00,2025-05-25,08:03,1,0,1
2,2025-05-25T14:49:00+02:00,2025-05-25,22:49,0,3,3
24,2025-05-24T23:58:00+02:00,2025-05-25,07:58,0,2,2
24,2025-05-25T00:02:00+02:00,2025-05-25,08:02,3,2,5
24,2025-05-25T00:06:00+02:00,2025-05-25,08:06,2,1,3
24,2025-05-25T00:08:00+02:00,2025-05-25,08:08,0,3,3
25,2025-05-24T23:55:00+02:00,2025-05-25,07:55,20,14,34
27,2025-05-25T00:00:00+02:00,2025-05-25,08:00,2,0,2
30,2025-05-24T23:59:00+02:00,2025-05-25,07:59,0,1,1
30,2025-05-25T00:02:00+02:00,2025-05-25,08:02,2,5,7
30,2025-05-25T00:03:00+02:00,2025-05-25,08:03,0,2,2
30,2025-05-25T00:04:00+02:00,2025-05-25,08:04,3,2,5
9,2025-05-25T14:54:00+02:00,2025-05-25,22:54,0,1,1
30,2025-05-25T00:05:00+02:00,2025-05-25,08:05,1,5,6
30,2025-05-25T00:06:00+02:00,2025-05-25,08:06,0,2,2
30,2025-05-25T00:08:00+02:00,2025-05-25,08:08,3,1,4
10,2025-05-25T14:54:00+02:00,2025-05-25,22:54,1,0,1
35,2025-05-24T23:59:00+02:00,2025-05-25,07:59,5,4,9
35,2025-05-25T00:05:00+02:00,2025-05-25,08:05,0,5,5
12,2025-05-25T14:42:00+02:00,2025-05-25,22:42,1,1,2
35,2025-05-25T00:09:00+02:00,2025-05-25,08:09,10,3,13
12,2025-05-25T14:46:00+02:00,2025-05-25,22:46,4,0,4
46,2025-05-25T00:00:00+02:00,2025-05-25,08:00,1,0,1
48,2025-05-24T23:56:00+02:00,2025-05-25,07:56,1,3,4
48,2025-05-24T23:58:00+02:00,2025-05-25,07:58,0,3,3
49,2025-05-24T23:58:00+02:00,2025-05-25,07:58,2,5,7
49,2025-05-25T00:03:00+02:00,2025-05-25,08:03,1,0,1
49,2025-05-25T00:05:00+02:00,2025-05-25,08:05,1,4,5
49,2025-05-25T00:06:00+02:00,2025-05-25,08:06,0,1,1
49,2025-05-25T00:08:00+02:00,2025-05-25,08:08,3,0,3
17,2025-05-25T14:44:00+02:00,2025-05-25,22:44,0,2,2
49,2025-05-25T00:09:00+02:00,2025-05-25,08:09,1,1,2
51,2025-05-25T00:00:00+02:00,2025-05-25,08:00,1,0,1
19,2025-05-25T14:43:00+02:00,2025-05-25,22:43,3,7,10
51,2025-05-25T00:09:00+02:00,2025-05-25,08:09,0,1,1
19,2025-05-25T14:45:00+02:00,2025-05-25,22:45,1,2,3
52,2025-05-24T23:56:00+02:00,2025-05-25,07:56,1,0,1
19,2025-05-25T14:48:00+02:00,2025-05-25,22:48,8,0,8
52,2025-05-25T00:09:00+02:00,2025-05-25,08:09,1,1,2
19,2025-05-25T14:49:00+02:00,2025-05-25,22:49,1,0,1
53,2025-05-24T23:56:00+02:00,2025-05-25,07:56,1,0,1
19,2025-05-25T14:53:00+02:00,2025-05-25,22:53,5,0,5
53,2025-05-24T23:57:00+02:00,2025-05-25,07:57,1,1,2
19,2025-05-25T14:54:00+02:00,2025-05-25,22:54,2,1,3
53,2025-05-25T00:00:00+02:00,2025-05-25,08:00,0,1,1
58,2025-05-24T23:55:00+02:00,2025-05-25,07:55,0,2,2
58,2025-05-24T23:57:00+02:00,2025-05-25,07:57,1,0,1
58,2025-05-25T00:08:00+02:00,2025-05-25,08:08,5,4,9
58,2025-05-25T00:09:00+02:00,2025-05-25,08:09,1,2,3
62,2025-05-25T00:04:00+02:00,2025-05-25,08:04,1,0,1
62,2025-05-25T00:09:00+02:00,2025-05-25,08:09,3,1,4
63,2025-05-24T23:58:00+02:00,2025-05-25,07:58,0,2,2
63,2025-05-25T00:00:00+02:00,2025-05-25,08:00,0,1,1
63,2025-05-25T00:03:00+02:00,2025-05-25,08:03,4,1,5
63,2025-05-25T00:07:00+02:00,2025-05-25,08:07,0,1,1
67,2025-05-24T23:55:00+02:00,2025-05-25,07:55,1,0,1
67,2025-05-24T23:59:00+02:00,2025-05-25,07:59,0,2,2
67,2025-05-25T00:04:00+02:00,2025-05-25,08:04,1,0,1
68,2025-05-24T23:55:00+02:00,2025-05-25,07:55,1,0,1
68,2025-05-25T00:01:00+02:00,2025-05-25,08:01,2,0,2
68,2025-05-25T00:09:00+02:00,2025-05-25,08:09,4,0,4
20,2025-05-25T14:41:00+02:00,2025-05-25,22:41,0,4,4
72,2025-05-24T23:57:00+02:00,2025-05-25,07:57,1,0,1
20,2025-05-25T14:42:00+02:00,2025-05-25,22:42,2,1,3
72,2025-05-24T23:58:00+02:00,2025-05-25,07:58,0,1,1
20,2025-05-25T14:48:00+02:00,2025-05-25,22:48,8,2,10
72,2025-05-25T00:04:00+02:00,2025-05-25,08:04,0,1,1
20,2025-05-25T14:49:00+02:00,2025-05-25,22:49,5,3,8
72,2025-05-25T00:05:00+02:00,2025-05-25,08:05,0,1,1
20,2025-05-25T14:54:00+02:00,2025-05-25,22:54,9,1,10
72,2025-05-25T00:08:00+02:00,2025-05-25,08:08,1,2,3
76,2025-05-25T00:04:00+02:00,2025-05-25,08:04,0,2,2
76,2025-05-25T00:09:00+02:00,2025-05-25,08:09,1,0,1
79,2025-05-24T23:56:00+02:00,2025-05-25,07:56,4,0,4
79,2025-05-24T23:58:00+02:00,2025-05-25,07:58,2,1,3
79,2025-05-25T00:06:00+02:00,2025-05-25,08:06,0,2,2
79,2025-05-25T00:07:00+02:00,2025-05-25,08:07,6,2,8
23,2025-05-25T14:40:00+02:00,2025-05-25,22:40,0,3,3
85,2025-05-25T00:00:00+02:00,2025-05-25,08:00,4,0,4
23,2025-05-25T14:45:00+02:00,2025-05-25,22:45,2,1,3
85,2025-05-25T00:01:00+02:00,2025-05-25,08:01,0,2,2
23,2025-05-25T14:48:00+02:00,2025-05-25,22:48,1,0,1
109,2025-05-24T23:55:00+02:00,2025-05-25,07:55,3,2,5
23,2025-05-25T14:51:00+02:00,2025-05-25,22:51,2,1,3
109,2025-05-25T00:05:00+02:00,2025-05-25,08:05,1,3,4
23,2025-05-25T14:53:00+02:00,2025-05-25,22:53,3,3,6
117,2025-05-24T23:55:00+02:00,2025-05-25,07:55,2,4,6
117,2025-05-25T00:05:00+02:00,2025-05-25,08:05,2,0,2
123,2025-05-25T00:00:00+02:00,2025-05-25,08:00,1,1,2
130,2025-05-25T00:05:00+02:00,2025-05-25,08:05,2,1,3
136,2025-05-25T00:05:00+02:00,2025-05-25,08:05,6,6,12
139,2025-05-24T23:55:00+02:00,2025-05-25,07:55,1,0,1
141,2025-05-25T00:05:00+02:00,2025-05-25,08:05,4,2,6
142,2025-05-25T00:05:00+02:00,2025-05-25,08:05,16,14,30
161,2025-05-24T23:55:00+02:00,2025-05-25,07:55,6,14,20
161,2025-05-25T00:00:00+02:00,2025-05-25,08:00,7,8,15
24,2025-05-25T14:41:00+02:00,2025-05-25,22:41,0,5,5
164,2025-05-24T23:55:00+02:00,2025-05-25,07:55,1,2,3
24,2025-05-25T14:43:00+02:00,2025-05-25,22:43,7,8,15
24,2025-05-25T14:44:00+02:00,2025-05-25,22:44,1,6,7
24,2025-05-25T14:45:00+02:00,2025-05-25,22:45,1,0,1
24,2025-05-25T14:47:00+02:00,2025-05-25,22:47,1,7,8
24,2025-05-25T14:48:00+02:00,2025-05-25,22:48,3,1,4
24,2025-05-25T14:49:00+02:00,2025-05-25,22:49,1,0,1
24,2025-05-25T14:52:00+02:00,2025-05-25,22:52,2,2,4
181,2025-05-25T00:11:00+02:00,2025-05-25,08:11,0,5,5
24,2025-05-25T14:53:00+02:00,2025-05-25,22:53,0,26,26
181,2025-05-25T00:15:00+02:00,2025-05-25,08:15,4,4,8
24,2025-05-25T14:54:00+02:00,2025-05-25,22:54,0,2,2
181,2025-05-25T00:16:00+02:00,2025-05-25,08:16,1,3,4
181,2025-05-25T00:17:00+02:00,2025-05-25,08:17,0,1,1
181,2025-05-25T00:23:00+02:00,2025-05-25,08:23,0,3,3
182,2025-05-25T00:20:00+02:00,2025-05-25,08:20,2,7,9
25,2025-05-25T14:45:00+02:00,2025-05-25,22:45,2,1,3
25,2025-05-25T14:50:00+02:00,2025-05-25,22:50,3,9,12
3,2025-05-25T00:22:00+02:00,2025-05-25,08:22,1,0,1
4,2025-05-25T00:10:00+02:00,2025-05-25,08:10,1,1,2
4,2025-05-25T00:13:00+02:00,2025-05-25,08:13,3,5,8
4,2025-05-25T00:14:00+02:00,2025-05-25,08:14,1,3,4
30,2025-05-25T14:44:00+02:00,2025-05-25,22:44,4,0,4
4,2025-05-25T00:15:00+02:00,2025-05-25,08:15,2,1,3
30,2025-05-25T14:45:00+02:00,2025-05-25,22:45,8,4,12
4,2025-05-25T00:18:00+02:00,2025-05-25,08:18,4,2,6
30,2025-05-25T14:50:00+02:00,2025-05-25,22:50,4,2,6
4,2025-05-25T00:19:00+02:00,2025-05-25,08:19,0,2,2
30,2025-05-25T14:51:00+02:00,2025-05-25,22:51,0,3,3
5,2025-05-25T00:20:00+02:00,2025-05-25,08:20,7,8,15
30,2025-05-25T14:53:00+02:00,2025-05-25,22:53,7,1,8
6,2025-05-25T00:12:00+02:00,2025-05-25,08:12,2,8,10
6,2025-05-25T00:15:00+02:00,2025-05-25,08:15,1,0,1
6,2025-05-25T00:18:00+02:00,2025-05-25,08:18,2,0,2
6,2025-05-25T00:21:00+02:00,2025-05-25,08:21,0,2,2
6,2025-05-25T00:22:00+02:00,2025-05-25,08:22,3,0,3
6,2025-05-25T00:23:00+02:00,2025-05-25,08:23,6,16,22
6,2025-05-25T00:24:00+02:00,2025-05-25,08:24,5,2,7
8,2025-05-25T00:10:00+02:00,2025-05-25,08:10,2,0,2
8,2025-05-25T00:11:00+02:00,2025-05-25,08:11,0,2,2
8,2025-05-25T00:18:00+02:00,2025-05-25,08:18,0,1,1
8,2025-05-25T00:19:00+02:00,2025-05-25,08:19,2,0,2
8,2025-05-25T00:22:00+02:00,2025-05-25,08:22,1,3,4
28,2025-05-25T00:12:00+02:00,2025-05-25,08:12,3,0,3
28,2025-05-25T00:16:00+02:00,2025-05-25,08:16,1,2,3
28,2025-05-25T00:17:00+02:00,2025-05-25,08:17,0,2,2
28,2025-05-25T00:18:00+02:00,2025-05-25,08:18,1,0,1
28,2025-05-25T00:24:00+02:00,2025-05-25,08:24,4,2,6
29,2025-05-25T00:12:00+02:00,2025-05-25,08:12,3,3,6
35,2025-05-25T14:42:00+02:00,2025-05-25,22:42,1,3,4
29,2025-05-25T00:14:00+02:00,2025-05-25,08:14,1,1,2
35,2025-05-25T14:44:00+02:00,2025-05-25,22:44,1,1,2
29,2025-05-25T00:15:00+02:00,2025-05-25,08:15,1,1,2
35,2025-05-25T14:46:00+02:00,2025-05-25,22:46,0,1,1
29,2025-05-25T00:18:00+02:00,2025-05-25,08:18,1,8,9
35,2025-05-25T14:48:00+02:00,2025-05-25,22:48,4,0,4
36,2025-05-25T00:10:00+02:00,2025-05-25,08:10,1,0,1
35,2025-05-25T14:50:00+02:00,2025-05-25,22:50,3,5,8
36,2025-05-25T00:13:00+02:00,2025-05-25,08:13,1,4,5
36,2025-05-25T00:15:00+02:00,2025-05-25,08:15,0,2,2
36,2025-05-25T00:19:00+02:00,2025-05-25,08:19,0,1,1
36,2025-05-25T00:24:00+02:00,2025-05-25,08:24,0,1,1
37,2025-05-25T00:12:00+02:00,2025-05-25,08:12,0,2,2
37,2025-05-25T00:14:00+02:00,2025-05-25,08:14,0,1,1
37,2025-05-25T00:15:00+02:00,2025-05-25,08:15,0,1,1
37,2025-05-25T00:20:00+02:00,2025-05-25,08:20,0,1,1
39,2025-05-25T00:15:00+02:00,2025-05-25,08:15,1,0,1
39,2025-05-25T00:18:00+02:00,2025-05-25,08:18,1,0,1
39,2025-05-25T00:20:00+02:00,2025-05-25,08:20,2,0,2
39,2025-05-25T00:21:00+02:00,2025-05-25,08:21,0,2,2
40,2025-05-25T00:13:00+02:00,2025-05-25,08:13,0,1,1
41,2025-05-25T00:12:00+02:00,2025-05-25,08:12,0,1,1
41,2025-05-25T00:22:00+02:00,2025-05-25,08:22,2,1,3
43,2025-05-25T00:15:00+02:00,2025-05-25,08:15,2,0,2
48,2025-05-25T14:40:00+02:00,2025-05-25,22:40,1,0,1
43,2025-05-25T00:20:00+02:00,2025-05-25,08:20,2,0,2
48,2025-05-25T14:45:00+02:00,2025-05-25,22:45,2,0,2
45,2025-05-25T00:10:00+02:00,2025-05-25,08:10,1,0,1
48,2025-05-25T14:47:00+02:00,2025-05-25,22:47,1,0,1
45,2025-05-25T00:20:00+02:00,2025-05-25,08:20,2,1,3
47,2025-05-25T00:12:00+02:00,2025-05-25,08:12,2,1,3
47,2025-05-25T00:13:00+02:00,2025-05-25,08:13,0,1,1
47,2025-05-25T00:15:00+02:00,2025-05-25,08:15,2,4,6
47,2025-05-25T00:21:00+02:00,2025-05-25,08:21,0,2,2
54,2025-05-25T00:11:00+02:00,2025-05-25,08:11,0,2,2
54,2025-05-25T00:12:00+02:00,2025-05-25,08:12,1,0,1
59,2025-05-25T00:10:00+02:00,2025-05-25,08:10,6,1,7
59,2025-05-25T00:15:00+02:00,2025-05-25,08:15,5,2,7
61,2025-05-25T00:12:00+02:00,2025-05-25,08:12,7,2,9
61,2025-05-25T00:16:00+02:00,2025-05-25,08:16,1,0,1
61,2025-05-25T00:17:00+02:00,2025-05-25,08:17,0,1,1
61,2025-05-25T00:18:00+02:00,2025-05-25,08:18,1,3,4
61,2025-05-25T00:20:00+02:00,2025-05-25,08:20,1,0,1
61,2025-05-25T00:23:00+02:00,2025-05-25,08:23,2,0,2
66,2025-05-25T00:21:00+02:00,2025-05-25,08:21,0,1,1
69,2025-05-25T00:13:00+02:00,2025-05-25,08:13,3,0,3
69,2025-05-25T00:16:00+02:00,2025-05-25,08:16,0,2,2
69,2025-05-25T00:23:00+02:00,2025-05-25,08:23,0,3,3
70,2025-05-25T00:13:00+02:00,2025-05-25,08:13,1,0,1
70,2025-05-25T00:18:00+02:00,2025-05-25,08:18,1,1,2
70,2025-05-25T00:19:00+02:00,2025-05-25,08:19,4,1,5
52,2025-05-25T14:49:00+02:00,2025-05-25,22:49,0,8,8
70,2025-05-25T00:20:00+02:00,2025-05-25,08:20,2,2,4
52,2025-05-25T14:50:00+02:00,2025-05-25,22:50,0,1,1
70,2025-05-25T00:21:00+02:00,2025-05-25,08:21,0,1,1
52,2025-05-25T14:54:00+02:00,2025-05-25,22:54,2,2,4
75,2025-05-25T00:18:00+02:00,2025-05-25,08:18,1,0,1
75,2025-05-25T00:22:00+02:00,2025-05-25,08:22,3,0,3
77,2025-05-25T00:10:00+02:00,2025-05-25,08:10,1,3,4
77,2025-05-25T00:20:00+02:00,2025-05-25,08:20,9,2,11
78,2025-05-25T00:12:00+02:00,2025-05-25,08:12,4,1,5
78,2025-05-25T00:15:00+02:00,2025-05-25,08:15,1,1,2
78,2025-05-25T00:17:00+02:00,2025-05-25,08:17,0,1,1
78,2025-05-25T00:19:00+02:00,2025-05-25,08:19,1,0,1
53,2025-05-25T14:41:00+02:00,2025-05-25,22:41,1,0,1
78,2025-05-25T00:21:00+02:00,2025-05-25,08:21,2,2,4
53,2025-05-25T14:42:00+02:00,2025-05-25,22:42,1,0,1
84,2025-05-25T00:15:00+02:00,2025-05-25,08:15,14,13,27
53,2025-05-25T14:44:00+02:00,2025-05-25,22:44,1,0,1
87,2025-05-25T00:11:00+02:00,2025-05-25,08:11,0,1,1
53,2025-05-25T14:52:00+02:00,2025-05-25,22:52,0,1,1
87,2025-05-25T00:12:00+02:00,2025-05-25,08:12,0,1,1
87,2025-05-25T00:20:00+02:00,2025-05-25,08:20,2,0,2
107,2025-05-25T00:10:00+02:00,2025-05-25,08:10,2,3,5
107,2025-05-25T00:15:00+02:00,2025-05-25,08:15,0,2,2
107,2025-05-25T00:20:00+02:00,2025-05-25,08:20,2,5,7
108,2025-05-25T00:20:00+02:00,2025-05-25,08:20,0,8,8
108,2025-05-25T00:21:00+02:00,2025-05-25,08:21,1,0,1
118,2025-05-25T00:20:00+02:00,2025-05-25,08:20,0,1,1
131,2025-05-25T00:15:00+02:00,2025-05-25,08:15,1,0,1
132,2025-05-25T00:10:00+02:00,2025-05-25,08:10,2,1,3
132,2025-05-25T00:15:00+02:00,2025-05-25,08:15,8,3,11
133,2025-05-25T00:10:00+02:00,2025-05-25,08:10,13,29,42
56,2025-05-25T14:41:00+02:00,2025-05-25,22:41,0,5,5
134,2025-05-25T00:10:00+02:00,2025-05-25,08:10,6,10,16
56,2025-05-25T14:44:00+02:00,2025-05-25,22:44,4,0,4
134,2025-05-25T00:20:00+02:00,2025-05-25,08:20,22,18,40
56,2025-05-25T14:48:00+02:00,2025-05-25,22:48,5,1,6
135,2025-05-25T00:10:00+02:00,2025-05-25,08:10,5,5,10
56,2025-05-25T14:53:00+02:00,2025-05-25,22:53,2,0,2
140,2025-05-25T00:20:00+02:00,2025-05-25,08:20,10,3,13
58,2025-05-25T14:50:00+02:00,2025-05-25,22:50,4,3,7
162,2025-05-25T00:10:00+02:00,2025-05-25,08:10,3,11,14
58,2025-05-25T14:52:00+02:00,2025-05-25,22:52,1,3,4
162,2025-05-25T00:15:00+02:00,2025-05-25,08:15,5,12,17
58,2025-05-25T14:54:00+02:00,2025-05-25,22:54,5,2,7
162,2025-05-25T00:20:00+02:00,2025-05-25,08:20,8,1,9
1,2025-05-25T00:15:00+02:00,2025-05-25,08:15,3,0,3
1,2025-05-25T00:23:00+02:00,2025-05-25,08:23,1,1,2
1,2025-05-25T00:24:00+02:00,2025-05-25,08:24,0,2,2
2,2025-05-25T00:12:00+02:00,2025-05-25,08:12,0,1,1
2,2025-05-25T00:15:00+02:00,2025-05-25,08:15,1,0,1
2,2025-05-25T00:17:00+02:00,2025-05-25,08:17,2,0,2
2,2025-05-25T00:23:00+02:00,2025-05-25,08:23,0,1,1
9,2025-05-25T00:20:00+02:00,2025-05-25,08:20,3,0,3
9,2025-05-25T00:22:00+02:00,2025-05-25,08:22,1,1,2
10,2025-05-25T00:24:00+02:00,2025-05-25,08:24,1,0,1
11,2025-05-25T00:13:00+02:00,2025-05-25,08:13,1,0,1
11,2025-05-25T00:14:00+02:00,2025-05-25,08:14,2,0,2
11,2025-05-25T00:15:00+02:00,2025-05-25,08:15,5,2,7
11,2025-05-25T00:22:00+02:00,2025-05-25,08:22,0,1,1
62,2025-05-25T14:40:00+02:00,2025-05-25,22:40,3,0,3
11,2025-05-25T00:24:00+02:00,2025-05-25,08:24,1,2,3
62,2025-05-25T14:41:00+02:00,2025-05-25,22:41,3,0,3
12,2025-05-25T00:15:00+02:00,2025-05-25,08:15,1,1,2
62,2025-05-25T14:42:00+02:00,2025-05-25,22:42,0,4,4
12,2025-05-25T00:16:00+02:00,2025-05-25,08:16,3,1,4
62,2025-05-25T14:43:00+02:00,2025-05-25,22:43,4,1,5
12,2025-05-25T00:23:00+02:00,2025-05-25,08:23,1,4,5
62,2025-05-25T14:44:00+02:00,2025-05-25,22:44,3,1,4
17,2025-05-25T00:17:00+02:00,2025-05-25,08:17,0,1,1
62,2025-05-25T14:48:00+02:00,2025-05-25,22:48,1,0,1
18,2025-05-25T00:13:00+02:00,2025-05-25,08:13,2,1,3
18,2025-05-25T00:15:00+02:00,2025-05-25,08:15,4,2,6
19,2025-05-25T00:16:00+02:00,2025-05-25,08:16,0,1,1
19,2025-05-25T00:21:00+02:00,2025-05-25,08:21,0,1,1
20,2025-05-25T00:11:00+02:00,2025-05-25,08:11,0,2,2
20,2025-05-25T00:15:00+02:00,2025-05-25,08:15,2,0,2
20,2025-05-25T00:20:00+02:00,2025-05-25,08:20,0,1,1
23,2025-05-25T00:10:00+02:00,2025-05-25,08:10,3,0,3
23,2025-05-25T00:15:00+02:00,2025-05-25,08:15,1,4,5
63,2025-05-25T14:52:00+02:00,2025-05-25,22:52,0,3,3
23,2025-05-25T00:18:00+02:00,2025-05-25,08:18,1,2,3
23,2025-05-25T00:19:00+02:00,2025-05-25,08:19,1,2,3
24,2025-05-25T00:10:00+02:00,2025-05-25,08:10,3,3,6
24,2025-05-25T00:12:00+02:00,2025-05-25,08:12,2,15,17
24,2025-05-25T00:20:00+02:00,2025-05-25,08:20,1,5,6
67,2025-05-25T14:47:00+02:00,2025-05-25,22:47,1,2,3
25,2025-05-25T00:20:00+02:00,2025-05-25,08:20,14,25,39
67,2025-05-25T14:52:00+02:00,2025-05-25,22:52,0,2,2
27,2025-05-25T00:14:00+02:00,2025-05-25,08:14,1,0,1
27,2025-05-25T00:21:00+02:00,2025-05-25,08:21,1,3,4
27,2025-05-25T00:22:00+02:00,2025-05-25,08:22,1,0,1
27,2025-05-25T00:24:00+02:00,2025-05-25,08:24,1,1,2
30,2025-05-25T00:11:00+02:00,2025-05-25,08:11,2,5,7
30,2025-05-25T00:13:00+02:00,2025-05-25,08:13,2,2,4
30,2025-05-25T00:16:00+02:00,2025-05-25,08:16,1,0,1
30,2025-05-25T00:17:00+02:00,2025-05-25,08:17,2,3,5
30,2025-05-25T00:21:00+02:00,2025-05-25,08:21,0,3,3
68,2025-05-25T14:43:00+02:00,2025-05-25,22:43,0,1,1
30,2025-05-25T00:22:00+02:00,2025-05-25,08:22,0,1,1
35,2025-05-25T00:17:00+02:00,2025-05-25,08:17,12,0,12
35,2025-05-25T00:18:00+02:00,2025-05-25,08:18,12,5,17
35,2025-05-25T00:20:00+02:00,2025-05-25,08:20,8,23,31
35,2025-05-25T00:22:00+02:00,2025-05-25,08:22,12,52,64
35,2025-05-25T00:24:00+02:00,2025-05-25,08:24,6,5,11
48,2025-05-25T00:13:00+02:00,2025-05-25,08:13,1,0,1
48,2025-05-25T00:15:00+02:00,2025-05-25,08:15,1,2,3
48,2025-05-25T00:20:00+02:00,2025-05-25,08:20,0,1,1
48,2025-05-25T00:21:00+02:00,2025-05-25,08:21,1,1,2
79,2025-05-25T14:40:00+02:00,2025-05-25,22:40,0,4,4
48,2025-05-25T00:22:00+02:00,2025-05-25,08:22,1,3,4
79,2025-05-25T14:43:00+02:00,2025-05-25,22:43,2,0,2
49,2025-05-25T00:10:00+02:00,2025-05-25,08:10,1,2,3
79,2025-05-25T14:48:00+02:00,2025-05-25,22:48,0,4,4
49,2025-05-25T00:12:00+02:00,2025-05-25,08:12,1,3,4
79,2025-05-25T14:54:00+02:00,2025-05-25,22:54,1,1,2
49,2025-05-25T00:15:00+02:00,2025-05-25,08:15,1,5,6
49,2025-05-25T00:17:00+02:00,2025-05-25,08:17,3,4,7
49,2025-05-25T00:18:00+02:00,2025-05-25,08:18,0,2,2
51,2025-05-25T00:12:00+02:00,2025-05-25,08:12,0,1,1
51,2025-05-25T00:19:00+02:00,2025-05-25,08:19,0,1,1
51,2025-05-25T00:20:00+02:00,2025-05-25,08:20,3,1,4
51,2025-05-25T00:23:00+02:00,2025-05-25,08:23,1,0,1
52,2025-05-25T00:11:00+02:00,2025-05-25,08:11,0,2,2
52,2025-05-25T00:18:00+02:00,2025-05-25,08:18,2,1,3
53,2025-05-25T00:10:00+02:00,2025-05-25,08:10,3,0,3
53,2025-05-25T00:15:00+02:00,2025-05-25,08:15,0,1,1
53,2025-05-25T00:16:00+02:00,2025-05-25,08:16,1,0,1
53,2025-05-25T00:18:00+02:00,2025-05-25,08:18,1,1,2
53,2025-05-25T00:24:00+02:00,2025-05-25,08:24,0,1,1
109,2025-05-25T14:40:00+02:00,2025-05-25,22:40,3,3,6
56,2025-05-25T00:10:00+02:00,2025-05-25,08:10,2,0,2
56,2025-05-25T00:14:00+02:00,2025-05-25,08:14,2,1,3
56,2025-05-25T00:17:00+02:00,2025-05-25,08:17,2,0,2
56,2025-05-25T00:21:00+02:00,2025-05-25,08:21,2,1,3
56,2025-05-25T00:24:00+02:00,2025-05-25,08:24,4,2,6
117,2025-05-25T14:40:00+02:00,2025-05-25,22:40,3,1,4
58,2025-05-25T00:12:00+02:00,2025-05-25,08:12,3,0,3
58,2025-05-25T00:15:00+02:00,2025-05-25,08:15,1,1,2
58,2025-05-25T00:19:00+02:00,2025-05-25,08:19,2,3,5
58,2025-05-25T00:24:00+02:00,2025-05-25,08:24,0,1,1
62,2025-05-25T00:21:00+02:00,2025-05-25,08:21,2,1,3
137,2025-05-25T14:50:00+02:00,2025-05-25,22:50,1,0,1
62,2025-05-25T00:24:00+02:00,2025-05-25,08:24,1,0,1
139,2025-05-25T14:40:00+02:00,2025-05-25,22:40,3,0,3
63,2025-05-25T00:13:00+02:00,2025-05-25,08:13,0,1,1
63,2025-05-25T00:16:00+02:00,2025-05-25,08:16,1,4,5
141,2025-05-25T14:50:00+02:00,2025-05-25,22:50,3,5,8
63,2025-05-25T00:19:00+02:00,2025-05-25,08:19,2,0,2
63,2025-05-25T00:21:00+02:00,2025-05-25,08:21,0,2,2
67,2025-05-25T00:10:00+02:00,2025-05-25,08:10,1,4,5
67,2025-05-25T00:17:00+02:00,2025-05-25,08:17,4,0,4
142,2025-05-25T14:40:00+02:00,2025-05-25,22:40,4,0,4
67,2025-05-25T00:24:00+02:00,2025-05-25,08:24,1,0,1
68,2025-05-25T00:11:00+02:00,2025-05-25,08:11,1,1,2
164,2025-05-25T14:40:00+02:00,2025-05-25,22:40,1,9,10
68,2025-05-25T00:21:00+02:00,2025-05-25,08:21,1,1,2
68,2025-05-25T00:23:00+02:00,2025-05-25,08:23,0,2,2
68,2025-05-25T00:24:00+02:00,2025-05-25,08:24,2,3,5
72,2025-05-25T00:14:00+02:00,2025-05-25,08:14,3,0,3
72,2025-05-25T00:15:00+02:00,2025-05-25,08:15,1,0,1
72,2025-05-25T00:18:00+02:00,2025-05-25,08:18,2,0,2
72,2025-05-25T00:19:00+02:00,2025-05-25,08:19,0,1,1
72,2025-05-25T00:22:00+02:00,2025-05-25,08:22,3,0,3
76,2025-05-25T00:14:00+02:00,2025-05-25,08:14,1,0,1
76,2025-05-25T00:24:00+02:00,2025-05-25,08:24,1,0,1
79,2025-05-25T00:10:00+02:00,2025-05-25,08:10,3,1,4
79,2025-05-25T00:11:00+02:00,2025-05-25,08:11,1,3,4
79,2025-05-25T00:20:00+02:00,2025-05-25,08:20,0,2,2
79,2025-05-25T00:23:00+02:00,2025-05-25,08:23,0,3,3
85,2025-05-25T00:12:00+02:00,2025-05-25,08:12,0,1,1
85,2025-05-25T00:13:00+02:00,2025-05-25,08:13,0,2,2
86,2025-05-25T00:10:00+02:00,2025-05-25,08:10,0,1,1
86,2025-05-25T00:13:00+02:00,2025-05-25,08:13,3,0,3
86,2025-05-25T00:17:00+02:00,2025-05-25,08:17,1,0,1
117,2025-05-25T00:10:00+02:00,2025-05-25,08:10,1,0,1
117,2025-05-25T00:15:00+02:00,2025-05-25,08:15,2,0,2
123,2025-05-25T00:15:00+02:00,2025-05-25,08:15,0,1,1
136,2025-05-25T00:15:00+02:00,2025-05-25,08:15,46,11,57
136,2025-05-25T00:20:00+02:00,2025-05-25,08:20,5,10,15
137,2025-05-25T00:10:00+02:00,2025-05-25,08:10,0,1,1
137,2025-05-25T00:20:00+02:00,2025-05-25,08:20,1,0,1
138,2025-05-25T00:20:00+02:00,2025-05-25,08:20,0,1,1
139,2025-05-25T00:10:00+02:00,2025-05-25,08:10,1,1,2
139,2025-05-25T00:15:00+02:00,2025-05-25,08:15,1,1,2
141,2025-05-25T00:15:00+02:00,2025-05-25,08:15,2,2,4
142,2025-05-25T00:10:00+02:00,2025-05-25,08:10,25,16,41
161,2025-05-25T00:15:00+02:00,2025-05-25,08:15,41,9,50
161,2025-05-25T00:20:00+02:00,2025-05-25,08:20,6,14,20
164,2025-05-25T00:10:00+02:00,2025-05-25,08:10,1,0,1
181,2025-05-25T00:25:00+02:00,2025-05-25,08:25,0,4,4
181,2025-05-25T00:26:00+02:00,2025-05-25,08:26,1,5,6
181,2025-05-25T00:27:00+02:00,2025-05-25,08:27,1,1,2
181,2025-05-25T00:29:00+02:00,2025-05-25,08:29,0,1,1
181,2025-05-25T00:34:00+02:00,2025-05-25,08:34,3,6,9
181,2025-05-25T00:38:00+02:00,2025-05-25,08:38,2,3,5
182,2025-05-25T00:30:00+02:00,2025-05-25,08:30,6,4,10
182,2025-05-25T00:35:00+02:00,2025-05-25,08:35,8,6,14
3,2025-05-25T00:26:00+02:00,2025-05-25,08:26,1,1,2
3,2025-05-25T00:28:00+02:00,2025-05-25,08:28,1,1,2
3,2025-05-25T00:29:00+02:00,2025-05-25,08:29,1,2,3
3,2025-05-25T00:33:00+02:00,2025-05-25,08:33,1,0,1
3,2025-05-25T00:34:00+02:00,2025-05-25,08:34,2,2,4
3,2025-05-25T00:35:00+02:00,2025-05-25,08:35,2,0,2
3,2025-05-25T00:36:00+02:00,2025-05-25,08:36,3,2,5
4,2025-05-25T00:25:00+02:00,2025-05-25,08:25,2,0,2
4,2025-05-25T00:26:00+02:00,2025-05-25,08:26,2,0,2
4,2025-05-25T00:30:00+02:00,2025-05-25,08:30,0,1,1
4,2025-05-25T00:31:00+02:00,2025-05-25,08:31,1,0,1
4,2025-05-25T00:33:00+02:00,2025-05-25,08:33,3,2,5
6,2025-05-25T00:25:00+02:00,2025-05-25,08:25,3,7,10
6,2025-05-25T00:26:00+02:00,2025-05-25,08:26,2,1,3
6,2025-05-25T00:30:00+02:00,2025-05-25,08:30,2,1,3
6,2025-05-25T00:31:00+02:00,2025-05-25,08:31,4,0,4
6,2025-05-25T00:33:00+02:00,2025-05-25,08:33,2,0,2
6,2025-05-25T00:34:00+02:00,2025-05-25,08:34,3,4,7
6,2025-05-25T00:37:00+02:00,2025-05-25,08:37,4,8,12
6,2025-05-25T00:38:00+02:00,2025-05-25,08:38,2,8,10
8,2025-05-25T00:27:00+02:00,2025-05-25,08:27,1,0,1
8,2025-05-25T00:35:00+02:00,2025-05-25,08:35,7,1,8
28,2025-05-25T00:27:00+02:00,2025-05-25,08:27,0,1,1
28,2025-05-25T00:31:00+02:00,2025-05-25,08:31,6,2,8
28,2025-05-25T00:32:00+02:00,2025-05-25,08:32,3,0,3
29,2025-05-25T00:29:00+02:00,2025-05-25,08:29,4,1,5
29,2025-05-25T00:35:00+02:00,2025-05-25,08:35,2,6,8
29,2025-05-25T00:36:00+02:00,2025-05-25,08:36,2,3,5
29,2025-05-25T00:37:00+02:00,2025-05-25,08:37,0,3,3
29,2025-05-25T00:38:00+02:00,2025-05-25,08:38,0,5,5
31,2025-05-25T00:26:00+02:00,2025-05-25,08:26,1,0,1
31,2025-05-25T00:27:00+02:00,2025-05-25,08:27,0,2,2
31,2025-05-25T00:31:00+02:00,2025-05-25,08:31,1,0,1
36,2025-05-25T00:31:00+02:00,2025-05-25,08:31,0,1,1
36,2025-05-25T00:32:00+02:00,2025-05-25,08:32,2,2,4
36,2025-05-25T00:35:00+02:00,2025-05-25,08:35,5,1,6
37,2025-05-25T00:27:00+02:00,2025-05-25,08:27,1,0,1
37,2025-05-25T00:34:00+02:00,2025-05-25,08:34,1,0,1
37,2025-05-25T00:35:00+02:00,2025-05-25,08:35,0,1,1
39,2025-05-25T00:25:00+02:00,2025-05-25,08:25,1,2,3
39,2025-05-25T00:29:00+02:00,2025-05-25,08:29,1,0,1
39,2025-05-25T00:39:00+02:00,2025-05-25,08:39,1,0,1
40,2025-05-25T00:27:00+02:00,2025-05-25,08:27,2,0,2
40,2025-05-25T00:29:00+02:00,2025-05-25,08:29,0,1,1
40,2025-05-25T00:33:00+02:00,2025-05-25,08:33,0,1,1
40,2025-05-25T00:38:00+02:00,2025-05-25,08:38,1,0,1
41,2025-05-25T00:37:00+02:00,2025-05-25,08:37,1,2,3
44,2025-05-25T00:25:00+02:00,2025-05-25,08:25,1,0,1
44,2025-05-25T00:30:00+02:00,2025-05-25,08:30,1,0,1
45,2025-05-25T00:29:00+02:00,2025-05-25,08:29,0,1,1
45,2025-05-25T00:30:00+02:00,2025-05-25,08:30,3,1,4
45,2025-05-25T00:33:00+02:00,2025-05-25,08:33,2,0,2
47,2025-05-25T00:26:00+02:00,2025-05-25,08:26,4,0,4
47,2025-05-25T00:28:00+02:00,2025-05-25,08:28,2,2,4
47,2025-05-25T00:31:00+02:00,2025-05-25,08:31,2,4,6
47,2025-05-25T00:35:00+02:00,2025-05-25,08:35,2,2,4
50,2025-05-25T00:28:00+02:00,2025-05-25,08:28,1,1,2
54,2025-05-25T00:25:00+02:00,2025-05-25,08:25,1,0,1
54,2025-05-25T00:27:00+02:00,2025-05-25,08:27,3,0,3
54,2025-05-25T00:33:00+02:00,2025-05-25,08:33,0,2,2
54,2025-05-25T00:37:00+02:00,2025-05-25,08:37,1,0,1
61,2025-05-25T00:28:00+02:00,2025-05-25,08:28,1,2,3
61,2025-05-25T00:37:00+02:00,2025-05-25,08:37,1,0,1
66,2025-05-25T00:26:00+02:00,2025-05-25,08:26,1,1,2
66,2025-05-25T00:28:00+02:00,2025-05-25,08:28,1,4,5
66,2025-05-25T00:29:00+02:00,2025-05-25,08:29,4,0,4
66,2025-05-25T00:30:00+02:00,2025-05-25,08:30,2,0,2
66,2025-05-25T00:34:00+02:00,2025-05-25,08:34,0,4,4
69,2025-05-25T00:27:00+02:00,2025-05-25,08:27,2,1,3
69,2025-05-25T00:29:00+02:00,2025-05-25,08:29,2,0,2
69,2025-05-25T00:35:00+02:00,2025-05-25,08:35,1,0,1
69,2025-05-25T00:38:00+02:00,2025-05-25,08:38,3,0,3
70,2025-05-25T00:27:00+02:00,2025-05-25,08:27,1,0,1
70,2025-05-25T00:28:00+02:00,2025-05-25,08:28,0,2,2
70,2025-05-25T00:29:00+02:00,2025-05-25,08:29,1,0,1
70,2025-05-25T00:32:00+02:00,2025-05-25,08:32,0,2,2
70,2025-05-25T00:36:00+02:00,2025-05-25,08:36,1,0,1
70,2025-05-25T00:37:00+02:00,2025-05-25,08:37,0,1,1
75,2025-05-25T00:25:00+02:00,2025-05-25,08:25,1,0,1
75,2025-05-25T00:26:00+02:00,2025-05-25,08:26,1,1,2
75,2025-05-25T00:30:00+02:00,2025-05-25,08:30,0,2,2
75,2025-05-25T00:31:00+02:00,2025-05-25,08:31,0,1,1
75,2025-05-25T00:35:00+02:00,2025-05-25,08:35,0,1,1
77,2025-05-25T00:35:00+02:00,2025-05-25,08:35,17,17,34
78,2025-05-25T00:27:00+02:00,2025-05-25,08:27,0,1,1
181,2025-05-25T14:40:00+02:00,2025-05-25,22:40,14,7,21
78,2025-05-25T00:34:00+02:00,2025-05-25,08:34,1,1,2
181,2025-05-25T14:42:00+02:00,2025-05-25,22:42,7,3,10
78,2025-05-25T00:39:00+02:00,2025-05-25,08:39,4,1,5
181,2025-05-25T14:45:00+02:00,2025-05-25,22:45,5,2,7
84,2025-05-25T00:30:00+02:00,2025-05-25,08:30,20,16,36
181,2025-05-25T14:52:00+02:00,2025-05-25,22:52,12,8,20
84,2025-05-25T00:35:00+02:00,2025-05-25,08:35,45,16,61
181,2025-05-25T14:54:00+02:00,2025-05-25,22:54,12,4,16
87,2025-05-25T00:25:00+02:00,2025-05-25,08:25,1,0,1
87,2025-05-25T00:26:00+02:00,2025-05-25,08:26,0,1,1
87,2025-05-25T00:27:00+02:00,2025-05-25,08:27,1,1,2
87,2025-05-25T00:31:00+02:00,2025-05-25,08:31,1,0,1
87,2025-05-25T00:32:00+02:00,2025-05-25,08:32,2,0,2
87,2025-05-25T00:33:00+02:00,2025-05-25,08:33,1,0,1
87,2025-05-25T00:35:00+02:00,2025-05-25,08:35,2,0,2
87,2025-05-25T00:36:00+02:00,2025-05-25,08:36,0,1,1
107,2025-05-25T00:25:00+02:00,2025-05-25,08:25,2,3,5
107,2025-05-25T00:30:00+02:00,2025-05-25,08:30,1,1,2
108,2025-05-25T00:27:00+02:00,2025-05-25,08:27,2,2,4
108,2025-05-25T00:28:00+02:00,2025-05-25,08:28,1,1,2
108,2025-05-25T00:30:00+02:00,2025-05-25,08:30,2,6,8
108,2025-05-25T00:34:00+02:00,2025-05-25,08:34,0,2,2
132,2025-05-25T00:25:00+02:00,2025-05-25,08:25,8,0,8
134,2025-05-25T00:25:00+02:00,2025-05-25,08:25,28,18,46
135,2025-05-25T00:25:00+02:00,2025-05-25,08:25,16,13,29
165,2025-05-25T00:30:00+02:00,2025-05-25,08:30,0,1,1
165,2025-05-25T00:35:00+02:00,2025-05-25,08:35,1,4,5
166,2025-05-25T00:25:00+02:00,2025-05-25,08:25,1,0,1
167,2025-05-25T00:30:00+02:00,2025-05-25,08:30,2,2,4
167,2025-05-25T00:35:00+02:00,2025-05-25,08:35,2,2,4
1,2025-05-25T00:27:00+02:00,2025-05-25,08:27,1,0,1
1,2025-05-25T00:30:00+02:00,2025-05-25,08:30,3,0,3
1,2025-05-25T00:31:00+02:00,2025-05-25,08:31,0,2,2
1,2025-05-25T00:34:00+02:00,2025-05-25,08:34,1,1,2
2,2025-05-25T00:26:00+02:00,2025-05-25,08:26,0,4,4
2,2025-05-25T00:32:00+02:00,2025-05-25,08:32,2,0,2
2,2025-05-25T00:33:00+02:00,2025-05-25,08:33,1,3,4
2,2025-05-25T00:34:00+02:00,2025-05-25,08:34,2,2,4
2,2025-05-25T00:39:00+02:00,2025-05-25,08:39,0,3,3
9,2025-05-25T00:25:00+02:00,2025-05-25,08:25,2,0,2
9,2025-05-25T00:27:00+02:00,2025-05-25,08:27,0,1,1
9,2025-05-25T00:32:00+02:00,2025-05-25,08:32,2,0,2
10,2025-05-25T00:31:00+02:00,2025-05-25,08:31,1,1,2
10,2025-05-25T00:32:00+02:00,2025-05-25,08:32,1,0,1
10,2025-05-25T00:36:00+02:00,2025-05-25,08:36,1,0,1
181,2025-05-25T14:57:00+02:00,2025-05-25,22:57,12,6,18
10,2025-05-25T00:39:00+02:00,2025-05-25,08:39,0,1,1
181,2025-05-25T14:59:00+02:00,2025-05-25,22:59,12,3,15
11,2025-05-25T00:29:00+02:00,2025-05-25,08:29,0,2,2
181,2025-05-25T15:00:00+02:00,2025-05-25,23:00,13,0,13
11,2025-05-25T00:36:00+02:00,2025-05-25,08:36,1,2,3
181,2025-05-25T15:02:00+02:00,2025-05-25,23:02,8,4,12
12,2025-05-25T00:26:00+02:00,2025-05-25,08:26,2,0,2
181,2025-05-25T15:04:00+02:00,2025-05-25,23:04,9,8,17
12,2025-05-25T00:27:00+02:00,2025-05-25,08:27,0,1,1
181,2025-05-25T15:06:00+02:00,2025-05-25,23:06,7,1,8
12,2025-05-25T00:28:00+02:00,2025-05-25,08:28,0,1,1
181,2025-05-25T15:07:00+02:00,2025-05-25,23:07,7,3,10
12,2025-05-25T00:29:00+02:00,2025-05-25,08:29,2,0,2
181,2025-05-25T15:14:00+02:00,2025-05-25,23:14,0,7,7
12,2025-05-25T00:30:00+02:00,2025-05-25,08:30,2,2,4
181,2025-05-25T15:15:00+02:00,2025-05-25,23:15,6,3,9
12,2025-05-25T00:33:00+02:00,2025-05-25,08:33,1,2,3
181,2025-05-25T15:16:00+02:00,2025-05-25,23:16,2,7,9
12,2025-05-25T00:36:00+02:00,2025-05-25,08:36,2,1,3
181,2025-05-25T15:18:00+02:00,2025-05-25,23:18,13,8,21
12,2025-05-25T00:37:00+02:00,2025-05-25,08:37,3,0,3
181,2025-05-25T15:20:00+02:00,2025-05-25,23:20,6,6,12
12,2025-05-25T00:38:00+02:00,2025-05-25,08:38,1,1,2
181,2025-05-25T15:24:00+02:00,2025-05-25,23:24,4,5,9
17,2025-05-25T00:30:00+02:00,2025-05-25,08:30,1,0,1
181,2025-05-25T15:33:00+02:00,2025-05-25,23:33,2,7,9
18,2025-05-25T00:30:00+02:00,2025-05-25,08:30,2,0,2
181,2025-05-25T15:39:00+02:00,2025-05-25,23:39,1,7,8
20,2025-05-25T00:27:00+02:00,2025-05-25,08:27,4,5,9
181,2025-05-25T15:40:00+02:00,2025-05-25,23:40,3,1,4
20,2025-05-25T00:34:00+02:00,2025-05-25,08:34,0,1,1
181,2025-05-25T15:41:00+02:00,2025-05-25,23:41,3,3,6
23,2025-05-25T00:28:00+02:00,2025-05-25,08:28,0,1,1
181,2025-05-25T15:42:00+02:00,2025-05-25,23:42,3,2,5
23,2025-05-25T00:29:00+02:00,2025-05-25,08:29,0,1,1
181,2025-05-25T15:44:00+02:00,2025-05-25,23:44,4,3,7
23,2025-05-25T00:34:00+02:00,2025-05-25,08:34,1,0,1
181,2025-05-25T15:47:00+02:00,2025-05-25,23:47,5,3,8
24,2025-05-25T00:25:00+02:00,2025-05-25,08:25,1,3,4
181,2025-05-25T15:49:00+02:00,2025-05-25,23:49,2,0,2
24,2025-05-25T00:27:00+02:00,2025-05-25,08:27,3,2,5
181,2025-05-25T15:50:00+02:00,2025-05-25,23:50,4,0,4
24,2025-05-25T00:31:00+02:00,2025-05-25,08:31,5,5,10
181,2025-05-25T15:53:00+02:00,2025-05-25,23:53,4,0,4
24,2025-05-25T00:32:00+02:00,2025-05-25,08:32,7,2,9
181,2025-05-25T15:55:00+02:00,2025-05-25,23:55,5,1,6
24,2025-05-25T00:35:00+02:00,2025-05-25,08:35,3,1,4
182,2025-05-25T14:55:00+02:00,2025-05-25,22:55,2,9,11
25,2025-05-25T00:35:00+02:00,2025-05-25,08:35,16,38,54
182,2025-05-25T15:05:00+02:00,2025-05-25,23:05,5,4,9
27,2025-05-25T00:26:00+02:00,2025-05-25,08:26,0,2,2
182,2025-05-25T15:15:00+02:00,2025-05-25,23:15,3,9,12
27,2025-05-25T00:27:00+02:00,2025-05-25,08:27,5,1,6
182,2025-05-25T15:35:00+02:00,2025-05-25,23:35,9,4,13
27,2025-05-25T00:29:00+02:00,2025-05-25,08:29,0,3,3
182,2025-05-25T15:40:00+02:00,2025-05-25,23:40,7,9,16
27,2025-05-25T00:30:00+02:00,2025-05-25,08:30,1,2,3
182,2025-05-25T15:50:00+02:00,2025-05-25,23:50,6,8,14
27,2025-05-25T00:31:00+02:00,2025-05-25,08:31,4,2,6
182,2025-05-25T15:55:00+02:00,2025-05-25,23:55,5,6,11
27,2025-05-25T00:36:00+02:00,2025-05-25,08:36,2,2,4
3,2025-05-25T14:55:00+02:00,2025-05-25,22:55,3,3,6
27,2025-05-25T00:38:00+02:00,2025-05-25,08:38,0,1,1
3,2025-05-25T14:57:00+02:00,2025-05-25,22:57,7,8,15
27,2025-05-25T00:39:00+02:00,2025-05-25,08:39,0,1,1
3,2025-05-25T15:05:00+02:00,2025-05-25,23:05,8,2,10
30,2025-05-25T00:27:00+02:00,2025-05-25,08:27,0,4,4
3,2025-05-25T15:06:00+02:00,2025-05-25,23:06,9,4,13
30,2025-05-25T00:28:00+02:00,2025-05-25,08:28,1,0,1
3,2025-05-25T15:09:00+02:00,2025-05-25,23:09,2,3,5
30,2025-05-25T00:31:00+02:00,2025-05-25,08:31,0,4,4
3,2025-05-25T15:18:00+02:00,2025-05-25,23:18,3,13,16
30,2025-05-25T00:32:00+02:00,2025-05-25,08:32,1,2,3
3,2025-05-25T15:21:00+02:00,2025-05-25,23:21,3,4,7
30,2025-05-25T00:35:00+02:00,2025-05-25,08:35,0,2,2
3,2025-05-25T15:28:00+02:00,2025-05-25,23:28,1,0,1
30,2025-05-25T00:38:00+02:00,2025-05-25,08:38,1,3,4
3,2025-05-25T15:29:00+02:00,2025-05-25,23:29,3,1,4
35,2025-05-25T00:25:00+02:00,2025-05-25,08:25,8,11,19
3,2025-05-25T15:30:00+02:00,2025-05-25,23:30,3,2,5
35,2025-05-25T00:31:00+02:00,2025-05-25,08:31,3,22,25
3,2025-05-25T15:31:00+02:00,2025-05-25,23:31,3,2,5
35,2025-05-25T00:34:00+02:00,2025-05-25,08:34,2,5,7
3,2025-05-25T15:33:00+02:00,2025-05-25,23:33,2,1,3
35,2025-05-25T00:35:00+02:00,2025-05-25,08:35,6,2,8
3,2025-05-25T15:38:00+02:00,2025-05-25,23:38,15,4,19
46,2025-05-25T00:25:00+02:00,2025-05-25,08:25,1,0,1
3,2025-05-25T15:41:00+02:00,2025-05-25,23:41,0,5,5
48,2025-05-25T00:25:00+02:00,2025-05-25,08:25,0,4,4
3,2025-05-25T15:42:00+02:00,2025-05-25,23:42,0,3,3
48,2025-05-25T00:27:00+02:00,2025-05-25,08:27,7,2,9
3,2025-05-25T15:43:00+02:00,2025-05-25,23:43,2,4,6
48,2025-05-25T00:29:00+02:00,2025-05-25,08:29,2,0,2
3,2025-05-25T15:44:00+02:00,2025-05-25,23:44,2,6,8
48,2025-05-25T00:30:00+02:00,2025-05-25,08:30,1,1,2
3,2025-05-25T15:45:00+02:00,2025-05-25,23:45,1,0,1
48,2025-05-25T00:31:00+02:00,2025-05-25,08:31,2,1,3
3,2025-05-25T15:46:00+02:00,2025-05-25,23:46,1,0,1
48,2025-05-25T00:32:00+02:00,2025-05-25,08:32,2,3,5
3,2025-05-25T15:47:00+02:00,2025-05-25,23:47,2,3,5
48,2025-05-25T00:34:00+02:00,2025-05-25,08:34,5,2,7
3,2025-05-25T15:48:00+02:00,2025-05-25,23:48,0,4,4
48,2025-05-25T00:37:00+02:00,2025-05-25,08:37,0,3,3
3,2025-05-25T15:49:00+02:00,2025-05-25,23:49,2,1,3
49,2025-05-25T00:26:00+02:00,2025-05-25,08:26,2,1,3
3,2025-05-25T15:51:00+02:00,2025-05-25,23:51,0,6,6
49,2025-05-25T00:28:00+02:00,2025-05-25,08:28,0,2,2
3,2025-05-25T15:55:00+02:00,2025-05-25,23:55,2,2,4
49,2025-05-25T00:31:00+02:00,2025-05-25,08:31,2,1,3
4,2025-05-25T14:55:00+02:00,2025-05-25,22:55,2,7,9
49,2025-05-25T00:33:00+02:00,2025-05-25,08:33,1,0,1
4,2025-05-25T14:58:00+02:00,2025-05-25,22:58,1,9,10
49,2025-05-25T00:37:00+02:00,2025-05-25,08:37,0,2,2
4,2025-05-25T15:03:00+02:00,2025-05-25,23:03,0,3,3
51,2025-05-25T00:27:00+02:00,2025-05-25,08:27,0,1,1
4,2025-05-25T15:05:00+02:00,2025-05-25,23:05,0,5,5
51,2025-05-25T00:29:00+02:00,2025-05-25,08:29,2,0,2
4,2025-05-25T15:06:00+02:00,2025-05-25,23:06,3,4,7
51,2025-05-25T00:30:00+02:00,2025-05-25,08:30,1,1,2
4,2025-05-25T15:14:00+02:00,2025-05-25,23:14,3,4,7
51,2025-05-25T00:36:00+02:00,2025-05-25,08:36,2,0,2
4,2025-05-25T15:16:00+02:00,2025-05-25,23:16,1,9,10
52,2025-05-25T00:25:00+02:00,2025-05-25,08:25,2,0,2
4,2025-05-25T15:25:00+02:00,2025-05-25,23:25,3,5,8
52,2025-05-25T00:29:00+02:00,2025-05-25,08:29,1,1,2
4,2025-05-25T15:26:00+02:00,2025-05-25,23:26,8,1,9
53,2025-05-25T00:25:00+02:00,2025-05-25,08:25,1,2,3
4,2025-05-25T15:27:00+02:00,2025-05-25,23:27,2,4,6
53,2025-05-25T00:28:00+02:00,2025-05-25,08:28,2,1,3
4,2025-05-25T15:29:00+02:00,2025-05-25,23:29,0,4,4
53,2025-05-25T00:30:00+02:00,2025-05-25,08:30,1,2,3
4,2025-05-25T15:30:00+02:00,2025-05-25,23:30,0,1,1
56,2025-05-25T00:27:00+02:00,2025-05-25,08:27,3,0,3
4,2025-05-25T15:33:00+02:00,2025-05-25,23:33,1,0,1
56,2025-05-25T00:28:00+02:00,2025-05-25,08:28,0,1,1
4,2025-05-25T15:38:00+02:00,2025-05-25,23:38,5,0,5
56,2025-05-25T00:33:00+02:00,2025-05-25,08:33,0,2,2
4,2025-05-25T15:42:00+02:00,2025-05-25,23:42,5,5,10
56,2025-05-25T00:38:00+02:00,2025-05-25,08:38,1,0,1
4,2025-05-25T15:48:00+02:00,2025-05-25,23:48,0,4,4
56,2025-05-25T00:39:00+02:00,2025-05-25,08:39,0,5,5
4,2025-05-25T15:51:00+02:00,2025-05-25,23:51,0,3,3
58,2025-05-25T00:25:00+02:00,2025-05-25,08:25,1,0,1
4,2025-05-25T15:55:00+02:00,2025-05-25,23:55,0,6,6
58,2025-05-25T00:26:00+02:00,2025-05-25,08:26,8,8,16
5,2025-05-25T15:00:00+02:00,2025-05-25,23:00,4,3,7
58,2025-05-25T00:32:00+02:00,2025-05-25,08:32,8,1,9
5,2025-05-25T15:05:00+02:00,2025-05-25,23:05,1,18,19
58,2025-05-25T00:38:00+02:00,2025-05-25,08:38,6,5,11
5,2025-05-25T15:10:00+02:00,2025-05-25,23:10,4,14,18
63,2025-05-25T00:31:00+02:00,2025-05-25,08:31,1,3,4
5,2025-05-25T15:30:00+02:00,2025-05-25,23:30,8,3,11
63,2025-05-25T00:35:00+02:00,2025-05-25,08:35,1,1,2
6,2025-05-25T14:57:00+02:00,2025-05-25,22:57,5,3,8
63,2025-05-25T00:37:00+02:00,2025-05-25,08:37,1,0,1
6,2025-05-25T14:58:00+02:00,2025-05-25,22:58,12,3,15
67,2025-05-25T00:34:00+02:00,2025-05-25,08:34,0,3,3
6,2025-05-25T15:03:00+02:00,2025-05-25,23:03,2,8,10
68,2025-05-25T00:26:00+02:00,2025-05-25,08:26,0,1,1
6,2025-05-25T15:04:00+02:00,2025-05-25,23:04,0,6,6
68,2025-05-25T00:28:00+02:00,2025-05-25,08:28,1,0,1
6,2025-05-25T15:05:00+02:00,2025-05-25,23:05,5,0,5
68,2025-05-25T00:30:00+02:00,2025-05-25,08:30,1,0,1
6,2025-05-25T15:07:00+02:00,2025-05-25,23:07,5,4,9
68,2025-05-25T00:32:00+02:00,2025-05-25,08:32,3,5,8
6,2025-05-25T15:08:00+02:00,2025-05-25,23:08,6,1,7
68,2025-05-25T00:36:00+02:00,2025-05-25,08:36,1,1,2
6,2025-05-25T15:09:00+02:00,2025-05-25,23:09,2,3,5
68,2025-05-25T00:38:00+02:00,2025-05-25,08:38,3,4,7
6,2025-05-25T15:16:00+02:00,2025-05-25,23:16,2,0,2
72,2025-05-25T00:26:00+02:00,2025-05-25,08:26,0,3,3
6,2025-05-25T15:17:00+02:00,2025-05-25,23:17,1,0,1
72,2025-05-25T00:30:00+02:00,2025-05-25,08:30,4,0,4
6,2025-05-25T15:22:00+02:00,2025-05-25,23:22,2,4,6
72,2025-05-25T00:31:00+02:00,2025-05-25,08:31,2,0,2
6,2025-05-25T15:29:00+02:00,2025-05-25,23:29,5,2,7
72,2025-05-25T00:35:00+02:00,2025-05-25,08:35,0,1,1
6,2025-05-25T15:30:00+02:00,2025-05-25,23:30,0,2,2
76,2025-05-25T00:25:00+02:00,2025-05-25,08:25,1,0,1
6,2025-05-25T15:34:00+02:00,2025-05-25,23:34,4,0,4
76,2025-05-25T00:27:00+02:00,2025-05-25,08:27,2,0,2
6,2025-05-25T15:38:00+02:00,2025-05-25,23:38,5,0,5
76,2025-05-25T00:30:00+02:00,2025-05-25,08:30,1,0,1
6,2025-05-25T15:39:00+02:00,2025-05-25,23:39,9,1,10
76,2025-05-25T00:32:00+02:00,2025-05-25,08:32,2,0,2
6,2025-05-25T15:41:00+02:00,2025-05-25,23:41,2,0,2
76,2025-05-25T00:39:00+02:00,2025-05-25,08:39,0,1,1
6,2025-05-25T15:43:00+02:00,2025-05-25,23:43,1,9,10
79,2025-05-25T00:25:00+02:00,2025-05-25,08:25,0,1,1
6,2025-05-25T15:45:00+02:00,2025-05-25,23:45,1,0,1
79,2025-05-25T00:28:00+02:00,2025-05-25,08:28,1,0,1
6,2025-05-25T15:46:00+02:00,2025-05-25,23:46,3,2,5
79,2025-05-25T00:34:00+02:00,2025-05-25,08:34,2,1,3
6,2025-05-25T15:47:00+02:00,2025-05-25,23:47,1,0,1
79,2025-05-25T00:35:00+02:00,2025-05-25,08:35,5,4,9
6,2025-05-25T15:48:00+02:00,2025-05-25,23:48,1,2,3
79,2025-05-25T00:36:00+02:00,2025-05-25,08:36,6,2,8
6,2025-05-25T15:50:00+02:00,2025-05-25,23:50,2,1,3
79,2025-05-25T00:37:00+02:00,2025-05-25,08:37,3,2,5
6,2025-05-25T15:54:00+02:00,2025-05-25,23:54,1,1,2
79,2025-05-25T00:38:00+02:00,2025-05-25,08:38,4,7,11
8,2025-05-25T15:20:00+02:00,2025-05-25,23:20,1,0,1
85,2025-05-25T00:26:00+02:00,2025-05-25,08:26,0,1,1
21,2025-05-25T14:55:00+02:00,2025-05-25,22:55,4,11,15
85,2025-05-25T00:35:00+02:00,2025-05-25,08:35,1,0,1
21,2025-05-25T15:10:00+02:00,2025-05-25,23:10,13,8,21
85,2025-05-25T00:37:00+02:00,2025-05-25,08:37,0,1,1
21,2025-05-25T15:40:00+02:00,2025-05-25,23:40,3,6,9
86,2025-05-25T00:28:00+02:00,2025-05-25,08:28,0,1,1
21,2025-05-25T15:50:00+02:00,2025-05-25,23:50,0,4,4
86,2025-05-25T00:29:00+02:00,2025-05-25,08:29,1,0,1
28,2025-05-25T14:57:00+02:00,2025-05-25,22:57,2,0,2
86,2025-05-25T00:32:00+02:00,2025-05-25,08:32,2,0,2
28,2025-05-25T15:05:00+02:00,2025-05-25,23:05,2,0,2
86,2025-05-25T00:35:00+02:00,2025-05-25,08:35,3,0,3
28,2025-05-25T15:08:00+02:00,2025-05-25,23:08,4,0,4
109,2025-05-25T00:35:00+02:00,2025-05-25,08:35,2,1,3
28,2025-05-25T15:11:00+02:00,2025-05-25,23:11,0,1,1
117,2025-05-25T00:25:00+02:00,2025-05-25,08:25,2,2,4
28,2025-05-25T15:13:00+02:00,2025-05-25,23:13,4,0,4
117,2025-05-25T00:30:00+02:00,2025-05-25,08:30,8,1,9
28,2025-05-25T15:15:00+02:00,2025-05-25,23:15,1,0,1
130,2025-05-25T00:25:00+02:00,2025-05-25,08:25,1,0,1
28,2025-05-25T15:31:00+02:00,2025-05-25,23:31,1,0,1
130,2025-05-25T00:30:00+02:00,2025-05-25,08:30,2,3,5
28,2025-05-25T15:32:00+02:00,2025-05-25,23:32,2,0,2
130,2025-05-25T00:35:00+02:00,2025-05-25,08:35,0,3,3
29,2025-05-25T15:07:00+02:00,2025-05-25,23:07,1,3,4
136,2025-05-25T00:30:00+02:00,2025-05-25,08:30,8,13,21
29,2025-05-25T15:18:00+02:00,2025-05-25,23:18,0,2,2
136,2025-05-25T00:35:00+02:00,2025-05-25,08:35,4,11,15
29,2025-05-25T15:25:00+02:00,2025-05-25,23:25,0,2,2
137,2025-05-25T00:30:00+02:00,2025-05-25,08:30,1,2,3
31,2025-05-25T14:55:00+02:00,2025-05-25,22:55,0,3,3
137,2025-05-25T00:35:00+02:00,2025-05-25,08:35,1,1,2
31,2025-05-25T14:56:00+02:00,2025-05-25,22:56,0,2,2
139,2025-05-25T00:25:00+02:00,2025-05-25,08:25,3,1,4
31,2025-05-25T15:04:00+02:00,2025-05-25,23:04,0,2,2
161,2025-05-25T00:25:00+02:00,2025-05-25,08:25,6,11,17
31,2025-05-25T15:05:00+02:00,2025-05-25,23:05,0,1,1
161,2025-05-25T00:35:00+02:00,2025-05-25,08:35,6,11,17
31,2025-05-25T15:21:00+02:00,2025-05-25,23:21,0,3,3
31,2025-05-25T15:29:00+02:00,2025-05-25,23:29,0,2,2
31,2025-05-25T15:43:00+02:00,2025-05-25,23:43,1,0,1
31,2025-05-25T15:46:00+02:00,2025-05-25,23:46,0,1,1
31,2025-05-25T15:51:00+02:00,2025-05-25,23:51,2,2,4
31,2025-05-25T15:54:00+02:00,2025-05-25,23:54,0,1,1
36,2025-05-25T15:09:00+02:00,2025-05-25,23:09,0,1,1
36,2025-05-25T15:17:00+02:00,2025-05-25,23:17,2,1,3
36,2025-05-25T15:21:00+02:00,2025-05-25,23:21,4,1,5
36,2025-05-25T15:24:00+02:00,2025-05-25,23:24,0,1,1
36,2025-05-25T15:34:00+02:00,2025-05-25,23:34,2,1,3
36,2025-05-25T15:35:00+02:00,2025-05-25,23:35,0,2,2
36,2025-05-25T15:46:00+02:00,2025-05-25,23:46,0,2,2
37,2025-05-25T14:56:00+02:00,2025-05-25,22:56,4,3,7
37,2025-05-25T14:59:00+02:00,2025-05-25,22:59,0,3,3
37,2025-05-25T15:01:00+02:00,2025-05-25,23:01,0,7,7
37,2025-05-25T15:04:00+02:00,2025-05-25,23:04,0,1,1
37,2025-05-25T15:05:00+02:00,2025-05-25,23:05,1,0,1
37,2025-05-25T15:17:00+02:00,2025-05-25,23:17,0,1,1
37,2025-05-25T15:24:00+02:00,2025-05-25,23:24,1,0,1
37,2025-05-25T15:30:00+02:00,2025-05-25,23:30,0,1,1
37,2025-05-25T15:39:00+02:00,2025-05-25,23:39,0,4,4
37,2025-05-25T15:44:00+02:00,2025-05-25,23:44,0,1,1
37,2025-05-25T15:45:00+02:00,2025-05-25,23:45,1,1,2
37,2025-05-25T15:47:00+02:00,2025-05-25,23:47,1,1,2
37,2025-05-25T15:48:00+02:00,2025-05-25,23:48,0,1,1
39,2025-05-25T14:58:00+02:00,2025-05-25,22:58,1,0,1
40,2025-05-25T15:06:00+02:00,2025-05-25,23:06,0,1,1
40,2025-05-25T15:08:00+02:00,2025-05-25,23:08,1,0,1
40,2025-05-25T15:32:00+02:00,2025-05-25,23:32,0,1,1
40,2025-05-25T15:43:00+02:00,2025-05-25,23:43,0,2,2
40,2025-05-25T15:50:00+02:00,2025-05-25,23:50,0,1,1
41,2025-05-25T14:57:00+02:00,2025-05-25,22:57,2,4,6
41,2025-05-25T15:11:00+02:00,2025-05-25,23:11,0,2,2
41,2025-05-25T15:12:00+02:00,2025-05-25,23:12,1,3,4
41,2025-05-25T15:19:00+02:00,2025-05-25,23:19,2,2,4
41,2025-05-25T15:20:00+02:00,2025-05-25,23:20,0,2,2
41,2025-05-25T15:26:00+02:00,2025-05-25,23:26,0,1,1
41,2025-05-25T15:33:00+02:00,2025-05-25,23:33,0,1,1
41,2025-05-25T15:36:00+02:00,2025-05-25,23:36,0,3,3
41,2025-05-25T15:37:00+02:00,2025-05-25,23:37,1,2,3
41,2025-05-25T15:40:00+02:00,2025-05-25,23:40,0,1,1
41,2025-05-25T15:44:00+02:00,2025-05-25,23:44,4,0,4
41,2025-05-25T15:50:00+02:00,2025-05-25,23:50,1,0,1
43,2025-05-25T15:15:00+02:00,2025-05-25,23:15,1,3,4
44,2025-05-25T15:25:00+02:00,2025-05-25,23:25,1,0,1
45,2025-05-25T14:56:00+02:00,2025-05-25,22:56,0,8,8
45,2025-05-25T15:04:00+02:00,2025-05-25,23:04,1,1,2
45,2025-05-25T15:07:00+02:00,2025-05-25,23:07,0,2,2
45,2025-05-25T15:09:00+02:00,2025-05-25,23:09,1,1,2
45,2025-05-25T15:10:00+02:00,2025-05-25,23:10,4,3,7
45,2025-05-25T15:26:00+02:00,2025-05-25,23:26,4,0,4
45,2025-05-25T15:29:00+02:00,2025-05-25,23:29,2,0,2
45,2025-05-25T15:33:00+02:00,2025-05-25,23:33,0,4,4
45,2025-05-25T15:35:00+02:00,2025-05-25,23:35,2,2,4
45,2025-05-25T15:36:00+02:00,2025-05-25,23:36,0,2,2
45,2025-05-25T15:37:00+02:00,2025-05-25,23:37,1,1,2
45,2025-05-25T15:42:00+02:00,2025-05-25,23:42,3,0,3
45,2025-05-25T15:43:00+02:00,2025-05-25,23:43,1,0,1
45,2025-05-25T15:44:00+02:00,2025-05-25,23:44,0,1,1
45,2025-05-25T15:45:00+02:00,2025-05-25,23:45,2,2,4
47,2025-05-25T14:55:00+02:00,2025-05-25,22:55,5,6,11
47,2025-05-25T14:58:00+02:00,2025-05-25,22:58,0,6,6
47,2025-05-25T14:59:00+02:00,2025-05-25,22:59,0,2,2
47,2025-05-25T15:00:00+02:00,2025-05-25,23:00,5,2,7
47,2025-05-25T15:02:00+02:00,2025-05-25,23:02,8,2,10
47,2025-05-25T15:05:00+02:00,2025-05-25,23:05,2,3,5
47,2025-05-25T15:06:00+02:00,2025-05-25,23:06,6,9,15
47,2025-05-25T15:07:00+02:00,2025-05-25,23:07,1,2,3
47,2025-05-25T15:08:00+02:00,2025-05-25,23:08,1,3,4
47,2025-05-25T15:17:00+02:00,2025-05-25,23:17,6,6,12
47,2025-05-25T15:19:00+02:00,2025-05-25,23:19,3,2,5
47,2025-05-25T15:22:00+02:00,2025-05-25,23:22,0,6,6
47,2025-05-25T15:24:00+02:00,2025-05-25,23:24,4,3,7
47,2025-05-25T15:25:00+02:00,2025-05-25,23:25,7,1,8
47,2025-05-25T15:26:00+02:00,2025-05-25,23:26,3,0,3
47,2025-05-25T15:27:00+02:00,2025-05-25,23:27,2,2,4
47,2025-05-25T15:33:00+02:00,2025-05-25,23:33,2,3,5
47,2025-05-25T15:34:00+02:00,2025-05-25,23:34,0,2,2
47,2025-05-25T15:38:00+02:00,2025-05-25,23:38,2,2,4
47,2025-05-25T15:42:00+02:00,2025-05-25,23:42,1,2,3
47,2025-05-25T15:49:00+02:00,2025-05-25,23:49,0,2,2
47,2025-05-25T15:50:00+02:00,2025-05-25,23:50,2,1,3
47,2025-05-25T15:54:00+02:00,2025-05-25,23:54,2,1,3
47,2025-05-25T15:55:00+02:00,2025-05-25,23:55,3,1,4
50,2025-05-25T14:56:00+02:00,2025-05-25,22:56,1,0,1
50,2025-05-25T15:01:00+02:00,2025-05-25,23:01,3,1,4
50,2025-05-25T15:42:00+02:00,2025-05-25,23:42,0,4,4
50,2025-05-25T15:47:00+02:00,2025-05-25,23:47,1,0,1
54,2025-05-25T14:56:00+02:00,2025-05-25,22:56,2,0,2
54,2025-05-25T15:00:00+02:00,2025-05-25,23:00,3,0,3
54,2025-05-25T15:01:00+02:00,2025-05-25,23:01,1,0,1
54,2025-05-25T15:08:00+02:00,2025-05-25,23:08,2,1,3
54,2025-05-25T15:09:00+02:00,2025-05-25,23:09,1,1,2
54,2025-05-25T15:15:00+02:00,2025-05-25,23:15,3,2,5
54,2025-05-25T15:21:00+02:00,2025-05-25,23:21,0,1,1
54,2025-05-25T15:23:00+02:00,2025-05-25,23:23,1,0,1
54,2025-05-25T15:32:00+02:00,2025-05-25,23:32,0,2,2
54,2025-05-25T15:36:00+02:00,2025-05-25,23:36,0,2,2
54,2025-05-25T15:46:00+02:00,2025-05-25,23:46,0,3,3
54,2025-05-25T15:47:00+02:00,2025-05-25,23:47,0,3,3
54,2025-05-25T15:51:00+02:00,2025-05-25,23:51,4,2,6
54,2025-05-25T15:53:00+02:00,2025-05-25,23:53,1,3,4
59,2025-05-25T14:55:00+02:00,2025-05-25,22:55,5,5,10
59,2025-05-25T15:25:00+02:00,2025-05-25,23:25,3,10,13
59,2025-05-25T15:40:00+02:00,2025-05-25,23:40,4,12,16
59,2025-05-25T15:55:00+02:00,2025-05-25,23:55,4,6,10
61,2025-05-25T15:02:00+02:00,2025-05-25,23:02,3,2,5
61,2025-05-25T15:03:00+02:00,2025-05-25,23:03,2,1,3
61,2025-05-25T15:07:00+02:00,2025-05-25,23:07,1,0,1
61,2025-05-25T15:08:00+02:00,2025-05-25,23:08,1,1,2
61,2025-05-25T15:10:00+02:00,2025-05-25,23:10,2,0,2
61,2025-05-25T15:11:00+02:00,2025-05-25,23:11,2,0,2
61,2025-05-25T15:16:00+02:00,2025-05-25,23:16,1,1,2
61,2025-05-25T15:22:00+02:00,2025-05-25,23:22,1,0,1
61,2025-05-25T15:25:00+02:00,2025-05-25,23:25,1,0,1
61,2025-05-25T15:26:00+02:00,2025-05-25,23:26,1,0,1
61,2025-05-25T15:28:00+02:00,2025-05-25,23:28,6,0,6
61,2025-05-25T15:29:00+02:00,2025-05-25,23:29,3,0,3
61,2025-05-25T15:34:00+02:00,2025-05-25,23:34,4,0,4
61,2025-05-25T15:39:00+02:00,2025-05-25,23:39,1,3,4
61,2025-05-25T15:45:00+02:00,2025-05-25,23:45,0,2,2
61,2025-05-25T15:46:00+02:00,2025-05-25,23:46,1,0,1
61,2025-05-25T15:48:00+02:00,2025-05-25,23:48,1,0,1
61,2025-05-25T15:49:00+02:00,2025-05-25,23:49,3,0,3
61,2025-05-25T15:50:00+02:00,2025-05-25,23:50,0,1,1
61,2025-05-25T15:52:00+02:00,2025-05-25,23:52,2,0,2
61,2025-05-25T15:54:00+02:00,2025-05-25,23:54,1,0,1
66,2025-05-25T14:59:00+02:00,2025-05-25,22:59,4,5,9
66,2025-05-25T15:02:00+02:00,2025-05-25,23:02,5,0,5
66,2025-05-25T15:04:00+02:00,2025-05-25,23:04,8,3,11
66,2025-05-25T15:05:00+02:00,2025-05-25,23:05,4,1,5
66,2025-05-25T15:08:00+02:00,2025-05-25,23:08,4,1,5
66,2025-05-25T15:11:00+02:00,2025-05-25,23:11,10,4,14
66,2025-05-25T15:15:00+02:00,2025-05-25,23:15,5,2,7
66,2025-05-25T15:17:00+02:00,2025-05-25,23:17,1,5,6
66,2025-05-25T15:20:00+02:00,2025-05-25,23:20,0,1,1
66,2025-05-25T15:21:00+02:00,2025-05-25,23:21,5,6,11
66,2025-05-25T15:22:00+02:00,2025-05-25,23:22,4,4,8
66,2025-05-25T15:23:00+02:00,2025-05-25,23:23,1,3,4
66,2025-05-25T15:27:00+02:00,2025-05-25,23:27,2,1,3
66,2025-05-25T15:29:00+02:00,2025-05-25,23:29,2,3,5
66,2025-05-25T15:32:00+02:00,2025-05-25,23:32,0,3,3
66,2025-05-25T15:34:00+02:00,2025-05-25,23:34,0,3,3
66,2025-05-25T15:35:00+02:00,2025-05-25,23:35,2,5,7
66,2025-05-25T15:38:00+02:00,2025-05-25,23:38,2,0,2
66,2025-05-25T15:41:00+02:00,2025-05-25,23:41,1,1,2
66,2025-05-25T15:43:00+02:00,2025-05-25,23:43,0,2,2
66,2025-05-25T15:44:00+02:00,2025-05-25,23:44,1,2,3
66,2025-05-25T15:49:00+02:00,2025-05-25,23:49,2,6,8
66,2025-05-25T15:51:00+02:00,2025-05-25,23:51,0,1,1
66,2025-05-25T15:53:00+02:00,2025-05-25,23:53,2,2,4
70,2025-05-25T15:15:00+02:00,2025-05-25,23:15,0,3,3
70,2025-05-25T15:38:00+02:00,2025-05-25,23:38,0,1,1
71,2025-05-25T15:03:00+02:00,2025-05-25,23:03,1,0,1
71,2025-05-25T15:25:00+02:00,2025-05-25,23:25,0,1,1
71,2025-05-25T15:32:00+02:00,2025-05-25,23:32,2,0,2
75,2025-05-25T15:13:00+02:00,2025-05-25,23:13,1,0,1
75,2025-05-25T15:34:00+02:00,2025-05-25,23:34,1,1,2
77,2025-05-25T15:35:00+02:00,2025-05-25,23:35,3,0,3
77,2025-05-25T15:40:00+02:00,2025-05-25,23:40,1,0,1
77,2025-05-25T15:45:00+02:00,2025-05-25,23:45,1,3,4
78,2025-05-25T15:02:00+02:00,2025-05-25,23:02,0,1,1
78,2025-05-25T15:20:00+02:00,2025-05-25,23:20,1,0,1
84,2025-05-25T14:55:00+02:00,2025-05-25,22:55,11,24,35
84,2025-05-25T15:15:00+02:00,2025-05-25,23:15,11,6,17
84,2025-05-25T15:30:00+02:00,2025-05-25,23:30,4,9,13
84,2025-05-25T15:35:00+02:00,2025-05-25,23:35,3,6,9
84,2025-05-25T15:45:00+02:00,2025-05-25,23:45,1,5,6
87,2025-05-25T15:10:00+02:00,2025-05-25,23:10,0,1,1
87,2025-05-25T15:53:00+02:00,2025-05-25,23:53,0,2,2
107,2025-05-25T15:05:00+02:00,2025-05-25,23:05,2,2,4
107,2025-05-25T15:15:00+02:00,2025-05-25,23:15,1,2,3
107,2025-05-25T15:20:00+02:00,2025-05-25,23:20,2,3,5
107,2025-05-25T15:25:00+02:00,2025-05-25,23:25,3,0,3
107,2025-05-25T15:55:00+02:00,2025-05-25,23:55,3,4,7
108,2025-05-25T15:01:00+02:00,2025-05-25,23:01,1,2,3
108,2025-05-25T15:03:00+02:00,2025-05-25,23:03,2,0,2
108,2025-05-25T15:07:00+02:00,2025-05-25,23:07,1,0,1
108,2025-05-25T15:10:00+02:00,2025-05-25,23:10,0,1,1
108,2025-05-25T15:13:00+02:00,2025-05-25,23:13,0,2,2
108,2025-05-25T15:18:00+02:00,2025-05-25,23:18,1,3,4
108,2025-05-25T15:26:00+02:00,2025-05-25,23:26,1,0,1
108,2025-05-25T15:39:00+02:00,2025-05-25,23:39,0,1,1
108,2025-05-25T15:42:00+02:00,2025-05-25,23:42,0,1,1
108,2025-05-25T15:44:00+02:00,2025-05-25,23:44,1,0,1
108,2025-05-25T15:47:00+02:00,2025-05-25,23:47,1,1,2
108,2025-05-25T15:51:00+02:00,2025-05-25,23:51,2,0,2
108,2025-05-25T15:52:00+02:00,2025-05-25,23:52,1,0,1
108,2025-05-25T15:55:00+02:00,2025-05-25,23:55,0,1,1
131,2025-05-25T15:35:00+02:00,2025-05-25,23:35,5,0,5
131,2025-05-25T15:50:00+02:00,2025-05-25,23:50,7,7,14
132,2025-05-25T14:55:00+02:00,2025-05-25,22:55,4,3,7
132,2025-05-25T15:00:00+02:00,2025-05-25,23:00,5,7,12
132,2025-05-25T15:20:00+02:00,2025-05-25,23:20,3,3,6
132,2025-05-25T15:35:00+02:00,2025-05-25,23:35,3,3,6
132,2025-05-25T15:40:00+02:00,2025-05-25,23:40,1,3,4
132,2025-05-25T15:55:00+02:00,2025-05-25,23:55,0,3,3
133,2025-05-25T14:55:00+02:00,2025-05-25,22:55,16,6,22
133,2025-05-25T15:00:00+02:00,2025-05-25,23:00,10,10,20
133,2025-05-25T15:05:00+02:00,2025-05-25,23:05,6,7,13
133,2025-05-25T15:30:00+02:00,2025-05-25,23:30,1,7,8
133,2025-05-25T15:35:00+02:00,2025-05-25,23:35,5,1,6
133,2025-05-25T15:45:00+02:00,2025-05-25,23:45,1,4,5
134,2025-05-25T15:00:00+02:00,2025-05-25,23:00,7,4,11
134,2025-05-25T15:05:00+02:00,2025-05-25,23:05,5,6,11
134,2025-05-25T15:10:00+02:00,2025-05-25,23:10,8,3,11
134,2025-05-25T15:20:00+02:00,2025-05-25,23:20,5,4,9
134,2025-05-25T15:40:00+02:00,2025-05-25,23:40,5,8,13
134,2025-05-25T15:55:00+02:00,2025-05-25,23:55,2,7,9
135,2025-05-25T15:05:00+02:00,2025-05-25,23:05,1,1,2
135,2025-05-25T15:20:00+02:00,2025-05-25,23:20,1,1,2
162,2025-05-25T15:05:00+02:00,2025-05-25,23:05,0,2,2
162,2025-05-25T15:20:00+02:00,2025-05-25,23:20,3,11,14
162,2025-05-25T15:30:00+02:00,2025-05-25,23:30,0,1,1
162,2025-05-25T15:40:00+02:00,2025-05-25,23:40,1,1,2
162,2025-05-25T15:45:00+02:00,2025-05-25,23:45,0,3,3
165,2025-05-25T15:10:00+02:00,2025-05-25,23:10,1,0,1
166,2025-05-25T15:30:00+02:00,2025-05-25,23:30,0,1,1
166,2025-05-25T15:55:00+02:00,2025-05-25,23:55,1,0,1
167,2025-05-25T14:55:00+02:00,2025-05-25,22:55,0,2,2
167,2025-05-25T15:05:00+02:00,2025-05-25,23:05,1,1,2
167,2025-05-25T15:20:00+02:00,2025-05-25,23:20,0,1,1
179,2025-05-25T14:55:00+02:00,2025-05-25,22:55,3,1,4
179,2025-05-25T15:10:00+02:00,2025-05-25,23:10,0,3,3
179,2025-05-25T15:20:00+02:00,2025-05-25,23:20,2,0,2
179,2025-05-25T15:30:00+02:00,2025-05-25,23:30,1,4,5
179,2025-05-25T15:40:00+02:00,2025-05-25,23:40,1,2,3
179,2025-05-25T15:45:00+02:00,2025-05-25,23:45,3,0,3
179,2025-05-25T15:55:00+02:00,2025-05-25,23:55,0,1,1
1,2025-05-25T14:55:00+02:00,2025-05-25,22:55,1,0,1
1,2025-05-25T14:56:00+02:00,2025-05-25,22:56,0,1,1
1,2025-05-25T15:02:00+02:00,2025-05-25,23:02,0,2,2
1,2025-05-25T15:04:00+02:00,2025-05-25,23:04,4,0,4
1,2025-05-25T15:06:00+02:00,2025-05-25,23:06,0,1,1
1,2025-05-25T15:07:00+02:00,2025-05-25,23:07,0,1,1
1,2025-05-25T15:08:00+02:00,2025-05-25,23:08,1,0,1
1,2025-05-25T15:09:00+02:00,2025-05-25,23:09,2,1,3
1,2025-05-25T15:11:00+02:00,2025-05-25,23:11,2,2,4
1,2025-05-25T15:15:00+02:00,2025-05-25,23:15,1,1,2
1,2025-05-25T15:18:00+02:00,2025-05-25,23:18,1,0,1
1,2025-05-25T15:20:00+02:00,2025-05-25,23:20,2,0,2
1,2025-05-25T15:22:00+02:00,2025-05-25,23:22,2,0,2
1,2025-05-25T15:23:00+02:00,2025-05-25,23:23,1,0,1
1,2025-05-25T15:24:00+02:00,2025-05-25,23:24,1,1,2
1,2025-05-25T15:28:00+02:00,2025-05-25,23:28,2,2,4
1,2025-05-25T15:31:00+02:00,2025-05-25,23:31,0,2,2
1,2025-05-25T15:34:00+02:00,2025-05-25,23:34,1,1,2
1,2025-05-25T15:46:00+02:00,2025-05-25,23:46,1,0,1
1,2025-05-25T15:52:00+02:00,2025-05-25,23:52,0,2,2
2,2025-05-25T14:56:00+02:00,2025-05-25,22:56,0,1,1
2,2025-05-25T15:05:00+02:00,2025-05-25,23:05,2,1,3
2,2025-05-25T15:08:00+02:00,2025-05-25,23:08,0,3,3
2,2025-05-25T15:09:00+02:00,2025-05-25,23:09,2,0,2
2,2025-05-25T15:14:00+02:00,2025-05-25,23:14,0,3,3
2,2025-05-25T15:15:00+02:00,2025-05-25,23:15,0,1,1
2,2025-05-25T15:18:00+02:00,2025-05-25,23:18,0,2,2
2,2025-05-25T15:19:00+02:00,2025-05-25,23:19,0,3,3
2,2025-05-25T15:40:00+02:00,2025-05-25,23:40,1,0,1
2,2025-05-25T15:48:00+02:00,2025-05-25,23:48,2,0,2
2,2025-05-25T15:49:00+02:00,2025-05-25,23:49,0,1,1
9,2025-05-25T14:56:00+02:00,2025-05-25,22:56,1,0,1
9,2025-05-25T15:07:00+02:00,2025-05-25,23:07,1,0,1
10,2025-05-25T15:00:00+02:00,2025-05-25,23:00,0,1,1
10,2025-05-25T15:54:00+02:00,2025-05-25,23:54,1,0,1
12,2025-05-25T14:56:00+02:00,2025-05-25,22:56,0,5,5
12,2025-05-25T15:04:00+02:00,2025-05-25,23:04,0,1,1
12,2025-05-25T15:08:00+02:00,2025-05-25,23:08,0,1,1
12,2025-05-25T15:16:00+02:00,2025-05-25,23:16,2,3,5
12,2025-05-25T15:18:00+02:00,2025-05-25,23:18,0,3,3
12,2025-05-25T15:21:00+02:00,2025-05-25,23:21,1,0,1
12,2025-05-25T15:40:00+02:00,2025-05-25,23:40,2,0,2
12,2025-05-25T15:44:00+02:00,2025-05-25,23:44,0,1,1
12,2025-05-25T15:45:00+02:00,2025-05-25,23:45,0,2,2
12,2025-05-25T15:49:00+02:00,2025-05-25,23:49,1,0,1
12,2025-05-25T15:50:00+02:00,2025-05-25,23:50,1,1,2
12,2025-05-25T15:51:00+02:00,2025-05-25,23:51,2,0,2
12,2025-05-25T15:52:00+02:00,2025-05-25,23:52,0,2,2
12,2025-05-25T15:55:00+02:00,2025-05-25,23:55,1,0,1
17,2025-05-25T15:40:00+02:00,2025-05-25,23:40,2,0,2
17,2025-05-25T15:45:00+02:00,2025-05-25,23:45,1,0,1
19,2025-05-25T14:55:00+02:00,2025-05-25,22:55,4,0,4
19,2025-05-25T15:00:00+02:00,2025-05-25,23:00,2,3,5
19,2025-05-25T15:01:00+02:00,2025-05-25,23:01,0,4,4
19,2025-05-25T15:04:00+02:00,2025-05-25,23:04,0,9,9
19,2025-05-25T15:10:00+02:00,2025-05-25,23:10,3,2,5
19,2025-05-25T15:12:00+02:00,2025-05-25,23:12,0,1,1
19,2025-05-25T15:13:00+02:00,2025-05-25,23:13,2,2,4
19,2025-05-25T15:19:00+02:00,2025-05-25,23:19,3,3,6
19,2025-05-25T15:21:00+02:00,2025-05-25,23:21,4,5,9
19,2025-05-25T15:22:00+02:00,2025-05-25,23:22,1,2,3
19,2025-05-25T15:24:00+02:00,2025-05-25,23:24,0,1,1
19,2025-05-25T15:27:00+02:00,2025-05-25,23:27,0,1,1
19,2025-05-25T15:28:00+02:00,2025-05-25,23:28,0,3,3
19,2025-05-25T15:33:00+02:00,2025-05-25,23:33,0,1,1
19,2025-05-25T15:38:00+02:00,2025-05-25,23:38,3,2,5
19,2025-05-25T15:40:00+02:00,2025-05-25,23:40,0,2,2
19,2025-05-25T15:45:00+02:00,2025-05-25,23:45,3,3,6
19,2025-05-25T15:48:00+02:00,2025-05-25,23:48,0,3,3
19,2025-05-25T15:50:00+02:00,2025-05-25,23:50,0,6,6
19,2025-05-25T15:51:00+02:00,2025-05-25,23:51,0,3,3
19,2025-05-25T15:55:00+02:00,2025-05-25,23:55,0,2,2
20,2025-05-25T14:56:00+02:00,2025-05-25,22:56,0,3,3
20,2025-05-25T14:58:00+02:00,2025-05-25,22:58,0,1,1
20,2025-05-25T15:02:00+02:00,2025-05-25,23:02,2,3,5
20,2025-05-25T15:05:00+02:00,2025-05-25,23:05,2,0,2
20,2025-05-25T15:06:00+02:00,2025-05-25,23:06,6,0,6
20,2025-05-25T15:07:00+02:00,2025-05-25,23:07,4,2,6
20,2025-05-25T15:41:00+02:00,2025-05-25,23:41,1,0,1
20,2025-05-25T15:43:00+02:00,2025-05-25,23:43,0,2,2
20,2025-05-25T15:45:00+02:00,2025-05-25,23:45,0,5,5
20,2025-05-25T15:46:00+02:00,2025-05-25,23:46,0,1,1
23,2025-05-25T14:58:00+02:00,2025-05-25,22:58,0,1,1
23,2025-05-25T14:59:00+02:00,2025-05-25,22:59,0,1,1
23,2025-05-25T15:05:00+02:00,2025-05-25,23:05,0,5,5
23,2025-05-25T15:08:00+02:00,2025-05-25,23:08,3,0,3
23,2025-05-25T15:19:00+02:00,2025-05-25,23:19,0,2,2
23,2025-05-25T15:22:00+02:00,2025-05-25,23:22,1,0,1
23,2025-05-25T15:27:00+02:00,2025-05-25,23:27,0,2,2
23,2025-05-25T15:32:00+02:00,2025-05-25,23:32,0,1,1
23,2025-05-25T15:40:00+02:00,2025-05-25,23:40,1,0,1
23,2025-05-25T15:45:00+02:00,2025-05-25,23:45,0,1,1
23,2025-05-25T15:48:00+02:00,2025-05-25,23:48,0,1,1
24,2025-05-25T14:57:00+02:00,2025-05-25,22:57,4,1,5
24,2025-05-25T14:58:00+02:00,2025-05-25,22:58,6,2,8
24,2025-05-25T14:59:00+02:00,2025-05-25,22:59,2,2,4
24,2025-05-25T15:11:00+02:00,2025-05-25,23:11,3,0,3
24,2025-05-25T15:26:00+02:00,2025-05-25,23:26,1,7,8
24,2025-05-25T15:27:00+02:00,2025-05-25,23:27,2,8,10
24,2025-05-25T15:29:00+02:00,2025-05-25,23:29,1,6,7
24,2025-05-25T15:40:00+02:00,2025-05-25,23:40,0,16,16
24,2025-05-25T15:42:00+02:00,2025-05-25,23:42,4,0,4
24,2025-05-25T15:43:00+02:00,2025-05-25,23:43,0,7,7
24,2025-05-25T15:44:00+02:00,2025-05-25,23:44,0,2,2
24,2025-05-25T15:45:00+02:00,2025-05-25,23:45,1,4,5
24,2025-05-25T15:46:00+02:00,2025-05-25,23:46,2,2,4
24,2025-05-25T15:48:00+02:00,2025-05-25,23:48,1,1,2
24,2025-05-25T15:54:00+02:00,2025-05-25,23:54,1,0,1
25,2025-05-25T15:15:00+02:00,2025-05-25,23:15,4,13,17
25,2025-05-25T15:25:00+02:00,2025-05-25,23:25,0,3,3
25,2025-05-25T15:40:00+02:00,2025-05-25,23:40,0,2,2
27,2025-05-25T15:06:00+02:00,2025-05-25,23:06,0,1,1
27,2025-05-25T15:11:00+02:00,2025-05-25,23:11,1,0,1
27,2025-05-25T15:18:00+02:00,2025-05-25,23:18,0,1,1
27,2025-05-25T15:23:00+02:00,2025-05-25,23:23,0,1,1
27,2025-05-25T15:25:00+02:00,2025-05-25,23:25,3,3,6
27,2025-05-25T15:26:00+02:00,2025-05-25,23:26,1,0,1
27,2025-05-25T15:38:00+02:00,2025-05-25,23:38,3,0,3
27,2025-05-25T15:42:00+02:00,2025-05-25,23:42,0,1,1
27,2025-05-25T15:52:00+02:00,2025-05-25,23:52,2,0,2
30,2025-05-25T14:56:00+02:00,2025-05-25,22:56,2,0,2
30,2025-05-25T14:58:00+02:00,2025-05-25,22:58,3,5,8
30,2025-05-25T15:03:00+02:00,2025-05-25,23:03,0,10,10
30,2025-05-25T15:05:00+02:00,2025-05-25,23:05,6,1,7
30,2025-05-25T15:06:00+02:00,2025-05-25,23:06,1,3,4
30,2025-05-25T15:07:00+02:00,2025-05-25,23:07,2,0,2
30,2025-05-25T15:08:00+02:00,2025-05-25,23:08,6,5,11
30,2025-05-25T15:09:00+02:00,2025-05-25,23:09,3,2,5
30,2025-05-25T15:10:00+02:00,2025-05-25,23:10,0,5,5
30,2025-05-25T15:13:00+02:00,2025-05-25,23:13,10,1,11
30,2025-05-25T15:19:00+02:00,2025-05-25,23:19,2,2,4
30,2025-05-25T15:21:00+02:00,2025-05-25,23:21,7,2,9
30,2025-05-25T15:23:00+02:00,2025-05-25,23:23,1,3,4
30,2025-05-25T15:24:00+02:00,2025-05-25,23:24,4,5,9
30,2025-05-25T15:29:00+02:00,2025-05-25,23:29,1,6,7
30,2025-05-25T15:37:00+02:00,2025-05-25,23:37,3,0,3
30,2025-05-25T15:38:00+02:00,2025-05-25,23:38,1,1,2
30,2025-05-25T15:41:00+02:00,2025-05-25,23:41,0,2,2
30,2025-05-25T15:43:00+02:00,2025-05-25,23:43,1,0,1
30,2025-05-25T15:44:00+02:00,2025-05-25,23:44,1,1,2
30,2025-05-25T15:45:00+02:00,2025-05-25,23:45,5,3,8
30,2025-05-25T15:46:00+02:00,2025-05-25,23:46,0,1,1
35,2025-05-25T15:00:00+02:00,2025-05-25,23:00,1,2,3
35,2025-05-25T15:01:00+02:00,2025-05-25,23:01,0,1,1
35,2025-05-25T15:06:00+02:00,2025-05-25,23:06,1,2,3
35,2025-05-25T15:08:00+02:00,2025-05-25,23:08,3,0,3
35,2025-05-25T15:12:00+02:00,2025-05-25,23:12,2,0,2
35,2025-05-25T15:13:00+02:00,2025-05-25,23:13,4,2,6
35,2025-05-25T15:16:00+02:00,2025-05-25,23:16,0,3,3
35,2025-05-25T15:18:00+02:00,2025-05-25,23:18,2,2,4
35,2025-05-25T15:19:00+02:00,2025-05-25,23:19,2,4,6
35,2025-05-25T15:22:00+02:00,2025-05-25,23:22,3,2,5
35,2025-05-25T15:23:00+02:00,2025-05-25,23:23,0,2,2
35,2025-05-25T15:25:00+02:00,2025-05-25,23:25,5,2,7
35,2025-05-25T15:28:00+02:00,2025-05-25,23:28,0,1,1
35,2025-05-25T15:29:00+02:00,2025-05-25,23:29,1,0,1
35,2025-05-25T15:31:00+02:00,2025-05-25,23:31,3,4,7
35,2025-05-25T15:42:00+02:00,2025-05-25,23:42,5,1,6
35,2025-05-25T15:43:00+02:00,2025-05-25,23:43,1,0,1
35,2025-05-25T15:54:00+02:00,2025-05-25,23:54,0,2,2
49,2025-05-25T14:55:00+02:00,2025-05-25,22:55,5,1,6
49,2025-05-25T14:58:00+02:00,2025-05-25,22:58,0,2,2
49,2025-05-25T14:59:00+02:00,2025-05-25,22:59,1,0,1
49,2025-05-25T15:04:00+02:00,2025-05-25,23:04,8,6,14
49,2025-05-25T15:10:00+02:00,2025-05-25,23:10,2,0,2
49,2025-05-25T15:12:00+02:00,2025-05-25,23:12,3,5,8
49,2025-05-25T15:14:00+02:00,2025-05-25,23:14,4,0,4
49,2025-05-25T15:16:00+02:00,2025-05-25,23:16,1,5,6
49,2025-05-25T15:20:00+02:00,2025-05-25,23:20,8,3,11
49,2025-05-25T15:22:00+02:00,2025-05-25,23:22,0,5,5
49,2025-05-25T15:26:00+02:00,2025-05-25,23:26,2,5,7
49,2025-05-25T15:29:00+02:00,2025-05-25,23:29,0,1,1
49,2025-05-25T15:30:00+02:00,2025-05-25,23:30,0,2,2
49,2025-05-25T15:35:00+02:00,2025-05-25,23:35,0,2,2
49,2025-05-25T15:42:00+02:00,2025-05-25,23:42,2,2,4
49,2025-05-25T15:46:00+02:00,2025-05-25,23:46,1,2,3
49,2025-05-25T15:53:00+02:00,2025-05-25,23:53,0,1,1
51,2025-05-25T14:59:00+02:00,2025-05-25,22:59,3,1,4
51,2025-05-25T15:02:00+02:00,2025-05-25,23:02,0,1,1
51,2025-05-25T15:03:00+02:00,2025-05-25,23:03,1,1,2
51,2025-05-25T15:10:00+02:00,2025-05-25,23:10,0,4,4
51,2025-05-25T15:11:00+02:00,2025-05-25,23:11,2,0,2
51,2025-05-25T15:36:00+02:00,2025-05-25,23:36,2,0,2
51,2025-05-25T15:40:00+02:00,2025-05-25,23:40,1,0,1
51,2025-05-25T15:43:00+02:00,2025-05-25,23:43,0,2,2
51,2025-05-25T15:49:00+02:00,2025-05-25,23:49,2,0,2
51,2025-05-25T15:50:00+02:00,2025-05-25,23:50,4,0,4
51,2025-05-25T15:53:00+02:00,2025-05-25,23:53,2,4,6
51,2025-05-25T15:54:00+02:00,2025-05-25,23:54,0,2,2
52,2025-05-25T14:55:00+02:00,2025-05-25,22:55,3,0,3
52,2025-05-25T15:05:00+02:00,2025-05-25,23:05,0,1,1
52,2025-05-25T15:23:00+02:00,2025-05-25,23:23,2,0,2
52,2025-05-25T15:28:00+02:00,2025-05-25,23:28,2,0,2
52,2025-05-25T15:35:00+02:00,2025-05-25,23:35,1,0,1
52,2025-05-25T15:37:00+02:00,2025-05-25,23:37,2,0,2
52,2025-05-25T15:39:00+02:00,2025-05-25,23:39,2,0,2
52,2025-05-25T15:48:00+02:00,2025-05-25,23:48,0,3,3
52,2025-05-25T15:49:00+02:00,2025-05-25,23:49,1,0,1
52,2025-05-25T15:52:00+02:00,2025-05-25,23:52,0,2,2
52,2025-05-25T15:55:00+02:00,2025-05-25,23:55,2,0,2
53,2025-05-25T14:57:00+02:00,2025-05-25,22:57,1,0,1
53,2025-05-25T14:58:00+02:00,2025-05-25,22:58,1,0,1
53,2025-05-25T15:05:00+02:00,2025-05-25,23:05,3,0,3
53,2025-05-25T15:10:00+02:00,2025-05-25,23:10,2,0,2
53,2025-05-25T15:15:00+02:00,2025-05-25,23:15,1,0,1
53,2025-05-25T15:16:00+02:00,2025-05-25,23:16,0,1,1
53,2025-05-25T15:21:00+02:00,2025-05-25,23:21,0,2,2
53,2025-05-25T15:26:00+02:00,2025-05-25,23:26,0,1,1
53,2025-05-25T15:31:00+02:00,2025-05-25,23:31,2,0,2
53,2025-05-25T15:34:00+02:00,2025-05-25,23:34,1,0,1
53,2025-05-25T15:37:00+02:00,2025-05-25,23:37,1,0,1
53,2025-05-25T15:55:00+02:00,2025-05-25,23:55,2,0,2
56,2025-05-25T15:19:00+02:00,2025-05-25,23:19,0,1,1
56,2025-05-25T15:21:00+02:00,2025-05-25,23:21,1,1,2
56,2025-05-25T15:22:00+02:00,2025-05-25,23:22,0,1,1
56,2025-05-25T15:23:00+02:00,2025-05-25,23:23,2,0,2
56,2025-05-25T15:30:00+02:00,2025-05-25,23:30,0,1,1
56,2025-05-25T15:38:00+02:00,2025-05-25,23:38,0,1,1
56,2025-05-25T15:39:00+02:00,2025-05-25,23:39,4,1,5
56,2025-05-25T15:40:00+02:00,2025-05-25,23:40,1,0,1
56,2025-05-25T15:45:00+02:00,2025-05-25,23:45,4,2,6
56,2025-05-25T15:46:00+02:00,2025-05-25,23:46,1,2,3
56,2025-05-25T15:55:00+02:00,2025-05-25,23:55,0,2,2
58,2025-05-25T14:57:00+02:00,2025-05-25,22:57,6,3,9
58,2025-05-25T14:58:00+02:00,2025-05-25,22:58,1,4,5
58,2025-05-25T14:59:00+02:00,2025-05-25,22:59,3,0,3
58,2025-05-25T15:00:00+02:00,2025-05-25,23:00,4,0,4
58,2025-05-25T15:07:00+02:00,2025-05-25,23:07,1,0,1
58,2025-05-25T15:09:00+02:00,2025-05-25,23:09,2,1,3
58,2025-05-25T15:13:00+02:00,2025-05-25,23:13,0,4,4
58,2025-05-25T15:14:00+02:00,2025-05-25,23:14,1,0,1
58,2025-05-25T15:15:00+02:00,2025-05-25,23:15,0,6,6
58,2025-05-25T15:19:00+02:00,2025-05-25,23:19,1,0,1
58,2025-05-25T15:21:00+02:00,2025-05-25,23:21,1,1,2
58,2025-05-25T15:32:00+02:00,2025-05-25,23:32,4,5,9
58,2025-05-25T15:36:00+02:00,2025-05-25,23:36,0,1,1
58,2025-05-25T15:38:00+02:00,2025-05-25,23:38,3,0,3
58,2025-05-25T15:44:00+02:00,2025-05-25,23:44,1,6,7
58,2025-05-25T15:54:00+02:00,2025-05-25,23:54,0,1,1
58,2025-05-25T15:55:00+02:00,2025-05-25,23:55,1,0,1
62,2025-05-25T15:00:00+02:00,2025-05-25,23:00,2,3,5
62,2025-05-25T15:03:00+02:00,2025-05-25,23:03,2,2,4
62,2025-05-25T15:14:00+02:00,2025-05-25,23:14,4,0,4
62,2025-05-25T15:22:00+02:00,2025-05-25,23:22,2,0,2
62,2025-05-25T15:25:00+02:00,2025-05-25,23:25,2,1,3
62,2025-05-25T15:30:00+02:00,2025-05-25,23:30,2,5,7
62,2025-05-25T15:32:00+02:00,2025-05-25,23:32,1,1,2
62,2025-05-25T15:40:00+02:00,2025-05-25,23:40,0,1,1
62,2025-05-25T15:41:00+02:00,2025-05-25,23:41,1,1,2
62,2025-05-25T15:42:00+02:00,2025-05-25,23:42,1,0,1
62,2025-05-25T15:43:00+02:00,2025-05-25,23:43,0,1,1
62,2025-05-25T15:48:00+02:00,2025-05-25,23:48,0,3,3
62,2025-05-25T15:50:00+02:00,2025-05-25,23:50,1,0,1
63,2025-05-25T15:03:00+02:00,2025-05-25,23:03,0,1,1
63,2025-05-25T15:04:00+02:00,2025-05-25,23:04,1,1,2
63,2025-05-25T15:08:00+02:00,2025-05-25,23:08,0,1,1
63,2025-05-25T15:16:00+02:00,2025-05-25,23:16,0,1,1
63,2025-05-25T15:43:00+02:00,2025-05-25,23:43,0,1,1
63,2025-05-25T15:49:00+02:00,2025-05-25,23:49,0,4,4
67,2025-05-25T14:59:00+02:00,2025-05-25,22:59,0,1,1
67,2025-05-25T15:02:00+02:00,2025-05-25,23:02,0,2,2
67,2025-05-25T15:05:00+02:00,2025-05-25,23:05,0,2,2
67,2025-05-25T15:09:00+02:00,2025-05-25,23:09,0,3,3
67,2025-05-25T15:11:00+02:00,2025-05-25,23:11,2,0,2
67,2025-05-25T15:23:00+02:00,2025-05-25,23:23,2,0,2
67,2025-05-25T15:27:00+02:00,2025-05-25,23:27,0,2,2
67,2025-05-25T15:31:00+02:00,2025-05-25,23:31,0,2,2
67,2025-05-25T15:42:00+02:00,2025-05-25,23:42,0,2,2
67,2025-05-25T15:43:00+02:00,2025-05-25,23:43,1,0,1
67,2025-05-25T15:54:00+02:00,2025-05-25,23:54,2,0,2
68,2025-05-25T14:59:00+02:00,2025-05-25,22:59,0,3,3
72,2025-05-25T15:02:00+02:00,2025-05-25,23:02,0,1,1
72,2025-05-25T15:05:00+02:00,2025-05-25,23:05,0,11,11
72,2025-05-25T15:06:00+02:00,2025-05-25,23:06,2,0,2
72,2025-05-25T15:07:00+02:00,2025-05-25,23:07,0,1,1
72,2025-05-25T15:38:00+02:00,2025-05-25,23:38,0,1,1
72,2025-05-25T15:42:00+02:00,2025-05-25,23:42,0,1,1
72,2025-05-25T15:48:00+02:00,2025-05-25,23:48,1,0,1
72,2025-05-25T15:49:00+02:00,2025-05-25,23:49,0,9,9
76,2025-05-25T15:04:00+02:00,2025-05-25,23:04,1,0,1
76,2025-05-25T15:05:00+02:00,2025-05-25,23:05,0,1,1
76,2025-05-25T15:26:00+02:00,2025-05-25,23:26,1,1,2
76,2025-05-25T15:53:00+02:00,2025-05-25,23:53,1,0,1
79,2025-05-25T14:56:00+02:00,2025-05-25,22:56,2,3,5
79,2025-05-25T14:57:00+02:00,2025-05-25,22:57,1,1,2
79,2025-05-25T15:00:00+02:00,2025-05-25,23:00,1,2,3
79,2025-05-25T15:01:00+02:00,2025-05-25,23:01,2,2,4
79,2025-05-25T15:08:00+02:00,2025-05-25,23:08,1,0,1
79,2025-05-25T15:13:00+02:00,2025-05-25,23:13,0,1,1
79,2025-05-25T15:29:00+02:00,2025-05-25,23:29,0,2,2
79,2025-05-25T15:39:00+02:00,2025-05-25,23:39,1,0,1
79,2025-05-25T15:50:00+02:00,2025-05-25,23:50,1,0,1
85,2025-05-25T15:04:00+02:00,2025-05-25,23:04,0,1,1
86,2025-05-25T15:03:00+02:00,2025-05-25,23:03,0,1,1
86,2025-05-25T15:18:00+02:00,2025-05-25,23:18,0,1,1
86,2025-05-25T15:19:00+02:00,2025-05-25,23:19,2,0,2
86,2025-05-25T15:23:00+02:00,2025-05-25,23:23,0,2,2
109,2025-05-25T14:55:00+02:00,2025-05-25,22:55,0,7,7
109,2025-05-25T15:05:00+02:00,2025-05-25,23:05,3,0,3
109,2025-05-25T15:35:00+02:00,2025-05-25,23:35,2,2,4
109,2025-05-25T15:40:00+02:00,2025-05-25,23:40,3,1,4
117,2025-05-25T15:10:00+02:00,2025-05-25,23:10,12,0,12
130,2025-05-25T15:05:00+02:00,2025-05-25,23:05,2,0,2
130,2025-05-25T15:25:00+02:00,2025-05-25,23:25,1,0,1
136,2025-05-25T15:00:00+02:00,2025-05-25,23:00,0,1,1
139,2025-05-25T15:00:00+02:00,2025-05-25,23:00,0,3,3
141,2025-05-25T14:55:00+02:00,2025-05-25,22:55,0,5,5
141,2025-05-25T15:05:00+02:00,2025-05-25,23:05,2,2,4
141,2025-05-25T15:25:00+02:00,2025-05-25,23:25,1,4,5
142,2025-05-25T14:55:00+02:00,2025-05-25,22:55,0,1,1
164,2025-05-25T15:00:00+02:00,2025-05-25,23:00,0,3,3
164,2025-05-25T15:05:00+02:00,2025-05-25,23:05,2,0,2
164,2025-05-25T15:25:00+02:00,2025-05-25,23:25,0,3,3
164,2025-05-25T15:30:00+02:00,2025-05-25,23:30,1,0,1
3,2025-05-25T00:40:00+02:00,2025-05-25,08:40,2,0,2
3,2025-05-25T00:44:00+02:00,2025-05-25,08:44,2,0,2
3,2025-05-25T00:49:00+02:00,2025-05-25,08:49,3,1,4
3,2025-05-25T00:51:00+02:00,2025-05-25,08:51,0,2,2
4,2025-05-25T00:41:00+02:00,2025-05-25,08:41,4,3,7
4,2025-05-25T00:43:00+02:00,2025-05-25,08:43,5,2,7
4,2025-05-25T00:44:00+02:00,2025-05-25,08:44,12,1,13
4,2025-05-25T00:45:00+02:00,2025-05-25,08:45,2,1,3
4,2025-05-25T00:46:00+02:00,2025-05-25,08:46,1,2,3
4,2025-05-25T00:49:00+02:00,2025-05-25,08:49,0,1,1
4,2025-05-25T00:51:00+02:00,2025-05-25,08:51,6,2,8
4,2025-05-25T00:52:00+02:00,2025-05-25,08:52,7,2,9
6,2025-05-25T00:42:00+02:00,2025-05-25,08:42,3,3,6
6,2025-05-25T00:43:00+02:00,2025-05-25,08:43,4,1,5
6,2025-05-25T00:48:00+02:00,2025-05-25,08:48,11,3,14
6,2025-05-25T00:50:00+02:00,2025-05-25,08:50,3,1,4
6,2025-05-25T00:53:00+02:00,2025-05-25,08:53,6,7,13
6,2025-05-25T00:54:00+02:00,2025-05-25,08:54,5,3,8
8,2025-05-25T00:40:00+02:00,2025-05-25,08:40,0,1,1
8,2025-05-25T00:41:00+02:00,2025-05-25,08:41,1,3,4
8,2025-05-25T00:43:00+02:00,2025-05-25,08:43,3,3,6
8,2025-05-25T00:46:00+02:00,2025-05-25,08:46,1,0,1
8,2025-05-25T00:47:00+02:00,2025-05-25,08:47,3,5,8
8,2025-05-25T00:50:00+02:00,2025-05-25,08:50,0,4,4
8,2025-05-25T00:53:00+02:00,2025-05-25,08:53,1,2,3
28,2025-05-25T00:40:00+02:00,2025-05-25,08:40,3,1,4
28,2025-05-25T00:41:00+02:00,2025-05-25,08:41,4,2,6
28,2025-05-25T00:44:00+02:00,2025-05-25,08:44,0,1,1
28,2025-05-25T00:52:00+02:00,2025-05-25,08:52,1,0,1
28,2025-05-25T00:53:00+02:00,2025-05-25,08:53,1,3,4
28,2025-05-25T00:54:00+02:00,2025-05-25,08:54,1,1,2
29,2025-05-25T00:43:00+02:00,2025-05-25,08:43,1,3,4
29,2025-05-25T00:52:00+02:00,2025-05-25,08:52,3,1,4
29,2025-05-25T00:54:00+02:00,2025-05-25,08:54,3,1,4
36,2025-05-25T00:40:00+02:00,2025-05-25,08:40,1,2,3
36,2025-05-25T00:45:00+02:00,2025-05-25,08:45,0,2,2
36,2025-05-25T00:46:00+02:00,2025-05-25,08:46,0,4,4
36,2025-05-25T00:47:00+02:00,2025-05-25,08:47,1,0,1
36,2025-05-25T00:49:00+02:00,2025-05-25,08:49,0,1,1
37,2025-05-25T00:42:00+02:00,2025-05-25,08:42,2,0,2
37,2025-05-25T00:52:00+02:00,2025-05-25,08:52,1,0,1
39,2025-05-25T00:49:00+02:00,2025-05-25,08:49,0,3,3
39,2025-05-25T00:52:00+02:00,2025-05-25,08:52,1,0,1
40,2025-05-25T00:42:00+02:00,2025-05-25,08:42,0,1,1
40,2025-05-25T00:48:00+02:00,2025-05-25,08:48,0,1,1
40,2025-05-25T00:53:00+02:00,2025-05-25,08:53,1,1,2
40,2025-05-25T00:54:00+02:00,2025-05-25,08:54,1,0,1
41,2025-05-25T00:42:00+02:00,2025-05-25,08:42,1,2,3
41,2025-05-25T00:45:00+02:00,2025-05-25,08:45,0,5,5
41,2025-05-25T00:46:00+02:00,2025-05-25,08:46,1,2,3
41,2025-05-25T00:49:00+02:00,2025-05-25,08:49,1,2,3
41,2025-05-25T00:51:00+02:00,2025-05-25,08:51,1,0,1
41,2025-05-25T00:52:00+02:00,2025-05-25,08:52,5,8,13
43,2025-05-25T00:40:00+02:00,2025-05-25,08:40,0,3,3
43,2025-05-25T00:45:00+02:00,2025-05-25,08:45,4,1,5
44,2025-05-25T00:40:00+02:00,2025-05-25,08:40,0,3,3
45,2025-05-25T00:41:00+02:00,2025-05-25,08:41,1,2,3
45,2025-05-25T00:43:00+02:00,2025-05-25,08:43,4,0,4
45,2025-05-25T00:45:00+02:00,2025-05-25,08:45,3,0,3
45,2025-05-25T00:49:00+02:00,2025-05-25,08:49,4,5,9
45,2025-05-25T00:53:00+02:00,2025-05-25,08:53,0,2,2
45,2025-05-25T00:54:00+02:00,2025-05-25,08:54,3,5,8
47,2025-05-25T00:41:00+02:00,2025-05-25,08:41,0,1,1
47,2025-05-25T00:43:00+02:00,2025-05-25,08:43,3,4,7
47,2025-05-25T00:44:00+02:00,2025-05-25,08:44,4,1,5
47,2025-05-25T00:48:00+02:00,2025-05-25,08:48,1,3,4
50,2025-05-25T00:40:00+02:00,2025-05-25,08:40,0,1,1
50,2025-05-25T00:45:00+02:00,2025-05-25,08:45,1,2,3
50,2025-05-25T00:53:00+02:00,2025-05-25,08:53,0,1,1
50,2025-05-25T00:54:00+02:00,2025-05-25,08:54,1,1,2
61,2025-05-25T00:46:00+02:00,2025-05-25,08:46,0,4,4
61,2025-05-25T00:49:00+02:00,2025-05-25,08:49,0,2,2
61,2025-05-25T00:52:00+02:00,2025-05-25,08:52,2,1,3
61,2025-05-25T00:53:00+02:00,2025-05-25,08:53,1,1,2
66,2025-05-25T00:44:00+02:00,2025-05-25,08:44,0,1,1
66,2025-05-25T00:45:00+02:00,2025-05-25,08:45,1,1,2
66,2025-05-25T00:50:00+02:00,2025-05-25,08:50,4,0,4
66,2025-05-25T00:51:00+02:00,2025-05-25,08:51,0,5,5
66,2025-05-25T00:52:00+02:00,2025-05-25,08:52,1,1,2
66,2025-05-25T00:54:00+02:00,2025-05-25,08:54,3,7,10
69,2025-05-25T00:45:00+02:00,2025-05-25,08:45,1,2,3
69,2025-05-25T00:50:00+02:00,2025-05-25,08:50,4,0,4
69,2025-05-25T00:52:00+02:00,2025-05-25,08:52,1,1,2
69,2025-05-25T00:53:00+02:00,2025-05-25,08:53,2,0,2
70,2025-05-25T00:51:00+02:00,2025-05-25,08:51,1,1,2
75,2025-05-25T00:44:00+02:00,2025-05-25,08:44,3,1,4
75,2025-05-25T00:49:00+02:00,2025-05-25,08:49,0,1,1
75,2025-05-25T00:50:00+02:00,2025-05-25,08:50,2,1,3
77,2025-05-25T00:50:00+02:00,2025-05-25,08:50,15,6,21
78,2025-05-25T00:53:00+02:00,2025-05-25,08:53,0,1,1
84,2025-05-25T00:45:00+02:00,2025-05-25,08:45,18,19,37
87,2025-05-25T00:47:00+02:00,2025-05-25,08:47,1,0,1
87,2025-05-25T00:49:00+02:00,2025-05-25,08:49,1,1,2
87,2025-05-25T00:51:00+02:00,2025-05-25,08:51,0,2,2
108,2025-05-25T00:42:00+02:00,2025-05-25,08:42,1,1,2
108,2025-05-25T00:44:00+02:00,2025-05-25,08:44,2,5,7
108,2025-05-25T00:47:00+02:00,2025-05-25,08:47,2,5,7
108,2025-05-25T00:50:00+02:00,2025-05-25,08:50,4,1,5
118,2025-05-25T00:40:00+02:00,2025-05-25,08:40,1,0,1
131,2025-05-25T00:50:00+02:00,2025-05-25,08:50,4,3,7
132,2025-05-25T00:50:00+02:00,2025-05-25,08:50,10,8,18
134,2025-05-25T00:40:00+02:00,2025-05-25,08:40,20,16,36
135,2025-05-25T00:45:00+02:00,2025-05-25,08:45,14,6,20
135,2025-05-25T00:50:00+02:00,2025-05-25,08:50,15,17,32
140,2025-05-25T00:45:00+02:00,2025-05-25,08:45,4,1,5
162,2025-05-25T00:45:00+02:00,2025-05-25,08:45,22,12,34
165,2025-05-25T00:40:00+02:00,2025-05-25,08:40,3,5,8
166,2025-05-25T00:50:00+02:00,2025-05-25,08:50,1,1,2
167,2025-05-25T00:50:00+02:00,2025-05-25,08:50,4,3,7
1,2025-05-25T00:45:00+02:00,2025-05-25,08:45,1,3,4
2,2025-05-25T00:41:00+02:00,2025-05-25,08:41,3,0,3
2,2025-05-25T00:50:00+02:00,2025-05-25,08:50,0,2,2
2,2025-05-25T00:53:00+02:00,2025-05-25,08:53,0,1,1
9,2025-05-25T00:43:00+02:00,2025-05-25,08:43,1,1,2
9,2025-05-25T00:46:00+02:00,2025-05-25,08:46,0,1,1
9,2025-05-25T00:50:00+02:00,2025-05-25,08:50,4,1,5
9,2025-05-25T00:52:00+02:00,2025-05-25,08:52,1,0,1
10,2025-05-25T00:41:00+02:00,2025-05-25,08:41,1,2,3
10,2025-05-25T00:44:00+02:00,2025-05-25,08:44,0,2,2
10,2025-05-25T00:53:00+02:00,2025-05-25,08:53,1,1,2
11,2025-05-25T00:40:00+02:00,2025-05-25,08:40,1,0,1
11,2025-05-25T00:41:00+02:00,2025-05-25,08:41,3,0,3
11,2025-05-25T00:42:00+02:00,2025-05-25,08:42,1,0,1
11,2025-05-25T00:43:00+02:00,2025-05-25,08:43,1,0,1
11,2025-05-25T00:47:00+02:00,2025-05-25,08:47,0,3,3
11,2025-05-25T00:52:00+02:00,2025-05-25,08:52,4,0,4
12,2025-05-25T00:40:00+02:00,2025-05-25,08:40,2,0,2
12,2025-05-25T00:42:00+02:00,2025-05-25,08:42,2,0,2
12,2025-05-25T00:45:00+02:00,2025-05-25,08:45,9,0,9
12,2025-05-25T00:54:00+02:00,2025-05-25,08:54,9,4,13
17,2025-05-25T00:42:00+02:00,2025-05-25,08:42,3,0,3
17,2025-05-25T00:44:00+02:00,2025-05-25,08:44,0,1,1
18,2025-05-25T00:45:00+02:00,2025-05-25,08:45,0,3,3
18,2025-05-25T00:48:00+02:00,2025-05-25,08:48,0,2,2
19,2025-05-25T00:41:00+02:00,2025-05-25,08:41,1,0,1
19,2025-05-25T00:51:00+02:00,2025-05-25,08:51,0,4,4
19,2025-05-25T00:54:00+02:00,2025-05-25,08:54,0,1,1
20,2025-05-25T00:44:00+02:00,2025-05-25,08:44,1,2,3
20,2025-05-25T00:51:00+02:00,2025-05-25,08:51,0,1,1
20,2025-05-25T00:54:00+02:00,2025-05-25,08:54,0,2,2
23,2025-05-25T00:45:00+02:00,2025-05-25,08:45,9,0,9
23,2025-05-25T00:48:00+02:00,2025-05-25,08:48,1,1,2
23,2025-05-25T00:52:00+02:00,2025-05-25,08:52,3,1,4
24,2025-05-25T00:41:00+02:00,2025-05-25,08:41,5,9,14
24,2025-05-25T00:51:00+02:00,2025-05-25,08:51,2,0,2
25,2025-05-25T00:40:00+02:00,2025-05-25,08:40,19,28,47
25,2025-05-25T00:45:00+02:00,2025-05-25,08:45,18,32,50
27,2025-05-25T00:40:00+02:00,2025-05-25,08:40,3,2,5
27,2025-05-25T00:43:00+02:00,2025-05-25,08:43,0,2,2
27,2025-05-25T00:53:00+02:00,2025-05-25,08:53,0,3,3
27,2025-05-25T00:54:00+02:00,2025-05-25,08:54,0,1,1
30,2025-05-25T00:43:00+02:00,2025-05-25,08:43,1,2,3
30,2025-05-25T00:44:00+02:00,2025-05-25,08:44,0,1,1
30,2025-05-25T00:48:00+02:00,2025-05-25,08:48,1,3,4
30,2025-05-25T00:54:00+02:00,2025-05-25,08:54,0,2,2
35,2025-05-25T00:40:00+02:00,2025-05-25,08:40,6,12,18
35,2025-05-25T00:41:00+02:00,2025-05-25,08:41,10,7,17
35,2025-05-25T00:48:00+02:00,2025-05-25,08:48,4,1,5
35,2025-05-25T00:49:00+02:00,2025-05-25,08:49,10,10,20
35,2025-05-25T00:50:00+02:00,2025-05-25,08:50,9,6,15
35,2025-05-25T00:51:00+02:00,2025-05-25,08:51,14,9,23
35,2025-05-25T00:53:00+02:00,2025-05-25,08:53,19,11,30
46,2025-05-25T00:45:00+02:00,2025-05-25,08:45,0,2,2
48,2025-05-25T00:41:00+02:00,2025-05-25,08:41,1,2,3
48,2025-05-25T00:43:00+02:00,2025-05-25,08:43,5,0,5
48,2025-05-25T00:44:00+02:00,2025-05-25,08:44,3,0,3
48,2025-05-25T00:50:00+02:00,2025-05-25,08:50,3,1,4
48,2025-05-25T00:52:00+02:00,2025-05-25,08:52,2,1,3
48,2025-05-25T00:53:00+02:00,2025-05-25,08:53,1,0,1
49,2025-05-25T00:41:00+02:00,2025-05-25,08:41,0,1,1
49,2025-05-25T00:43:00+02:00,2025-05-25,08:43,6,3,9
49,2025-05-25T00:47:00+02:00,2025-05-25,08:47,3,4,7
49,2025-05-25T00:49:00+02:00,2025-05-25,08:49,1,0,1
51,2025-05-25T00:46:00+02:00,2025-05-25,08:46,0,5,5
51,2025-05-25T00:47:00+02:00,2025-05-25,08:47,0,2,2
51,2025-05-25T00:48:00+02:00,2025-05-25,08:48,3,1,4
51,2025-05-25T00:52:00+02:00,2025-05-25,08:52,2,2,4
52,2025-05-25T00:46:00+02:00,2025-05-25,08:46,1,0,1
52,2025-05-25T00:52:00+02:00,2025-05-25,08:52,3,2,5
53,2025-05-25T00:40:00+02:00,2025-05-25,08:40,5,0,5
53,2025-05-25T00:50:00+02:00,2025-05-25,08:50,0,2,2
53,2025-05-25T00:53:00+02:00,2025-05-25,08:53,3,0,3
56,2025-05-25T00:42:00+02:00,2025-05-25,08:42,4,0,4
56,2025-05-25T00:53:00+02:00,2025-05-25,08:53,2,0,2
58,2025-05-25T00:40:00+02:00,2025-05-25,08:40,4,3,7
58,2025-05-25T00:45:00+02:00,2025-05-25,08:45,7,1,8
58,2025-05-25T00:48:00+02:00,2025-05-25,08:48,5,2,7
58,2025-05-25T00:53:00+02:00,2025-05-25,08:53,2,0,2
62,2025-05-25T00:40:00+02:00,2025-05-25,08:40,1,1,2
62,2025-05-25T00:46:00+02:00,2025-05-25,08:46,1,0,1
62,2025-05-25T00:48:00+02:00,2025-05-25,08:48,0,1,1
62,2025-05-25T00:50:00+02:00,2025-05-25,08:50,0,1,1
63,2025-05-25T00:41:00+02:00,2025-05-25,08:41,1,0,1
63,2025-05-25T00:43:00+02:00,2025-05-25,08:43,1,4,5
63,2025-05-25T00:44:00+02:00,2025-05-25,08:44,0,1,1
63,2025-05-25T00:46:00+02:00,2025-05-25,08:46,1,4,5
63,2025-05-25T00:49:00+02:00,2025-05-25,08:49,0,6,6
63,2025-05-25T00:53:00+02:00,2025-05-25,08:53,1,0,1
63,2025-05-25T00:54:00+02:00,2025-05-25,08:54,1,3,4
67,2025-05-25T00:40:00+02:00,2025-05-25,08:40,0,3,3
67,2025-05-25T00:41:00+02:00,2025-05-25,08:41,1,0,1
68,2025-05-25T00:40:00+02:00,2025-05-25,08:40,6,1,7
68,2025-05-25T00:49:00+02:00,2025-05-25,08:49,1,0,1
72,2025-05-25T00:45:00+02:00,2025-05-25,08:45,1,0,1
72,2025-05-25T00:46:00+02:00,2025-05-25,08:46,0,2,2
72,2025-05-25T00:54:00+02:00,2025-05-25,08:54,3,1,4
76,2025-05-25T00:40:00+02:00,2025-05-25,08:40,0,1,1
76,2025-05-25T00:44:00+02:00,2025-05-25,08:44,0,1,1
76,2025-05-25T00:50:00+02:00,2025-05-25,08:50,1,3,4
76,2025-05-25T00:51:00+02:00,2025-05-25,08:51,2,0,2
79,2025-05-25T00:41:00+02:00,2025-05-25,08:41,1,1,2
79,2025-05-25T00:44:00+02:00,2025-05-25,08:44,2,0,2
79,2025-05-25T00:45:00+02:00,2025-05-25,08:45,2,1,3
79,2025-05-25T00:49:00+02:00,2025-05-25,08:49,0,1,1
79,2025-05-25T00:50:00+02:00,2025-05-25,08:50,2,3,5
79,2025-05-25T00:53:00+02:00,2025-05-25,08:53,1,1,2
85,2025-05-25T00:42:00+02:00,2025-05-25,08:42,2,0,2
85,2025-05-25T00:45:00+02:00,2025-05-25,08:45,4,0,4
85,2025-05-25T00:50:00+02:00,2025-05-25,08:50,1,2,3
85,2025-05-25T00:52:00+02:00,2025-05-25,08:52,3,0,3
85,2025-05-25T00:53:00+02:00,2025-05-25,08:53,5,0,5
86,2025-05-25T00:42:00+02:00,2025-05-25,08:42,0,1,1
86,2025-05-25T00:49:00+02:00,2025-05-25,08:49,1,0,1
86,2025-05-25T00:51:00+02:00,2025-05-25,08:51,1,0,1
86,2025-05-25T00:53:00+02:00,2025-05-25,08:53,0,2,2
117,2025-05-25T00:45:00+02:00,2025-05-25,08:45,5,4,9
130,2025-05-25T00:40:00+02:00,2025-05-25,08:40,2,0,2
130,2025-05-25T00:45:00+02:00,2025-05-25,08:45,1,0,1
136,2025-05-25T00:50:00+02:00,2025-05-25,08:50,1,12,13
137,2025-05-25T00:40:00+02:00,2025-05-25,08:40,1,2,3
137,2025-05-25T00:50:00+02:00,2025-05-25,08:50,2,0,2
141,2025-05-25T00:40:00+02:00,2025-05-25,08:40,0,1,1
141,2025-05-25T00:50:00+02:00,2025-05-25,08:50,9,3,12
142,2025-05-25T00:50:00+02:00,2025-05-25,08:50,29,27,56
164,2025-05-25T00:45:00+02:00,2025-05-25,08:45,3,2,5
181,2025-05-25T00:41:00+02:00,2025-05-25,08:41,2,1,3
181,2025-05-25T00:45:00+02:00,2025-05-25,08:45,1,3,4
181,2025-05-25T00:46:00+02:00,2025-05-25,08:46,2,3,5
181,2025-05-25T00:47:00+02:00,2025-05-25,08:47,1,2,3
181,2025-05-25T00:48:00+02:00,2025-05-25,08:48,0,3,3
181,2025-05-25T00:53:00+02:00,2025-05-25,08:53,3,7,10
182,2025-05-25T00:45:00+02:00,2025-05-25,08:45,7,5,12
182,2025-05-25T00:50:00+02:00,2025-05-25,08:50,1,11,12
180,2025-05-25T00:54:00+02:00,2025-05-25,08:54,2,1,3
3,2025-05-25T00:55:00+02:00,2025-05-25,08:55,2,0,2
4,2025-05-25T00:58:00+02:00,2025-05-25,08:58,2,1,3
4,2025-05-25T00:59:00+02:00,2025-05-25,08:59,4,1,5
4,2025-05-25T01:07:00+02:00,2025-05-25,09:07,3,9,12
6,2025-05-25T00:58:00+02:00,2025-05-25,08:58,5,3,8
6,2025-05-25T00:59:00+02:00,2025-05-25,08:59,3,4,7
6,2025-05-25T01:00:00+02:00,2025-05-25,09:00,2,0,2
6,2025-05-25T01:07:00+02:00,2025-05-25,09:07,11,1,12
8,2025-05-25T00:57:00+02:00,2025-05-25,08:57,1,0,1
8,2025-05-25T01:02:00+02:00,2025-05-25,09:02,1,1,2
8,2025-05-25T01:09:00+02:00,2025-05-25,09:09,2,2,4
28,2025-05-25T00:57:00+02:00,2025-05-25,08:57,2,0,2
28,2025-05-25T00:59:00+02:00,2025-05-25,08:59,0,4,4
28,2025-05-25T01:00:00+02:00,2025-05-25,09:00,1,0,1
28,2025-05-25T01:01:00+02:00,2025-05-25,09:01,3,1,4
28,2025-05-25T01:02:00+02:00,2025-05-25,09:02,1,1,2
28,2025-05-25T01:04:00+02:00,2025-05-25,09:04,5,0,5
29,2025-05-25T01:02:00+02:00,2025-05-25,09:02,3,4,7
29,2025-05-25T01:03:00+02:00,2025-05-25,09:03,4,4,8
29,2025-05-25T01:04:00+02:00,2025-05-25,09:04,0,3,3
29,2025-05-25T01:05:00+02:00,2025-05-25,09:05,0,2,2
29,2025-05-25T01:08:00+02:00,2025-05-25,09:08,2,2,4
31,2025-05-25T00:58:00+02:00,2025-05-25,08:58,1,0,1
31,2025-05-25T01:05:00+02:00,2025-05-25,09:05,1,1,2
31,2025-05-25T01:07:00+02:00,2025-05-25,09:07,2,0,2
36,2025-05-25T01:05:00+02:00,2025-05-25,09:05,1,0,1
36,2025-05-25T01:06:00+02:00,2025-05-25,09:06,3,6,9
37,2025-05-25T01:01:00+02:00,2025-05-25,09:01,1,0,1
37,2025-05-25T01:02:00+02:00,2025-05-25,09:02,1,0,1
37,2025-05-25T01:03:00+02:00,2025-05-25,09:03,1,1,2
37,2025-05-25T01:08:00+02:00,2025-05-25,09:08,0,3,3
37,2025-05-25T01:09:00+02:00,2025-05-25,09:09,2,0,2
39,2025-05-25T00:55:00+02:00,2025-05-25,08:55,2,1,3
39,2025-05-25T01:05:00+02:00,2025-05-25,09:05,2,1,3
40,2025-05-25T00:58:00+02:00,2025-05-25,08:58,0,1,1
40,2025-05-25T01:00:00+02:00,2025-05-25,09:00,2,1,3
40,2025-05-25T01:02:00+02:00,2025-05-25,09:02,2,5,7
40,2025-05-25T01:03:00+02:00,2025-05-25,09:03,1,4,5
40,2025-05-25T01:06:00+02:00,2025-05-25,09:06,0,1,1
41,2025-05-25T00:55:00+02:00,2025-05-25,08:55,1,2,3
41,2025-05-25T01:04:00+02:00,2025-05-25,09:04,3,1,4
45,2025-05-25T01:00:00+02:00,2025-05-25,09:00,3,7,10
45,2025-05-25T01:02:00+02:00,2025-05-25,09:02,5,3,8
45,2025-05-25T01:06:00+02:00,2025-05-25,09:06,3,2,5
45,2025-05-25T01:08:00+02:00,2025-05-25,09:08,1,0,1
45,2025-05-25T01:09:00+02:00,2025-05-25,09:09,7,2,9
47,2025-05-25T00:56:00+02:00,2025-05-25,08:56,0,2,2
47,2025-05-25T00:57:00+02:00,2025-05-25,08:57,2,1,3
47,2025-05-25T01:00:00+02:00,2025-05-25,09:00,2,1,3
47,2025-05-25T01:02:00+02:00,2025-05-25,09:02,0,7,7
47,2025-05-25T01:08:00+02:00,2025-05-25,09:08,1,2,3
47,2025-05-25T01:09:00+02:00,2025-05-25,09:09,3,6,9
50,2025-05-25T00:58:00+02:00,2025-05-25,08:58,1,1,2
50,2025-05-25T01:02:00+02:00,2025-05-25,09:02,0,1,1
50,2025-05-25T01:05:00+02:00,2025-05-25,09:05,1,0,1
50,2025-05-25T01:09:00+02:00,2025-05-25,09:09,1,0,1
54,2025-05-25T00:55:00+02:00,2025-05-25,08:55,1,0,1
54,2025-05-25T00:57:00+02:00,2025-05-25,08:57,1,0,1
54,2025-05-25T01:03:00+02:00,2025-05-25,09:03,1,0,1
54,2025-05-25T01:08:00+02:00,2025-05-25,09:08,1,2,3
61,2025-05-25T00:57:00+02:00,2025-05-25,08:57,1,1,2
61,2025-05-25T01:05:00+02:00,2025-05-25,09:05,0,1,1
61,2025-05-25T01:06:00+02:00,2025-05-25,09:06,0,3,3
66,2025-05-25T00:55:00+02:00,2025-05-25,08:55,1,4,5
66,2025-05-25T00:56:00+02:00,2025-05-25,08:56,2,4,6
66,2025-05-25T00:58:00+02:00,2025-05-25,08:58,3,4,7
66,2025-05-25T00:59:00+02:00,2025-05-25,08:59,0,4,4
66,2025-05-25T01:03:00+02:00,2025-05-25,09:03,1,4,5
66,2025-05-25T01:05:00+02:00,2025-05-25,09:05,1,4,5
66,2025-05-25T01:07:00+02:00,2025-05-25,09:07,6,4,10
66,2025-05-25T01:09:00+02:00,2025-05-25,09:09,2,6,8
69,2025-05-25T00:55:00+02:00,2025-05-25,08:55,0,5,5
69,2025-05-25T00:59:00+02:00,2025-05-25,08:59,2,0,2
69,2025-05-25T01:08:00+02:00,2025-05-25,09:08,2,0,2
69,2025-05-25T01:09:00+02:00,2025-05-25,09:09,7,1,8
70,2025-05-25T01:00:00+02:00,2025-05-25,09:00,1,2,3
70,2025-05-25T01:03:00+02:00,2025-05-25,09:03,3,1,4
70,2025-05-25T01:04:00+02:00,2025-05-25,09:04,0,2,2
70,2025-05-25T01:05:00+02:00,2025-05-25,09:05,1,0,1
70,2025-05-25T01:06:00+02:00,2025-05-25,09:06,0,2,2
70,2025-05-25T01:08:00+02:00,2025-05-25,09:08,0,2,2
75,2025-05-25T00:58:00+02:00,2025-05-25,08:58,0,1,1
75,2025-05-25T01:03:00+02:00,2025-05-25,09:03,1,0,1
75,2025-05-25T01:08:00+02:00,2025-05-25,09:08,0,1,1
78,2025-05-25T01:03:00+02:00,2025-05-25,09:03,1,3,4
87,2025-05-25T00:56:00+02:00,2025-05-25,08:56,1,0,1
87,2025-05-25T00:59:00+02:00,2025-05-25,08:59,1,1,2
87,2025-05-25T01:03:00+02:00,2025-05-25,09:03,2,3,5
87,2025-05-25T01:05:00+02:00,2025-05-25,09:05,0,1,1
87,2025-05-25T01:06:00+02:00,2025-05-25,09:06,2,1,3
108,2025-05-25T01:04:00+02:00,2025-05-25,09:04,2,1,3
108,2025-05-25T01:06:00+02:00,2025-05-25,09:06,0,1,1
131,2025-05-25T00:55:00+02:00,2025-05-25,08:55,0,2,2
132,2025-05-25T00:55:00+02:00,2025-05-25,08:55,3,5,8
132,2025-05-25T01:05:00+02:00,2025-05-25,09:05,3,8,11
133,2025-05-25T00:55:00+02:00,2025-05-25,08:55,28,28,56
134,2025-05-25T01:00:00+02:00,2025-05-25,09:00,20,16,36
135,2025-05-25T01:00:00+02:00,2025-05-25,09:00,19,8,27
140,2025-05-25T00:55:00+02:00,2025-05-25,08:55,10,1,11
140,2025-05-25T01:00:00+02:00,2025-05-25,09:00,12,5,17
140,2025-05-25T01:05:00+02:00,2025-05-25,09:05,1,2,3
162,2025-05-25T01:00:00+02:00,2025-05-25,09:00,23,17,40
162,2025-05-25T01:05:00+02:00,2025-05-25,09:05,23,13,36
165,2025-05-25T01:00:00+02:00,2025-05-25,09:00,2,1,3
166,2025-05-25T00:55:00+02:00,2025-05-25,08:55,4,3,7
167,2025-05-25T01:00:00+02:00,2025-05-25,09:00,1,6,7
179,2025-05-25T00:55:00+02:00,2025-05-25,08:55,0,3,3
1,2025-05-25T00:58:00+02:00,2025-05-25,08:58,0,2,2
1,2025-05-25T00:59:00+02:00,2025-05-25,08:59,6,1,7
1,2025-05-25T01:09:00+02:00,2025-05-25,09:09,1,0,1
2,2025-05-25T00:55:00+02:00,2025-05-25,08:55,0,2,2
2,2025-05-25T01:05:00+02:00,2025-05-25,09:05,0,1,1
2,2025-05-25T01:06:00+02:00,2025-05-25,09:06,5,2,7
2,2025-05-25T01:09:00+02:00,2025-05-25,09:09,1,2,3
9,2025-05-25T00:56:00+02:00,2025-05-25,08:56,1,2,3
9,2025-05-25T01:03:00+02:00,2025-05-25,09:03,1,0,1
9,2025-05-25T01:05:00+02:00,2025-05-25,09:05,1,1,2
9,2025-05-25T01:06:00+02:00,2025-05-25,09:06,4,0,4
9,2025-05-25T01:07:00+02:00,2025-05-25,09:07,1,0,1
10,2025-05-25T01:09:00+02:00,2025-05-25,09:09,1,0,1
11,2025-05-25T00:56:00+02:00,2025-05-25,08:56,2,1,3
11,2025-05-25T01:00:00+02:00,2025-05-25,09:00,4,0,4
11,2025-05-25T01:06:00+02:00,2025-05-25,09:06,1,1,2
11,2025-05-25T01:09:00+02:00,2025-05-25,09:09,1,0,1
12,2025-05-25T00:55:00+02:00,2025-05-25,08:55,3,0,3
12,2025-05-25T00:59:00+02:00,2025-05-25,08:59,3,0,3
12,2025-05-25T01:01:00+02:00,2025-05-25,09:01,2,1,3
12,2025-05-25T01:02:00+02:00,2025-05-25,09:02,4,0,4
12,2025-05-25T01:04:00+02:00,2025-05-25,09:04,1,1,2
12,2025-05-25T01:05:00+02:00,2025-05-25,09:05,8,2,10
12,2025-05-25T01:06:00+02:00,2025-05-25,09:06,1,2,3
17,2025-05-25T00:56:00+02:00,2025-05-25,08:56,1,0,1
18,2025-05-25T01:03:00+02:00,2025-05-25,09:03,1,0,1
19,2025-05-25T00:55:00+02:00,2025-05-25,08:55,1,0,1
19,2025-05-25T00:59:00+02:00,2025-05-25,08:59,1,0,1
19,2025-05-25T01:09:00+02:00,2025-05-25,09:09,0,1,1
20,2025-05-25T00:56:00+02:00,2025-05-25,08:56,1,3,4
20,2025-05-25T00:59:00+02:00,2025-05-25,08:59,0,1,1
23,2025-05-25T00:55:00+02:00,2025-05-25,08:55,2,0,2
23,2025-05-25T00:58:00+02:00,2025-05-25,08:58,1,0,1
23,2025-05-25T01:06:00+02:00,2025-05-25,09:06,1,0,1
24,2025-05-25T00:57:00+02:00,2025-05-25,08:57,3,2,5
24,2025-05-25T01:00:00+02:00,2025-05-25,09:00,5,17,22
24,2025-05-25T01:02:00+02:00,2025-05-25,09:02,2,8,10
24,2025-05-25T01:07:00+02:00,2025-05-25,09:07,13,1,14
25,2025-05-25T00:55:00+02:00,2025-05-25,08:55,18,20,38
27,2025-05-25T00:55:00+02:00,2025-05-25,08:55,0,8,8
27,2025-05-25T00:56:00+02:00,2025-05-25,08:56,0,6,6
27,2025-05-25T00:59:00+02:00,2025-05-25,08:59,1,1,2
27,2025-05-25T01:05:00+02:00,2025-05-25,09:05,4,0,4
30,2025-05-25T00:58:00+02:00,2025-05-25,08:58,1,6,7
30,2025-05-25T01:00:00+02:00,2025-05-25,09:00,2,1,3
30,2025-05-25T01:01:00+02:00,2025-05-25,09:01,2,0,2
30,2025-05-25T01:04:00+02:00,2025-05-25,09:04,0,1,1
30,2025-05-25T01:05:00+02:00,2025-05-25,09:05,1,1,2
30,2025-05-25T01:07:00+02:00,2025-05-25,09:07,2,0,2
35,2025-05-25T00:56:00+02:00,2025-05-25,08:56,14,25,39
35,2025-05-25T00:57:00+02:00,2025-05-25,08:57,13,8,21
35,2025-05-25T00:58:00+02:00,2025-05-25,08:58,29,2,31
35,2025-05-25T01:05:00+02:00,2025-05-25,09:05,13,4,17
35,2025-05-25T01:08:00+02:00,2025-05-25,09:08,8,11,19
48,2025-05-25T00:55:00+02:00,2025-05-25,08:55,1,0,1
48,2025-05-25T00:57:00+02:00,2025-05-25,08:57,1,3,4
48,2025-05-25T00:59:00+02:00,2025-05-25,08:59,5,1,6
48,2025-05-25T01:03:00+02:00,2025-05-25,09:03,0,1,1
48,2025-05-25T01:06:00+02:00,2025-05-25,09:06,3,0,3
48,2025-05-25T01:09:00+02:00,2025-05-25,09:09,2,4,6
49,2025-05-25T00:55:00+02:00,2025-05-25,08:55,3,1,4
49,2025-05-25T01:00:00+02:00,2025-05-25,09:00,2,1,3
49,2025-05-25T01:02:00+02:00,2025-05-25,09:02,1,0,1
49,2025-05-25T01:04:00+02:00,2025-05-25,09:04,2,5,7
49,2025-05-25T01:07:00+02:00,2025-05-25,09:07,2,8,10
49,2025-05-25T01:09:00+02:00,2025-05-25,09:09,15,6,21
51,2025-05-25T00:57:00+02:00,2025-05-25,08:57,1,0,1
51,2025-05-25T01:03:00+02:00,2025-05-25,09:03,1,1,2
52,2025-05-25T00:55:00+02:00,2025-05-25,08:55,0,2,2
52,2025-05-25T01:05:00+02:00,2025-05-25,09:05,0,3,3
52,2025-05-25T01:07:00+02:00,2025-05-25,09:07,0,1,1
52,2025-05-25T01:09:00+02:00,2025-05-25,09:09,0,1,1
53,2025-05-25T00:56:00+02:00,2025-05-25,08:56,5,0,5
53,2025-05-25T00:58:00+02:00,2025-05-25,08:58,0,4,4
53,2025-05-25T01:00:00+02:00,2025-05-25,09:00,1,0,1
53,2025-05-25T01:01:00+02:00,2025-05-25,09:01,1,0,1
53,2025-05-25T01:02:00+02:00,2025-05-25,09:02,7,1,8
53,2025-05-25T01:06:00+02:00,2025-05-25,09:06,2,1,3
53,2025-05-25T01:07:00+02:00,2025-05-25,09:07,16,3,19
53,2025-05-25T01:08:00+02:00,2025-05-25,09:08,6,0,6
56,2025-05-25T00:56:00+02:00,2025-05-25,08:56,2,5,7
58,2025-05-25T00:55:00+02:00,2025-05-25,08:55,2,7,9
58,2025-05-25T00:58:00+02:00,2025-05-25,08:58,2,1,3
58,2025-05-25T01:00:00+02:00,2025-05-25,09:00,2,7,9
58,2025-05-25T01:09:00+02:00,2025-05-25,09:09,1,1,2
62,2025-05-25T00:58:00+02:00,2025-05-25,08:58,2,0,2
62,2025-05-25T00:59:00+02:00,2025-05-25,08:59,3,1,4
62,2025-05-25T01:04:00+02:00,2025-05-25,09:04,2,1,3
62,2025-05-25T01:06:00+02:00,2025-05-25,09:06,0,1,1
63,2025-05-25T00:57:00+02:00,2025-05-25,08:57,0,3,3
63,2025-05-25T00:58:00+02:00,2025-05-25,08:58,1,3,4
63,2025-05-25T01:02:00+02:00,2025-05-25,09:02,1,1,2
63,2025-05-25T01:06:00+02:00,2025-05-25,09:06,0,4,4
67,2025-05-25T00:58:00+02:00,2025-05-25,08:58,2,1,3
67,2025-05-25T01:03:00+02:00,2025-05-25,09:03,1,4,5
67,2025-05-25T01:04:00+02:00,2025-05-25,09:04,1,4,5
67,2025-05-25T01:05:00+02:00,2025-05-25,09:05,3,5,8
67,2025-05-25T01:06:00+02:00,2025-05-25,09:06,1,2,3
68,2025-05-25T00:57:00+02:00,2025-05-25,08:57,4,2,6
68,2025-05-25T00:58:00+02:00,2025-05-25,08:58,5,4,9
68,2025-05-25T01:05:00+02:00,2025-05-25,09:05,10,0,10
68,2025-05-25T01:08:00+02:00,2025-05-25,09:08,2,3,5
72,2025-05-25T00:56:00+02:00,2025-05-25,08:56,1,2,3
72,2025-05-25T00:57:00+02:00,2025-05-25,08:57,2,3,5
72,2025-05-25T01:06:00+02:00,2025-05-25,09:06,3,2,5
76,2025-05-25T00:59:00+02:00,2025-05-25,08:59,4,0,4
76,2025-05-25T01:05:00+02:00,2025-05-25,09:05,2,2,4
79,2025-05-25T00:59:00+02:00,2025-05-25,08:59,1,1,2
79,2025-05-25T01:02:00+02:00,2025-05-25,09:02,0,2,2
79,2025-05-25T01:03:00+02:00,2025-05-25,09:03,3,5,8
79,2025-05-25T01:04:00+02:00,2025-05-25,09:04,3,1,4
79,2025-05-25T01:07:00+02:00,2025-05-25,09:07,3,1,4
79,2025-05-25T01:09:00+02:00,2025-05-25,09:09,0,5,5
85,2025-05-25T00:57:00+02:00,2025-05-25,08:57,1,0,1
85,2025-05-25T00:59:00+02:00,2025-05-25,08:59,0,1,1
85,2025-05-25T01:00:00+02:00,2025-05-25,09:00,4,0,4
86,2025-05-25T01:03:00+02:00,2025-05-25,09:03,3,1,4
86,2025-05-25T01:09:00+02:00,2025-05-25,09:09,0,1,1
109,2025-05-25T01:00:00+02:00,2025-05-25,09:00,5,2,7
109,2025-05-25T01:05:00+02:00,2025-05-25,09:05,6,5,11
117,2025-05-25T01:00:00+02:00,2025-05-25,09:00,5,4,9
117,2025-05-25T01:05:00+02:00,2025-05-25,09:05,2,4,6
123,2025-05-25T00:55:00+02:00,2025-05-25,08:55,1,1,2
123,2025-05-25T01:00:00+02:00,2025-05-25,09:00,0,4,4
123,2025-05-25T01:05:00+02:00,2025-05-25,09:05,4,0,4
130,2025-05-25T01:00:00+02:00,2025-05-25,09:00,2,3,5
136,2025-05-25T01:05:00+02:00,2025-05-25,09:05,12,4,16
139,2025-05-25T00:55:00+02:00,2025-05-25,08:55,0,1,1
139,2025-05-25T01:00:00+02:00,2025-05-25,09:00,0,3,3
139,2025-05-25T01:05:00+02:00,2025-05-25,09:05,0,4,4
141,2025-05-25T00:55:00+02:00,2025-05-25,08:55,11,4,15
141,2025-05-25T01:00:00+02:00,2025-05-25,09:00,1,7,8
161,2025-05-25T00:55:00+02:00,2025-05-25,08:55,6,9,15
181,2025-05-25T00:56:00+02:00,2025-05-25,08:56,4,6,10
181,2025-05-25T00:57:00+02:00,2025-05-25,08:57,3,5,8
181,2025-05-25T01:01:00+02:00,2025-05-25,09:01,3,9,12
181,2025-05-25T01:02:00+02:00,2025-05-25,09:02,3,17,20
181,2025-05-25T01:06:00+02:00,2025-05-25,09:06,1,5,6
181,2025-05-25T01:09:00+02:00,2025-05-25,09:09,4,4,8
182,2025-05-25T00:55:00+02:00,2025-05-25,08:55,8,9,17
182,2025-05-25T01:00:00+02:00,2025-05-25,09:00,6,8,14
182,2025-05-25T01:05:00+02:00,2025-05-25,09:05,7,7,14
180,2025-05-25T00:57:00+02:00,2025-05-25,08:57,2,0,2
180,2025-05-25T00:59:00+02:00,2025-05-25,08:59,0,2,2
180,2025-05-25T01:08:00+02:00,2025-05-25,09:08,4,0,4
180,2025-05-25T01:09:00+02:00,2025-05-25,09:09,0,2,2
3,2025-05-25T01:10:00+02:00,2025-05-25,09:10,3,9,12
3,2025-05-25T01:18:00+02:00,2025-05-25,09:18,1,4,5
3,2025-05-25T01:20:00+02:00,2025-05-25,09:20,1,2,3
3,2025-05-25T01:22:00+02:00,2025-05-25,09:22,0,5,5
4,2025-05-25T01:11:00+02:00,2025-05-25,09:11,5,3,8
4,2025-05-25T01:12:00+02:00,2025-05-25,09:12,6,3,9
4,2025-05-25T01:16:00+02:00,2025-05-25,09:16,8,5,13
4,2025-05-25T01:17:00+02:00,2025-05-25,09:17,3,4,7
4,2025-05-25T01:19:00+02:00,2025-05-25,09:19,4,5,9
5,2025-05-25T01:10:00+02:00,2025-05-25,09:10,13,11,24
5,2025-05-25T01:15:00+02:00,2025-05-25,09:15,13,12,25
6,2025-05-25T01:10:00+02:00,2025-05-25,09:10,1,1,2
6,2025-05-25T01:12:00+02:00,2025-05-25,09:12,6,4,10
6,2025-05-25T01:14:00+02:00,2025-05-25,09:14,5,4,9
6,2025-05-25T01:16:00+02:00,2025-05-25,09:16,7,0,7
6,2025-05-25T01:20:00+02:00,2025-05-25,09:20,8,4,12
6,2025-05-25T01:21:00+02:00,2025-05-25,09:21,4,1,5
8,2025-05-25T01:10:00+02:00,2025-05-25,09:10,3,1,4
8,2025-05-25T01:13:00+02:00,2025-05-25,09:13,5,3,8
8,2025-05-25T01:14:00+02:00,2025-05-25,09:14,2,2,4
8,2025-05-25T01:20:00+02:00,2025-05-25,09:20,1,5,6
8,2025-05-25T01:22:00+02:00,2025-05-25,09:22,1,3,4
28,2025-05-25T01:11:00+02:00,2025-05-25,09:11,4,3,7
28,2025-05-25T01:14:00+02:00,2025-05-25,09:14,4,0,4
28,2025-05-25T01:15:00+02:00,2025-05-25,09:15,3,3,6
28,2025-05-25T01:18:00+02:00,2025-05-25,09:18,0,7,7
28,2025-05-25T01:19:00+02:00,2025-05-25,09:19,0,7,7
28,2025-05-25T01:21:00+02:00,2025-05-25,09:21,1,2,3
29,2025-05-25T01:11:00+02:00,2025-05-25,09:11,6,6,12
29,2025-05-25T01:12:00+02:00,2025-05-25,09:12,0,4,4
29,2025-05-25T01:14:00+02:00,2025-05-25,09:14,1,4,5
29,2025-05-25T01:17:00+02:00,2025-05-25,09:17,2,2,4
29,2025-05-25T01:23:00+02:00,2025-05-25,09:23,8,4,12
29,2025-05-25T01:24:00+02:00,2025-05-25,09:24,0,2,2
31,2025-05-25T01:12:00+02:00,2025-05-25,09:12,0,1,1
31,2025-05-25T01:16:00+02:00,2025-05-25,09:16,0,1,1
31,2025-05-25T01:18:00+02:00,2025-05-25,09:18,2,0,2
31,2025-05-25T01:24:00+02:00,2025-05-25,09:24,0,2,2
36,2025-05-25T01:11:00+02:00,2025-05-25,09:11,0,1,1
36,2025-05-25T01:22:00+02:00,2025-05-25,09:22,2,1,3
36,2025-05-25T01:23:00+02:00,2025-05-25,09:23,0,1,1
37,2025-05-25T01:11:00+02:00,2025-05-25,09:11,1,2,3
37,2025-05-25T01:19:00+02:00,2025-05-25,09:19,1,0,1
39,2025-05-25T01:11:00+02:00,2025-05-25,09:11,0,2,2
40,2025-05-25T01:10:00+02:00,2025-05-25,09:10,1,0,1
40,2025-05-25T01:22:00+02:00,2025-05-25,09:22,2,0,2
41,2025-05-25T01:12:00+02:00,2025-05-25,09:12,1,0,1
41,2025-05-25T01:13:00+02:00,2025-05-25,09:13,0,1,1
41,2025-05-25T01:19:00+02:00,2025-05-25,09:19,3,0,3
44,2025-05-25T01:10:00+02:00,2025-05-25,09:10,2,1,3
44,2025-05-25T01:20:00+02:00,2025-05-25,09:20,7,1,8
45,2025-05-25T01:10:00+02:00,2025-05-25,09:10,2,5,7
45,2025-05-25T01:11:00+02:00,2025-05-25,09:11,0,3,3
45,2025-05-25T01:13:00+02:00,2025-05-25,09:13,4,1,5
45,2025-05-25T01:19:00+02:00,2025-05-25,09:19,2,5,7
45,2025-05-25T01:21:00+02:00,2025-05-25,09:21,2,6,8
45,2025-05-25T01:24:00+02:00,2025-05-25,09:24,4,4,8
47,2025-05-25T01:10:00+02:00,2025-05-25,09:10,6,3,9
47,2025-05-25T01:13:00+02:00,2025-05-25,09:13,5,6,11
47,2025-05-25T01:15:00+02:00,2025-05-25,09:15,1,10,11
47,2025-05-25T01:17:00+02:00,2025-05-25,09:17,2,1,3
47,2025-05-25T01:20:00+02:00,2025-05-25,09:20,2,8,10
47,2025-05-25T01:23:00+02:00,2025-05-25,09:23,5,5,10
50,2025-05-25T01:12:00+02:00,2025-05-25,09:12,2,1,3
50,2025-05-25T01:15:00+02:00,2025-05-25,09:15,1,1,2
50,2025-05-25T01:24:00+02:00,2025-05-25,09:24,1,2,3
59,2025-05-25T01:15:00+02:00,2025-05-25,09:15,4,14,18
61,2025-05-25T01:10:00+02:00,2025-05-25,09:10,2,2,4
61,2025-05-25T01:15:00+02:00,2025-05-25,09:15,3,1,4
61,2025-05-25T01:18:00+02:00,2025-05-25,09:18,1,1,2
61,2025-05-25T01:19:00+02:00,2025-05-25,09:19,0,2,2
66,2025-05-25T01:10:00+02:00,2025-05-25,09:10,1,5,6
66,2025-05-25T01:11:00+02:00,2025-05-25,09:11,0,4,4
66,2025-05-25T01:13:00+02:00,2025-05-25,09:13,0,3,3
66,2025-05-25T01:14:00+02:00,2025-05-25,09:14,1,2,3
66,2025-05-25T01:19:00+02:00,2025-05-25,09:19,0,4,4
66,2025-05-25T01:22:00+02:00,2025-05-25,09:22,4,5,9
66,2025-05-25T01:23:00+02:00,2025-05-25,09:23,6,3,9
66,2025-05-25T01:24:00+02:00,2025-05-25,09:24,2,2,4
69,2025-05-25T01:12:00+02:00,2025-05-25,09:12,3,3,6
69,2025-05-25T01:17:00+02:00,2025-05-25,09:17,4,2,6
69,2025-05-25T01:21:00+02:00,2025-05-25,09:21,4,0,4
69,2025-05-25T01:22:00+02:00,2025-05-25,09:22,1,0,1
69,2025-05-25T01:23:00+02:00,2025-05-25,09:23,1,2,3
70,2025-05-25T01:10:00+02:00,2025-05-25,09:10,2,0,2
70,2025-05-25T01:11:00+02:00,2025-05-25,09:11,1,0,1
70,2025-05-25T01:17:00+02:00,2025-05-25,09:17,1,1,2
70,2025-05-25T01:20:00+02:00,2025-05-25,09:20,1,0,1
70,2025-05-25T01:21:00+02:00,2025-05-25,09:21,1,1,2
70,2025-05-25T01:22:00+02:00,2025-05-25,09:22,2,2,4
70,2025-05-25T01:23:00+02:00,2025-05-25,09:23,0,2,2
75,2025-05-25T01:17:00+02:00,2025-05-25,09:17,0,1,1
77,2025-05-25T01:15:00+02:00,2025-05-25,09:15,7,8,15
78,2025-05-25T01:17:00+02:00,2025-05-25,09:17,2,0,2
78,2025-05-25T01:18:00+02:00,2025-05-25,09:18,0,3,3
78,2025-05-25T01:20:00+02:00,2025-05-25,09:20,8,0,8
78,2025-05-25T01:23:00+02:00,2025-05-25,09:23,1,0,1
78,2025-05-25T01:24:00+02:00,2025-05-25,09:24,2,0,2
84,2025-05-25T01:20:00+02:00,2025-05-25,09:20,25,21,46
87,2025-05-25T01:14:00+02:00,2025-05-25,09:14,0,1,1
87,2025-05-25T01:15:00+02:00,2025-05-25,09:15,0,1,1
87,2025-05-25T01:16:00+02:00,2025-05-25,09:16,1,2,3
87,2025-05-25T01:21:00+02:00,2025-05-25,09:21,0,3,3
87,2025-05-25T01:24:00+02:00,2025-05-25,09:24,1,0,1
107,2025-05-25T01:10:00+02:00,2025-05-25,09:10,3,7,10
108,2025-05-25T01:10:00+02:00,2025-05-25,09:10,1,0,1
108,2025-05-25T01:11:00+02:00,2025-05-25,09:11,2,0,2
108,2025-05-25T01:16:00+02:00,2025-05-25,09:16,0,2,2
108,2025-05-25T01:17:00+02:00,2025-05-25,09:17,3,2,5
108,2025-05-25T01:18:00+02:00,2025-05-25,09:18,1,0,1
108,2025-05-25T01:19:00+02:00,2025-05-25,09:19,1,3,4
108,2025-05-25T01:20:00+02:00,2025-05-25,09:20,0,1,1
108,2025-05-25T01:23:00+02:00,2025-05-25,09:23,3,1,4
132,2025-05-25T01:15:00+02:00,2025-05-25,09:15,11,12,23
132,2025-05-25T01:20:00+02:00,2025-05-25,09:20,13,4,17
133,2025-05-25T01:20:00+02:00,2025-05-25,09:20,14,22,36
134,2025-05-25T01:20:00+02:00,2025-05-25,09:20,10,23,33
135,2025-05-25T01:20:00+02:00,2025-05-25,09:20,16,18,34
140,2025-05-25T01:15:00+02:00,2025-05-25,09:15,8,4,12
162,2025-05-25T01:15:00+02:00,2025-05-25,09:15,26,8,34
165,2025-05-25T01:10:00+02:00,2025-05-25,09:10,1,4,5
166,2025-05-25T01:10:00+02:00,2025-05-25,09:10,2,1,3
166,2025-05-25T01:15:00+02:00,2025-05-25,09:15,3,3,6
167,2025-05-25T01:20:00+02:00,2025-05-25,09:20,1,4,5
179,2025-05-25T01:10:00+02:00,2025-05-25,09:10,6,1,7
1,2025-05-25T01:13:00+02:00,2025-05-25,09:13,6,7,13
1,2025-05-25T01:14:00+02:00,2025-05-25,09:14,5,2,7
1,2025-05-25T01:15:00+02:00,2025-05-25,09:15,3,2,5
1,2025-05-25T01:21:00+02:00,2025-05-25,09:21,1,3,4
1,2025-05-25T01:22:00+02:00,2025-05-25,09:22,2,7,9
1,2025-05-25T01:23:00+02:00,2025-05-25,09:23,2,4,6
1,2025-05-25T01:24:00+02:00,2025-05-25,09:24,3,8,11
2,2025-05-25T01:10:00+02:00,2025-05-25,09:10,3,0,3
2,2025-05-25T01:19:00+02:00,2025-05-25,09:19,3,1,4
2,2025-05-25T01:23:00+02:00,2025-05-25,09:23,2,1,3
2,2025-05-25T01:24:00+02:00,2025-05-25,09:24,6,5,11
9,2025-05-25T01:12:00+02:00,2025-05-25,09:12,0,4,4
9,2025-05-25T01:16:00+02:00,2025-05-25,09:16,1,0,1
9,2025-05-25T01:19:00+02:00,2025-05-25,09:19,0,4,4
9,2025-05-25T01:21:00+02:00,2025-05-25,09:21,1,0,1
10,2025-05-25T01:10:00+02:00,2025-05-25,09:10,1,0,1
10,2025-05-25T01:12:00+02:00,2025-05-25,09:12,0,1,1
10,2025-05-25T01:14:00+02:00,2025-05-25,09:14,1,0,1
11,2025-05-25T01:15:00+02:00,2025-05-25,09:15,6,2,8
11,2025-05-25T01:18:00+02:00,2025-05-25,09:18,0,1,1
12,2025-05-25T01:15:00+02:00,2025-05-25,09:15,5,3,8
12,2025-05-25T01:16:00+02:00,2025-05-25,09:16,0,3,3
12,2025-05-25T01:19:00+02:00,2025-05-25,09:19,9,3,12
12,2025-05-25T01:23:00+02:00,2025-05-25,09:23,1,1,2
17,2025-05-25T01:10:00+02:00,2025-05-25,09:10,3,0,3
17,2025-05-25T01:12:00+02:00,2025-05-25,09:12,0,7,7
17,2025-05-25T01:14:00+02:00,2025-05-25,09:14,1,0,1
17,2025-05-25T01:18:00+02:00,2025-05-25,09:18,1,2,3
17,2025-05-25T01:23:00+02:00,2025-05-25,09:23,2,4,6
17,2025-05-25T01:24:00+02:00,2025-05-25,09:24,1,2,3
18,2025-05-25T01:15:00+02:00,2025-05-25,09:15,0,2,2
19,2025-05-25T01:21:00+02:00,2025-05-25,09:21,1,2,3
20,2025-05-25T01:12:00+02:00,2025-05-25,09:12,3,0,3
20,2025-05-25T01:15:00+02:00,2025-05-25,09:15,2,1,3
20,2025-05-25T01:22:00+02:00,2025-05-25,09:22,0,2,2
20,2025-05-25T01:24:00+02:00,2025-05-25,09:24,1,2,3
23,2025-05-25T01:12:00+02:00,2025-05-25,09:12,4,4,8
23,2025-05-25T01:22:00+02:00,2025-05-25,09:22,3,0,3
24,2025-05-25T01:15:00+02:00,2025-05-25,09:15,3,7,10
24,2025-05-25T01:17:00+02:00,2025-05-25,09:17,6,4,10
24,2025-05-25T01:18:00+02:00,2025-05-25,09:18,0,4,4
27,2025-05-25T01:11:00+02:00,2025-05-25,09:11,2,9,11
27,2025-05-25T01:14:00+02:00,2025-05-25,09:14,2,4,6
27,2025-05-25T01:19:00+02:00,2025-05-25,09:19,2,1,3
27,2025-05-25T01:21:00+02:00,2025-05-25,09:21,3,5,8
30,2025-05-25T01:11:00+02:00,2025-05-25,09:11,0,4,4
30,2025-05-25T01:14:00+02:00,2025-05-25,09:14,8,2,10
30,2025-05-25T01:15:00+02:00,2025-05-25,09:15,0,1,1
30,2025-05-25T01:23:00+02:00,2025-05-25,09:23,0,1,1
35,2025-05-25T01:10:00+02:00,2025-05-25,09:10,2,2,4
35,2025-05-25T01:11:00+02:00,2025-05-25,09:11,13,11,24
35,2025-05-25T01:12:00+02:00,2025-05-25,09:12,9,5,14
35,2025-05-25T01:13:00+02:00,2025-05-25,09:13,8,10,18
35,2025-05-25T01:15:00+02:00,2025-05-25,09:15,7,0,7
35,2025-05-25T01:17:00+02:00,2025-05-25,09:17,7,8,15
35,2025-05-25T01:23:00+02:00,2025-05-25,09:23,8,6,14
46,2025-05-25T01:10:00+02:00,2025-05-25,09:10,1,1,2
48,2025-05-25T01:11:00+02:00,2025-05-25,09:11,0,8,8
48,2025-05-25T01:12:00+02:00,2025-05-25,09:12,2,3,5
48,2025-05-25T01:22:00+02:00,2025-05-25,09:22,1,3,4
49,2025-05-25T01:12:00+02:00,2025-05-25,09:12,2,6,8
49,2025-05-25T01:13:00+02:00,2025-05-25,09:13,6,3,9
49,2025-05-25T01:14:00+02:00,2025-05-25,09:14,6,1,7
49,2025-05-25T01:18:00+02:00,2025-05-25,09:18,5,0,5
49,2025-05-25T01:21:00+02:00,2025-05-25,09:21,3,8,11
51,2025-05-25T01:11:00+02:00,2025-05-25,09:11,2,0,2
51,2025-05-25T01:12:00+02:00,2025-05-25,09:12,2,2,4
51,2025-05-25T01:15:00+02:00,2025-05-25,09:15,3,2,5
51,2025-05-25T01:17:00+02:00,2025-05-25,09:17,3,0,3
51,2025-05-25T01:18:00+02:00,2025-05-25,09:18,0,2,2
52,2025-05-25T01:10:00+02:00,2025-05-25,09:10,1,0,1
52,2025-05-25T01:14:00+02:00,2025-05-25,09:14,1,0,1
52,2025-05-25T01:17:00+02:00,2025-05-25,09:17,0,1,1
53,2025-05-25T01:12:00+02:00,2025-05-25,09:12,1,11,12
53,2025-05-25T01:13:00+02:00,2025-05-25,09:13,3,1,4
53,2025-05-25T01:14:00+02:00,2025-05-25,09:14,0,1,1
53,2025-05-25T01:17:00+02:00,2025-05-25,09:17,2,0,2
53,2025-05-25T01:20:00+02:00,2025-05-25,09:20,4,3,7
53,2025-05-25T01:24:00+02:00,2025-05-25,09:24,5,8,13
56,2025-05-25T01:15:00+02:00,2025-05-25,09:15,4,0,4
56,2025-05-25T01:19:00+02:00,2025-05-25,09:19,0,1,1
56,2025-05-25T01:21:00+02:00,2025-05-25,09:21,1,0,1
56,2025-05-25T01:23:00+02:00,2025-05-25,09:23,8,0,8
58,2025-05-25T01:11:00+02:00,2025-05-25,09:11,4,2,6
58,2025-05-25T01:12:00+02:00,2025-05-25,09:12,1,1,2
58,2025-05-25T01:13:00+02:00,2025-05-25,09:13,5,0,5
58,2025-05-25T01:17:00+02:00,2025-05-25,09:17,13,6,19
58,2025-05-25T01:18:00+02:00,2025-05-25,09:18,7,0,7
62,2025-05-25T01:14:00+02:00,2025-05-25,09:14,3,0,3
62,2025-05-25T01:15:00+02:00,2025-05-25,09:15,0,1,1
62,2025-05-25T01:16:00+02:00,2025-05-25,09:16,0,1,1
62,2025-05-25T01:17:00+02:00,2025-05-25,09:17,0,2,2
62,2025-05-25T01:23:00+02:00,2025-05-25,09:23,1,1,2
63,2025-05-25T01:10:00+02:00,2025-05-25,09:10,0,3,3
63,2025-05-25T01:12:00+02:00,2025-05-25,09:12,2,2,4
63,2025-05-25T01:14:00+02:00,2025-05-25,09:14,3,5,8
63,2025-05-25T01:22:00+02:00,2025-05-25,09:22,1,6,7
63,2025-05-25T01:23:00+02:00,2025-05-25,09:23,1,2,3
63,2025-05-25T01:24:00+02:00,2025-05-25,09:24,1,3,4
67,2025-05-25T01:10:00+02:00,2025-05-25,09:10,2,0,2
67,2025-05-25T01:11:00+02:00,2025-05-25,09:11,0,1,1
67,2025-05-25T01:12:00+02:00,2025-05-25,09:12,5,3,8
67,2025-05-25T01:13:00+02:00,2025-05-25,09:13,2,1,3
67,2025-05-25T01:17:00+02:00,2025-05-25,09:17,0,5,5
67,2025-05-25T01:19:00+02:00,2025-05-25,09:19,4,0,4
67,2025-05-25T01:20:00+02:00,2025-05-25,09:20,1,0,1
68,2025-05-25T01:10:00+02:00,2025-05-25,09:10,3,0,3
68,2025-05-25T01:14:00+02:00,2025-05-25,09:14,2,0,2
68,2025-05-25T01:15:00+02:00,2025-05-25,09:15,0,4,4
68,2025-05-25T01:19:00+02:00,2025-05-25,09:19,3,4,7
68,2025-05-25T01:23:00+02:00,2025-05-25,09:23,1,0,1
72,2025-05-25T01:11:00+02:00,2025-05-25,09:11,0,1,1
72,2025-05-25T01:19:00+02:00,2025-05-25,09:19,0,1,1
72,2025-05-25T01:24:00+02:00,2025-05-25,09:24,0,3,3
76,2025-05-25T01:13:00+02:00,2025-05-25,09:13,2,0,2
76,2025-05-25T01:14:00+02:00,2025-05-25,09:14,2,2,4
76,2025-05-25T01:16:00+02:00,2025-05-25,09:16,0,1,1
76,2025-05-25T01:18:00+02:00,2025-05-25,09:18,3,0,3
79,2025-05-25T01:10:00+02:00,2025-05-25,09:10,7,5,12
79,2025-05-25T01:11:00+02:00,2025-05-25,09:11,4,2,6
79,2025-05-25T01:15:00+02:00,2025-05-25,09:15,1,0,1
79,2025-05-25T01:23:00+02:00,2025-05-25,09:23,1,1,2
85,2025-05-25T01:10:00+02:00,2025-05-25,09:10,2,0,2
85,2025-05-25T01:14:00+02:00,2025-05-25,09:14,3,0,3
85,2025-05-25T01:19:00+02:00,2025-05-25,09:19,1,1,2
85,2025-05-25T01:22:00+02:00,2025-05-25,09:22,0,1,1
86,2025-05-25T01:10:00+02:00,2025-05-25,09:10,2,0,2
86,2025-05-25T01:13:00+02:00,2025-05-25,09:13,1,0,1
86,2025-05-25T01:18:00+02:00,2025-05-25,09:18,0,1,1
123,2025-05-25T01:20:00+02:00,2025-05-25,09:20,1,2,3
130,2025-05-25T01:10:00+02:00,2025-05-25,09:10,3,5,8
130,2025-05-25T01:20:00+02:00,2025-05-25,09:20,3,1,4
136,2025-05-25T01:10:00+02:00,2025-05-25,09:10,11,9,20
136,2025-05-25T01:20:00+02:00,2025-05-25,09:20,6,5,11
139,2025-05-25T01:15:00+02:00,2025-05-25,09:15,1,0,1
139,2025-05-25T01:20:00+02:00,2025-05-25,09:20,2,3,5
142,2025-05-25T01:20:00+02:00,2025-05-25,09:20,32,23,55
161,2025-05-25T01:20:00+02:00,2025-05-25,09:20,16,16,32
164,2025-05-25T01:10:00+02:00,2025-05-25,09:10,3,1,4
164,2025-05-25T01:15:00+02:00,2025-05-25,09:15,0,3,3
181,2025-05-25T01:10:00+02:00,2025-05-25,09:10,4,7,11
181,2025-05-25T01:24:00+02:00,2025-05-25,09:24,4,12,16
180,2025-05-25T01:14:00+02:00,2025-05-25,09:14,0,1,1
3,2025-05-25T01:28:00+02:00,2025-05-25,09:28,1,5,6
3,2025-05-25T01:34:00+02:00,2025-05-25,09:34,4,4,8
3,2025-05-25T01:39:00+02:00,2025-05-25,09:39,1,2,3
4,2025-05-25T01:28:00+02:00,2025-05-25,09:28,3,3,6
4,2025-05-25T01:33:00+02:00,2025-05-25,09:33,2,4,6
4,2025-05-25T01:36:00+02:00,2025-05-25,09:36,6,5,11
6,2025-05-25T01:25:00+02:00,2025-05-25,09:25,3,0,3
6,2025-05-25T01:26:00+02:00,2025-05-25,09:26,9,0,9
6,2025-05-25T01:30:00+02:00,2025-05-25,09:30,7,3,10
6,2025-05-25T01:32:00+02:00,2025-05-25,09:32,10,4,14
6,2025-05-25T01:35:00+02:00,2025-05-25,09:35,15,4,19
6,2025-05-25T01:38:00+02:00,2025-05-25,09:38,8,7,15
8,2025-05-25T01:29:00+02:00,2025-05-25,09:29,2,0,2
8,2025-05-25T01:32:00+02:00,2025-05-25,09:32,0,2,2
8,2025-05-25T01:33:00+02:00,2025-05-25,09:33,3,0,3
8,2025-05-25T01:35:00+02:00,2025-05-25,09:35,4,3,7
8,2025-05-25T01:37:00+02:00,2025-05-25,09:37,4,5,9
28,2025-05-25T01:28:00+02:00,2025-05-25,09:28,0,1,1
28,2025-05-25T01:30:00+02:00,2025-05-25,09:30,6,4,10
28,2025-05-25T01:34:00+02:00,2025-05-25,09:34,1,4,5
28,2025-05-25T01:37:00+02:00,2025-05-25,09:37,1,3,4
29,2025-05-25T01:29:00+02:00,2025-05-25,09:29,5,0,5
29,2025-05-25T01:30:00+02:00,2025-05-25,09:30,3,0,3
29,2025-05-25T01:31:00+02:00,2025-05-25,09:31,6,1,7
29,2025-05-25T01:32:00+02:00,2025-05-25,09:32,1,4,5
29,2025-05-25T01:33:00+02:00,2025-05-25,09:33,6,4,10
29,2025-05-25T01:34:00+02:00,2025-05-25,09:34,0,5,5
29,2025-05-25T01:35:00+02:00,2025-05-25,09:35,0,3,3
29,2025-05-25T01:36:00+02:00,2025-05-25,09:36,0,1,1
29,2025-05-25T01:38:00+02:00,2025-05-25,09:38,2,1,3
31,2025-05-25T01:28:00+02:00,2025-05-25,09:28,1,0,1
31,2025-05-25T01:35:00+02:00,2025-05-25,09:35,1,0,1
36,2025-05-25T01:28:00+02:00,2025-05-25,09:28,2,0,2
36,2025-05-25T01:30:00+02:00,2025-05-25,09:30,2,2,4
36,2025-05-25T01:32:00+02:00,2025-05-25,09:32,0,1,1
36,2025-05-25T01:34:00+02:00,2025-05-25,09:34,3,1,4
36,2025-05-25T01:35:00+02:00,2025-05-25,09:35,2,0,2
36,2025-05-25T01:39:00+02:00,2025-05-25,09:39,2,0,2
37,2025-05-25T01:28:00+02:00,2025-05-25,09:28,2,1,3
37,2025-05-25T01:30:00+02:00,2025-05-25,09:30,0,1,1
37,2025-05-25T01:35:00+02:00,2025-05-25,09:35,1,0,1
37,2025-05-25T01:36:00+02:00,2025-05-25,09:36,0,1,1
37,2025-05-25T01:39:00+02:00,2025-05-25,09:39,2,0,2
39,2025-05-25T01:29:00+02:00,2025-05-25,09:29,1,1,2
40,2025-05-25T01:28:00+02:00,2025-05-25,09:28,1,1,2
40,2025-05-25T01:31:00+02:00,2025-05-25,09:31,0,1,1
40,2025-05-25T01:32:00+02:00,2025-05-25,09:32,3,1,4
40,2025-05-25T01:34:00+02:00,2025-05-25,09:34,0,2,2
40,2025-05-25T01:36:00+02:00,2025-05-25,09:36,2,0,2
41,2025-05-25T01:25:00+02:00,2025-05-25,09:25,2,0,2
41,2025-05-25T01:26:00+02:00,2025-05-25,09:26,1,0,1
41,2025-05-25T01:29:00+02:00,2025-05-25,09:29,0,6,6
41,2025-05-25T01:31:00+02:00,2025-05-25,09:31,3,0,3
43,2025-05-25T01:35:00+02:00,2025-05-25,09:35,3,0,3
45,2025-05-25T01:27:00+02:00,2025-05-25,09:27,1,0,1
45,2025-05-25T01:30:00+02:00,2025-05-25,09:30,4,0,4
45,2025-05-25T01:32:00+02:00,2025-05-25,09:32,3,3,6
45,2025-05-25T01:33:00+02:00,2025-05-25,09:33,1,1,2
45,2025-05-25T01:35:00+02:00,2025-05-25,09:35,1,3,4
47,2025-05-25T01:26:00+02:00,2025-05-25,09:26,2,7,9
47,2025-05-25T01:27:00+02:00,2025-05-25,09:27,4,15,19
47,2025-05-25T01:36:00+02:00,2025-05-25,09:36,14,3,17
47,2025-05-25T01:39:00+02:00,2025-05-25,09:39,3,8,11
50,2025-05-25T01:25:00+02:00,2025-05-25,09:25,1,0,1
50,2025-05-25T01:28:00+02:00,2025-05-25,09:28,0,1,1
50,2025-05-25T01:29:00+02:00,2025-05-25,09:29,2,1,3
50,2025-05-25T01:33:00+02:00,2025-05-25,09:33,4,5,9
50,2025-05-25T01:36:00+02:00,2025-05-25,09:36,0,3,3
50,2025-05-25T01:39:00+02:00,2025-05-25,09:39,4,0,4
54,2025-05-25T01:32:00+02:00,2025-05-25,09:32,0,1,1
54,2025-05-25T01:33:00+02:00,2025-05-25,09:33,0,2,2
54,2025-05-25T01:38:00+02:00,2025-05-25,09:38,4,4,8
54,2025-05-25T01:39:00+02:00,2025-05-25,09:39,1,0,1
59,2025-05-25T01:25:00+02:00,2025-05-25,09:25,10,11,21
59,2025-05-25T01:35:00+02:00,2025-05-25,09:35,4,11,15
61,2025-05-25T01:27:00+02:00,2025-05-25,09:27,1,5,6
61,2025-05-25T01:28:00+02:00,2025-05-25,09:28,1,3,4
61,2025-05-25T01:33:00+02:00,2025-05-25,09:33,3,7,10
61,2025-05-25T01:37:00+02:00,2025-05-25,09:37,0,1,1
61,2025-05-25T01:38:00+02:00,2025-05-25,09:38,0,10,10
66,2025-05-25T01:25:00+02:00,2025-05-25,09:25,0,6,6
66,2025-05-25T01:26:00+02:00,2025-05-25,09:26,5,2,7
66,2025-05-25T01:27:00+02:00,2025-05-25,09:27,7,2,9
66,2025-05-25T01:28:00+02:00,2025-05-25,09:28,1,1,2
66,2025-05-25T01:29:00+02:00,2025-05-25,09:29,3,5,8
66,2025-05-25T01:39:00+02:00,2025-05-25,09:39,6,5,11
69,2025-05-25T01:27:00+02:00,2025-05-25,09:27,3,4,7
69,2025-05-25T01:29:00+02:00,2025-05-25,09:29,0,5,5
69,2025-05-25T01:30:00+02:00,2025-05-25,09:30,5,0,5
69,2025-05-25T01:31:00+02:00,2025-05-25,09:31,2,0,2
69,2025-05-25T01:32:00+02:00,2025-05-25,09:32,1,0,1
69,2025-05-25T01:34:00+02:00,2025-05-25,09:34,4,2,6
69,2025-05-25T01:37:00+02:00,2025-05-25,09:37,2,1,3
69,2025-05-25T01:39:00+02:00,2025-05-25,09:39,2,1,3
70,2025-05-25T01:29:00+02:00,2025-05-25,09:29,1,0,1
70,2025-05-25T01:32:00+02:00,2025-05-25,09:32,2,1,3
70,2025-05-25T01:36:00+02:00,2025-05-25,09:36,0,2,2
75,2025-05-25T01:29:00+02:00,2025-05-25,09:29,0,1,1
75,2025-05-25T01:30:00+02:00,2025-05-25,09:30,0,1,1
75,2025-05-25T01:33:00+02:00,2025-05-25,09:33,0,1,1
75,2025-05-25T01:34:00+02:00,2025-05-25,09:34,1,2,3
75,2025-05-25T01:39:00+02:00,2025-05-25,09:39,3,0,3
78,2025-05-25T01:25:00+02:00,2025-05-25,09:25,1,4,5
78,2025-05-25T01:26:00+02:00,2025-05-25,09:26,1,2,3
78,2025-05-25T01:28:00+02:00,2025-05-25,09:28,1,3,4
78,2025-05-25T01:29:00+02:00,2025-05-25,09:29,0,1,1
78,2025-05-25T01:30:00+02:00,2025-05-25,09:30,6,1,7
78,2025-05-25T01:31:00+02:00,2025-05-25,09:31,0,1,1
84,2025-05-25T01:25:00+02:00,2025-05-25,09:25,46,19,65
87,2025-05-25T01:32:00+02:00,2025-05-25,09:32,0,1,1
87,2025-05-25T01:35:00+02:00,2025-05-25,09:35,0,2,2
87,2025-05-25T01:36:00+02:00,2025-05-25,09:36,3,3,6
87,2025-05-25T01:39:00+02:00,2025-05-25,09:39,0,2,2
107,2025-05-25T01:25:00+02:00,2025-05-25,09:25,11,9,20
108,2025-05-25T01:30:00+02:00,2025-05-25,09:30,2,0,2
108,2025-05-25T01:38:00+02:00,2025-05-25,09:38,2,1,3
124,2025-05-25T01:30:00+02:00,2025-05-25,09:30,1,0,1
131,2025-05-25T01:35:00+02:00,2025-05-25,09:35,2,6,8
132,2025-05-25T01:30:00+02:00,2025-05-25,09:30,6,5,11
133,2025-05-25T01:30:00+02:00,2025-05-25,09:30,14,19,33
134,2025-05-25T01:30:00+02:00,2025-05-25,09:30,29,19,48
135,2025-05-25T01:25:00+02:00,2025-05-25,09:25,19,20,39
140,2025-05-25T01:25:00+02:00,2025-05-25,09:25,11,4,15
140,2025-05-25T01:30:00+02:00,2025-05-25,09:30,7,4,11
140,2025-05-25T01:35:00+02:00,2025-05-25,09:35,9,3,12
162,2025-05-25T01:35:00+02:00,2025-05-25,09:35,27,18,45
165,2025-05-25T01:30:00+02:00,2025-05-25,09:30,3,1,4
1,2025-05-25T01:28:00+02:00,2025-05-25,09:28,5,4,9
1,2025-05-25T01:34:00+02:00,2025-05-25,09:34,1,3,4
1,2025-05-25T01:37:00+02:00,2025-05-25,09:37,3,5,8
2,2025-05-25T01:25:00+02:00,2025-05-25,09:25,2,1,3
2,2025-05-25T01:30:00+02:00,2025-05-25,09:30,0,1,1
2,2025-05-25T01:38:00+02:00,2025-05-25,09:38,3,2,5
9,2025-05-25T01:26:00+02:00,2025-05-25,09:26,1,1,2
9,2025-05-25T01:37:00+02:00,2025-05-25,09:37,1,0,1
10,2025-05-25T01:35:00+02:00,2025-05-25,09:35,3,0,3
11,2025-05-25T01:25:00+02:00,2025-05-25,09:25,13,8,21
11,2025-05-25T01:26:00+02:00,2025-05-25,09:26,4,0,4
11,2025-05-25T01:32:00+02:00,2025-05-25,09:32,1,0,1
11,2025-05-25T01:36:00+02:00,2025-05-25,09:36,0,1,1
11,2025-05-25T01:38:00+02:00,2025-05-25,09:38,0,1,1
11,2025-05-25T01:39:00+02:00,2025-05-25,09:39,1,0,1
12,2025-05-25T01:31:00+02:00,2025-05-25,09:31,3,4,7
12,2025-05-25T01:35:00+02:00,2025-05-25,09:35,5,2,7
12,2025-05-25T01:36:00+02:00,2025-05-25,09:36,3,1,4
12,2025-05-25T01:38:00+02:00,2025-05-25,09:38,1,2,3
17,2025-05-25T01:31:00+02:00,2025-05-25,09:31,0,2,2
17,2025-05-25T01:33:00+02:00,2025-05-25,09:33,1,1,2
17,2025-05-25T01:35:00+02:00,2025-05-25,09:35,1,1,2
17,2025-05-25T01:38:00+02:00,2025-05-25,09:38,4,3,7
19,2025-05-25T01:25:00+02:00,2025-05-25,09:25,1,0,1
19,2025-05-25T01:27:00+02:00,2025-05-25,09:27,0,4,4
19,2025-05-25T01:30:00+02:00,2025-05-25,09:30,0,2,2
19,2025-05-25T01:36:00+02:00,2025-05-25,09:36,1,0,1
19,2025-05-25T01:37:00+02:00,2025-05-25,09:37,1,0,1
19,2025-05-25T01:38:00+02:00,2025-05-25,09:38,1,1,2
20,2025-05-25T01:27:00+02:00,2025-05-25,09:27,0,2,2
20,2025-05-25T01:28:00+02:00,2025-05-25,09:28,1,0,1
23,2025-05-25T01:33:00+02:00,2025-05-25,09:33,1,1,2
23,2025-05-25T01:35:00+02:00,2025-05-25,09:35,0,4,4
24,2025-05-25T01:27:00+02:00,2025-05-25,09:27,2,3,5
24,2025-05-25T01:28:00+02:00,2025-05-25,09:28,5,5,10
24,2025-05-25T01:30:00+02:00,2025-05-25,09:30,2,2,4
24,2025-05-25T01:32:00+02:00,2025-05-25,09:32,1,1,2
24,2025-05-25T01:33:00+02:00,2025-05-25,09:33,11,2,13
24,2025-05-25T01:35:00+02:00,2025-05-25,09:35,4,10,14
25,2025-05-25T01:25:00+02:00,2025-05-25,09:25,33,39,72
27,2025-05-25T01:33:00+02:00,2025-05-25,09:33,2,5,7
27,2025-05-25T01:35:00+02:00,2025-05-25,09:35,4,4,8
27,2025-05-25T01:36:00+02:00,2025-05-25,09:36,2,3,5
27,2025-05-25T01:37:00+02:00,2025-05-25,09:37,4,3,7
30,2025-05-25T01:25:00+02:00,2025-05-25,09:25,0,3,3
30,2025-05-25T01:26:00+02:00,2025-05-25,09:26,0,1,1
30,2025-05-25T01:29:00+02:00,2025-05-25,09:29,0,2,2
30,2025-05-25T01:30:00+02:00,2025-05-25,09:30,2,2,4
35,2025-05-25T01:25:00+02:00,2025-05-25,09:25,16,12,28
35,2025-05-25T01:26:00+02:00,2025-05-25,09:26,11,6,17
35,2025-05-25T01:27:00+02:00,2025-05-25,09:27,35,9,44
35,2025-05-25T01:29:00+02:00,2025-05-25,09:29,6,4,10
35,2025-05-25T01:33:00+02:00,2025-05-25,09:33,16,2,18
35,2025-05-25T01:34:00+02:00,2025-05-25,09:34,15,9,24
48,2025-05-25T01:28:00+02:00,2025-05-25,09:28,5,7,12
48,2025-05-25T01:30:00+02:00,2025-05-25,09:30,0,4,4
48,2025-05-25T01:31:00+02:00,2025-05-25,09:31,0,2,2
48,2025-05-25T01:35:00+02:00,2025-05-25,09:35,8,0,8
48,2025-05-25T01:36:00+02:00,2025-05-25,09:36,1,1,2
49,2025-05-25T01:28:00+02:00,2025-05-25,09:28,1,0,1
49,2025-05-25T01:29:00+02:00,2025-05-25,09:29,8,2,10
49,2025-05-25T01:32:00+02:00,2025-05-25,09:32,14,4,18
49,2025-05-25T01:33:00+02:00,2025-05-25,09:33,5,4,9
49,2025-05-25T01:34:00+02:00,2025-05-25,09:34,0,2,2
49,2025-05-25T01:35:00+02:00,2025-05-25,09:35,3,8,11
49,2025-05-25T01:36:00+02:00,2025-05-25,09:36,1,11,12
49,2025-05-25T01:37:00+02:00,2025-05-25,09:37,4,2,6
49,2025-05-25T01:38:00+02:00,2025-05-25,09:38,9,5,14
51,2025-05-25T01:27:00+02:00,2025-05-25,09:27,4,1,5
51,2025-05-25T01:28:00+02:00,2025-05-25,09:28,1,0,1
51,2025-05-25T01:31:00+02:00,2025-05-25,09:31,0,1,1
51,2025-05-25T01:39:00+02:00,2025-05-25,09:39,2,3,5
52,2025-05-25T01:25:00+02:00,2025-05-25,09:25,1,0,1
52,2025-05-25T01:26:00+02:00,2025-05-25,09:26,1,2,3
52,2025-05-25T01:28:00+02:00,2025-05-25,09:28,0,4,4
52,2025-05-25T01:30:00+02:00,2025-05-25,09:30,2,0,2
52,2025-05-25T01:31:00+02:00,2025-05-25,09:31,1,0,1
52,2025-05-25T01:33:00+02:00,2025-05-25,09:33,11,0,11
52,2025-05-25T01:36:00+02:00,2025-05-25,09:36,2,3,5
53,2025-05-25T01:30:00+02:00,2025-05-25,09:30,3,0,3
53,2025-05-25T01:33:00+02:00,2025-05-25,09:33,5,2,7
53,2025-05-25T01:36:00+02:00,2025-05-25,09:36,5,3,8
53,2025-05-25T01:39:00+02:00,2025-05-25,09:39,6,1,7
56,2025-05-25T01:28:00+02:00,2025-05-25,09:28,5,2,7
56,2025-05-25T01:33:00+02:00,2025-05-25,09:33,2,2,4
56,2025-05-25T01:34:00+02:00,2025-05-25,09:34,3,0,3
56,2025-05-25T01:35:00+02:00,2025-05-25,09:35,4,2,6
56,2025-05-25T01:36:00+02:00,2025-05-25,09:36,4,0,4
58,2025-05-25T01:27:00+02:00,2025-05-25,09:27,4,6,10
58,2025-05-25T01:36:00+02:00,2025-05-25,09:36,11,1,12
58,2025-05-25T01:39:00+02:00,2025-05-25,09:39,8,6,14
62,2025-05-25T01:27:00+02:00,2025-05-25,09:27,5,2,7
62,2025-05-25T01:31:00+02:00,2025-05-25,09:31,1,2,3
62,2025-05-25T01:32:00+02:00,2025-05-25,09:32,1,3,4
62,2025-05-25T01:37:00+02:00,2025-05-25,09:37,0,1,1
63,2025-05-25T01:25:00+02:00,2025-05-25,09:25,2,2,4
63,2025-05-25T01:33:00+02:00,2025-05-25,09:33,0,4,4
63,2025-05-25T01:34:00+02:00,2025-05-25,09:34,2,0,2
63,2025-05-25T01:36:00+02:00,2025-05-25,09:36,0,2,2
67,2025-05-25T01:25:00+02:00,2025-05-25,09:25,4,3,7
67,2025-05-25T01:33:00+02:00,2025-05-25,09:33,0,8,8
67,2025-05-25T01:35:00+02:00,2025-05-25,09:35,3,4,7
67,2025-05-25T01:37:00+02:00,2025-05-25,09:37,4,0,4
67,2025-05-25T01:39:00+02:00,2025-05-25,09:39,0,3,3
68,2025-05-25T01:31:00+02:00,2025-05-25,09:31,2,1,3
68,2025-05-25T01:35:00+02:00,2025-05-25,09:35,2,4,6
68,2025-05-25T01:37:00+02:00,2025-05-25,09:37,1,1,2
68,2025-05-25T01:38:00+02:00,2025-05-25,09:38,9,0,9
72,2025-05-25T01:31:00+02:00,2025-05-25,09:31,1,7,8
72,2025-05-25T01:32:00+02:00,2025-05-25,09:32,1,2,3
72,2025-05-25T01:34:00+02:00,2025-05-25,09:34,1,1,2
76,2025-05-25T01:25:00+02:00,2025-05-25,09:25,0,1,1
76,2025-05-25T01:28:00+02:00,2025-05-25,09:28,2,1,3
76,2025-05-25T01:31:00+02:00,2025-05-25,09:31,1,2,3
76,2025-05-25T01:32:00+02:00,2025-05-25,09:32,3,2,5
76,2025-05-25T01:35:00+02:00,2025-05-25,09:35,1,1,2
79,2025-05-25T01:25:00+02:00,2025-05-25,09:25,3,4,7
79,2025-05-25T01:31:00+02:00,2025-05-25,09:31,2,4,6
79,2025-05-25T01:32:00+02:00,2025-05-25,09:32,2,3,5
79,2025-05-25T01:33:00+02:00,2025-05-25,09:33,2,3,5
79,2025-05-25T01:37:00+02:00,2025-05-25,09:37,6,6,12
85,2025-05-25T01:25:00+02:00,2025-05-25,09:25,1,2,3
85,2025-05-25T01:28:00+02:00,2025-05-25,09:28,2,1,3
85,2025-05-25T01:31:00+02:00,2025-05-25,09:31,1,1,2
85,2025-05-25T01:32:00+02:00,2025-05-25,09:32,0,3,3
85,2025-05-25T01:37:00+02:00,2025-05-25,09:37,1,2,3
86,2025-05-25T01:27:00+02:00,2025-05-25,09:27,5,1,6
86,2025-05-25T01:31:00+02:00,2025-05-25,09:31,2,1,3
86,2025-05-25T01:33:00+02:00,2025-05-25,09:33,2,1,3
109,2025-05-25T01:25:00+02:00,2025-05-25,09:25,6,5,11
109,2025-05-25T01:30:00+02:00,2025-05-25,09:30,10,5,15
117,2025-05-25T01:30:00+02:00,2025-05-25,09:30,6,8,14
117,2025-05-25T01:35:00+02:00,2025-05-25,09:35,4,13,17
123,2025-05-25T01:35:00+02:00,2025-05-25,09:35,7,7,14
130,2025-05-25T01:35:00+02:00,2025-05-25,09:35,5,6,11
136,2025-05-25T01:30:00+02:00,2025-05-25,09:30,3,7,10
136,2025-05-25T01:35:00+02:00,2025-05-25,09:35,6,5,11
137,2025-05-25T01:35:00+02:00,2025-05-25,09:35,1,0,1
138,2025-05-25T01:25:00+02:00,2025-05-25,09:25,1,0,1
139,2025-05-25T01:25:00+02:00,2025-05-25,09:25,3,9,12
141,2025-05-25T01:30:00+02:00,2025-05-25,09:30,11,10,21
142,2025-05-25T01:25:00+02:00,2025-05-25,09:25,50,25,75
161,2025-05-25T01:30:00+02:00,2025-05-25,09:30,9,16,25
164,2025-05-25T01:35:00+02:00,2025-05-25,09:35,5,5,10
181,2025-05-25T01:26:00+02:00,2025-05-25,09:26,10,11,21
181,2025-05-25T01:31:00+02:00,2025-05-25,09:31,5,12,17
180,2025-05-25T01:35:00+02:00,2025-05-25,09:35,2,0,2
180,2025-05-25T01:38:00+02:00,2025-05-25,09:38,2,0,2
180,2025-05-25T01:39:00+02:00,2025-05-25,09:39,5,0,5
3,2025-05-25T04:58:00+02:00,2025-05-25,12:58,27,13,40
3,2025-05-25T04:59:00+02:00,2025-05-25,12:59,20,35,55
3,2025-05-25T05:00:00+02:00,2025-05-25,13:00,14,14,28
3,2025-05-25T05:04:00+02:00,2025-05-25,13:04,28,27,55
4,2025-05-25T04:55:00+02:00,2025-05-25,12:55,26,24,50
4,2025-05-25T04:57:00+02:00,2025-05-25,12:57,32,31,63
4,2025-05-25T05:00:00+02:00,2025-05-25,13:00,42,45,87
4,2025-05-25T05:03:00+02:00,2025-05-25,13:03,31,22,53
4,2025-05-25T05:04:00+02:00,2025-05-25,13:04,52,17,69
4,2025-05-25T05:06:00+02:00,2025-05-25,13:06,45,24,69
4,2025-05-25T05:07:00+02:00,2025-05-25,13:07,23,37,60
4,2025-05-25T05:08:00+02:00,2025-05-25,13:08,35,29,64
6,2025-05-25T04:57:00+02:00,2025-05-25,12:57,12,15,27
6,2025-05-25T04:59:00+02:00,2025-05-25,12:59,10,17,27
6,2025-05-25T05:00:00+02:00,2025-05-25,13:00,7,20,27
6,2025-05-25T05:01:00+02:00,2025-05-25,13:01,9,27,36
6,2025-05-25T05:02:00+02:00,2025-05-25,13:02,6,18,24
6,2025-05-25T05:03:00+02:00,2025-05-25,13:03,17,16,33
6,2025-05-25T05:06:00+02:00,2025-05-25,13:06,20,19,39
8,2025-05-25T04:59:00+02:00,2025-05-25,12:59,1,2,3
8,2025-05-25T05:02:00+02:00,2025-05-25,13:02,8,1,9
8,2025-05-25T05:03:00+02:00,2025-05-25,13:03,2,0,2
8,2025-05-25T05:08:00+02:00,2025-05-25,13:08,3,7,10
28,2025-05-25T05:08:00+02:00,2025-05-25,13:08,11,7,18
29,2025-05-25T04:55:00+02:00,2025-05-25,12:55,19,9,28
29,2025-05-25T05:06:00+02:00,2025-05-25,13:06,10,7,17
29,2025-05-25T05:08:00+02:00,2025-05-25,13:08,11,7,18
29,2025-05-25T05:09:00+02:00,2025-05-25,13:09,16,16,32
31,2025-05-25T04:56:00+02:00,2025-05-25,12:56,3,1,4
31,2025-05-25T04:59:00+02:00,2025-05-25,12:59,5,8,13
31,2025-05-25T05:00:00+02:00,2025-05-25,13:00,5,6,11
31,2025-05-25T05:06:00+02:00,2025-05-25,13:06,3,5,8
31,2025-05-25T05:08:00+02:00,2025-05-25,13:08,2,1,3
36,2025-05-25T04:56:00+02:00,2025-05-25,12:56,0,3,3
36,2025-05-25T04:58:00+02:00,2025-05-25,12:58,5,1,6
36,2025-05-25T05:00:00+02:00,2025-05-25,13:00,1,0,1
36,2025-05-25T05:01:00+02:00,2025-05-25,13:01,1,3,4
36,2025-05-25T05:04:00+02:00,2025-05-25,13:04,5,0,5
36,2025-05-25T05:05:00+02:00,2025-05-25,13:05,1,3,4
36,2025-05-25T05:08:00+02:00,2025-05-25,13:08,3,0,3
36,2025-05-25T05:09:00+02:00,2025-05-25,13:09,2,0,2
39,2025-05-25T05:02:00+02:00,2025-05-25,13:02,2,0,2
39,2025-05-25T05:05:00+02:00,2025-05-25,13:05,2,2,4
39,2025-05-25T05:06:00+02:00,2025-05-25,13:06,0,3,3
40,2025-05-25T04:55:00+02:00,2025-05-25,12:55,2,10,12
40,2025-05-25T04:56:00+02:00,2025-05-25,12:56,2,2,4
40,2025-05-25T04:59:00+02:00,2025-05-25,12:59,1,4,5
40,2025-05-25T05:01:00+02:00,2025-05-25,13:01,4,3,7
40,2025-05-25T05:04:00+02:00,2025-05-25,13:04,0,4,4
40,2025-05-25T05:07:00+02:00,2025-05-25,13:07,1,0,1
41,2025-05-25T04:55:00+02:00,2025-05-25,12:55,7,9,16
41,2025-05-25T04:56:00+02:00,2025-05-25,12:56,18,10,28
41,2025-05-25T04:58:00+02:00,2025-05-25,12:58,4,5,9
41,2025-05-25T04:59:00+02:00,2025-05-25,12:59,7,13,20
41,2025-05-25T05:03:00+02:00,2025-05-25,13:03,11,8,19
41,2025-05-25T05:05:00+02:00,2025-05-25,13:05,5,0,5
41,2025-05-25T05:07:00+02:00,2025-05-25,13:07,22,10,32
41,2025-05-25T05:08:00+02:00,2025-05-25,13:08,22,6,28
43,2025-05-25T04:55:00+02:00,2025-05-25,12:55,4,5,9
43,2025-05-25T05:00:00+02:00,2025-05-25,13:00,5,4,9
44,2025-05-25T05:05:00+02:00,2025-05-25,13:05,2,3,5
45,2025-05-25T04:56:00+02:00,2025-05-25,12:56,30,17,47
45,2025-05-25T04:57:00+02:00,2025-05-25,12:57,32,18,50
45,2025-05-25T04:59:00+02:00,2025-05-25,12:59,25,25,50
45,2025-05-25T05:00:00+02:00,2025-05-25,13:00,28,18,46
45,2025-05-25T05:04:00+02:00,2025-05-25,13:04,33,19,52
45,2025-05-25T05:06:00+02:00,2025-05-25,13:06,22,27,49
45,2025-05-25T05:08:00+02:00,2025-05-25,13:08,22,26,48
47,2025-05-25T04:58:00+02:00,2025-05-25,12:58,10,20,30
47,2025-05-25T05:00:00+02:00,2025-05-25,13:00,20,15,35
47,2025-05-25T05:07:00+02:00,2025-05-25,13:07,4,21,25
50,2025-05-25T04:56:00+02:00,2025-05-25,12:56,2,2,4
50,2025-05-25T04:57:00+02:00,2025-05-25,12:57,5,10,15
50,2025-05-25T04:59:00+02:00,2025-05-25,12:59,6,2,8
50,2025-05-25T05:00:00+02:00,2025-05-25,13:00,0,11,11
50,2025-05-25T05:05:00+02:00,2025-05-25,13:05,3,3,6
50,2025-05-25T05:08:00+02:00,2025-05-25,13:08,8,4,12
50,2025-05-25T05:09:00+02:00,2025-05-25,13:09,3,2,5
54,2025-05-25T04:58:00+02:00,2025-05-25,12:58,6,3,9
54,2025-05-25T04:59:00+02:00,2025-05-25,12:59,2,0,2
54,2025-05-25T05:01:00+02:00,2025-05-25,13:01,3,2,5
54,2025-05-25T05:02:00+02:00,2025-05-25,13:02,2,4,6
54,2025-05-25T05:03:00+02:00,2025-05-25,13:03,5,3,8
59,2025-05-25T04:55:00+02:00,2025-05-25,12:55,19,38,57
59,2025-05-25T05:05:00+02:00,2025-05-25,13:05,44,26,70
61,2025-05-25T04:55:00+02:00,2025-05-25,12:55,13,17,30
61,2025-05-25T04:57:00+02:00,2025-05-25,12:57,11,7,18
61,2025-05-25T05:03:00+02:00,2025-05-25,13:03,10,4,14
61,2025-05-25T05:07:00+02:00,2025-05-25,13:07,15,11,26
61,2025-05-25T05:08:00+02:00,2025-05-25,13:08,11,16,27
66,2025-05-25T04:55:00+02:00,2025-05-25,12:55,22,57,79
66,2025-05-25T04:56:00+02:00,2025-05-25,12:56,32,39,71
66,2025-05-25T04:57:00+02:00,2025-05-25,12:57,21,33,54
66,2025-05-25T05:03:00+02:00,2025-05-25,13:03,16,21,37
66,2025-05-25T05:07:00+02:00,2025-05-25,13:07,24,18,42
66,2025-05-25T05:09:00+02:00,2025-05-25,13:09,34,20,54
69,2025-05-25T04:56:00+02:00,2025-05-25,12:56,7,5,12
69,2025-05-25T05:00:00+02:00,2025-05-25,13:00,5,7,12
69,2025-05-25T05:02:00+02:00,2025-05-25,13:02,4,21,25
69,2025-05-25T05:05:00+02:00,2025-05-25,13:05,4,9,13
69,2025-05-25T05:06:00+02:00,2025-05-25,13:06,2,3,5
69,2025-05-25T05:08:00+02:00,2025-05-25,13:08,1,2,3
69,2025-05-25T05:09:00+02:00,2025-05-25,13:09,8,1,9
70,2025-05-25T04:57:00+02:00,2025-05-25,12:57,3,5,8
70,2025-05-25T04:59:00+02:00,2025-05-25,12:59,3,0,3
70,2025-05-25T05:08:00+02:00,2025-05-25,13:08,3,1,4
70,2025-05-25T05:09:00+02:00,2025-05-25,13:09,4,4,8
75,2025-05-25T04:57:00+02:00,2025-05-25,12:57,0,1,1
75,2025-05-25T04:59:00+02:00,2025-05-25,12:59,0,4,4
75,2025-05-25T05:02:00+02:00,2025-05-25,13:02,1,1,2
75,2025-05-25T05:03:00+02:00,2025-05-25,13:03,2,4,6
75,2025-05-25T05:05:00+02:00,2025-05-25,13:05,0,2,2
77,2025-05-25T05:00:00+02:00,2025-05-25,13:00,16,14,30
77,2025-05-25T05:05:00+02:00,2025-05-25,13:05,19,17,36
78,2025-05-25T04:55:00+02:00,2025-05-25,12:55,4,0,4
78,2025-05-25T04:58:00+02:00,2025-05-25,12:58,4,0,4
78,2025-05-25T05:00:00+02:00,2025-05-25,13:00,1,0,1
78,2025-05-25T05:04:00+02:00,2025-05-25,13:04,2,4,6
78,2025-05-25T05:06:00+02:00,2025-05-25,13:06,0,5,5
87,2025-05-25T05:09:00+02:00,2025-05-25,13:09,0,4,4
108,2025-05-25T04:56:00+02:00,2025-05-25,12:56,3,0,3
108,2025-05-25T05:00:00+02:00,2025-05-25,13:00,0,2,2
108,2025-05-25T05:01:00+02:00,2025-05-25,13:01,3,0,3
108,2025-05-25T05:02:00+02:00,2025-05-25,13:02,3,6,9
108,2025-05-25T05:04:00+02:00,2025-05-25,13:04,0,2,2
108,2025-05-25T05:05:00+02:00,2025-05-25,13:05,4,4,8
108,2025-05-25T05:09:00+02:00,2025-05-25,13:09,1,0,1
124,2025-05-25T05:00:00+02:00,2025-05-25,13:00,0,1,1
132,2025-05-25T05:00:00+02:00,2025-05-25,13:00,8,13,21
133,2025-05-25T05:00:00+02:00,2025-05-25,13:00,35,34,69
135,2025-05-25T05:05:00+02:00,2025-05-25,13:05,33,31,64
162,2025-05-25T05:00:00+02:00,2025-05-25,13:00,61,106,167
167,2025-05-25T04:55:00+02:00,2025-05-25,12:55,2,2,4
167,2025-05-25T05:00:00+02:00,2025-05-25,13:00,3,3,6
1,2025-05-25T04:58:00+02:00,2025-05-25,12:58,15,17,32
1,2025-05-25T05:04:00+02:00,2025-05-25,13:04,11,30,41
1,2025-05-25T05:05:00+02:00,2025-05-25,13:05,25,51,76
1,2025-05-25T05:06:00+02:00,2025-05-25,13:06,30,28,58
1,2025-05-25T05:09:00+02:00,2025-05-25,13:09,41,21,62
2,2025-05-25T04:57:00+02:00,2025-05-25,12:57,7,12,19
2,2025-05-25T05:00:00+02:00,2025-05-25,13:00,10,16,26
2,2025-05-25T05:03:00+02:00,2025-05-25,13:03,9,29,38
9,2025-05-25T04:55:00+02:00,2025-05-25,12:55,1,1,2
9,2025-05-25T05:01:00+02:00,2025-05-25,13:01,1,0,1
9,2025-05-25T05:07:00+02:00,2025-05-25,13:07,1,1,2
9,2025-05-25T05:08:00+02:00,2025-05-25,13:08,0,2,2
10,2025-05-25T04:57:00+02:00,2025-05-25,12:57,0,2,2
10,2025-05-25T05:03:00+02:00,2025-05-25,13:03,3,0,3
10,2025-05-25T05:04:00+02:00,2025-05-25,13:04,4,0,4
10,2025-05-25T05:09:00+02:00,2025-05-25,13:09,2,0,2
11,2025-05-25T05:05:00+02:00,2025-05-25,13:05,13,2,15
11,2025-05-25T05:06:00+02:00,2025-05-25,13:06,0,1,1
12,2025-05-25T04:56:00+02:00,2025-05-25,12:56,2,4,6
12,2025-05-25T05:01:00+02:00,2025-05-25,13:01,6,2,8
12,2025-05-25T05:04:00+02:00,2025-05-25,13:04,1,2,3
12,2025-05-25T05:06:00+02:00,2025-05-25,13:06,2,6,8
12,2025-05-25T05:07:00+02:00,2025-05-25,13:07,1,2,3
17,2025-05-25T04:58:00+02:00,2025-05-25,12:58,12,4,16
17,2025-05-25T04:59:00+02:00,2025-05-25,12:59,8,0,8
17,2025-05-25T05:00:00+02:00,2025-05-25,13:00,3,3,6
17,2025-05-25T05:03:00+02:00,2025-05-25,13:03,4,4,8
18,2025-05-25T04:58:00+02:00,2025-05-25,12:58,2,1,3
18,2025-05-25T05:04:00+02:00,2025-05-25,13:04,1,3,4
18,2025-05-25T05:05:00+02:00,2025-05-25,13:05,2,1,3
18,2025-05-25T05:07:00+02:00,2025-05-25,13:07,0,2,2
19,2025-05-25T04:55:00+02:00,2025-05-25,12:55,3,18,21
19,2025-05-25T04:58:00+02:00,2025-05-25,12:58,7,7,14
19,2025-05-25T04:59:00+02:00,2025-05-25,12:59,4,7,11
19,2025-05-25T05:00:00+02:00,2025-05-25,13:00,14,15,29
19,2025-05-25T05:04:00+02:00,2025-05-25,13:04,9,6,15
19,2025-05-25T05:07:00+02:00,2025-05-25,13:07,4,9,13
20,2025-05-25T04:55:00+02:00,2025-05-25,12:55,0,5,5
20,2025-05-25T04:56:00+02:00,2025-05-25,12:56,7,3,10
20,2025-05-25T05:04:00+02:00,2025-05-25,13:04,3,3,6
20,2025-05-25T05:07:00+02:00,2025-05-25,13:07,0,6,6
20,2025-05-25T05:08:00+02:00,2025-05-25,13:08,7,9,16
23,2025-05-25T04:57:00+02:00,2025-05-25,12:57,1,5,6
23,2025-05-25T05:01:00+02:00,2025-05-25,13:01,0,7,7
23,2025-05-25T05:02:00+02:00,2025-05-25,13:02,1,10,11
23,2025-05-25T05:03:00+02:00,2025-05-25,13:03,2,3,5
23,2025-05-25T05:05:00+02:00,2025-05-25,13:05,4,0,4
23,2025-05-25T05:07:00+02:00,2025-05-25,13:07,6,9,15
24,2025-05-25T04:55:00+02:00,2025-05-25,12:55,17,11,28
24,2025-05-25T04:59:00+02:00,2025-05-25,12:59,9,1,10
24,2025-05-25T05:02:00+02:00,2025-05-25,13:02,1,22,23
24,2025-05-25T05:06:00+02:00,2025-05-25,13:06,5,1,6
24,2025-05-25T05:09:00+02:00,2025-05-25,13:09,0,10,10
25,2025-05-25T04:55:00+02:00,2025-05-25,12:55,67,68,135
27,2025-05-25T04:59:00+02:00,2025-05-25,12:59,2,0,2
27,2025-05-25T05:00:00+02:00,2025-05-25,13:00,8,12,20
27,2025-05-25T05:01:00+02:00,2025-05-25,13:01,2,2,4
27,2025-05-25T05:02:00+02:00,2025-05-25,13:02,10,9,19
27,2025-05-25T05:08:00+02:00,2025-05-25,13:08,5,1,6
27,2025-05-25T05:09:00+02:00,2025-05-25,13:09,8,10,18
30,2025-05-25T04:55:00+02:00,2025-05-25,12:55,10,0,10
30,2025-05-25T04:56:00+02:00,2025-05-25,12:56,13,13,26
30,2025-05-25T04:57:00+02:00,2025-05-25,12:57,1,5,6
30,2025-05-25T05:00:00+02:00,2025-05-25,13:00,7,3,10
30,2025-05-25T05:01:00+02:00,2025-05-25,13:01,8,3,11
30,2025-05-25T05:02:00+02:00,2025-05-25,13:02,5,13,18
30,2025-05-25T05:06:00+02:00,2025-05-25,13:06,3,13,16
35,2025-05-25T04:58:00+02:00,2025-05-25,12:58,15,14,29
35,2025-05-25T04:59:00+02:00,2025-05-25,12:59,21,22,43
35,2025-05-25T05:00:00+02:00,2025-05-25,13:00,17,20,37
35,2025-05-25T05:01:00+02:00,2025-05-25,13:01,15,16,31
35,2025-05-25T05:02:00+02:00,2025-05-25,13:02,13,13,26
35,2025-05-25T05:06:00+02:00,2025-05-25,13:06,15,26,41
35,2025-05-25T05:09:00+02:00,2025-05-25,13:09,26,39,65
46,2025-05-25T04:55:00+02:00,2025-05-25,12:55,1,1,2
46,2025-05-25T05:00:00+02:00,2025-05-25,13:00,4,6,10
48,2025-05-25T04:59:00+02:00,2025-05-25,12:59,20,4,24
48,2025-05-25T05:03:00+02:00,2025-05-25,13:03,17,3,20
49,2025-05-25T05:00:00+02:00,2025-05-25,13:00,23,10,33
49,2025-05-25T05:03:00+02:00,2025-05-25,13:03,6,17,23
49,2025-05-25T05:05:00+02:00,2025-05-25,13:05,3,13,16
49,2025-05-25T05:09:00+02:00,2025-05-25,13:09,16,19,35
51,2025-05-25T04:56:00+02:00,2025-05-25,12:56,3,1,4
51,2025-05-25T04:57:00+02:00,2025-05-25,12:57,3,0,3
51,2025-05-25T05:00:00+02:00,2025-05-25,13:00,8,0,8
51,2025-05-25T05:03:00+02:00,2025-05-25,13:03,3,2,5
52,2025-05-25T05:00:00+02:00,2025-05-25,13:00,6,6,12
52,2025-05-25T05:01:00+02:00,2025-05-25,13:01,8,5,13
52,2025-05-25T05:03:00+02:00,2025-05-25,13:03,4,11,15
52,2025-05-25T05:04:00+02:00,2025-05-25,13:04,7,1,8
52,2025-05-25T05:05:00+02:00,2025-05-25,13:05,12,4,16
52,2025-05-25T05:07:00+02:00,2025-05-25,13:07,11,9,20
52,2025-05-25T05:09:00+02:00,2025-05-25,13:09,10,2,12
53,2025-05-25T04:56:00+02:00,2025-05-25,12:56,8,7,15
53,2025-05-25T04:57:00+02:00,2025-05-25,12:57,16,4,20
53,2025-05-25T04:58:00+02:00,2025-05-25,12:58,8,15,23
53,2025-05-25T05:00:00+02:00,2025-05-25,13:00,9,9,18
53,2025-05-25T05:01:00+02:00,2025-05-25,13:01,8,4,12
53,2025-05-25T05:04:00+02:00,2025-05-25,13:04,7,8,15
53,2025-05-25T05:08:00+02:00,2025-05-25,13:08,15,8,23
56,2025-05-25T04:55:00+02:00,2025-05-25,12:55,7,9,16
56,2025-05-25T04:59:00+02:00,2025-05-25,12:59,9,3,12
56,2025-05-25T05:06:00+02:00,2025-05-25,13:06,9,7,16
56,2025-05-25T05:07:00+02:00,2025-05-25,13:07,14,0,14
58,2025-05-25T04:56:00+02:00,2025-05-25,12:56,5,3,8
58,2025-05-25T05:02:00+02:00,2025-05-25,13:02,8,10,18
58,2025-05-25T05:03:00+02:00,2025-05-25,13:03,9,6,15
58,2025-05-25T05:07:00+02:00,2025-05-25,13:07,23,13,36
62,2025-05-25T04:55:00+02:00,2025-05-25,12:55,0,1,1
62,2025-05-25T05:00:00+02:00,2025-05-25,13:00,0,1,1
62,2025-05-25T05:05:00+02:00,2025-05-25,13:05,6,1,7
62,2025-05-25T05:06:00+02:00,2025-05-25,13:06,1,2,3
62,2025-05-25T05:09:00+02:00,2025-05-25,13:09,5,2,7
63,2025-05-25T04:55:00+02:00,2025-05-25,12:55,9,5,14
63,2025-05-25T04:56:00+02:00,2025-05-25,12:56,2,0,2
63,2025-05-25T04:57:00+02:00,2025-05-25,12:57,8,4,12
63,2025-05-25T04:58:00+02:00,2025-05-25,12:58,3,13,16
63,2025-05-25T05:02:00+02:00,2025-05-25,13:02,9,4,13
63,2025-05-25T05:03:00+02:00,2025-05-25,13:03,4,5,9
63,2025-05-25T05:04:00+02:00,2025-05-25,13:04,6,10,16
63,2025-05-25T05:06:00+02:00,2025-05-25,13:06,4,12,16
63,2025-05-25T05:08:00+02:00,2025-05-25,13:08,9,5,14
63,2025-05-25T05:09:00+02:00,2025-05-25,13:09,5,8,13
67,2025-05-25T04:56:00+02:00,2025-05-25,12:56,6,6,12
67,2025-05-25T04:58:00+02:00,2025-05-25,12:58,6,13,19
67,2025-05-25T05:02:00+02:00,2025-05-25,13:02,4,6,10
67,2025-05-25T05:03:00+02:00,2025-05-25,13:03,9,6,15
67,2025-05-25T05:07:00+02:00,2025-05-25,13:07,0,11,11
67,2025-05-25T05:08:00+02:00,2025-05-25,13:08,2,2,4
68,2025-05-25T04:56:00+02:00,2025-05-25,12:56,3,9,12
68,2025-05-25T05:00:00+02:00,2025-05-25,13:00,7,9,16
68,2025-05-25T05:01:00+02:00,2025-05-25,13:01,2,5,7
68,2025-05-25T05:03:00+02:00,2025-05-25,13:03,7,12,19
68,2025-05-25T05:09:00+02:00,2025-05-25,13:09,1,3,4
72,2025-05-25T04:55:00+02:00,2025-05-25,12:55,4,12,16
72,2025-05-25T04:56:00+02:00,2025-05-25,12:56,6,13,19
72,2025-05-25T04:59:00+02:00,2025-05-25,12:59,3,12,15
72,2025-05-25T05:01:00+02:00,2025-05-25,13:01,6,7,13
72,2025-05-25T05:02:00+02:00,2025-05-25,13:02,3,2,5
72,2025-05-25T05:03:00+02:00,2025-05-25,13:03,3,8,11
72,2025-05-25T05:05:00+02:00,2025-05-25,13:05,5,2,7
72,2025-05-25T05:09:00+02:00,2025-05-25,13:09,6,9,15
76,2025-05-25T04:56:00+02:00,2025-05-25,12:56,2,1,3
76,2025-05-25T04:58:00+02:00,2025-05-25,12:58,1,0,1
76,2025-05-25T04:59:00+02:00,2025-05-25,12:59,0,1,1
76,2025-05-25T05:01:00+02:00,2025-05-25,13:01,0,5,5
76,2025-05-25T05:02:00+02:00,2025-05-25,13:02,2,0,2
76,2025-05-25T05:04:00+02:00,2025-05-25,13:04,1,2,3
79,2025-05-25T04:56:00+02:00,2025-05-25,12:56,21,12,33
79,2025-05-25T04:58:00+02:00,2025-05-25,12:58,29,16,45
79,2025-05-25T04:59:00+02:00,2025-05-25,12:59,15,12,27
79,2025-05-25T05:01:00+02:00,2025-05-25,13:01,4,12,16
79,2025-05-25T05:03:00+02:00,2025-05-25,13:03,20,9,29
79,2025-05-25T05:05:00+02:00,2025-05-25,13:05,5,4,9
85,2025-05-25T04:55:00+02:00,2025-05-25,12:55,1,0,1
85,2025-05-25T05:06:00+02:00,2025-05-25,13:06,5,0,5
85,2025-05-25T05:07:00+02:00,2025-05-25,13:07,1,2,3
85,2025-05-25T05:09:00+02:00,2025-05-25,13:09,4,3,7
86,2025-05-25T05:03:00+02:00,2025-05-25,13:03,1,0,1
86,2025-05-25T05:06:00+02:00,2025-05-25,13:06,1,1,2
86,2025-05-25T05:07:00+02:00,2025-05-25,13:07,4,1,5
86,2025-05-25T05:09:00+02:00,2025-05-25,13:09,2,3,5
117,2025-05-25T05:05:00+02:00,2025-05-25,13:05,19,17,36
130,2025-05-25T05:00:00+02:00,2025-05-25,13:00,3,5,8
130,2025-05-25T05:05:00+02:00,2025-05-25,13:05,5,4,9
136,2025-05-25T04:55:00+02:00,2025-05-25,12:55,12,15,27
137,2025-05-25T04:55:00+02:00,2025-05-25,12:55,1,0,1
138,2025-05-25T05:05:00+02:00,2025-05-25,13:05,1,2,3
139,2025-05-25T04:55:00+02:00,2025-05-25,12:55,4,3,7
141,2025-05-25T05:05:00+02:00,2025-05-25,13:05,8,2,10
164,2025-05-25T04:55:00+02:00,2025-05-25,12:55,14,6,20
3,2025-05-25T05:11:00+02:00,2025-05-25,13:11,28,23,51
3,2025-05-25T05:12:00+02:00,2025-05-25,13:12,15,9,24
3,2025-05-25T05:14:00+02:00,2025-05-25,13:14,11,13,24
3,2025-05-25T05:18:00+02:00,2025-05-25,13:18,1,7,8
3,2025-05-25T05:21:00+02:00,2025-05-25,13:21,17,19,36
3,2025-05-25T05:22:00+02:00,2025-05-25,13:22,30,21,51
4,2025-05-25T05:12:00+02:00,2025-05-25,13:12,31,35,66
4,2025-05-25T05:19:00+02:00,2025-05-25,13:19,34,22,56
4,2025-05-25T05:24:00+02:00,2025-05-25,13:24,25,19,44
5,2025-05-25T05:15:00+02:00,2025-05-25,13:15,85,93,178
6,2025-05-25T05:11:00+02:00,2025-05-25,13:11,15,7,22
6,2025-05-25T05:18:00+02:00,2025-05-25,13:18,12,23,35
6,2025-05-25T05:20:00+02:00,2025-05-25,13:20,13,17,30
8,2025-05-25T05:11:00+02:00,2025-05-25,13:11,1,4,5
8,2025-05-25T05:16:00+02:00,2025-05-25,13:16,5,12,17
8,2025-05-25T05:17:00+02:00,2025-05-25,13:17,7,9,16
8,2025-05-25T05:20:00+02:00,2025-05-25,13:20,3,2,5
8,2025-05-25T05:23:00+02:00,2025-05-25,13:23,1,4,5
8,2025-05-25T05:24:00+02:00,2025-05-25,13:24,3,10,13
28,2025-05-25T05:16:00+02:00,2025-05-25,13:16,10,8,18
28,2025-05-25T05:20:00+02:00,2025-05-25,13:20,7,19,26
29,2025-05-25T05:11:00+02:00,2025-05-25,13:11,12,14,26
29,2025-05-25T05:12:00+02:00,2025-05-25,13:12,5,17,22
29,2025-05-25T05:18:00+02:00,2025-05-25,13:18,13,16,29
29,2025-05-25T05:20:00+02:00,2025-05-25,13:20,17,8,25
31,2025-05-25T05:12:00+02:00,2025-05-25,13:12,5,0,5
31,2025-05-25T05:13:00+02:00,2025-05-25,13:13,7,2,9
31,2025-05-25T05:15:00+02:00,2025-05-25,13:15,1,2,3
31,2025-05-25T05:17:00+02:00,2025-05-25,13:17,2,6,8
31,2025-05-25T05:19:00+02:00,2025-05-25,13:19,4,3,7
31,2025-05-25T05:21:00+02:00,2025-05-25,13:21,5,6,11
31,2025-05-25T05:22:00+02:00,2025-05-25,13:22,5,5,10
31,2025-05-25T05:23:00+02:00,2025-05-25,13:23,15,0,15
31,2025-05-25T05:24:00+02:00,2025-05-25,13:24,2,1,3
36,2025-05-25T05:10:00+02:00,2025-05-25,13:10,1,0,1
36,2025-05-25T05:12:00+02:00,2025-05-25,13:12,1,0,1
36,2025-05-25T05:13:00+02:00,2025-05-25,13:13,2,5,7
36,2025-05-25T05:16:00+02:00,2025-05-25,13:16,0,3,3
36,2025-05-25T05:19:00+02:00,2025-05-25,13:19,2,0,2
36,2025-05-25T05:20:00+02:00,2025-05-25,13:20,1,0,1
36,2025-05-25T05:22:00+02:00,2025-05-25,13:22,8,0,8
36,2025-05-25T05:23:00+02:00,2025-05-25,13:23,0,10,10
36,2025-05-25T05:24:00+02:00,2025-05-25,13:24,0,1,1
39,2025-05-25T05:11:00+02:00,2025-05-25,13:11,2,0,2
39,2025-05-25T05:12:00+02:00,2025-05-25,13:12,4,0,4
39,2025-05-25T05:17:00+02:00,2025-05-25,13:17,1,2,3
40,2025-05-25T05:10:00+02:00,2025-05-25,13:10,1,1,2
40,2025-05-25T05:12:00+02:00,2025-05-25,13:12,8,0,8
40,2025-05-25T05:14:00+02:00,2025-05-25,13:14,0,7,7
40,2025-05-25T05:18:00+02:00,2025-05-25,13:18,6,3,9
40,2025-05-25T05:19:00+02:00,2025-05-25,13:19,2,0,2
40,2025-05-25T05:21:00+02:00,2025-05-25,13:21,1,0,1
41,2025-05-25T05:13:00+02:00,2025-05-25,13:13,16,2,18
41,2025-05-25T05:14:00+02:00,2025-05-25,13:14,5,4,9
41,2025-05-25T05:17:00+02:00,2025-05-25,13:17,14,2,16
41,2025-05-25T05:19:00+02:00,2025-05-25,13:19,8,5,13
41,2025-05-25T05:22:00+02:00,2025-05-25,13:22,11,8,19
43,2025-05-25T05:10:00+02:00,2025-05-25,13:10,5,8,13
43,2025-05-25T05:15:00+02:00,2025-05-25,13:15,6,2,8
44,2025-05-25T05:10:00+02:00,2025-05-25,13:10,3,4,7
45,2025-05-25T05:10:00+02:00,2025-05-25,13:10,29,9,38
45,2025-05-25T05:12:00+02:00,2025-05-25,13:12,20,18,38
45,2025-05-25T05:13:00+02:00,2025-05-25,13:13,14,31,45
45,2025-05-25T05:14:00+02:00,2025-05-25,13:14,14,30,44
45,2025-05-25T05:17:00+02:00,2025-05-25,13:17,23,13,36
45,2025-05-25T05:19:00+02:00,2025-05-25,13:19,9,16,25
45,2025-05-25T05:21:00+02:00,2025-05-25,13:21,18,19,37
45,2025-05-25T05:22:00+02:00,2025-05-25,13:22,13,15,28
47,2025-05-25T05:14:00+02:00,2025-05-25,13:14,11,18,29
47,2025-05-25T05:18:00+02:00,2025-05-25,13:18,12,15,27
50,2025-05-25T05:15:00+02:00,2025-05-25,13:15,6,1,7
50,2025-05-25T05:18:00+02:00,2025-05-25,13:18,3,7,10
50,2025-05-25T05:23:00+02:00,2025-05-25,13:23,5,5,10
50,2025-05-25T05:24:00+02:00,2025-05-25,13:24,4,6,10
54,2025-05-25T05:13:00+02:00,2025-05-25,13:13,3,1,4
54,2025-05-25T05:15:00+02:00,2025-05-25,13:15,2,7,9
54,2025-05-25T05:17:00+02:00,2025-05-25,13:17,2,5,7
54,2025-05-25T05:19:00+02:00,2025-05-25,13:19,4,0,4
54,2025-05-25T05:21:00+02:00,2025-05-25,13:21,1,3,4
59,2025-05-25T05:10:00+02:00,2025-05-25,13:10,43,35,78
59,2025-05-25T05:15:00+02:00,2025-05-25,13:15,21,26,47
61,2025-05-25T05:12:00+02:00,2025-05-25,13:12,3,2,5
61,2025-05-25T05:21:00+02:00,2025-05-25,13:21,15,6,21
61,2025-05-25T05:24:00+02:00,2025-05-25,13:24,13,9,22
66,2025-05-25T05:10:00+02:00,2025-05-25,13:10,13,33,46
66,2025-05-25T05:14:00+02:00,2025-05-25,13:14,44,21,65
66,2025-05-25T05:17:00+02:00,2025-05-25,13:17,13,29,42
66,2025-05-25T05:20:00+02:00,2025-05-25,13:20,16,17,33
69,2025-05-25T05:15:00+02:00,2025-05-25,13:15,3,4,7
69,2025-05-25T05:24:00+02:00,2025-05-25,13:24,5,2,7
70,2025-05-25T05:11:00+02:00,2025-05-25,13:11,6,2,8
70,2025-05-25T05:13:00+02:00,2025-05-25,13:13,4,1,5
70,2025-05-25T05:15:00+02:00,2025-05-25,13:15,2,2,4
70,2025-05-25T05:16:00+02:00,2025-05-25,13:16,9,1,10
70,2025-05-25T05:21:00+02:00,2025-05-25,13:21,2,5,7
70,2025-05-25T05:23:00+02:00,2025-05-25,13:23,1,0,1
75,2025-05-25T05:12:00+02:00,2025-05-25,13:12,1,0,1
75,2025-05-25T05:13:00+02:00,2025-05-25,13:13,2,0,2
75,2025-05-25T05:18:00+02:00,2025-05-25,13:18,3,0,3
75,2025-05-25T05:19:00+02:00,2025-05-25,13:19,1,1,2
75,2025-05-25T05:23:00+02:00,2025-05-25,13:23,1,0,1
78,2025-05-25T05:14:00+02:00,2025-05-25,13:14,1,0,1
78,2025-05-25T05:16:00+02:00,2025-05-25,13:16,0,1,1
78,2025-05-25T05:17:00+02:00,2025-05-25,13:17,0,1,1
78,2025-05-25T05:22:00+02:00,2025-05-25,13:22,0,3,3
78,2025-05-25T05:24:00+02:00,2025-05-25,13:24,2,0,2
84,2025-05-25T05:15:00+02:00,2025-05-25,13:15,86,94,180
87,2025-05-25T05:10:00+02:00,2025-05-25,13:10,2,5,7
87,2025-05-25T05:12:00+02:00,2025-05-25,13:12,5,0,5
87,2025-05-25T05:16:00+02:00,2025-05-25,13:16,4,6,10
87,2025-05-25T05:21:00+02:00,2025-05-25,13:21,0,2,2
108,2025-05-25T05:12:00+02:00,2025-05-25,13:12,4,1,5
108,2025-05-25T05:17:00+02:00,2025-05-25,13:17,0,7,7
108,2025-05-25T05:18:00+02:00,2025-05-25,13:18,1,1,2
108,2025-05-25T05:20:00+02:00,2025-05-25,13:20,2,3,5
108,2025-05-25T05:22:00+02:00,2025-05-25,13:22,1,1,2
132,2025-05-25T05:15:00+02:00,2025-05-25,13:15,12,5,17
132,2025-05-25T05:20:00+02:00,2025-05-25,13:20,14,21,35
133,2025-05-25T05:10:00+02:00,2025-05-25,13:10,27,45,72
134,2025-05-25T05:10:00+02:00,2025-05-25,13:10,15,16,31
135,2025-05-25T05:10:00+02:00,2025-05-25,13:10,31,34,65
135,2025-05-25T05:20:00+02:00,2025-05-25,13:20,21,46,67
140,2025-05-25T05:15:00+02:00,2025-05-25,13:15,7,9,16
162,2025-05-25T05:15:00+02:00,2025-05-25,13:15,73,92,165
166,2025-05-25T05:15:00+02:00,2025-05-25,13:15,2,2,4
167,2025-05-25T05:10:00+02:00,2025-05-25,13:10,1,3,4
1,2025-05-25T05:12:00+02:00,2025-05-25,13:12,17,26,43
1,2025-05-25T05:13:00+02:00,2025-05-25,13:13,25,21,46
1,2025-05-25T05:14:00+02:00,2025-05-25,13:14,17,33,50
1,2025-05-25T05:16:00+02:00,2025-05-25,13:16,21,12,33
1,2025-05-25T05:22:00+02:00,2025-05-25,13:22,23,22,45
2,2025-05-25T05:15:00+02:00,2025-05-25,13:15,4,13,17
2,2025-05-25T05:19:00+02:00,2025-05-25,13:19,17,16,33
2,2025-05-25T05:23:00+02:00,2025-05-25,13:23,6,10,16
9,2025-05-25T05:10:00+02:00,2025-05-25,13:10,0,1,1
9,2025-05-25T05:18:00+02:00,2025-05-25,13:18,2,1,3
9,2025-05-25T05:21:00+02:00,2025-05-25,13:21,0,3,3
10,2025-05-25T05:19:00+02:00,2025-05-25,13:19,1,0,1
11,2025-05-25T05:10:00+02:00,2025-05-25,13:10,6,3,9
11,2025-05-25T05:13:00+02:00,2025-05-25,13:13,3,1,4
11,2025-05-25T05:18:00+02:00,2025-05-25,13:18,1,0,1
11,2025-05-25T05:24:00+02:00,2025-05-25,13:24,4,0,4
12,2025-05-25T05:13:00+02:00,2025-05-25,13:13,2,6,8
12,2025-05-25T05:15:00+02:00,2025-05-25,13:15,4,3,7
12,2025-05-25T05:21:00+02:00,2025-05-25,13:21,4,2,6
12,2025-05-25T05:22:00+02:00,2025-05-25,13:22,6,2,8
17,2025-05-25T05:10:00+02:00,2025-05-25,13:10,3,3,6
17,2025-05-25T05:14:00+02:00,2025-05-25,13:14,5,3,8
17,2025-05-25T05:17:00+02:00,2025-05-25,13:17,5,0,5
17,2025-05-25T05:23:00+02:00,2025-05-25,13:23,0,5,5
17,2025-05-25T05:24:00+02:00,2025-05-25,13:24,5,0,5
18,2025-05-25T05:11:00+02:00,2025-05-25,13:11,0,1,1
18,2025-05-25T05:14:00+02:00,2025-05-25,13:14,2,6,8
18,2025-05-25T05:15:00+02:00,2025-05-25,13:15,2,0,2
18,2025-05-25T05:21:00+02:00,2025-05-25,13:21,3,2,5
18,2025-05-25T05:24:00+02:00,2025-05-25,13:24,1,0,1
19,2025-05-25T05:11:00+02:00,2025-05-25,13:11,15,11,26
19,2025-05-25T05:15:00+02:00,2025-05-25,13:15,20,9,29
20,2025-05-25T05:12:00+02:00,2025-05-25,13:12,2,10,12
20,2025-05-25T05:15:00+02:00,2025-05-25,13:15,10,7,17
20,2025-05-25T05:16:00+02:00,2025-05-25,13:16,1,3,4
20,2025-05-25T05:18:00+02:00,2025-05-25,13:18,6,5,11
20,2025-05-25T05:19:00+02:00,2025-05-25,13:19,4,5,9
20,2025-05-25T05:22:00+02:00,2025-05-25,13:22,6,9,15
23,2025-05-25T05:11:00+02:00,2025-05-25,13:11,4,4,8
23,2025-05-25T05:13:00+02:00,2025-05-25,13:13,5,1,6
23,2025-05-25T05:16:00+02:00,2025-05-25,13:16,5,1,6
23,2025-05-25T05:18:00+02:00,2025-05-25,13:18,8,8,16
23,2025-05-25T05:19:00+02:00,2025-05-25,13:19,1,3,4
23,2025-05-25T05:20:00+02:00,2025-05-25,13:20,0,3,3
23,2025-05-25T05:23:00+02:00,2025-05-25,13:23,6,2,8
23,2025-05-25T05:24:00+02:00,2025-05-25,13:24,0,1,1
24,2025-05-25T05:10:00+02:00,2025-05-25,13:10,6,8,14
24,2025-05-25T05:14:00+02:00,2025-05-25,13:14,9,2,11
24,2025-05-25T05:16:00+02:00,2025-05-25,13:16,7,17,24
24,2025-05-25T05:17:00+02:00,2025-05-25,13:17,6,22,28
25,2025-05-25T05:10:00+02:00,2025-05-25,13:10,55,93,148
27,2025-05-25T05:15:00+02:00,2025-05-25,13:15,2,2,4
27,2025-05-25T05:18:00+02:00,2025-05-25,13:18,8,5,13
27,2025-05-25T05:20:00+02:00,2025-05-25,13:20,5,6,11
27,2025-05-25T05:24:00+02:00,2025-05-25,13:24,12,2,14
30,2025-05-25T05:13:00+02:00,2025-05-25,13:13,5,16,21
30,2025-05-25T05:17:00+02:00,2025-05-25,13:17,3,6,9
30,2025-05-25T05:18:00+02:00,2025-05-25,13:18,8,21,29
30,2025-05-25T05:21:00+02:00,2025-05-25,13:21,6,11,17
35,2025-05-25T05:10:00+02:00,2025-05-25,13:10,25,26,51
35,2025-05-25T05:13:00+02:00,2025-05-25,13:13,16,12,28
35,2025-05-25T05:14:00+02:00,2025-05-25,13:14,19,21,40
35,2025-05-25T05:20:00+02:00,2025-05-25,13:20,30,24,54
35,2025-05-25T05:21:00+02:00,2025-05-25,13:21,28,14,42
35,2025-05-25T05:23:00+02:00,2025-05-25,13:23,32,13,45
35,2025-05-25T05:24:00+02:00,2025-05-25,13:24,19,26,45
46,2025-05-25T05:10:00+02:00,2025-05-25,13:10,0,2,2
48,2025-05-25T05:10:00+02:00,2025-05-25,13:10,5,2,7
48,2025-05-25T05:11:00+02:00,2025-05-25,13:11,2,7,9
48,2025-05-25T05:14:00+02:00,2025-05-25,13:14,5,3,8
48,2025-05-25T05:16:00+02:00,2025-05-25,13:16,8,16,24
48,2025-05-25T05:21:00+02:00,2025-05-25,13:21,7,5,12
49,2025-05-25T05:12:00+02:00,2025-05-25,13:12,0,8,8
49,2025-05-25T05:15:00+02:00,2025-05-25,13:15,12,7,19
49,2025-05-25T05:16:00+02:00,2025-05-25,13:16,6,9,15
49,2025-05-25T05:20:00+02:00,2025-05-25,13:20,13,8,21
49,2025-05-25T05:21:00+02:00,2025-05-25,13:21,4,16,20
49,2025-05-25T05:23:00+02:00,2025-05-25,13:23,5,11,16
49,2025-05-25T05:24:00+02:00,2025-05-25,13:24,14,14,28
51,2025-05-25T05:10:00+02:00,2025-05-25,13:10,3,3,6
51,2025-05-25T05:16:00+02:00,2025-05-25,13:16,3,8,11
51,2025-05-25T05:21:00+02:00,2025-05-25,13:21,3,1,4
52,2025-05-25T05:10:00+02:00,2025-05-25,13:10,5,6,11
52,2025-05-25T05:14:00+02:00,2025-05-25,13:14,1,6,7
52,2025-05-25T05:16:00+02:00,2025-05-25,13:16,10,7,17
52,2025-05-25T05:17:00+02:00,2025-05-25,13:17,8,12,20
52,2025-05-25T05:21:00+02:00,2025-05-25,13:21,2,11,13
53,2025-05-25T05:10:00+02:00,2025-05-25,13:10,8,4,12
53,2025-05-25T05:12:00+02:00,2025-05-25,13:12,10,15,25
53,2025-05-25T05:16:00+02:00,2025-05-25,13:16,13,7,20
53,2025-05-25T05:17:00+02:00,2025-05-25,13:17,14,6,20
53,2025-05-25T05:19:00+02:00,2025-05-25,13:19,14,8,22
53,2025-05-25T05:20:00+02:00,2025-05-25,13:20,3,8,11
53,2025-05-25T05:24:00+02:00,2025-05-25,13:24,13,6,19
56,2025-05-25T05:11:00+02:00,2025-05-25,13:11,1,8,9
56,2025-05-25T05:12:00+02:00,2025-05-25,13:12,7,8,15
58,2025-05-25T05:13:00+02:00,2025-05-25,13:13,6,8,14
58,2025-05-25T05:14:00+02:00,2025-05-25,13:14,7,5,12
58,2025-05-25T05:15:00+02:00,2025-05-25,13:15,11,11,22
58,2025-05-25T05:16:00+02:00,2025-05-25,13:16,6,8,14
62,2025-05-25T05:10:00+02:00,2025-05-25,13:10,0,4,4
62,2025-05-25T05:12:00+02:00,2025-05-25,13:12,3,0,3
62,2025-05-25T05:15:00+02:00,2025-05-25,13:15,2,3,5
62,2025-05-25T05:16:00+02:00,2025-05-25,13:16,3,1,4
62,2025-05-25T05:20:00+02:00,2025-05-25,13:20,3,1,4
63,2025-05-25T05:11:00+02:00,2025-05-25,13:11,0,4,4
63,2025-05-25T05:14:00+02:00,2025-05-25,13:14,4,4,8
63,2025-05-25T05:15:00+02:00,2025-05-25,13:15,2,9,11
63,2025-05-25T05:18:00+02:00,2025-05-25,13:18,3,7,10
63,2025-05-25T05:19:00+02:00,2025-05-25,13:19,7,7,14
63,2025-05-25T05:20:00+02:00,2025-05-25,13:20,2,6,8
63,2025-05-25T05:22:00+02:00,2025-05-25,13:22,6,8,14
63,2025-05-25T05:23:00+02:00,2025-05-25,13:23,2,9,11
67,2025-05-25T05:12:00+02:00,2025-05-25,13:12,2,6,8
67,2025-05-25T05:15:00+02:00,2025-05-25,13:15,7,9,16
67,2025-05-25T05:16:00+02:00,2025-05-25,13:16,7,7,14
67,2025-05-25T05:17:00+02:00,2025-05-25,13:17,5,17,22
67,2025-05-25T05:20:00+02:00,2025-05-25,13:20,3,13,16
67,2025-05-25T05:22:00+02:00,2025-05-25,13:22,11,15,26
67,2025-05-25T05:23:00+02:00,2025-05-25,13:23,7,14,21
67,2025-05-25T05:24:00+02:00,2025-05-25,13:24,7,6,13
68,2025-05-25T05:10:00+02:00,2025-05-25,13:10,4,8,12
68,2025-05-25T05:19:00+02:00,2025-05-25,13:19,6,4,10
68,2025-05-25T05:20:00+02:00,2025-05-25,13:20,5,0,5
68,2025-05-25T05:21:00+02:00,2025-05-25,13:21,6,4,10
68,2025-05-25T05:22:00+02:00,2025-05-25,13:22,3,8,11
72,2025-05-25T05:11:00+02:00,2025-05-25,13:11,7,10,17
72,2025-05-25T05:13:00+02:00,2025-05-25,13:13,2,0,2
72,2025-05-25T05:14:00+02:00,2025-05-25,13:14,0,11,11
72,2025-05-25T05:18:00+02:00,2025-05-25,13:18,5,4,9
72,2025-05-25T05:19:00+02:00,2025-05-25,13:19,5,31,36
72,2025-05-25T05:20:00+02:00,2025-05-25,13:20,4,5,9
72,2025-05-25T05:22:00+02:00,2025-05-25,13:22,10,5,15
72,2025-05-25T05:24:00+02:00,2025-05-25,13:24,0,12,12
76,2025-05-25T05:10:00+02:00,2025-05-25,13:10,0,2,2
76,2025-05-25T05:11:00+02:00,2025-05-25,13:11,1,0,1
76,2025-05-25T05:12:00+02:00,2025-05-25,13:12,0,4,4
76,2025-05-25T05:14:00+02:00,2025-05-25,13:14,0,2,2
76,2025-05-25T05:15:00+02:00,2025-05-25,13:15,0,3,3
76,2025-05-25T05:19:00+02:00,2025-05-25,13:19,0,1,1
79,2025-05-25T05:10:00+02:00,2025-05-25,13:10,9,6,15
79,2025-05-25T05:11:00+02:00,2025-05-25,13:11,21,7,28
79,2025-05-25T05:12:00+02:00,2025-05-25,13:12,9,2,11
79,2025-05-25T05:15:00+02:00,2025-05-25,13:15,13,2,15
79,2025-05-25T05:17:00+02:00,2025-05-25,13:17,22,9,31
79,2025-05-25T05:20:00+02:00,2025-05-25,13:20,16,12,28
79,2025-05-25T05:24:00+02:00,2025-05-25,13:24,13,19,32
85,2025-05-25T05:16:00+02:00,2025-05-25,13:16,1,0,1
85,2025-05-25T05:20:00+02:00,2025-05-25,13:20,1,1,2
86,2025-05-25T05:11:00+02:00,2025-05-25,13:11,1,2,3
86,2025-05-25T05:14:00+02:00,2025-05-25,13:14,3,0,3
86,2025-05-25T05:23:00+02:00,2025-05-25,13:23,1,0,1
117,2025-05-25T05:10:00+02:00,2025-05-25,13:10,22,22,44
123,2025-05-25T05:10:00+02:00,2025-05-25,13:10,11,2,13
123,2025-05-25T05:15:00+02:00,2025-05-25,13:15,2,0,2
123,2025-05-25T05:20:00+02:00,2025-05-25,13:20,4,6,10
130,2025-05-25T05:10:00+02:00,2025-05-25,13:10,3,3,6
130,2025-05-25T05:15:00+02:00,2025-05-25,13:15,1,1,2
130,2025-05-25T05:20:00+02:00,2025-05-25,13:20,3,5,8
136,2025-05-25T05:10:00+02:00,2025-05-25,13:10,23,2,25
137,2025-05-25T05:10:00+02:00,2025-05-25,13:10,0,6,6
137,2025-05-25T05:20:00+02:00,2025-05-25,13:20,0,1,1
139,2025-05-25T05:15:00+02:00,2025-05-25,13:15,5,6,11
141,2025-05-25T05:20:00+02:00,2025-05-25,13:20,17,8,25
181,2025-05-25T04:57:00+02:00,2025-05-25,12:57,14,18,32
181,2025-05-25T05:00:00+02:00,2025-05-25,13:00,16,24,40
181,2025-05-25T05:02:00+02:00,2025-05-25,13:02,6,24,30
181,2025-05-25T05:06:00+02:00,2025-05-25,13:06,12,19,31
182,2025-05-25T05:05:00+02:00,2025-05-25,13:05,4,14,18
180,2025-05-25T04:56:00+02:00,2025-05-25,12:56,1,0,1
181,2025-05-25T05:13:00+02:00,2025-05-25,13:13,18,11,29
181,2025-05-25T05:16:00+02:00,2025-05-25,13:16,6,20,26
181,2025-05-25T05:19:00+02:00,2025-05-25,13:19,22,20,42
181,2025-05-25T05:21:00+02:00,2025-05-25,13:21,9,17,26
181,2025-05-25T05:22:00+02:00,2025-05-25,13:22,15,23,38
181,2025-05-25T05:23:00+02:00,2025-05-25,13:23,12,20,32
182,2025-05-25T05:10:00+02:00,2025-05-25,13:10,13,16,29
3,2025-05-25T05:25:00+02:00,2025-05-25,13:25,23,33,56
3,2025-05-25T05:29:00+02:00,2025-05-25,13:29,23,23,46
3,2025-05-25T05:31:00+02:00,2025-05-25,13:31,24,22,46
3,2025-05-25T05:32:00+02:00,2025-05-25,13:32,10,21,31
3,2025-05-25T05:33:00+02:00,2025-05-25,13:33,26,13,39
3,2025-05-25T05:37:00+02:00,2025-05-25,13:37,26,15,41
3,2025-05-25T05:39:00+02:00,2025-05-25,13:39,9,30,39
4,2025-05-25T05:28:00+02:00,2025-05-25,13:28,32,22,54
4,2025-05-25T05:37:00+02:00,2025-05-25,13:37,49,24,73
4,2025-05-25T05:38:00+02:00,2025-05-25,13:38,27,26,53
6,2025-05-25T05:28:00+02:00,2025-05-25,13:28,7,17,24
6,2025-05-25T05:31:00+02:00,2025-05-25,13:31,17,13,30
8,2025-05-25T05:26:00+02:00,2025-05-25,13:26,3,2,5
8,2025-05-25T05:29:00+02:00,2025-05-25,13:29,4,2,6
8,2025-05-25T05:30:00+02:00,2025-05-25,13:30,4,5,9
8,2025-05-25T05:32:00+02:00,2025-05-25,13:32,1,3,4
8,2025-05-25T05:33:00+02:00,2025-05-25,13:33,2,4,6
8,2025-05-25T05:35:00+02:00,2025-05-25,13:35,7,0,7
8,2025-05-25T05:38:00+02:00,2025-05-25,13:38,0,4,4
28,2025-05-25T05:27:00+02:00,2025-05-25,13:27,11,6,17
28,2025-05-25T05:29:00+02:00,2025-05-25,13:29,13,19,32
28,2025-05-25T05:30:00+02:00,2025-05-25,13:30,15,18,33
28,2025-05-25T05:31:00+02:00,2025-05-25,13:31,5,4,9
28,2025-05-25T05:33:00+02:00,2025-05-25,13:33,3,9,12
28,2025-05-25T05:35:00+02:00,2025-05-25,13:35,9,11,20
28,2025-05-25T05:36:00+02:00,2025-05-25,13:36,8,10,18
28,2025-05-25T05:37:00+02:00,2025-05-25,13:37,8,6,14
29,2025-05-25T05:25:00+02:00,2025-05-25,13:25,9,15,24
29,2025-05-25T05:34:00+02:00,2025-05-25,13:34,15,7,22
29,2025-05-25T05:36:00+02:00,2025-05-25,13:36,2,14,16
29,2025-05-25T05:37:00+02:00,2025-05-25,13:37,3,6,9
31,2025-05-25T05:25:00+02:00,2025-05-25,13:25,3,2,5
31,2025-05-25T05:27:00+02:00,2025-05-25,13:27,3,2,5
31,2025-05-25T05:29:00+02:00,2025-05-25,13:29,3,1,4
31,2025-05-25T05:35:00+02:00,2025-05-25,13:35,6,1,7
31,2025-05-25T05:37:00+02:00,2025-05-25,13:37,1,0,1
31,2025-05-25T05:38:00+02:00,2025-05-25,13:38,2,3,5
36,2025-05-25T05:27:00+02:00,2025-05-25,13:27,0,1,1
36,2025-05-25T05:28:00+02:00,2025-05-25,13:28,1,5,6
36,2025-05-25T05:31:00+02:00,2025-05-25,13:31,2,7,9
36,2025-05-25T05:38:00+02:00,2025-05-25,13:38,4,1,5
39,2025-05-25T05:26:00+02:00,2025-05-25,13:26,0,2,2
39,2025-05-25T05:27:00+02:00,2025-05-25,13:27,0,2,2
39,2025-05-25T05:29:00+02:00,2025-05-25,13:29,6,0,6
39,2025-05-25T05:32:00+02:00,2025-05-25,13:32,5,1,6
39,2025-05-25T05:36:00+02:00,2025-05-25,13:36,2,0,2
39,2025-05-25T05:38:00+02:00,2025-05-25,13:38,1,0,1
39,2025-05-25T05:39:00+02:00,2025-05-25,13:39,5,0,5
40,2025-05-25T05:27:00+02:00,2025-05-25,13:27,0,2,2
40,2025-05-25T05:31:00+02:00,2025-05-25,13:31,0,3,3
40,2025-05-25T05:34:00+02:00,2025-05-25,13:34,11,0,11
40,2025-05-25T05:37:00+02:00,2025-05-25,13:37,0,6,6
40,2025-05-25T05:38:00+02:00,2025-05-25,13:38,4,6,10
41,2025-05-25T05:25:00+02:00,2025-05-25,13:25,2,10,12
41,2025-05-25T05:27:00+02:00,2025-05-25,13:27,4,8,12
41,2025-05-25T05:29:00+02:00,2025-05-25,13:29,42,6,48
41,2025-05-25T05:31:00+02:00,2025-05-25,13:31,12,4,16
41,2025-05-25T05:34:00+02:00,2025-05-25,13:34,22,12,34
45,2025-05-25T05:25:00+02:00,2025-05-25,13:25,14,19,33
45,2025-05-25T05:27:00+02:00,2025-05-25,13:27,15,20,35
45,2025-05-25T05:30:00+02:00,2025-05-25,13:30,17,36,53
45,2025-05-25T05:36:00+02:00,2025-05-25,13:36,19,17,36
47,2025-05-25T05:28:00+02:00,2025-05-25,13:28,10,14,24
47,2025-05-25T05:29:00+02:00,2025-05-25,13:29,27,24,51
47,2025-05-25T05:30:00+02:00,2025-05-25,13:30,17,12,29
47,2025-05-25T05:32:00+02:00,2025-05-25,13:32,12,21,33
47,2025-05-25T05:33:00+02:00,2025-05-25,13:33,13,20,33
50,2025-05-25T05:27:00+02:00,2025-05-25,13:27,6,9,15
50,2025-05-25T05:29:00+02:00,2025-05-25,13:29,4,4,8
50,2025-05-25T05:31:00+02:00,2025-05-25,13:31,5,6,11
50,2025-05-25T05:37:00+02:00,2025-05-25,13:37,3,8,11
54,2025-05-25T05:25:00+02:00,2025-05-25,13:25,2,4,6
54,2025-05-25T05:26:00+02:00,2025-05-25,13:26,6,4,10
54,2025-05-25T05:27:00+02:00,2025-05-25,13:27,4,1,5
54,2025-05-25T05:28:00+02:00,2025-05-25,13:28,0,2,2
54,2025-05-25T05:29:00+02:00,2025-05-25,13:29,7,2,9
54,2025-05-25T05:30:00+02:00,2025-05-25,13:30,3,3,6
54,2025-05-25T05:31:00+02:00,2025-05-25,13:31,0,3,3
54,2025-05-25T05:32:00+02:00,2025-05-25,13:32,2,6,8
54,2025-05-25T05:34:00+02:00,2025-05-25,13:34,3,2,5
54,2025-05-25T05:36:00+02:00,2025-05-25,13:36,12,2,14
54,2025-05-25T05:37:00+02:00,2025-05-25,13:37,1,1,2
54,2025-05-25T05:39:00+02:00,2025-05-25,13:39,3,2,5
61,2025-05-25T05:25:00+02:00,2025-05-25,13:25,4,13,17
61,2025-05-25T05:29:00+02:00,2025-05-25,13:29,11,12,23
61,2025-05-25T05:30:00+02:00,2025-05-25,13:30,7,12,19
61,2025-05-25T05:39:00+02:00,2025-05-25,13:39,7,2,9
66,2025-05-25T05:27:00+02:00,2025-05-25,13:27,26,32,58
66,2025-05-25T05:28:00+02:00,2025-05-25,13:28,6,22,28
66,2025-05-25T05:29:00+02:00,2025-05-25,13:29,27,35,62
66,2025-05-25T05:31:00+02:00,2025-05-25,13:31,21,28,49
66,2025-05-25T05:32:00+02:00,2025-05-25,13:32,27,35,62
66,2025-05-25T05:33:00+02:00,2025-05-25,13:33,19,35,54
66,2025-05-25T05:35:00+02:00,2025-05-25,13:35,24,20,44
66,2025-05-25T05:38:00+02:00,2025-05-25,13:38,29,9,38
69,2025-05-25T05:27:00+02:00,2025-05-25,13:27,2,2,4
69,2025-05-25T05:28:00+02:00,2025-05-25,13:28,8,1,9
69,2025-05-25T05:33:00+02:00,2025-05-25,13:33,1,16,17
69,2025-05-25T05:35:00+02:00,2025-05-25,13:35,6,3,9
70,2025-05-25T05:28:00+02:00,2025-05-25,13:28,5,7,12
70,2025-05-25T05:32:00+02:00,2025-05-25,13:32,1,8,9
70,2025-05-25T05:33:00+02:00,2025-05-25,13:33,2,4,6
70,2025-05-25T05:34:00+02:00,2025-05-25,13:34,6,2,8
70,2025-05-25T05:37:00+02:00,2025-05-25,13:37,1,0,1
70,2025-05-25T05:39:00+02:00,2025-05-25,13:39,2,1,3
71,2025-05-25T05:27:00+02:00,2025-05-25,13:27,1,0,1
75,2025-05-25T05:28:00+02:00,2025-05-25,13:28,0,2,2
75,2025-05-25T05:33:00+02:00,2025-05-25,13:33,0,1,1
75,2025-05-25T05:37:00+02:00,2025-05-25,13:37,2,3,5
78,2025-05-25T05:26:00+02:00,2025-05-25,13:26,5,0,5
78,2025-05-25T05:29:00+02:00,2025-05-25,13:29,1,2,3
78,2025-05-25T05:31:00+02:00,2025-05-25,13:31,1,0,1
78,2025-05-25T05:32:00+02:00,2025-05-25,13:32,0,3,3
78,2025-05-25T05:37:00+02:00,2025-05-25,13:37,1,1,2
78,2025-05-25T05:38:00+02:00,2025-05-25,13:38,0,1,1
87,2025-05-25T05:27:00+02:00,2025-05-25,13:27,4,4,8
87,2025-05-25T05:29:00+02:00,2025-05-25,13:29,2,2,4
87,2025-05-25T05:35:00+02:00,2025-05-25,13:35,3,0,3
87,2025-05-25T05:37:00+02:00,2025-05-25,13:37,2,3,5
87,2025-05-25T05:39:00+02:00,2025-05-25,13:39,0,4,4
108,2025-05-25T05:26:00+02:00,2025-05-25,13:26,6,3,9
108,2025-05-25T05:31:00+02:00,2025-05-25,13:31,5,5,10
108,2025-05-25T05:33:00+02:00,2025-05-25,13:33,6,1,7
108,2025-05-25T05:35:00+02:00,2025-05-25,13:35,2,2,4
108,2025-05-25T05:38:00+02:00,2025-05-25,13:38,6,6,12
124,2025-05-25T05:35:00+02:00,2025-05-25,13:35,0,5,5
132,2025-05-25T05:30:00+02:00,2025-05-25,13:30,20,9,29
132,2025-05-25T05:35:00+02:00,2025-05-25,13:35,14,16,30
133,2025-05-25T05:25:00+02:00,2025-05-25,13:25,31,20,51
133,2025-05-25T05:30:00+02:00,2025-05-25,13:30,27,21,48
134,2025-05-25T05:25:00+02:00,2025-05-25,13:25,23,23,46
134,2025-05-25T05:30:00+02:00,2025-05-25,13:30,27,20,47
134,2025-05-25T05:35:00+02:00,2025-05-25,13:35,37,13,50
135,2025-05-25T05:25:00+02:00,2025-05-25,13:25,26,21,47
140,2025-05-25T05:25:00+02:00,2025-05-25,13:25,18,7,25
140,2025-05-25T05:30:00+02:00,2025-05-25,13:30,15,13,28
140,2025-05-25T05:35:00+02:00,2025-05-25,13:35,8,5,13
162,2025-05-25T05:25:00+02:00,2025-05-25,13:25,71,90,161
162,2025-05-25T05:35:00+02:00,2025-05-25,13:35,97,86,183
165,2025-05-25T05:30:00+02:00,2025-05-25,13:30,1,2,3
166,2025-05-25T05:30:00+02:00,2025-05-25,13:30,3,5,8
167,2025-05-25T05:25:00+02:00,2025-05-25,13:25,5,11,16
167,2025-05-25T05:30:00+02:00,2025-05-25,13:30,6,7,13
179,2025-05-25T05:25:00+02:00,2025-05-25,13:25,3,10,13
179,2025-05-25T05:30:00+02:00,2025-05-25,13:30,10,0,10
179,2025-05-25T05:35:00+02:00,2025-05-25,13:35,7,6,13
1,2025-05-25T05:27:00+02:00,2025-05-25,13:27,20,23,43
1,2025-05-25T05:29:00+02:00,2025-05-25,13:29,20,32,52
1,2025-05-25T05:39:00+02:00,2025-05-25,13:39,32,42,74
2,2025-05-25T05:27:00+02:00,2025-05-25,13:27,8,12,20
2,2025-05-25T05:29:00+02:00,2025-05-25,13:29,10,16,26
2,2025-05-25T05:36:00+02:00,2025-05-25,13:36,22,10,32
2,2025-05-25T05:38:00+02:00,2025-05-25,13:38,22,15,37
9,2025-05-25T05:31:00+02:00,2025-05-25,13:31,3,2,5
9,2025-05-25T05:35:00+02:00,2025-05-25,13:35,2,4,6
9,2025-05-25T05:37:00+02:00,2025-05-25,13:37,0,3,3
10,2025-05-25T05:26:00+02:00,2025-05-25,13:26,0,1,1
10,2025-05-25T05:27:00+02:00,2025-05-25,13:27,0,1,1
10,2025-05-25T05:30:00+02:00,2025-05-25,13:30,0,1,1
10,2025-05-25T05:33:00+02:00,2025-05-25,13:33,2,0,2
10,2025-05-25T05:34:00+02:00,2025-05-25,13:34,1,0,1
10,2025-05-25T05:39:00+02:00,2025-05-25,13:39,3,2,5
11,2025-05-25T05:25:00+02:00,2025-05-25,13:25,8,4,12
11,2025-05-25T05:30:00+02:00,2025-05-25,13:30,1,5,6
11,2025-05-25T05:35:00+02:00,2025-05-25,13:35,4,6,10
11,2025-05-25T05:36:00+02:00,2025-05-25,13:36,4,2,6
12,2025-05-25T05:33:00+02:00,2025-05-25,13:33,5,5,10
12,2025-05-25T05:36:00+02:00,2025-05-25,13:36,0,1,1
12,2025-05-25T05:38:00+02:00,2025-05-25,13:38,1,0,1
12,2025-05-25T05:39:00+02:00,2025-05-25,13:39,1,1,2
17,2025-05-25T05:27:00+02:00,2025-05-25,13:27,6,4,10
17,2025-05-25T05:29:00+02:00,2025-05-25,13:29,4,2,6
17,2025-05-25T05:34:00+02:00,2025-05-25,13:34,0,3,3
17,2025-05-25T05:36:00+02:00,2025-05-25,13:36,3,1,4
17,2025-05-25T05:38:00+02:00,2025-05-25,13:38,4,3,7
17,2025-05-25T05:39:00+02:00,2025-05-25,13:39,1,3,4
18,2025-05-25T05:32:00+02:00,2025-05-25,13:32,3,0,3
18,2025-05-25T05:39:00+02:00,2025-05-25,13:39,0,2,2
19,2025-05-25T05:25:00+02:00,2025-05-25,13:25,5,9,14
19,2025-05-25T05:27:00+02:00,2025-05-25,13:27,6,13,19
19,2025-05-25T05:29:00+02:00,2025-05-25,13:29,11,6,17
19,2025-05-25T05:32:00+02:00,2025-05-25,13:32,17,16,33
19,2025-05-25T05:36:00+02:00,2025-05-25,13:36,9,13,22
19,2025-05-25T05:37:00+02:00,2025-05-25,13:37,13,11,24
19,2025-05-25T05:39:00+02:00,2025-05-25,13:39,6,9,15
20,2025-05-25T05:25:00+02:00,2025-05-25,13:25,2,3,5
20,2025-05-25T05:28:00+02:00,2025-05-25,13:28,1,1,2
20,2025-05-25T05:33:00+02:00,2025-05-25,13:33,10,10,20
20,2025-05-25T05:34:00+02:00,2025-05-25,13:34,1,11,12
20,2025-05-25T05:38:00+02:00,2025-05-25,13:38,3,6,9
23,2025-05-25T05:25:00+02:00,2025-05-25,13:25,3,5,8
23,2025-05-25T05:27:00+02:00,2025-05-25,13:27,1,0,1
23,2025-05-25T05:35:00+02:00,2025-05-25,13:35,0,5,5
23,2025-05-25T05:38:00+02:00,2025-05-25,13:38,5,2,7
24,2025-05-25T05:25:00+02:00,2025-05-25,13:25,11,30,41
24,2025-05-25T05:29:00+02:00,2025-05-25,13:29,10,10,20
24,2025-05-25T05:30:00+02:00,2025-05-25,13:30,11,13,24
24,2025-05-25T05:34:00+02:00,2025-05-25,13:34,8,15,23
24,2025-05-25T05:36:00+02:00,2025-05-25,13:36,7,5,12
24,2025-05-25T05:37:00+02:00,2025-05-25,13:37,8,3,11
25,2025-05-25T05:25:00+02:00,2025-05-25,13:25,88,81,169
25,2025-05-25T05:30:00+02:00,2025-05-25,13:30,90,56,146
27,2025-05-25T05:31:00+02:00,2025-05-25,13:31,8,5,13
27,2025-05-25T05:35:00+02:00,2025-05-25,13:35,5,0,5
27,2025-05-25T05:36:00+02:00,2025-05-25,13:36,3,1,4
27,2025-05-25T05:37:00+02:00,2025-05-25,13:37,8,3,11
30,2025-05-25T05:25:00+02:00,2025-05-25,13:25,1,6,7
30,2025-05-25T05:26:00+02:00,2025-05-25,13:26,10,6,16
30,2025-05-25T05:36:00+02:00,2025-05-25,13:36,4,6,10
30,2025-05-25T05:37:00+02:00,2025-05-25,13:37,1,2,3
30,2025-05-25T05:38:00+02:00,2025-05-25,13:38,5,13,18
35,2025-05-25T05:27:00+02:00,2025-05-25,13:27,21,18,39
35,2025-05-25T05:28:00+02:00,2025-05-25,13:28,27,23,50
35,2025-05-25T05:32:00+02:00,2025-05-25,13:32,18,35,53
35,2025-05-25T05:33:00+02:00,2025-05-25,13:33,15,22,37
35,2025-05-25T05:37:00+02:00,2025-05-25,13:37,20,26,46
46,2025-05-25T05:25:00+02:00,2025-05-25,13:25,7,9,16
46,2025-05-25T05:35:00+02:00,2025-05-25,13:35,4,5,9
48,2025-05-25T05:25:00+02:00,2025-05-25,13:25,28,2,30
48,2025-05-25T05:27:00+02:00,2025-05-25,13:27,6,3,9
48,2025-05-25T05:28:00+02:00,2025-05-25,13:28,18,3,21
48,2025-05-25T05:30:00+02:00,2025-05-25,13:30,17,5,22
48,2025-05-25T05:31:00+02:00,2025-05-25,13:31,11,4,15
49,2025-05-25T05:28:00+02:00,2025-05-25,13:28,7,25,32
49,2025-05-25T05:31:00+02:00,2025-05-25,13:31,14,12,26
49,2025-05-25T05:36:00+02:00,2025-05-25,13:36,7,10,17
49,2025-05-25T05:39:00+02:00,2025-05-25,13:39,6,8,14
51,2025-05-25T05:30:00+02:00,2025-05-25,13:30,0,2,2
52,2025-05-25T05:28:00+02:00,2025-05-25,13:28,8,4,12
52,2025-05-25T05:30:00+02:00,2025-05-25,13:30,15,7,22
52,2025-05-25T05:31:00+02:00,2025-05-25,13:31,9,8,17
52,2025-05-25T05:34:00+02:00,2025-05-25,13:34,14,1,15
52,2025-05-25T05:35:00+02:00,2025-05-25,13:35,11,8,19
52,2025-05-25T05:38:00+02:00,2025-05-25,13:38,11,4,15
52,2025-05-25T05:39:00+02:00,2025-05-25,13:39,10,7,17
53,2025-05-25T05:27:00+02:00,2025-05-25,13:27,13,3,16
53,2025-05-25T05:29:00+02:00,2025-05-25,13:29,12,13,25
53,2025-05-25T05:35:00+02:00,2025-05-25,13:35,12,4,16
53,2025-05-25T05:38:00+02:00,2025-05-25,13:38,5,6,11
53,2025-05-25T05:39:00+02:00,2025-05-25,13:39,11,6,17
56,2025-05-25T05:27:00+02:00,2025-05-25,13:27,6,3,9
56,2025-05-25T05:29:00+02:00,2025-05-25,13:29,10,8,18
56,2025-05-25T05:35:00+02:00,2025-05-25,13:35,11,10,21
56,2025-05-25T05:36:00+02:00,2025-05-25,13:36,4,6,10
58,2025-05-25T05:25:00+02:00,2025-05-25,13:25,7,11,18
58,2025-05-25T05:26:00+02:00,2025-05-25,13:26,8,1,9
58,2025-05-25T05:30:00+02:00,2025-05-25,13:30,14,6,20
58,2025-05-25T05:32:00+02:00,2025-05-25,13:32,9,5,14
58,2025-05-25T05:35:00+02:00,2025-05-25,13:35,13,5,18
58,2025-05-25T05:39:00+02:00,2025-05-25,13:39,3,6,9
62,2025-05-25T05:28:00+02:00,2025-05-25,13:28,2,0,2
62,2025-05-25T05:29:00+02:00,2025-05-25,13:29,2,3,5
62,2025-05-25T05:30:00+02:00,2025-05-25,13:30,2,3,5
62,2025-05-25T05:38:00+02:00,2025-05-25,13:38,3,0,3
62,2025-05-25T05:39:00+02:00,2025-05-25,13:39,9,2,11
63,2025-05-25T05:25:00+02:00,2025-05-25,13:25,5,16,21
63,2025-05-25T05:27:00+02:00,2025-05-25,13:27,11,17,28
63,2025-05-25T05:28:00+02:00,2025-05-25,13:28,2,14,16
63,2025-05-25T05:31:00+02:00,2025-05-25,13:31,4,3,7
63,2025-05-25T05:33:00+02:00,2025-05-25,13:33,4,11,15
63,2025-05-25T05:34:00+02:00,2025-05-25,13:34,5,6,11
63,2025-05-25T05:35:00+02:00,2025-05-25,13:35,5,3,8
67,2025-05-25T05:26:00+02:00,2025-05-25,13:26,8,13,21
67,2025-05-25T05:28:00+02:00,2025-05-25,13:28,2,13,15
67,2025-05-25T05:29:00+02:00,2025-05-25,13:29,14,12,26
67,2025-05-25T05:32:00+02:00,2025-05-25,13:32,4,6,10
67,2025-05-25T05:34:00+02:00,2025-05-25,13:34,3,8,11
67,2025-05-25T05:35:00+02:00,2025-05-25,13:35,12,12,24
67,2025-05-25T05:36:00+02:00,2025-05-25,13:36,5,7,12
67,2025-05-25T05:38:00+02:00,2025-05-25,13:38,4,5,9
68,2025-05-25T05:27:00+02:00,2025-05-25,13:27,5,8,13
68,2025-05-25T05:29:00+02:00,2025-05-25,13:29,8,0,8
68,2025-05-25T05:31:00+02:00,2025-05-25,13:31,9,2,11
68,2025-05-25T05:33:00+02:00,2025-05-25,13:33,1,11,12
68,2025-05-25T05:37:00+02:00,2025-05-25,13:37,2,7,9
72,2025-05-25T05:25:00+02:00,2025-05-25,13:25,7,12,19
72,2025-05-25T05:27:00+02:00,2025-05-25,13:27,8,4,12
72,2025-05-25T05:29:00+02:00,2025-05-25,13:29,8,2,10
72,2025-05-25T05:32:00+02:00,2025-05-25,13:32,8,12,20
72,2025-05-25T05:33:00+02:00,2025-05-25,13:33,6,3,9
72,2025-05-25T05:34:00+02:00,2025-05-25,13:34,9,12,21
72,2025-05-25T05:35:00+02:00,2025-05-25,13:35,1,8,9
72,2025-05-25T05:36:00+02:00,2025-05-25,13:36,1,9,10
72,2025-05-25T05:37:00+02:00,2025-05-25,13:37,7,5,12
72,2025-05-25T05:38:00+02:00,2025-05-25,13:38,9,4,13
72,2025-05-25T05:39:00+02:00,2025-05-25,13:39,8,8,16
76,2025-05-25T05:27:00+02:00,2025-05-25,13:27,0,1,1
76,2025-05-25T05:28:00+02:00,2025-05-25,13:28,4,0,4
76,2025-05-25T05:31:00+02:00,2025-05-25,13:31,2,2,4
76,2025-05-25T05:36:00+02:00,2025-05-25,13:36,2,3,5
76,2025-05-25T05:38:00+02:00,2025-05-25,13:38,3,0,3
79,2025-05-25T05:26:00+02:00,2025-05-25,13:26,17,1,18
79,2025-05-25T05:27:00+02:00,2025-05-25,13:27,11,3,14
79,2025-05-25T05:32:00+02:00,2025-05-25,13:32,10,7,17
79,2025-05-25T05:33:00+02:00,2025-05-25,13:33,6,6,12
79,2025-05-25T05:38:00+02:00,2025-05-25,13:38,35,7,42
79,2025-05-25T05:39:00+02:00,2025-05-25,13:39,13,9,22
85,2025-05-25T05:25:00+02:00,2025-05-25,13:25,1,4,5
85,2025-05-25T05:30:00+02:00,2025-05-25,13:30,2,4,6
85,2025-05-25T05:37:00+02:00,2025-05-25,13:37,0,2,2
85,2025-05-25T05:38:00+02:00,2025-05-25,13:38,1,2,3
86,2025-05-25T05:28:00+02:00,2025-05-25,13:28,1,0,1
86,2025-05-25T05:34:00+02:00,2025-05-25,13:34,1,1,2
86,2025-05-25T05:38:00+02:00,2025-05-25,13:38,2,1,3
109,2025-05-25T05:30:00+02:00,2025-05-25,13:30,11,9,20
109,2025-05-25T05:35:00+02:00,2025-05-25,13:35,7,7,14
130,2025-05-25T05:30:00+02:00,2025-05-25,13:30,1,8,9
137,2025-05-25T05:35:00+02:00,2025-05-25,13:35,4,0,4
138,2025-05-25T05:30:00+02:00,2025-05-25,13:30,1,0,1
142,2025-05-25T05:30:00+02:00,2025-05-25,13:30,57,64,121
164,2025-05-25T05:30:00+02:00,2025-05-25,13:30,14,9,23
164,2025-05-25T05:35:00+02:00,2025-05-25,13:35,1,18,19
181,2025-05-25T05:40:00+02:00,2025-05-25,13:40,4,32,36
181,2025-05-25T05:46:00+02:00,2025-05-25,13:46,8,17,25
181,2025-05-25T05:50:00+02:00,2025-05-25,13:50,12,28,40
181,2025-05-25T05:51:00+02:00,2025-05-25,13:51,14,21,35
181,2025-05-25T05:53:00+02:00,2025-05-25,13:53,7,28,35
181,2025-05-25T05:54:00+02:00,2025-05-25,13:54,12,17,29
182,2025-05-25T05:40:00+02:00,2025-05-25,13:40,28,24,52
182,2025-05-25T05:45:00+02:00,2025-05-25,13:45,14,17,31
180,2025-05-25T05:43:00+02:00,2025-05-25,13:43,1,0,1
180,2025-05-25T05:45:00+02:00,2025-05-25,13:45,0,1,1
180,2025-05-25T05:53:00+02:00,2025-05-25,13:53,2,0,2
181,2025-05-25T05:27:00+02:00,2025-05-25,13:27,19,26,45
181,2025-05-25T05:33:00+02:00,2025-05-25,13:33,14,27,41
182,2025-05-25T05:25:00+02:00,2025-05-25,13:25,9,8,17
182,2025-05-25T05:35:00+02:00,2025-05-25,13:35,19,20,39
180,2025-05-25T05:28:00+02:00,2025-05-25,13:28,1,0,1
3,2025-05-25T05:44:00+02:00,2025-05-25,13:44,16,19,35
3,2025-05-25T05:46:00+02:00,2025-05-25,13:46,23,15,38
3,2025-05-25T05:48:00+02:00,2025-05-25,13:48,24,21,45
3,2025-05-25T05:53:00+02:00,2025-05-25,13:53,16,21,37
4,2025-05-25T05:41:00+02:00,2025-05-25,13:41,28,45,73
4,2025-05-25T05:49:00+02:00,2025-05-25,13:49,28,35,63
4,2025-05-25T05:54:00+02:00,2025-05-25,13:54,25,5,30
5,2025-05-25T05:40:00+02:00,2025-05-25,13:40,87,92,179
5,2025-05-25T05:45:00+02:00,2025-05-25,13:45,78,72,150
6,2025-05-25T05:46:00+02:00,2025-05-25,13:46,9,15,24
6,2025-05-25T05:48:00+02:00,2025-05-25,13:48,17,6,23
6,2025-05-25T05:51:00+02:00,2025-05-25,13:51,14,14,28
6,2025-05-25T05:52:00+02:00,2025-05-25,13:52,10,10,20
8,2025-05-25T05:40:00+02:00,2025-05-25,13:40,1,2,3
8,2025-05-25T05:46:00+02:00,2025-05-25,13:46,1,5,6
8,2025-05-25T05:47:00+02:00,2025-05-25,13:47,3,14,17
8,2025-05-25T05:49:00+02:00,2025-05-25,13:49,3,3,6
8,2025-05-25T05:51:00+02:00,2025-05-25,13:51,3,0,3
28,2025-05-25T05:49:00+02:00,2025-05-25,13:49,3,4,7
28,2025-05-25T05:52:00+02:00,2025-05-25,13:52,12,8,20
28,2025-05-25T05:53:00+02:00,2025-05-25,13:53,3,4,7
29,2025-05-25T05:41:00+02:00,2025-05-25,13:41,8,12,20
29,2025-05-25T05:47:00+02:00,2025-05-25,13:47,15,6,21
29,2025-05-25T05:48:00+02:00,2025-05-25,13:48,4,4,8
31,2025-05-25T05:40:00+02:00,2025-05-25,13:40,3,0,3
31,2025-05-25T05:45:00+02:00,2025-05-25,13:45,3,2,5
31,2025-05-25T05:46:00+02:00,2025-05-25,13:46,3,2,5
31,2025-05-25T05:48:00+02:00,2025-05-25,13:48,0,4,4
31,2025-05-25T05:49:00+02:00,2025-05-25,13:49,6,21,27
31,2025-05-25T05:51:00+02:00,2025-05-25,13:51,7,2,9
31,2025-05-25T05:52:00+02:00,2025-05-25,13:52,0,7,7
31,2025-05-25T05:53:00+02:00,2025-05-25,13:53,11,11,22
36,2025-05-25T05:44:00+02:00,2025-05-25,13:44,2,0,2
36,2025-05-25T05:45:00+02:00,2025-05-25,13:45,2,1,3
36,2025-05-25T05:46:00+02:00,2025-05-25,13:46,2,8,10
36,2025-05-25T05:51:00+02:00,2025-05-25,13:51,2,0,2
39,2025-05-25T05:40:00+02:00,2025-05-25,13:40,0,1,1
39,2025-05-25T05:48:00+02:00,2025-05-25,13:48,0,2,2
39,2025-05-25T05:52:00+02:00,2025-05-25,13:52,3,1,4
40,2025-05-25T05:44:00+02:00,2025-05-25,13:44,1,3,4
40,2025-05-25T05:46:00+02:00,2025-05-25,13:46,3,0,3
40,2025-05-25T05:47:00+02:00,2025-05-25,13:47,8,0,8
40,2025-05-25T05:48:00+02:00,2025-05-25,13:48,3,2,5
40,2025-05-25T05:49:00+02:00,2025-05-25,13:49,0,5,5
40,2025-05-25T05:51:00+02:00,2025-05-25,13:51,0,4,4
41,2025-05-25T05:42:00+02:00,2025-05-25,13:42,29,6,35
41,2025-05-25T05:45:00+02:00,2025-05-25,13:45,8,15,23
41,2025-05-25T05:47:00+02:00,2025-05-25,13:47,3,6,9
41,2025-05-25T05:49:00+02:00,2025-05-25,13:49,13,7,20
41,2025-05-25T05:51:00+02:00,2025-05-25,13:51,3,3,6
41,2025-05-25T05:53:00+02:00,2025-05-25,13:53,11,6,17
43,2025-05-25T05:40:00+02:00,2025-05-25,13:40,3,2,5
43,2025-05-25T05:50:00+02:00,2025-05-25,13:50,8,0,8
44,2025-05-25T05:45:00+02:00,2025-05-25,13:45,3,2,5
44,2025-05-25T05:50:00+02:00,2025-05-25,13:50,2,1,3
45,2025-05-25T05:40:00+02:00,2025-05-25,13:40,14,17,31
45,2025-05-25T05:43:00+02:00,2025-05-25,13:43,19,20,39
45,2025-05-25T05:45:00+02:00,2025-05-25,13:45,14,20,34
45,2025-05-25T05:47:00+02:00,2025-05-25,13:47,9,15,24
45,2025-05-25T05:49:00+02:00,2025-05-25,13:49,26,9,35
45,2025-05-25T05:52:00+02:00,2025-05-25,13:52,17,16,33
47,2025-05-25T05:41:00+02:00,2025-05-25,13:41,15,31,46
47,2025-05-25T05:49:00+02:00,2025-05-25,13:49,18,27,45
47,2025-05-25T05:50:00+02:00,2025-05-25,13:50,21,30,51
47,2025-05-25T05:54:00+02:00,2025-05-25,13:54,19,10,29
50,2025-05-25T05:40:00+02:00,2025-05-25,13:40,3,5,8
50,2025-05-25T05:42:00+02:00,2025-05-25,13:42,6,3,9
50,2025-05-25T05:45:00+02:00,2025-05-25,13:45,8,3,11
50,2025-05-25T05:46:00+02:00,2025-05-25,13:46,3,9,12
50,2025-05-25T05:47:00+02:00,2025-05-25,13:47,10,10,20
50,2025-05-25T05:53:00+02:00,2025-05-25,13:53,3,7,10
50,2025-05-25T05:54:00+02:00,2025-05-25,13:54,14,4,18
54,2025-05-25T05:41:00+02:00,2025-05-25,13:41,8,0,8
54,2025-05-25T05:42:00+02:00,2025-05-25,13:42,0,3,3
54,2025-05-25T05:45:00+02:00,2025-05-25,13:45,1,4,5
54,2025-05-25T05:48:00+02:00,2025-05-25,13:48,1,0,1
54,2025-05-25T05:49:00+02:00,2025-05-25,13:49,1,0,1
54,2025-05-25T05:51:00+02:00,2025-05-25,13:51,2,0,2
54,2025-05-25T05:54:00+02:00,2025-05-25,13:54,2,5,7
59,2025-05-25T05:40:00+02:00,2025-05-25,13:40,21,33,54
59,2025-05-25T05:50:00+02:00,2025-05-25,13:50,15,40,55
61,2025-05-25T05:42:00+02:00,2025-05-25,13:42,9,16,25
61,2025-05-25T05:43:00+02:00,2025-05-25,13:43,2,17,19
61,2025-05-25T05:47:00+02:00,2025-05-25,13:47,14,6,20
61,2025-05-25T05:49:00+02:00,2025-05-25,13:49,2,7,9
61,2025-05-25T05:50:00+02:00,2025-05-25,13:50,9,12,21
66,2025-05-25T05:40:00+02:00,2025-05-25,13:40,12,27,39
66,2025-05-25T05:42:00+02:00,2025-05-25,13:42,34,18,52
66,2025-05-25T05:43:00+02:00,2025-05-25,13:43,23,37,60
66,2025-05-25T05:44:00+02:00,2025-05-25,13:44,22,22,44
66,2025-05-25T05:48:00+02:00,2025-05-25,13:48,31,31,62
66,2025-05-25T05:53:00+02:00,2025-05-25,13:53,35,8,43
69,2025-05-25T05:40:00+02:00,2025-05-25,13:40,5,10,15
69,2025-05-25T05:42:00+02:00,2025-05-25,13:42,4,3,7
69,2025-05-25T05:45:00+02:00,2025-05-25,13:45,6,5,11
69,2025-05-25T05:49:00+02:00,2025-05-25,13:49,5,10,15
69,2025-05-25T05:50:00+02:00,2025-05-25,13:50,3,5,8
69,2025-05-25T05:51:00+02:00,2025-05-25,13:51,10,5,15
69,2025-05-25T05:53:00+02:00,2025-05-25,13:53,3,6,9
70,2025-05-25T05:45:00+02:00,2025-05-25,13:45,1,3,4
70,2025-05-25T05:46:00+02:00,2025-05-25,13:46,3,5,8
70,2025-05-25T05:48:00+02:00,2025-05-25,13:48,1,1,2
70,2025-05-25T05:50:00+02:00,2025-05-25,13:50,5,1,6
70,2025-05-25T05:51:00+02:00,2025-05-25,13:51,1,0,1
71,2025-05-25T05:52:00+02:00,2025-05-25,13:52,1,0,1
75,2025-05-25T05:42:00+02:00,2025-05-25,13:42,0,2,2
75,2025-05-25T05:45:00+02:00,2025-05-25,13:45,1,0,1
75,2025-05-25T05:48:00+02:00,2025-05-25,13:48,1,2,3
75,2025-05-25T05:53:00+02:00,2025-05-25,13:53,1,0,1
78,2025-05-25T05:42:00+02:00,2025-05-25,13:42,0,3,3
78,2025-05-25T05:47:00+02:00,2025-05-25,13:47,0,5,5
78,2025-05-25T05:48:00+02:00,2025-05-25,13:48,3,1,4
78,2025-05-25T05:50:00+02:00,2025-05-25,13:50,1,1,2
78,2025-05-25T05:51:00+02:00,2025-05-25,13:51,0,1,1
78,2025-05-25T05:52:00+02:00,2025-05-25,13:52,0,1,1
78,2025-05-25T05:54:00+02:00,2025-05-25,13:54,0,3,3
84,2025-05-25T05:40:00+02:00,2025-05-25,13:40,96,101,197
87,2025-05-25T05:42:00+02:00,2025-05-25,13:42,1,3,4
87,2025-05-25T05:46:00+02:00,2025-05-25,13:46,1,1,2
87,2025-05-25T05:50:00+02:00,2025-05-25,13:50,2,1,3
87,2025-05-25T05:53:00+02:00,2025-05-25,13:53,3,3,6
108,2025-05-25T05:43:00+02:00,2025-05-25,13:43,4,2,6
108,2025-05-25T05:44:00+02:00,2025-05-25,13:44,9,1,10
108,2025-05-25T05:53:00+02:00,2025-05-25,13:53,6,5,11
118,2025-05-25T05:40:00+02:00,2025-05-25,13:40,5,5,10
124,2025-05-25T05:50:00+02:00,2025-05-25,13:50,0,1,1
131,2025-05-25T05:45:00+02:00,2025-05-25,13:45,17,7,24
132,2025-05-25T05:40:00+02:00,2025-05-25,13:40,16,9,25
135,2025-05-25T05:40:00+02:00,2025-05-25,13:40,36,49,85
135,2025-05-25T05:50:00+02:00,2025-05-25,13:50,27,27,54
140,2025-05-25T05:50:00+02:00,2025-05-25,13:50,14,3,17
162,2025-05-25T05:40:00+02:00,2025-05-25,13:40,67,76,143
162,2025-05-25T05:45:00+02:00,2025-05-25,13:45,71,108,179
165,2025-05-25T05:40:00+02:00,2025-05-25,13:40,3,4,7
166,2025-05-25T05:45:00+02:00,2025-05-25,13:45,7,7,14
179,2025-05-25T05:50:00+02:00,2025-05-25,13:50,5,6,11
1,2025-05-25T05:42:00+02:00,2025-05-25,13:42,6,26,32
1,2025-05-25T05:43:00+02:00,2025-05-25,13:43,16,27,43
1,2025-05-25T05:46:00+02:00,2025-05-25,13:46,19,33,52
1,2025-05-25T05:48:00+02:00,2025-05-25,13:48,38,16,54
1,2025-05-25T05:50:00+02:00,2025-05-25,13:50,20,17,37
1,2025-05-25T05:52:00+02:00,2025-05-25,13:52,38,20,58
1,2025-05-25T05:53:00+02:00,2025-05-25,13:53,35,11,46
2,2025-05-25T05:47:00+02:00,2025-05-25,13:47,16,8,24
2,2025-05-25T05:48:00+02:00,2025-05-25,13:48,13,11,24
2,2025-05-25T05:51:00+02:00,2025-05-25,13:51,22,3,25
2,2025-05-25T05:53:00+02:00,2025-05-25,13:53,14,5,19
9,2025-05-25T05:40:00+02:00,2025-05-25,13:40,4,0,4
9,2025-05-25T05:41:00+02:00,2025-05-25,13:41,1,0,1
9,2025-05-25T05:42:00+02:00,2025-05-25,13:42,1,1,2
9,2025-05-25T05:44:00+02:00,2025-05-25,13:44,1,0,1
9,2025-05-25T05:46:00+02:00,2025-05-25,13:46,2,0,2
10,2025-05-25T05:42:00+02:00,2025-05-25,13:42,4,2,6
10,2025-05-25T05:45:00+02:00,2025-05-25,13:45,3,0,3
10,2025-05-25T05:46:00+02:00,2025-05-25,13:46,1,0,1
10,2025-05-25T05:52:00+02:00,2025-05-25,13:52,0,4,4
11,2025-05-25T05:48:00+02:00,2025-05-25,13:48,0,2,2
11,2025-05-25T05:50:00+02:00,2025-05-25,13:50,4,4,8
11,2025-05-25T05:52:00+02:00,2025-05-25,13:52,0,3,3
12,2025-05-25T05:41:00+02:00,2025-05-25,13:41,1,10,11
12,2025-05-25T05:43:00+02:00,2025-05-25,13:43,3,1,4
12,2025-05-25T05:44:00+02:00,2025-05-25,13:44,6,10,16
12,2025-05-25T05:45:00+02:00,2025-05-25,13:45,5,11,16
12,2025-05-25T05:51:00+02:00,2025-05-25,13:51,6,4,10
12,2025-05-25T05:52:00+02:00,2025-05-25,13:52,3,3,6
17,2025-05-25T05:49:00+02:00,2025-05-25,13:49,5,1,6
17,2025-05-25T05:53:00+02:00,2025-05-25,13:53,2,3,5
18,2025-05-25T05:43:00+02:00,2025-05-25,13:43,1,3,4
18,2025-05-25T05:45:00+02:00,2025-05-25,13:45,0,1,1
18,2025-05-25T05:46:00+02:00,2025-05-25,13:46,0,4,4
18,2025-05-25T05:48:00+02:00,2025-05-25,13:48,1,1,2
18,2025-05-25T05:51:00+02:00,2025-05-25,13:51,2,0,2
19,2025-05-25T05:40:00+02:00,2025-05-25,13:40,7,9,16
19,2025-05-25T05:43:00+02:00,2025-05-25,13:43,8,17,25
19,2025-05-25T05:44:00+02:00,2025-05-25,13:44,14,12,26
19,2025-05-25T05:47:00+02:00,2025-05-25,13:47,12,9,21
19,2025-05-25T05:53:00+02:00,2025-05-25,13:53,14,13,27
19,2025-05-25T05:54:00+02:00,2025-05-25,13:54,10,11,21
20,2025-05-25T05:41:00+02:00,2025-05-25,13:41,2,3,5
20,2025-05-25T05:44:00+02:00,2025-05-25,13:44,11,14,25
20,2025-05-25T05:45:00+02:00,2025-05-25,13:45,8,8,16
20,2025-05-25T05:48:00+02:00,2025-05-25,13:48,3,2,5
20,2025-05-25T05:49:00+02:00,2025-05-25,13:49,1,0,1
23,2025-05-25T05:45:00+02:00,2025-05-25,13:45,5,1,6
23,2025-05-25T05:47:00+02:00,2025-05-25,13:47,0,7,7
23,2025-05-25T05:49:00+02:00,2025-05-25,13:49,3,3,6
23,2025-05-25T05:50:00+02:00,2025-05-25,13:50,3,9,12
23,2025-05-25T05:53:00+02:00,2025-05-25,13:53,0,6,6
24,2025-05-25T05:43:00+02:00,2025-05-25,13:43,22,8,30
24,2025-05-25T05:48:00+02:00,2025-05-25,13:48,20,13,33
24,2025-05-25T05:49:00+02:00,2025-05-25,13:49,13,6,19
24,2025-05-25T05:50:00+02:00,2025-05-25,13:50,17,2,19
25,2025-05-25T05:50:00+02:00,2025-05-25,13:50,58,47,105
27,2025-05-25T05:48:00+02:00,2025-05-25,13:48,9,9,18
27,2025-05-25T05:49:00+02:00,2025-05-25,13:49,4,11,15
27,2025-05-25T05:52:00+02:00,2025-05-25,13:52,6,7,13
27,2025-05-25T05:54:00+02:00,2025-05-25,13:54,10,5,15
30,2025-05-25T05:44:00+02:00,2025-05-25,13:44,0,21,21
30,2025-05-25T05:45:00+02:00,2025-05-25,13:45,6,16,22
30,2025-05-25T05:46:00+02:00,2025-05-25,13:46,4,3,7
30,2025-05-25T05:49:00+02:00,2025-05-25,13:49,4,9,13
30,2025-05-25T05:51:00+02:00,2025-05-25,13:51,1,11,12
35,2025-05-25T05:43:00+02:00,2025-05-25,13:43,14,13,27
35,2025-05-25T05:45:00+02:00,2025-05-25,13:45,10,21,31
35,2025-05-25T05:54:00+02:00,2025-05-25,13:54,14,25,39
46,2025-05-25T05:45:00+02:00,2025-05-25,13:45,6,5,11
48,2025-05-25T05:40:00+02:00,2025-05-25,13:40,8,2,10
48,2025-05-25T05:41:00+02:00,2025-05-25,13:41,15,11,26
48,2025-05-25T05:42:00+02:00,2025-05-25,13:42,18,7,25
48,2025-05-25T05:44:00+02:00,2025-05-25,13:44,10,5,15
48,2025-05-25T05:49:00+02:00,2025-05-25,13:49,5,2,7
48,2025-05-25T05:53:00+02:00,2025-05-25,13:53,7,1,8
48,2025-05-25T05:54:00+02:00,2025-05-25,13:54,15,7,22
49,2025-05-25T05:40:00+02:00,2025-05-25,13:40,15,13,28
49,2025-05-25T05:43:00+02:00,2025-05-25,13:43,2,9,11
49,2025-05-25T05:45:00+02:00,2025-05-25,13:45,5,11,16
49,2025-05-25T05:46:00+02:00,2025-05-25,13:46,15,12,27
49,2025-05-25T05:52:00+02:00,2025-05-25,13:52,5,13,18
51,2025-05-25T05:40:00+02:00,2025-05-25,13:40,0,3,3
51,2025-05-25T05:44:00+02:00,2025-05-25,13:44,4,2,6
51,2025-05-25T05:47:00+02:00,2025-05-25,13:47,2,6,8
51,2025-05-25T05:48:00+02:00,2025-05-25,13:48,4,3,7
51,2025-05-25T05:49:00+02:00,2025-05-25,13:49,5,5,10
52,2025-05-25T05:44:00+02:00,2025-05-25,13:44,5,1,6
52,2025-05-25T05:46:00+02:00,2025-05-25,13:46,16,8,24
52,2025-05-25T05:51:00+02:00,2025-05-25,13:51,3,5,8
52,2025-05-25T05:53:00+02:00,2025-05-25,13:53,3,13,16
53,2025-05-25T05:40:00+02:00,2025-05-25,13:40,16,7,23
53,2025-05-25T05:44:00+02:00,2025-05-25,13:44,11,10,21
53,2025-05-25T05:45:00+02:00,2025-05-25,13:45,10,17,27
53,2025-05-25T05:50:00+02:00,2025-05-25,13:50,7,3,10
53,2025-05-25T05:52:00+02:00,2025-05-25,13:52,18,8,26
56,2025-05-25T05:41:00+02:00,2025-05-25,13:41,11,7,18
56,2025-05-25T05:42:00+02:00,2025-05-25,13:42,5,3,8
56,2025-05-25T05:43:00+02:00,2025-05-25,13:43,8,12,20
56,2025-05-25T05:44:00+02:00,2025-05-25,13:44,8,15,23
56,2025-05-25T05:48:00+02:00,2025-05-25,13:48,20,7,27
56,2025-05-25T05:53:00+02:00,2025-05-25,13:53,10,15,25
58,2025-05-25T05:46:00+02:00,2025-05-25,13:46,10,3,13
58,2025-05-25T05:47:00+02:00,2025-05-25,13:47,3,3,6
58,2025-05-25T05:48:00+02:00,2025-05-25,13:48,12,8,20
58,2025-05-25T05:52:00+02:00,2025-05-25,13:52,10,5,15
58,2025-05-25T05:53:00+02:00,2025-05-25,13:53,4,10,14
62,2025-05-25T05:40:00+02:00,2025-05-25,13:40,1,4,5
62,2025-05-25T05:42:00+02:00,2025-05-25,13:42,2,1,3
62,2025-05-25T05:43:00+02:00,2025-05-25,13:43,2,6,8
62,2025-05-25T05:46:00+02:00,2025-05-25,13:46,2,0,2
62,2025-05-25T05:48:00+02:00,2025-05-25,13:48,0,2,2
62,2025-05-25T05:49:00+02:00,2025-05-25,13:49,1,0,1
62,2025-05-25T05:53:00+02:00,2025-05-25,13:53,4,5,9
62,2025-05-25T05:54:00+02:00,2025-05-25,13:54,1,8,9
63,2025-05-25T05:42:00+02:00,2025-05-25,13:42,13,7,20
63,2025-05-25T05:43:00+02:00,2025-05-25,13:43,6,11,17
63,2025-05-25T05:49:00+02:00,2025-05-25,13:49,3,6,9
63,2025-05-25T05:53:00+02:00,2025-05-25,13:53,12,3,15
67,2025-05-25T05:42:00+02:00,2025-05-25,13:42,11,6,17
67,2025-05-25T05:46:00+02:00,2025-05-25,13:46,7,8,15
67,2025-05-25T05:48:00+02:00,2025-05-25,13:48,8,12,20
67,2025-05-25T05:49:00+02:00,2025-05-25,13:49,6,11,17
67,2025-05-25T05:51:00+02:00,2025-05-25,13:51,7,16,23
67,2025-05-25T05:52:00+02:00,2025-05-25,13:52,9,8,17
68,2025-05-25T05:42:00+02:00,2025-05-25,13:42,6,1,7
68,2025-05-25T05:48:00+02:00,2025-05-25,13:48,10,8,18
68,2025-05-25T05:51:00+02:00,2025-05-25,13:51,11,7,18
68,2025-05-25T05:54:00+02:00,2025-05-25,13:54,5,6,11
72,2025-05-25T05:41:00+02:00,2025-05-25,13:41,5,0,5
72,2025-05-25T05:48:00+02:00,2025-05-25,13:48,5,4,9
72,2025-05-25T05:52:00+02:00,2025-05-25,13:52,3,4,7
72,2025-05-25T05:53:00+02:00,2025-05-25,13:53,1,12,13
72,2025-05-25T05:54:00+02:00,2025-05-25,13:54,2,8,10
76,2025-05-25T05:43:00+02:00,2025-05-25,13:43,2,0,2
76,2025-05-25T05:46:00+02:00,2025-05-25,13:46,1,2,3
76,2025-05-25T05:47:00+02:00,2025-05-25,13:47,1,0,1
76,2025-05-25T05:53:00+02:00,2025-05-25,13:53,3,1,4
79,2025-05-25T05:44:00+02:00,2025-05-25,13:44,12,10,22
79,2025-05-25T05:46:00+02:00,2025-05-25,13:46,14,8,22
79,2025-05-25T05:51:00+02:00,2025-05-25,13:51,16,12,28
79,2025-05-25T05:52:00+02:00,2025-05-25,13:52,5,3,8
79,2025-05-25T05:53:00+02:00,2025-05-25,13:53,5,3,8
85,2025-05-25T05:40:00+02:00,2025-05-25,13:40,0,1,1
85,2025-05-25T05:48:00+02:00,2025-05-25,13:48,0,2,2
85,2025-05-25T05:49:00+02:00,2025-05-25,13:49,1,1,2
86,2025-05-25T05:42:00+02:00,2025-05-25,13:42,1,1,2
86,2025-05-25T05:43:00+02:00,2025-05-25,13:43,0,5,5
86,2025-05-25T05:44:00+02:00,2025-05-25,13:44,2,2,4
86,2025-05-25T05:45:00+02:00,2025-05-25,13:45,1,1,2
86,2025-05-25T05:49:00+02:00,2025-05-25,13:49,1,0,1
86,2025-05-25T05:52:00+02:00,2025-05-25,13:52,0,1,1
86,2025-05-25T05:54:00+02:00,2025-05-25,13:54,0,6,6
130,2025-05-25T05:45:00+02:00,2025-05-25,13:45,5,4,9
130,2025-05-25T05:50:00+02:00,2025-05-25,13:50,13,2,15
137,2025-05-25T05:45:00+02:00,2025-05-25,13:45,2,2,4
139,2025-05-25T05:45:00+02:00,2025-05-25,13:45,0,3,3
141,2025-05-25T05:40:00+02:00,2025-05-25,13:40,18,14,32
141,2025-05-25T05:45:00+02:00,2025-05-25,13:45,10,19,29
141,2025-05-25T05:50:00+02:00,2025-05-25,13:50,18,17,35
142,2025-05-25T05:45:00+02:00,2025-05-25,13:45,44,47,91
142,2025-05-25T05:50:00+02:00,2025-05-25,13:50,55,44,99
161,2025-05-25T05:40:00+02:00,2025-05-25,13:40,45,13,58
161,2025-05-25T05:45:00+02:00,2025-05-25,13:45,59,8,67
164,2025-05-25T05:50:00+02:00,2025-05-25,13:50,7,7,14
3,2025-05-25T06:14:00+02:00,2025-05-25,14:14,11,11,22
3,2025-05-25T06:16:00+02:00,2025-05-25,14:16,29,16,45
3,2025-05-25T06:17:00+02:00,2025-05-25,14:17,3,25,28
3,2025-05-25T06:18:00+02:00,2025-05-25,14:18,24,12,36
3,2025-05-25T06:19:00+02:00,2025-05-25,14:19,23,27,50
4,2025-05-25T06:11:00+02:00,2025-05-25,14:11,20,41,61
4,2025-05-25T06:12:00+02:00,2025-05-25,14:12,31,19,50
4,2025-05-25T06:17:00+02:00,2025-05-25,14:17,39,32,71
4,2025-05-25T06:18:00+02:00,2025-05-25,14:18,27,29,56
4,2025-05-25T06:21:00+02:00,2025-05-25,14:21,16,30,46
4,2025-05-25T06:22:00+02:00,2025-05-25,14:22,40,30,70
5,2025-05-25T06:10:00+02:00,2025-05-25,14:10,84,128,212
5,2025-05-25T06:15:00+02:00,2025-05-25,14:15,99,83,182
6,2025-05-25T06:12:00+02:00,2025-05-25,14:12,15,14,29
6,2025-05-25T06:15:00+02:00,2025-05-25,14:15,14,17,31
6,2025-05-25T06:17:00+02:00,2025-05-25,14:17,12,29,41
6,2025-05-25T06:20:00+02:00,2025-05-25,14:20,15,13,28
6,2025-05-25T06:24:00+02:00,2025-05-25,14:24,20,16,36
8,2025-05-25T06:10:00+02:00,2025-05-25,14:10,2,2,4
8,2025-05-25T06:12:00+02:00,2025-05-25,14:12,3,9,12
8,2025-05-25T06:15:00+02:00,2025-05-25,14:15,1,12,13
8,2025-05-25T06:20:00+02:00,2025-05-25,14:20,3,5,8
8,2025-05-25T06:23:00+02:00,2025-05-25,14:23,4,1,5
28,2025-05-25T06:10:00+02:00,2025-05-25,14:10,8,12,20
28,2025-05-25T06:20:00+02:00,2025-05-25,14:20,16,6,22
28,2025-05-25T06:24:00+02:00,2025-05-25,14:24,4,4,8
29,2025-05-25T06:10:00+02:00,2025-05-25,14:10,14,10,24
29,2025-05-25T06:11:00+02:00,2025-05-25,14:11,14,11,25
29,2025-05-25T06:12:00+02:00,2025-05-25,14:12,5,4,9
29,2025-05-25T06:15:00+02:00,2025-05-25,14:15,17,12,29
29,2025-05-25T06:17:00+02:00,2025-05-25,14:17,11,20,31
29,2025-05-25T06:18:00+02:00,2025-05-25,14:18,15,15,30
29,2025-05-25T06:24:00+02:00,2025-05-25,14:24,9,5,14
31,2025-05-25T06:11:00+02:00,2025-05-25,14:11,3,4,7
31,2025-05-25T06:13:00+02:00,2025-05-25,14:13,3,11,14
31,2025-05-25T06:14:00+02:00,2025-05-25,14:14,6,5,11
31,2025-05-25T06:22:00+02:00,2025-05-25,14:22,3,4,7
31,2025-05-25T06:24:00+02:00,2025-05-25,14:24,6,6,12
36,2025-05-25T06:11:00+02:00,2025-05-25,14:11,0,4,4
36,2025-05-25T06:14:00+02:00,2025-05-25,14:14,1,1,2
36,2025-05-25T06:15:00+02:00,2025-05-25,14:15,1,1,2
36,2025-05-25T06:21:00+02:00,2025-05-25,14:21,9,2,11
36,2025-05-25T06:22:00+02:00,2025-05-25,14:22,6,0,6
36,2025-05-25T06:23:00+02:00,2025-05-25,14:23,5,0,5
40,2025-05-25T06:10:00+02:00,2025-05-25,14:10,1,2,3
40,2025-05-25T06:11:00+02:00,2025-05-25,14:11,0,2,2
40,2025-05-25T06:15:00+02:00,2025-05-25,14:15,2,1,3
40,2025-05-25T06:18:00+02:00,2025-05-25,14:18,4,1,5
41,2025-05-25T06:12:00+02:00,2025-05-25,14:12,1,6,7
41,2025-05-25T06:18:00+02:00,2025-05-25,14:18,6,2,8
41,2025-05-25T06:19:00+02:00,2025-05-25,14:19,6,4,10
41,2025-05-25T06:20:00+02:00,2025-05-25,14:20,2,9,11
43,2025-05-25T06:10:00+02:00,2025-05-25,14:10,4,5,9
43,2025-05-25T06:15:00+02:00,2025-05-25,14:15,7,2,9
45,2025-05-25T06:10:00+02:00,2025-05-25,14:10,18,25,43
45,2025-05-25T06:11:00+02:00,2025-05-25,14:11,27,15,42
45,2025-05-25T06:14:00+02:00,2025-05-25,14:14,21,21,42
45,2025-05-25T06:16:00+02:00,2025-05-25,14:16,27,15,42
45,2025-05-25T06:17:00+02:00,2025-05-25,14:17,17,22,39
45,2025-05-25T06:18:00+02:00,2025-05-25,14:18,25,18,43
45,2025-05-25T06:23:00+02:00,2025-05-25,14:23,17,26,43
47,2025-05-25T06:10:00+02:00,2025-05-25,14:10,15,31,46
47,2025-05-25T06:12:00+02:00,2025-05-25,14:12,11,34,45
47,2025-05-25T06:13:00+02:00,2025-05-25,14:13,16,23,39
47,2025-05-25T06:15:00+02:00,2025-05-25,14:15,23,29,52
47,2025-05-25T06:16:00+02:00,2025-05-25,14:16,13,35,48
47,2025-05-25T06:20:00+02:00,2025-05-25,14:20,27,11,38
47,2025-05-25T06:23:00+02:00,2025-05-25,14:23,19,18,37
50,2025-05-25T06:10:00+02:00,2025-05-25,14:10,3,1,4
50,2025-05-25T06:16:00+02:00,2025-05-25,14:16,0,3,3
50,2025-05-25T06:17:00+02:00,2025-05-25,14:17,4,10,14
50,2025-05-25T06:18:00+02:00,2025-05-25,14:18,4,3,7
50,2025-05-25T06:20:00+02:00,2025-05-25,14:20,2,4,6
50,2025-05-25T06:21:00+02:00,2025-05-25,14:21,1,5,6
54,2025-05-25T06:10:00+02:00,2025-05-25,14:10,5,2,7
54,2025-05-25T06:18:00+02:00,2025-05-25,14:18,2,0,2
54,2025-05-25T06:19:00+02:00,2025-05-25,14:19,2,3,5
61,2025-05-25T06:16:00+02:00,2025-05-25,14:16,8,1,9
61,2025-05-25T06:17:00+02:00,2025-05-25,14:17,3,7,10
61,2025-05-25T06:20:00+02:00,2025-05-25,14:20,4,6,10
61,2025-05-25T06:21:00+02:00,2025-05-25,14:21,9,11,20
61,2025-05-25T06:22:00+02:00,2025-05-25,14:22,16,4,20
61,2025-05-25T06:24:00+02:00,2025-05-25,14:24,8,2,10
66,2025-05-25T06:10:00+02:00,2025-05-25,14:10,21,22,43
66,2025-05-25T06:16:00+02:00,2025-05-25,14:16,33,12,45
66,2025-05-25T06:18:00+02:00,2025-05-25,14:18,29,43,72
69,2025-05-25T06:10:00+02:00,2025-05-25,14:10,1,12,13
69,2025-05-25T06:11:00+02:00,2025-05-25,14:11,3,4,7
69,2025-05-25T06:16:00+02:00,2025-05-25,14:16,9,3,12
69,2025-05-25T06:20:00+02:00,2025-05-25,14:20,12,4,16
69,2025-05-25T06:23:00+02:00,2025-05-25,14:23,7,3,10
70,2025-05-25T06:12:00+02:00,2025-05-25,14:12,6,4,10
70,2025-05-25T06:17:00+02:00,2025-05-25,14:17,3,0,3
71,2025-05-25T06:23:00+02:00,2025-05-25,14:23,1,0,1
75,2025-05-25T06:12:00+02:00,2025-05-25,14:12,1,0,1
75,2025-05-25T06:15:00+02:00,2025-05-25,14:15,1,6,7
75,2025-05-25T06:17:00+02:00,2025-05-25,14:17,0,4,4
75,2025-05-25T06:21:00+02:00,2025-05-25,14:21,0,2,2
75,2025-05-25T06:22:00+02:00,2025-05-25,14:22,2,5,7
77,2025-05-25T06:10:00+02:00,2025-05-25,14:10,27,20,47
78,2025-05-25T06:15:00+02:00,2025-05-25,14:15,0,1,1
78,2025-05-25T06:20:00+02:00,2025-05-25,14:20,0,1,1
87,2025-05-25T06:11:00+02:00,2025-05-25,14:11,3,1,4
87,2025-05-25T06:14:00+02:00,2025-05-25,14:14,1,0,1
87,2025-05-25T06:16:00+02:00,2025-05-25,14:16,0,2,2
87,2025-05-25T06:22:00+02:00,2025-05-25,14:22,0,4,4
87,2025-05-25T06:23:00+02:00,2025-05-25,14:23,0,1,1
87,2025-05-25T06:24:00+02:00,2025-05-25,14:24,1,2,3
108,2025-05-25T06:10:00+02:00,2025-05-25,14:10,0,1,1
108,2025-05-25T06:12:00+02:00,2025-05-25,14:12,4,5,9
108,2025-05-25T06:13:00+02:00,2025-05-25,14:13,2,7,9
108,2025-05-25T06:14:00+02:00,2025-05-25,14:14,1,4,5
108,2025-05-25T06:21:00+02:00,2025-05-25,14:21,4,6,10
108,2025-05-25T06:23:00+02:00,2025-05-25,14:23,3,1,4
108,2025-05-25T06:24:00+02:00,2025-05-25,14:24,7,3,10
118,2025-05-25T06:15:00+02:00,2025-05-25,14:15,1,10,11
124,2025-05-25T06:10:00+02:00,2025-05-25,14:10,0,2,2
133,2025-05-25T06:10:00+02:00,2025-05-25,14:10,39,26,65
133,2025-05-25T06:20:00+02:00,2025-05-25,14:20,43,33,76
134,2025-05-25T06:10:00+02:00,2025-05-25,14:10,36,38,74
135,2025-05-25T06:10:00+02:00,2025-05-25,14:10,23,32,55
135,2025-05-25T06:15:00+02:00,2025-05-25,14:15,43,28,71
162,2025-05-25T06:15:00+02:00,2025-05-25,14:15,68,69,137
162,2025-05-25T06:20:00+02:00,2025-05-25,14:20,62,67,129
165,2025-05-25T06:10:00+02:00,2025-05-25,14:10,6,7,13
166,2025-05-25T06:15:00+02:00,2025-05-25,14:15,9,2,11
166,2025-05-25T06:20:00+02:00,2025-05-25,14:20,3,8,11
167,2025-05-25T06:20:00+02:00,2025-05-25,14:20,1,1,2
1,2025-05-25T06:11:00+02:00,2025-05-25,14:11,28,32,60
1,2025-05-25T06:15:00+02:00,2025-05-25,14:15,30,15,45
1,2025-05-25T06:17:00+02:00,2025-05-25,14:17,22,25,47
1,2025-05-25T06:19:00+02:00,2025-05-25,14:19,20,30,50
1,2025-05-25T06:24:00+02:00,2025-05-25,14:24,22,26,48
2,2025-05-25T06:10:00+02:00,2025-05-25,14:10,8,18,26
2,2025-05-25T06:11:00+02:00,2025-05-25,14:11,9,14,23
2,2025-05-25T06:14:00+02:00,2025-05-25,14:14,25,4,29
2,2025-05-25T06:17:00+02:00,2025-05-25,14:17,12,7,19
2,2025-05-25T06:20:00+02:00,2025-05-25,14:20,13,10,23
2,2025-05-25T06:23:00+02:00,2025-05-25,14:23,15,11,26
2,2025-05-25T06:24:00+02:00,2025-05-25,14:24,21,5,26
9,2025-05-25T06:14:00+02:00,2025-05-25,14:14,0,1,1
9,2025-05-25T06:16:00+02:00,2025-05-25,14:16,2,0,2
9,2025-05-25T06:20:00+02:00,2025-05-25,14:20,1,0,1
9,2025-05-25T06:21:00+02:00,2025-05-25,14:21,1,1,2
9,2025-05-25T06:23:00+02:00,2025-05-25,14:23,0,4,4
9,2025-05-25T06:24:00+02:00,2025-05-25,14:24,5,0,5
10,2025-05-25T06:13:00+02:00,2025-05-25,14:13,2,0,2
10,2025-05-25T06:18:00+02:00,2025-05-25,14:18,0,2,2
10,2025-05-25T06:21:00+02:00,2025-05-25,14:21,1,1,2
10,2025-05-25T06:22:00+02:00,2025-05-25,14:22,3,3,6
11,2025-05-25T06:20:00+02:00,2025-05-25,14:20,5,12,17
11,2025-05-25T06:21:00+02:00,2025-05-25,14:21,2,1,3
11,2025-05-25T06:24:00+02:00,2025-05-25,14:24,1,0,1
12,2025-05-25T06:19:00+02:00,2025-05-25,14:19,2,0,2
12,2025-05-25T06:20:00+02:00,2025-05-25,14:20,2,6,8
12,2025-05-25T06:21:00+02:00,2025-05-25,14:21,0,1,1
12,2025-05-25T06:24:00+02:00,2025-05-25,14:24,1,1,2
17,2025-05-25T06:11:00+02:00,2025-05-25,14:11,0,2,2
17,2025-05-25T06:13:00+02:00,2025-05-25,14:13,1,9,10
17,2025-05-25T06:14:00+02:00,2025-05-25,14:14,3,3,6
17,2025-05-25T06:17:00+02:00,2025-05-25,14:17,1,0,1
17,2025-05-25T06:18:00+02:00,2025-05-25,14:18,2,1,3
17,2025-05-25T06:19:00+02:00,2025-05-25,14:19,0,1,1
17,2025-05-25T06:20:00+02:00,2025-05-25,14:20,5,2,7
17,2025-05-25T06:22:00+02:00,2025-05-25,14:22,3,3,6
18,2025-05-25T06:10:00+02:00,2025-05-25,14:10,0,2,2
18,2025-05-25T06:14:00+02:00,2025-05-25,14:14,2,0,2
18,2025-05-25T06:16:00+02:00,2025-05-25,14:16,1,0,1
18,2025-05-25T06:22:00+02:00,2025-05-25,14:22,1,5,6
19,2025-05-25T06:10:00+02:00,2025-05-25,14:10,17,12,29
19,2025-05-25T06:15:00+02:00,2025-05-25,14:15,13,4,17
19,2025-05-25T06:16:00+02:00,2025-05-25,14:16,17,13,30
19,2025-05-25T06:18:00+02:00,2025-05-25,14:18,10,7,17
19,2025-05-25T06:22:00+02:00,2025-05-25,14:22,10,15,25
20,2025-05-25T06:10:00+02:00,2025-05-25,14:10,1,1,2
20,2025-05-25T06:14:00+02:00,2025-05-25,14:14,2,5,7
20,2025-05-25T06:15:00+02:00,2025-05-25,14:15,5,7,12
20,2025-05-25T06:16:00+02:00,2025-05-25,14:16,10,11,21
20,2025-05-25T06:17:00+02:00,2025-05-25,14:17,3,9,12
20,2025-05-25T06:18:00+02:00,2025-05-25,14:18,2,8,10
20,2025-05-25T06:20:00+02:00,2025-05-25,14:20,4,7,11
20,2025-05-25T06:22:00+02:00,2025-05-25,14:22,4,8,12
20,2025-05-25T06:23:00+02:00,2025-05-25,14:23,9,3,12
23,2025-05-25T06:10:00+02:00,2025-05-25,14:10,0,2,2
23,2025-05-25T06:11:00+02:00,2025-05-25,14:11,1,3,4
23,2025-05-25T06:18:00+02:00,2025-05-25,14:18,0,3,3
23,2025-05-25T06:21:00+02:00,2025-05-25,14:21,2,2,4
23,2025-05-25T06:22:00+02:00,2025-05-25,14:22,0,1,1
23,2025-05-25T06:23:00+02:00,2025-05-25,14:23,1,8,9
23,2025-05-25T06:24:00+02:00,2025-05-25,14:24,1,1,2
24,2025-05-25T06:10:00+02:00,2025-05-25,14:10,6,11,17
24,2025-05-25T06:14:00+02:00,2025-05-25,14:14,1,10,11
24,2025-05-25T06:16:00+02:00,2025-05-25,14:16,10,8,18
24,2025-05-25T06:18:00+02:00,2025-05-25,14:18,6,13,19
24,2025-05-25T06:22:00+02:00,2025-05-25,14:22,9,8,17
27,2025-05-25T06:12:00+02:00,2025-05-25,14:12,9,1,10
27,2025-05-25T06:20:00+02:00,2025-05-25,14:20,2,4,6
27,2025-05-25T06:21:00+02:00,2025-05-25,14:21,2,1,3
27,2025-05-25T06:23:00+02:00,2025-05-25,14:23,6,1,7
30,2025-05-25T06:16:00+02:00,2025-05-25,14:16,3,6,9
30,2025-05-25T06:17:00+02:00,2025-05-25,14:17,5,12,17
30,2025-05-25T06:21:00+02:00,2025-05-25,14:21,6,3,9
30,2025-05-25T06:24:00+02:00,2025-05-25,14:24,6,4,10
35,2025-05-25T06:13:00+02:00,2025-05-25,14:13,26,23,49
35,2025-05-25T06:14:00+02:00,2025-05-25,14:14,25,31,56
35,2025-05-25T06:16:00+02:00,2025-05-25,14:16,18,21,39
35,2025-05-25T06:17:00+02:00,2025-05-25,14:17,20,16,36
35,2025-05-25T06:18:00+02:00,2025-05-25,14:18,27,28,55
35,2025-05-25T06:20:00+02:00,2025-05-25,14:20,20,40,60
46,2025-05-25T06:20:00+02:00,2025-05-25,14:20,8,4,12
48,2025-05-25T06:12:00+02:00,2025-05-25,14:12,3,7,10
48,2025-05-25T06:14:00+02:00,2025-05-25,14:14,13,8,21
48,2025-05-25T06:17:00+02:00,2025-05-25,14:17,9,8,17
48,2025-05-25T06:19:00+02:00,2025-05-25,14:19,14,14,28
48,2025-05-25T06:22:00+02:00,2025-05-25,14:22,15,9,24
49,2025-05-25T06:10:00+02:00,2025-05-25,14:10,3,1,4
49,2025-05-25T06:11:00+02:00,2025-05-25,14:11,11,8,19
49,2025-05-25T06:15:00+02:00,2025-05-25,14:15,8,10,18
49,2025-05-25T06:19:00+02:00,2025-05-25,14:19,18,13,31
49,2025-05-25T06:23:00+02:00,2025-05-25,14:23,6,9,15
51,2025-05-25T06:12:00+02:00,2025-05-25,14:12,0,1,1
51,2025-05-25T06:13:00+02:00,2025-05-25,14:13,3,1,4
51,2025-05-25T06:16:00+02:00,2025-05-25,14:16,2,2,4
52,2025-05-25T06:10:00+02:00,2025-05-25,14:10,9,12,21
52,2025-05-25T06:11:00+02:00,2025-05-25,14:11,12,3,15
52,2025-05-25T06:16:00+02:00,2025-05-25,14:16,3,6,9
52,2025-05-25T06:19:00+02:00,2025-05-25,14:19,14,5,19
52,2025-05-25T06:20:00+02:00,2025-05-25,14:20,21,7,28
53,2025-05-25T06:16:00+02:00,2025-05-25,14:16,12,8,20
53,2025-05-25T06:17:00+02:00,2025-05-25,14:17,10,7,17
53,2025-05-25T06:19:00+02:00,2025-05-25,14:19,21,10,31
53,2025-05-25T06:22:00+02:00,2025-05-25,14:22,10,8,18
53,2025-05-25T06:23:00+02:00,2025-05-25,14:23,6,11,17
56,2025-05-25T06:18:00+02:00,2025-05-25,14:18,12,7,19
56,2025-05-25T06:23:00+02:00,2025-05-25,14:23,11,5,16
56,2025-05-25T06:24:00+02:00,2025-05-25,14:24,5,5,10
58,2025-05-25T06:13:00+02:00,2025-05-25,14:13,10,4,14
58,2025-05-25T06:14:00+02:00,2025-05-25,14:14,7,4,11
58,2025-05-25T06:15:00+02:00,2025-05-25,14:15,24,3,27
58,2025-05-25T06:18:00+02:00,2025-05-25,14:18,17,7,24
58,2025-05-25T06:22:00+02:00,2025-05-25,14:22,5,3,8
58,2025-05-25T06:24:00+02:00,2025-05-25,14:24,1,10,11
62,2025-05-25T06:11:00+02:00,2025-05-25,14:11,2,4,6
62,2025-05-25T06:13:00+02:00,2025-05-25,14:13,10,2,12
62,2025-05-25T06:17:00+02:00,2025-05-25,14:17,12,3,15
62,2025-05-25T06:19:00+02:00,2025-05-25,14:19,16,1,17
62,2025-05-25T06:20:00+02:00,2025-05-25,14:20,13,5,18
62,2025-05-25T06:22:00+02:00,2025-05-25,14:22,6,4,10
62,2025-05-25T06:23:00+02:00,2025-05-25,14:23,5,2,7
63,2025-05-25T06:13:00+02:00,2025-05-25,14:13,2,2,4
63,2025-05-25T06:16:00+02:00,2025-05-25,14:16,9,15,24
63,2025-05-25T06:18:00+02:00,2025-05-25,14:18,14,3,17
63,2025-05-25T06:19:00+02:00,2025-05-25,14:19,13,6,19
67,2025-05-25T06:10:00+02:00,2025-05-25,14:10,4,13,17
67,2025-05-25T06:11:00+02:00,2025-05-25,14:11,11,6,17
67,2025-05-25T06:13:00+02:00,2025-05-25,14:13,4,9,13
67,2025-05-25T06:17:00+02:00,2025-05-25,14:17,8,9,17
67,2025-05-25T06:22:00+02:00,2025-05-25,14:22,1,5,6
68,2025-05-25T06:12:00+02:00,2025-05-25,14:12,5,4,9
68,2025-05-25T06:15:00+02:00,2025-05-25,14:15,5,6,11
72,2025-05-25T06:11:00+02:00,2025-05-25,14:11,8,14,22
72,2025-05-25T06:13:00+02:00,2025-05-25,14:13,13,2,15
72,2025-05-25T06:19:00+02:00,2025-05-25,14:19,3,15,18
72,2025-05-25T06:20:00+02:00,2025-05-25,14:20,3,11,14
72,2025-05-25T06:24:00+02:00,2025-05-25,14:24,5,13,18
76,2025-05-25T06:12:00+02:00,2025-05-25,14:12,0,1,1
76,2025-05-25T06:14:00+02:00,2025-05-25,14:14,2,0,2
76,2025-05-25T06:16:00+02:00,2025-05-25,14:16,4,3,7
79,2025-05-25T06:12:00+02:00,2025-05-25,14:12,18,14,32
79,2025-05-25T06:18:00+02:00,2025-05-25,14:18,27,15,42
79,2025-05-25T06:20:00+02:00,2025-05-25,14:20,14,4,18
79,2025-05-25T06:22:00+02:00,2025-05-25,14:22,13,6,19
79,2025-05-25T06:23:00+02:00,2025-05-25,14:23,14,2,16
79,2025-05-25T06:24:00+02:00,2025-05-25,14:24,10,5,15
85,2025-05-25T06:11:00+02:00,2025-05-25,14:11,3,0,3
85,2025-05-25T06:12:00+02:00,2025-05-25,14:12,3,1,4
85,2025-05-25T06:13:00+02:00,2025-05-25,14:13,1,3,4
85,2025-05-25T06:14:00+02:00,2025-05-25,14:14,0,2,2
85,2025-05-25T06:15:00+02:00,2025-05-25,14:15,4,6,10
85,2025-05-25T06:16:00+02:00,2025-05-25,14:16,0,1,1
85,2025-05-25T06:21:00+02:00,2025-05-25,14:21,0,1,1
85,2025-05-25T06:23:00+02:00,2025-05-25,14:23,2,0,2
86,2025-05-25T06:13:00+02:00,2025-05-25,14:13,0,2,2
86,2025-05-25T06:24:00+02:00,2025-05-25,14:24,0,1,1
109,2025-05-25T06:10:00+02:00,2025-05-25,14:10,13,9,22
109,2025-05-25T06:15:00+02:00,2025-05-25,14:15,13,16,29
117,2025-05-25T06:15:00+02:00,2025-05-25,14:15,47,16,63
117,2025-05-25T06:20:00+02:00,2025-05-25,14:20,28,26,54
130,2025-05-25T06:10:00+02:00,2025-05-25,14:10,6,3,9
130,2025-05-25T06:15:00+02:00,2025-05-25,14:15,2,3,5
136,2025-05-25T06:15:00+02:00,2025-05-25,14:15,133,8,141
136,2025-05-25T06:20:00+02:00,2025-05-25,14:20,114,7,121
137,2025-05-25T06:10:00+02:00,2025-05-25,14:10,0,4,4
139,2025-05-25T06:10:00+02:00,2025-05-25,14:10,0,12,12
139,2025-05-25T06:20:00+02:00,2025-05-25,14:20,9,1,10
141,2025-05-25T06:10:00+02:00,2025-05-25,14:10,18,8,26
141,2025-05-25T06:20:00+02:00,2025-05-25,14:20,12,20,32
164,2025-05-25T06:10:00+02:00,2025-05-25,14:10,9,24,33
3,2025-05-25T05:55:00+02:00,2025-05-25,13:55,19,31,50
3,2025-05-25T05:57:00+02:00,2025-05-25,13:57,14,17,31
3,2025-05-25T06:01:00+02:00,2025-05-25,14:01,27,25,52
3,2025-05-25T06:05:00+02:00,2025-05-25,14:05,5,18,23
3,2025-05-25T06:07:00+02:00,2025-05-25,14:07,30,18,48
3,2025-05-25T06:08:00+02:00,2025-05-25,14:08,17,24,41
3,2025-05-25T06:09:00+02:00,2025-05-25,14:09,32,22,54
4,2025-05-25T05:59:00+02:00,2025-05-25,13:59,36,15,51
4,2025-05-25T06:02:00+02:00,2025-05-25,14:02,29,14,43
4,2025-05-25T06:05:00+02:00,2025-05-25,14:05,27,31,58
4,2025-05-25T06:06:00+02:00,2025-05-25,14:06,46,28,74
4,2025-05-25T06:07:00+02:00,2025-05-25,14:07,65,25,90
6,2025-05-25T05:55:00+02:00,2025-05-25,13:55,33,4,37
6,2025-05-25T05:56:00+02:00,2025-05-25,13:56,6,4,10
6,2025-05-25T06:01:00+02:00,2025-05-25,14:01,9,12,21
6,2025-05-25T06:04:00+02:00,2025-05-25,14:04,15,14,29
6,2025-05-25T06:05:00+02:00,2025-05-25,14:05,14,10,24
6,2025-05-25T06:07:00+02:00,2025-05-25,14:07,29,5,34
6,2025-05-25T06:09:00+02:00,2025-05-25,14:09,21,20,41
8,2025-05-25T05:55:00+02:00,2025-05-25,13:55,3,2,5
8,2025-05-25T05:57:00+02:00,2025-05-25,13:57,4,2,6
8,2025-05-25T05:59:00+02:00,2025-05-25,13:59,2,2,4
8,2025-05-25T06:00:00+02:00,2025-05-25,14:00,3,3,6
8,2025-05-25T06:06:00+02:00,2025-05-25,14:06,8,0,8
28,2025-05-25T05:59:00+02:00,2025-05-25,13:59,5,11,16
28,2025-05-25T06:01:00+02:00,2025-05-25,14:01,8,8,16
28,2025-05-25T06:04:00+02:00,2025-05-25,14:04,11,12,23
28,2025-05-25T06:06:00+02:00,2025-05-25,14:06,5,11,16
29,2025-05-25T06:00:00+02:00,2025-05-25,14:00,10,22,32
29,2025-05-25T06:02:00+02:00,2025-05-25,14:02,11,14,25
29,2025-05-25T06:03:00+02:00,2025-05-25,14:03,9,2,11
29,2025-05-25T06:05:00+02:00,2025-05-25,14:05,12,7,19
29,2025-05-25T06:08:00+02:00,2025-05-25,14:08,10,12,22
29,2025-05-25T06:09:00+02:00,2025-05-25,14:09,9,12,21
31,2025-05-25T05:59:00+02:00,2025-05-25,13:59,2,4,6
31,2025-05-25T06:00:00+02:00,2025-05-25,14:00,4,3,7
31,2025-05-25T06:01:00+02:00,2025-05-25,14:01,2,6,8
31,2025-05-25T06:03:00+02:00,2025-05-25,14:03,3,0,3
31,2025-05-25T06:07:00+02:00,2025-05-25,14:07,5,1,6
31,2025-05-25T06:08:00+02:00,2025-05-25,14:08,4,1,5
36,2025-05-25T05:56:00+02:00,2025-05-25,13:56,2,4,6
36,2025-05-25T05:59:00+02:00,2025-05-25,13:59,2,0,2
36,2025-05-25T06:03:00+02:00,2025-05-25,14:03,2,1,3
36,2025-05-25T06:04:00+02:00,2025-05-25,14:04,1,2,3
39,2025-05-25T05:58:00+02:00,2025-05-25,13:58,4,0,4
39,2025-05-25T06:00:00+02:00,2025-05-25,14:00,2,1,3
40,2025-05-25T05:57:00+02:00,2025-05-25,13:57,5,3,8
40,2025-05-25T05:59:00+02:00,2025-05-25,13:59,5,3,8
40,2025-05-25T06:05:00+02:00,2025-05-25,14:05,0,5,5
40,2025-05-25T06:08:00+02:00,2025-05-25,14:08,1,4,5
40,2025-05-25T06:09:00+02:00,2025-05-25,14:09,3,0,3
41,2025-05-25T05:57:00+02:00,2025-05-25,13:57,3,1,4
41,2025-05-25T06:04:00+02:00,2025-05-25,14:04,6,7,13
41,2025-05-25T06:05:00+02:00,2025-05-25,14:05,5,3,8
41,2025-05-25T06:06:00+02:00,2025-05-25,14:06,16,15,31
43,2025-05-25T05:55:00+02:00,2025-05-25,13:55,13,3,16
43,2025-05-25T06:05:00+02:00,2025-05-25,14:05,5,9,14
45,2025-05-25T05:55:00+02:00,2025-05-25,13:55,14,24,38
45,2025-05-25T05:58:00+02:00,2025-05-25,13:58,10,29,39
45,2025-05-25T05:59:00+02:00,2025-05-25,13:59,11,17,28
45,2025-05-25T06:00:00+02:00,2025-05-25,14:00,15,20,35
45,2025-05-25T06:01:00+02:00,2025-05-25,14:01,24,21,45
45,2025-05-25T06:03:00+02:00,2025-05-25,14:03,20,21,41
45,2025-05-25T06:05:00+02:00,2025-05-25,14:05,10,17,27
45,2025-05-25T06:07:00+02:00,2025-05-25,14:07,7,14,21
47,2025-05-25T05:55:00+02:00,2025-05-25,13:55,19,20,39
47,2025-05-25T05:57:00+02:00,2025-05-25,13:57,12,11,23
47,2025-05-25T05:58:00+02:00,2025-05-25,13:58,21,46,67
47,2025-05-25T06:00:00+02:00,2025-05-25,14:00,17,23,40
47,2025-05-25T06:02:00+02:00,2025-05-25,14:02,16,22,38
47,2025-05-25T06:05:00+02:00,2025-05-25,14:05,13,17,30
47,2025-05-25T06:06:00+02:00,2025-05-25,14:06,15,17,32
47,2025-05-25T06:07:00+02:00,2025-05-25,14:07,10,39,49
47,2025-05-25T06:08:00+02:00,2025-05-25,14:08,14,18,32
50,2025-05-25T05:58:00+02:00,2025-05-25,13:58,2,6,8
50,2025-05-25T06:07:00+02:00,2025-05-25,14:07,3,3,6
54,2025-05-25T06:00:00+02:00,2025-05-25,14:00,1,5,6
54,2025-05-25T06:02:00+02:00,2025-05-25,14:02,0,5,5
54,2025-05-25T06:03:00+02:00,2025-05-25,14:03,1,1,2
54,2025-05-25T06:05:00+02:00,2025-05-25,14:05,0,1,1
59,2025-05-25T05:55:00+02:00,2025-05-25,13:55,18,31,49
59,2025-05-25T06:00:00+02:00,2025-05-25,14:00,28,43,71
61,2025-05-25T05:56:00+02:00,2025-05-25,13:56,11,8,19
61,2025-05-25T05:58:00+02:00,2025-05-25,13:58,11,2,13
61,2025-05-25T06:02:00+02:00,2025-05-25,14:02,2,8,10
61,2025-05-25T06:05:00+02:00,2025-05-25,14:05,7,3,10
61,2025-05-25T06:06:00+02:00,2025-05-25,14:06,13,9,22
61,2025-05-25T06:07:00+02:00,2025-05-25,14:07,9,5,14
66,2025-05-25T05:55:00+02:00,2025-05-25,13:55,25,25,50
66,2025-05-25T05:56:00+02:00,2025-05-25,13:56,40,16,56
66,2025-05-25T05:58:00+02:00,2025-05-25,13:58,14,26,40
66,2025-05-25T06:02:00+02:00,2025-05-25,14:02,35,24,59
66,2025-05-25T06:03:00+02:00,2025-05-25,14:03,27,28,55
66,2025-05-25T06:06:00+02:00,2025-05-25,14:06,18,37,55
69,2025-05-25T05:57:00+02:00,2025-05-25,13:57,3,3,6
69,2025-05-25T05:59:00+02:00,2025-05-25,13:59,7,0,7
69,2025-05-25T06:01:00+02:00,2025-05-25,14:01,1,4,5
69,2025-05-25T06:03:00+02:00,2025-05-25,14:03,11,1,12
69,2025-05-25T06:05:00+02:00,2025-05-25,14:05,7,1,8
69,2025-05-25T06:07:00+02:00,2025-05-25,14:07,9,3,12
69,2025-05-25T06:08:00+02:00,2025-05-25,14:08,5,1,6
69,2025-05-25T06:09:00+02:00,2025-05-25,14:09,4,6,10
70,2025-05-25T05:56:00+02:00,2025-05-25,13:56,0,3,3
70,2025-05-25T05:59:00+02:00,2025-05-25,13:59,2,0,2
70,2025-05-25T06:04:00+02:00,2025-05-25,14:04,0,4,4
70,2025-05-25T06:05:00+02:00,2025-05-25,14:05,2,2,4
70,2025-05-25T06:06:00+02:00,2025-05-25,14:06,2,3,5
75,2025-05-25T05:58:00+02:00,2025-05-25,13:58,1,0,1
75,2025-05-25T06:01:00+02:00,2025-05-25,14:01,1,0,1
77,2025-05-25T06:00:00+02:00,2025-05-25,14:00,25,14,39
77,2025-05-25T06:05:00+02:00,2025-05-25,14:05,17,8,25
78,2025-05-25T06:03:00+02:00,2025-05-25,14:03,0,5,5
78,2025-05-25T06:07:00+02:00,2025-05-25,14:07,0,3,3
84,2025-05-25T06:00:00+02:00,2025-05-25,14:00,95,114,209
87,2025-05-25T05:55:00+02:00,2025-05-25,13:55,3,2,5
87,2025-05-25T05:57:00+02:00,2025-05-25,13:57,2,4,6
87,2025-05-25T05:58:00+02:00,2025-05-25,13:58,2,0,2
87,2025-05-25T06:02:00+02:00,2025-05-25,14:02,2,0,2
87,2025-05-25T06:06:00+02:00,2025-05-25,14:06,1,0,1
87,2025-05-25T06:09:00+02:00,2025-05-25,14:09,1,0,1
108,2025-05-25T05:59:00+02:00,2025-05-25,13:59,3,6,9
108,2025-05-25T06:03:00+02:00,2025-05-25,14:03,5,8,13
108,2025-05-25T06:04:00+02:00,2025-05-25,14:04,0,5,5
108,2025-05-25T06:06:00+02:00,2025-05-25,14:06,2,3,5
108,2025-05-25T06:09:00+02:00,2025-05-25,14:09,6,0,6
118,2025-05-25T06:00:00+02:00,2025-05-25,14:00,5,2,7
132,2025-05-25T06:00:00+02:00,2025-05-25,14:00,21,17,38
132,2025-05-25T06:05:00+02:00,2025-05-25,14:05,11,10,21
134,2025-05-25T06:00:00+02:00,2025-05-25,14:00,30,15,45
162,2025-05-25T05:55:00+02:00,2025-05-25,13:55,68,68,136
162,2025-05-25T06:00:00+02:00,2025-05-25,14:00,65,74,139
166,2025-05-25T06:05:00+02:00,2025-05-25,14:05,7,10,17
1,2025-05-25T05:56:00+02:00,2025-05-25,13:56,23,24,47
1,2025-05-25T06:01:00+02:00,2025-05-25,14:01,31,15,46
1,2025-05-25T06:03:00+02:00,2025-05-25,14:03,27,27,54
1,2025-05-25T06:04:00+02:00,2025-05-25,14:04,12,4,16
1,2025-05-25T06:08:00+02:00,2025-05-25,14:08,31,26,57
1,2025-05-25T06:09:00+02:00,2025-05-25,14:09,27,29,56
2,2025-05-25T05:56:00+02:00,2025-05-25,13:56,14,7,21
2,2025-05-25T05:58:00+02:00,2025-05-25,13:58,5,10,15
2,2025-05-25T06:01:00+02:00,2025-05-25,14:01,11,17,28
2,2025-05-25T06:02:00+02:00,2025-05-25,14:02,24,17,41
2,2025-05-25T06:05:00+02:00,2025-05-25,14:05,12,8,20
2,2025-05-25T06:06:00+02:00,2025-05-25,14:06,12,8,20
2,2025-05-25T06:09:00+02:00,2025-05-25,14:09,12,21,33
9,2025-05-25T06:01:00+02:00,2025-05-25,14:01,1,3,4
9,2025-05-25T06:05:00+02:00,2025-05-25,14:05,2,2,4
10,2025-05-25T05:56:00+02:00,2025-05-25,13:56,4,0,4
10,2025-05-25T06:00:00+02:00,2025-05-25,14:00,0,1,1
10,2025-05-25T06:04:00+02:00,2025-05-25,14:04,0,4,4
11,2025-05-25T05:57:00+02:00,2025-05-25,13:57,0,1,1
11,2025-05-25T05:59:00+02:00,2025-05-25,13:59,2,2,4
11,2025-05-25T06:00:00+02:00,2025-05-25,14:00,4,5,9
12,2025-05-25T05:57:00+02:00,2025-05-25,13:57,1,94,95
12,2025-05-25T05:58:00+02:00,2025-05-25,13:58,4,22,26
12,2025-05-25T05:59:00+02:00,2025-05-25,13:59,8,11,19
12,2025-05-25T06:00:00+02:00,2025-05-25,14:00,5,4,9
12,2025-05-25T06:02:00+02:00,2025-05-25,14:02,2,5,7
12,2025-05-25T06:06:00+02:00,2025-05-25,14:06,7,3,10
17,2025-05-25T05:55:00+02:00,2025-05-25,13:55,5,0,5
17,2025-05-25T05:56:00+02:00,2025-05-25,13:56,3,6,9
17,2025-05-25T05:59:00+02:00,2025-05-25,13:59,5,2,7
17,2025-05-25T06:05:00+02:00,2025-05-25,14:05,2,1,3
17,2025-05-25T06:07:00+02:00,2025-05-25,14:07,1,2,3
18,2025-05-25T06:02:00+02:00,2025-05-25,14:02,1,0,1
18,2025-05-25T06:09:00+02:00,2025-05-25,14:09,1,2,3
19,2025-05-25T05:56:00+02:00,2025-05-25,13:56,13,7,20
19,2025-05-25T05:57:00+02:00,2025-05-25,13:57,3,10,13
19,2025-05-25T05:59:00+02:00,2025-05-25,13:59,18,17,35
19,2025-05-25T06:00:00+02:00,2025-05-25,14:00,9,8,17
19,2025-05-25T06:02:00+02:00,2025-05-25,14:02,7,8,15
19,2025-05-25T06:08:00+02:00,2025-05-25,14:08,11,6,17
20,2025-05-25T05:55:00+02:00,2025-05-25,13:55,5,17,22
20,2025-05-25T05:58:00+02:00,2025-05-25,13:58,7,8,15
20,2025-05-25T06:05:00+02:00,2025-05-25,14:05,13,10,23
20,2025-05-25T06:07:00+02:00,2025-05-25,14:07,1,0,1
20,2025-05-25T06:08:00+02:00,2025-05-25,14:08,3,8,11
23,2025-05-25T06:00:00+02:00,2025-05-25,14:00,4,5,9
23,2025-05-25T06:04:00+02:00,2025-05-25,14:04,2,2,4
23,2025-05-25T06:05:00+02:00,2025-05-25,14:05,0,5,5
23,2025-05-25T06:06:00+02:00,2025-05-25,14:06,3,4,7
23,2025-05-25T06:07:00+02:00,2025-05-25,14:07,0,1,1
24,2025-05-25T05:55:00+02:00,2025-05-25,13:55,3,16,19
24,2025-05-25T05:58:00+02:00,2025-05-25,13:58,17,10,27
24,2025-05-25T06:01:00+02:00,2025-05-25,14:01,9,4,13
24,2025-05-25T06:02:00+02:00,2025-05-25,14:02,7,13,20
24,2025-05-25T06:03:00+02:00,2025-05-25,14:03,14,12,26
24,2025-05-25T06:05:00+02:00,2025-05-25,14:05,16,20,36
24,2025-05-25T06:09:00+02:00,2025-05-25,14:09,3,8,11
27,2025-05-25T05:58:00+02:00,2025-05-25,13:58,5,9,14
27,2025-05-25T06:00:00+02:00,2025-05-25,14:00,2,1,3
27,2025-05-25T06:02:00+02:00,2025-05-25,14:02,6,1,7
27,2025-05-25T06:06:00+02:00,2025-05-25,14:06,2,3,5
30,2025-05-25T05:58:00+02:00,2025-05-25,13:58,3,5,8
30,2025-05-25T06:00:00+02:00,2025-05-25,14:00,4,8,12
30,2025-05-25T06:02:00+02:00,2025-05-25,14:02,7,13,20
30,2025-05-25T06:05:00+02:00,2025-05-25,14:05,6,12,18
30,2025-05-25T06:08:00+02:00,2025-05-25,14:08,6,7,13
35,2025-05-25T05:57:00+02:00,2025-05-25,13:57,42,10,52
35,2025-05-25T06:02:00+02:00,2025-05-25,14:02,28,25,53
35,2025-05-25T06:05:00+02:00,2025-05-25,14:05,17,14,31
35,2025-05-25T06:09:00+02:00,2025-05-25,14:09,34,18,52
46,2025-05-25T06:05:00+02:00,2025-05-25,14:05,3,2,5
48,2025-05-25T06:01:00+02:00,2025-05-25,14:01,4,8,12
48,2025-05-25T06:03:00+02:00,2025-05-25,14:03,18,8,26
48,2025-05-25T06:06:00+02:00,2025-05-25,14:06,9,12,21
49,2025-05-25T06:06:00+02:00,2025-05-25,14:06,5,9,14
51,2025-05-25T05:56:00+02:00,2025-05-25,13:56,3,1,4
51,2025-05-25T05:57:00+02:00,2025-05-25,13:57,3,5,8
51,2025-05-25T06:01:00+02:00,2025-05-25,14:01,4,1,5
51,2025-05-25T06:03:00+02:00,2025-05-25,14:03,5,4,9
51,2025-05-25T06:04:00+02:00,2025-05-25,14:04,1,1,2
51,2025-05-25T06:07:00+02:00,2025-05-25,14:07,3,4,7
51,2025-05-25T06:09:00+02:00,2025-05-25,14:09,3,1,4
52,2025-05-25T05:55:00+02:00,2025-05-25,13:55,5,1,6
52,2025-05-25T05:56:00+02:00,2025-05-25,13:56,9,5,14
52,2025-05-25T05:58:00+02:00,2025-05-25,13:58,7,7,14
52,2025-05-25T05:59:00+02:00,2025-05-25,13:59,3,7,10
52,2025-05-25T06:04:00+02:00,2025-05-25,14:04,3,8,11
53,2025-05-25T06:03:00+02:00,2025-05-25,14:03,12,7,19
53,2025-05-25T06:04:00+02:00,2025-05-25,14:04,18,8,26
53,2025-05-25T06:09:00+02:00,2025-05-25,14:09,13,4,17
56,2025-05-25T05:57:00+02:00,2025-05-25,13:57,6,8,14
56,2025-05-25T05:58:00+02:00,2025-05-25,13:58,14,5,19
56,2025-05-25T06:08:00+02:00,2025-05-25,14:08,12,5,17
56,2025-05-25T06:09:00+02:00,2025-05-25,14:09,13,5,18
58,2025-05-25T05:55:00+02:00,2025-05-25,13:55,15,3,18
58,2025-05-25T05:57:00+02:00,2025-05-25,13:57,5,9,14
58,2025-05-25T06:03:00+02:00,2025-05-25,14:03,9,1,10
58,2025-05-25T06:06:00+02:00,2025-05-25,14:06,4,3,7
58,2025-05-25T06:08:00+02:00,2025-05-25,14:08,11,2,13
62,2025-05-25T05:56:00+02:00,2025-05-25,13:56,3,7,10
62,2025-05-25T05:58:00+02:00,2025-05-25,13:58,10,1,11
62,2025-05-25T06:09:00+02:00,2025-05-25,14:09,0,2,2
63,2025-05-25T06:00:00+02:00,2025-05-25,14:00,3,4,7
63,2025-05-25T06:01:00+02:00,2025-05-25,14:01,6,7,13
63,2025-05-25T06:02:00+02:00,2025-05-25,14:02,3,8,11
63,2025-05-25T06:03:00+02:00,2025-05-25,14:03,7,5,12
63,2025-05-25T06:04:00+02:00,2025-05-25,14:04,10,5,15
63,2025-05-25T06:06:00+02:00,2025-05-25,14:06,10,6,16
63,2025-05-25T06:08:00+02:00,2025-05-25,14:08,10,3,13
67,2025-05-25T05:55:00+02:00,2025-05-25,13:55,4,8,12
67,2025-05-25T05:58:00+02:00,2025-05-25,13:58,9,8,17
67,2025-05-25T06:00:00+02:00,2025-05-25,14:00,1,9,10
67,2025-05-25T06:05:00+02:00,2025-05-25,14:05,3,5,8
67,2025-05-25T06:08:00+02:00,2025-05-25,14:08,8,9,17
68,2025-05-25T05:57:00+02:00,2025-05-25,13:57,4,9,13
68,2025-05-25T06:00:00+02:00,2025-05-25,14:00,6,3,9
68,2025-05-25T06:04:00+02:00,2025-05-25,14:04,10,5,15
68,2025-05-25T06:05:00+02:00,2025-05-25,14:05,6,13,19
72,2025-05-25T05:56:00+02:00,2025-05-25,13:56,1,10,11
72,2025-05-25T06:01:00+02:00,2025-05-25,14:01,10,3,13
72,2025-05-25T06:04:00+02:00,2025-05-25,14:04,7,11,18
72,2025-05-25T06:06:00+02:00,2025-05-25,14:06,8,9,17
72,2025-05-25T06:08:00+02:00,2025-05-25,14:08,3,11,14
76,2025-05-25T05:57:00+02:00,2025-05-25,13:57,1,2,3
76,2025-05-25T05:58:00+02:00,2025-05-25,13:58,2,0,2
76,2025-05-25T06:01:00+02:00,2025-05-25,14:01,0,1,1
76,2025-05-25T06:02:00+02:00,2025-05-25,14:02,1,0,1
76,2025-05-25T06:06:00+02:00,2025-05-25,14:06,0,1,1
76,2025-05-25T06:07:00+02:00,2025-05-25,14:07,0,2,2
79,2025-05-25T05:56:00+02:00,2025-05-25,13:56,20,3,23
79,2025-05-25T05:57:00+02:00,2025-05-25,13:57,15,7,22
79,2025-05-25T05:58:00+02:00,2025-05-25,13:58,6,4,10
79,2025-05-25T05:59:00+02:00,2025-05-25,13:59,19,2,21
79,2025-05-25T06:06:00+02:00,2025-05-25,14:06,12,18,30
79,2025-05-25T06:07:00+02:00,2025-05-25,14:07,25,16,41
79,2025-05-25T06:09:00+02:00,2025-05-25,14:09,14,11,25
85,2025-05-25T05:57:00+02:00,2025-05-25,13:57,1,0,1
85,2025-05-25T06:02:00+02:00,2025-05-25,14:02,0,3,3
86,2025-05-25T05:58:00+02:00,2025-05-25,13:58,1,0,1
86,2025-05-25T06:06:00+02:00,2025-05-25,14:06,1,0,1
86,2025-05-25T06:07:00+02:00,2025-05-25,14:07,0,1,1
86,2025-05-25T06:09:00+02:00,2025-05-25,14:09,0,2,2
117,2025-05-25T05:55:00+02:00,2025-05-25,13:55,15,18,33
117,2025-05-25T06:05:00+02:00,2025-05-25,14:05,25,11,36
123,2025-05-25T05:55:00+02:00,2025-05-25,13:55,0,3,3
123,2025-05-25T06:00:00+02:00,2025-05-25,14:00,7,1,8
123,2025-05-25T06:05:00+02:00,2025-05-25,14:05,1,2,3
137,2025-05-25T06:00:00+02:00,2025-05-25,14:00,1,4,5
137,2025-05-25T06:05:00+02:00,2025-05-25,14:05,1,1,2
139,2025-05-25T06:05:00+02:00,2025-05-25,14:05,7,3,10
141,2025-05-25T05:55:00+02:00,2025-05-25,13:55,13,10,23
141,2025-05-25T06:05:00+02:00,2025-05-25,14:05,23,12,35
142,2025-05-25T05:55:00+02:00,2025-05-25,13:55,52,66,118
142,2025-05-25T06:05:00+02:00,2025-05-25,14:05,79,29,108
161,2025-05-25T06:05:00+02:00,2025-05-25,14:05,87,14,101
164,2025-05-25T06:00:00+02:00,2025-05-25,14:00,5,8,13
181,2025-05-25T05:58:00+02:00,2025-05-25,13:58,16,16,32
181,2025-05-25T05:59:00+02:00,2025-05-25,13:59,2,13,15
181,2025-05-25T06:04:00+02:00,2025-05-25,14:04,5,18,23
181,2025-05-25T06:07:00+02:00,2025-05-25,14:07,13,21,34
181,2025-05-25T06:08:00+02:00,2025-05-25,14:08,8,22,30
182,2025-05-25T05:55:00+02:00,2025-05-25,13:55,26,25,51
182,2025-05-25T06:00:00+02:00,2025-05-25,14:00,26,16,42
180,2025-05-25T05:55:00+02:00,2025-05-25,13:55,4,1,5
181,2025-05-25T06:11:00+02:00,2025-05-25,14:11,15,25,40
181,2025-05-25T06:14:00+02:00,2025-05-25,14:14,5,24,29
181,2025-05-25T06:19:00+02:00,2025-05-25,14:19,3,18,21
181,2025-05-25T06:20:00+02:00,2025-05-25,14:20,16,32,48
181,2025-05-25T06:22:00+02:00,2025-05-25,14:22,6,21,27
182,2025-05-25T06:10:00+02:00,2025-05-25,14:10,14,14,28
180,2025-05-25T06:14:00+02:00,2025-05-25,14:14,2,2,4
180,2025-05-25T06:17:00+02:00,2025-05-25,14:17,1,0,1
180,2025-05-25T06:22:00+02:00,2025-05-25,14:22,1,0,1
3,2025-05-25T06:31:00+02:00,2025-05-25,14:31,19,33,52
3,2025-05-25T06:32:00+02:00,2025-05-25,14:32,10,22,32
3,2025-05-25T06:34:00+02:00,2025-05-25,14:34,26,27,53
3,2025-05-25T06:35:00+02:00,2025-05-25,14:35,19,20,39
3,2025-05-25T06:38:00+02:00,2025-05-25,14:38,16,29,45
4,2025-05-25T06:25:00+02:00,2025-05-25,14:25,19,2,21
4,2025-05-25T06:28:00+02:00,2025-05-25,14:28,39,2,41
4,2025-05-25T06:29:00+02:00,2025-05-25,14:29,26,19,45
4,2025-05-25T06:34:00+02:00,2025-05-25,14:34,20,29,49
4,2025-05-25T06:37:00+02:00,2025-05-25,14:37,31,30,61
5,2025-05-25T06:25:00+02:00,2025-05-25,14:25,93,100,193
6,2025-05-25T06:27:00+02:00,2025-05-25,14:27,18,18,36
6,2025-05-25T06:30:00+02:00,2025-05-25,14:30,10,15,25
6,2025-05-25T06:34:00+02:00,2025-05-25,14:34,16,7,23
6,2025-05-25T06:36:00+02:00,2025-05-25,14:36,19,8,27
6,2025-05-25T06:37:00+02:00,2025-05-25,14:37,14,7,21
6,2025-05-25T06:39:00+02:00,2025-05-25,14:39,24,22,46
8,2025-05-25T06:25:00+02:00,2025-05-25,14:25,1,4,5
8,2025-05-25T06:30:00+02:00,2025-05-25,14:30,1,1,2
8,2025-05-25T06:31:00+02:00,2025-05-25,14:31,2,5,7
8,2025-05-25T06:32:00+02:00,2025-05-25,14:32,1,12,13
8,2025-05-25T06:34:00+02:00,2025-05-25,14:34,5,0,5
8,2025-05-25T06:36:00+02:00,2025-05-25,14:36,11,5,16
8,2025-05-25T06:37:00+02:00,2025-05-25,14:37,4,1,5
28,2025-05-25T06:26:00+02:00,2025-05-25,14:26,8,10,18
28,2025-05-25T06:31:00+02:00,2025-05-25,14:31,9,8,17
28,2025-05-25T06:39:00+02:00,2025-05-25,14:39,9,19,28
29,2025-05-25T06:25:00+02:00,2025-05-25,14:25,13,21,34
29,2025-05-25T06:26:00+02:00,2025-05-25,14:26,8,10,18
29,2025-05-25T06:29:00+02:00,2025-05-25,14:29,4,14,18
29,2025-05-25T06:32:00+02:00,2025-05-25,14:32,17,9,26
29,2025-05-25T06:33:00+02:00,2025-05-25,14:33,4,11,15
29,2025-05-25T06:36:00+02:00,2025-05-25,14:36,10,15,25
29,2025-05-25T06:37:00+02:00,2025-05-25,14:37,17,10,27
29,2025-05-25T06:38:00+02:00,2025-05-25,14:38,11,14,25
31,2025-05-25T06:25:00+02:00,2025-05-25,14:25,6,3,9
31,2025-05-25T06:29:00+02:00,2025-05-25,14:29,2,3,5
31,2025-05-25T06:30:00+02:00,2025-05-25,14:30,8,3,11
31,2025-05-25T06:33:00+02:00,2025-05-25,14:33,1,7,8
31,2025-05-25T06:34:00+02:00,2025-05-25,14:34,8,7,15
31,2025-05-25T06:38:00+02:00,2025-05-25,14:38,6,5,11
36,2025-05-25T06:25:00+02:00,2025-05-25,14:25,0,2,2
36,2025-05-25T06:28:00+02:00,2025-05-25,14:28,0,1,1
36,2025-05-25T06:29:00+02:00,2025-05-25,14:29,3,0,3
36,2025-05-25T06:34:00+02:00,2025-05-25,14:34,6,1,7
36,2025-05-25T06:35:00+02:00,2025-05-25,14:35,2,0,2
39,2025-05-25T06:31:00+02:00,2025-05-25,14:31,4,0,4
39,2025-05-25T06:36:00+02:00,2025-05-25,14:36,0,4,4
39,2025-05-25T06:38:00+02:00,2025-05-25,14:38,4,1,5
39,2025-05-25T06:39:00+02:00,2025-05-25,14:39,0,1,1
40,2025-05-25T06:25:00+02:00,2025-05-25,14:25,4,6,10
40,2025-05-25T06:36:00+02:00,2025-05-25,14:36,1,2,3
40,2025-05-25T06:38:00+02:00,2025-05-25,14:38,1,1,2
41,2025-05-25T06:29:00+02:00,2025-05-25,14:29,5,5,10
41,2025-05-25T06:32:00+02:00,2025-05-25,14:32,7,2,9
41,2025-05-25T06:37:00+02:00,2025-05-25,14:37,7,1,8
41,2025-05-25T06:38:00+02:00,2025-05-25,14:38,11,9,20
43,2025-05-25T06:25:00+02:00,2025-05-25,14:25,3,4,7
45,2025-05-25T06:25:00+02:00,2025-05-25,14:25,17,23,40
45,2025-05-25T06:30:00+02:00,2025-05-25,14:30,32,4,36
45,2025-05-25T06:35:00+02:00,2025-05-25,14:35,12,17,29
45,2025-05-25T06:38:00+02:00,2025-05-25,14:38,20,15,35
45,2025-05-25T06:39:00+02:00,2025-05-25,14:39,15,19,34
47,2025-05-25T06:27:00+02:00,2025-05-25,14:27,27,14,41
47,2025-05-25T06:28:00+02:00,2025-05-25,14:28,16,33,49
47,2025-05-25T06:29:00+02:00,2025-05-25,14:29,23,20,43
47,2025-05-25T06:30:00+02:00,2025-05-25,14:30,17,25,42
47,2025-05-25T06:31:00+02:00,2025-05-25,14:31,33,32,65
50,2025-05-25T06:27:00+02:00,2025-05-25,14:27,2,3,5
50,2025-05-25T06:28:00+02:00,2025-05-25,14:28,5,5,10
50,2025-05-25T06:29:00+02:00,2025-05-25,14:29,3,1,4
50,2025-05-25T06:30:00+02:00,2025-05-25,14:30,2,2,4
50,2025-05-25T06:31:00+02:00,2025-05-25,14:31,16,7,23
50,2025-05-25T06:33:00+02:00,2025-05-25,14:33,1,7,8
50,2025-05-25T06:38:00+02:00,2025-05-25,14:38,1,2,3
54,2025-05-25T06:27:00+02:00,2025-05-25,14:27,1,1,2
54,2025-05-25T06:29:00+02:00,2025-05-25,14:29,3,0,3
54,2025-05-25T06:33:00+02:00,2025-05-25,14:33,7,2,9
54,2025-05-25T06:36:00+02:00,2025-05-25,14:36,7,0,7
54,2025-05-25T06:37:00+02:00,2025-05-25,14:37,0,1,1
54,2025-05-25T06:38:00+02:00,2025-05-25,14:38,3,1,4
59,2025-05-25T06:25:00+02:00,2025-05-25,14:25,22,30,52
59,2025-05-25T06:30:00+02:00,2025-05-25,14:30,18,40,58
61,2025-05-25T06:28:00+02:00,2025-05-25,14:28,10,12,22
61,2025-05-25T06:29:00+02:00,2025-05-25,14:29,9,4,13
61,2025-05-25T06:35:00+02:00,2025-05-25,14:35,14,5,19
66,2025-05-25T06:26:00+02:00,2025-05-25,14:26,16,27,43
66,2025-05-25T06:27:00+02:00,2025-05-25,14:27,25,42,67
66,2025-05-25T06:29:00+02:00,2025-05-25,14:29,37,27,64
66,2025-05-25T06:32:00+02:00,2025-05-25,14:32,39,23,62
66,2025-05-25T06:34:00+02:00,2025-05-25,14:34,42,39,81
66,2025-05-25T06:35:00+02:00,2025-05-25,14:35,35,16,51
66,2025-05-25T06:36:00+02:00,2025-05-25,14:36,20,34,54
66,2025-05-25T06:37:00+02:00,2025-05-25,14:37,31,21,52
66,2025-05-25T06:39:00+02:00,2025-05-25,14:39,17,36,53
69,2025-05-25T06:27:00+02:00,2025-05-25,14:27,1,10,11
69,2025-05-25T06:28:00+02:00,2025-05-25,14:28,4,1,5
69,2025-05-25T06:31:00+02:00,2025-05-25,14:31,4,3,7
69,2025-05-25T06:38:00+02:00,2025-05-25,14:38,9,7,16
69,2025-05-25T06:39:00+02:00,2025-05-25,14:39,6,6,12
70,2025-05-25T06:28:00+02:00,2025-05-25,14:28,1,2,3
70,2025-05-25T06:36:00+02:00,2025-05-25,14:36,2,7,9
70,2025-05-25T06:38:00+02:00,2025-05-25,14:38,2,4,6
71,2025-05-25T06:38:00+02:00,2025-05-25,14:38,0,1,1
75,2025-05-25T06:29:00+02:00,2025-05-25,14:29,1,0,1
75,2025-05-25T06:34:00+02:00,2025-05-25,14:34,0,3,3
75,2025-05-25T06:39:00+02:00,2025-05-25,14:39,0,2,2
78,2025-05-25T06:27:00+02:00,2025-05-25,14:27,0,1,1
78,2025-05-25T06:31:00+02:00,2025-05-25,14:31,0,2,2
84,2025-05-25T06:25:00+02:00,2025-05-25,14:25,65,94,159
87,2025-05-25T06:26:00+02:00,2025-05-25,14:26,2,1,3
87,2025-05-25T06:27:00+02:00,2025-05-25,14:27,0,1,1
87,2025-05-25T06:31:00+02:00,2025-05-25,14:31,1,2,3
87,2025-05-25T06:32:00+02:00,2025-05-25,14:32,1,3,4
87,2025-05-25T06:35:00+02:00,2025-05-25,14:35,2,1,3
87,2025-05-25T06:38:00+02:00,2025-05-25,14:38,2,0,2
87,2025-05-25T06:39:00+02:00,2025-05-25,14:39,1,0,1
107,2025-05-25T06:25:00+02:00,2025-05-25,14:25,12,10,22
108,2025-05-25T06:25:00+02:00,2025-05-25,14:25,0,1,1
108,2025-05-25T06:29:00+02:00,2025-05-25,14:29,5,8,13
108,2025-05-25T06:30:00+02:00,2025-05-25,14:30,9,2,11
108,2025-05-25T06:31:00+02:00,2025-05-25,14:31,2,3,5
108,2025-05-25T06:32:00+02:00,2025-05-25,14:32,5,1,6
108,2025-05-25T06:33:00+02:00,2025-05-25,14:33,2,3,5
108,2025-05-25T06:37:00+02:00,2025-05-25,14:37,2,3,5
132,2025-05-25T06:35:00+02:00,2025-05-25,14:35,13,14,27
133,2025-05-25T06:35:00+02:00,2025-05-25,14:35,24,36,60
162,2025-05-25T06:30:00+02:00,2025-05-25,14:30,71,75,146
166,2025-05-25T06:35:00+02:00,2025-05-25,14:35,7,4,11
179,2025-05-25T06:35:00+02:00,2025-05-25,14:35,5,8,13
1,2025-05-25T06:35:00+02:00,2025-05-25,14:35,14,25,39
1,2025-05-25T06:37:00+02:00,2025-05-25,14:37,23,11,34
1,2025-05-25T06:39:00+02:00,2025-05-25,14:39,20,36,56
2,2025-05-25T06:27:00+02:00,2025-05-25,14:27,7,17,24
2,2025-05-25T06:28:00+02:00,2025-05-25,14:28,12,13,25
2,2025-05-25T06:29:00+02:00,2025-05-25,14:29,7,15,22
2,2025-05-25T06:30:00+02:00,2025-05-25,14:30,18,5,23
2,2025-05-25T06:31:00+02:00,2025-05-25,14:31,9,8,17
2,2025-05-25T06:35:00+02:00,2025-05-25,14:35,11,7,18
2,2025-05-25T06:36:00+02:00,2025-05-25,14:36,14,14,28
2,2025-05-25T06:38:00+02:00,2025-05-25,14:38,11,11,22
2,2025-05-25T06:39:00+02:00,2025-05-25,14:39,20,7,27
9,2025-05-25T06:26:00+02:00,2025-05-25,14:26,1,0,1
9,2025-05-25T06:27:00+02:00,2025-05-25,14:27,4,0,4
9,2025-05-25T06:30:00+02:00,2025-05-25,14:30,1,3,4
9,2025-05-25T06:39:00+02:00,2025-05-25,14:39,1,2,3
10,2025-05-25T06:29:00+02:00,2025-05-25,14:29,0,2,2
10,2025-05-25T06:31:00+02:00,2025-05-25,14:31,1,0,1
10,2025-05-25T06:32:00+02:00,2025-05-25,14:32,1,2,3
10,2025-05-25T06:33:00+02:00,2025-05-25,14:33,2,0,2
10,2025-05-25T06:38:00+02:00,2025-05-25,14:38,4,0,4
11,2025-05-25T06:29:00+02:00,2025-05-25,14:29,2,2,4
11,2025-05-25T06:37:00+02:00,2025-05-25,14:37,5,1,6
12,2025-05-25T06:26:00+02:00,2025-05-25,14:26,2,1,3
12,2025-05-25T06:32:00+02:00,2025-05-25,14:32,9,0,9
12,2025-05-25T06:38:00+02:00,2025-05-25,14:38,3,4,7
17,2025-05-25T06:25:00+02:00,2025-05-25,14:25,0,1,1
17,2025-05-25T06:27:00+02:00,2025-05-25,14:27,6,5,11
17,2025-05-25T06:28:00+02:00,2025-05-25,14:28,4,0,4
17,2025-05-25T06:29:00+02:00,2025-05-25,14:29,5,5,10
17,2025-05-25T06:33:00+02:00,2025-05-25,14:33,1,3,4
17,2025-05-25T06:34:00+02:00,2025-05-25,14:34,2,2,4
17,2025-05-25T06:37:00+02:00,2025-05-25,14:37,1,1,2
17,2025-05-25T06:39:00+02:00,2025-05-25,14:39,3,0,3
18,2025-05-25T06:25:00+02:00,2025-05-25,14:25,0,2,2
18,2025-05-25T06:27:00+02:00,2025-05-25,14:27,2,0,2
18,2025-05-25T06:28:00+02:00,2025-05-25,14:28,0,1,1
18,2025-05-25T06:32:00+02:00,2025-05-25,14:32,1,0,1
18,2025-05-25T06:35:00+02:00,2025-05-25,14:35,0,2,2
18,2025-05-25T06:37:00+02:00,2025-05-25,14:37,1,0,1
18,2025-05-25T06:39:00+02:00,2025-05-25,14:39,4,1,5
19,2025-05-25T06:28:00+02:00,2025-05-25,14:28,9,24,33
19,2025-05-25T06:30:00+02:00,2025-05-25,14:30,11,8,19
19,2025-05-25T06:35:00+02:00,2025-05-25,14:35,9,5,14
19,2025-05-25T06:36:00+02:00,2025-05-25,14:36,7,7,14
19,2025-05-25T06:38:00+02:00,2025-05-25,14:38,3,10,13
20,2025-05-25T06:25:00+02:00,2025-05-25,14:25,0,4,4
20,2025-05-25T06:28:00+02:00,2025-05-25,14:28,1,8,9
20,2025-05-25T06:35:00+02:00,2025-05-25,14:35,7,9,16
20,2025-05-25T06:37:00+02:00,2025-05-25,14:37,0,6,6
23,2025-05-25T06:27:00+02:00,2025-05-25,14:27,4,5,9
23,2025-05-25T06:33:00+02:00,2025-05-25,14:33,0,2,2
23,2025-05-25T06:34:00+02:00,2025-05-25,14:34,1,3,4
23,2025-05-25T06:35:00+02:00,2025-05-25,14:35,1,2,3
23,2025-05-25T06:36:00+02:00,2025-05-25,14:36,1,4,5
23,2025-05-25T06:37:00+02:00,2025-05-25,14:37,2,1,3
23,2025-05-25T06:38:00+02:00,2025-05-25,14:38,1,2,3
24,2025-05-25T06:28:00+02:00,2025-05-25,14:28,13,12,25
24,2025-05-25T06:30:00+02:00,2025-05-25,14:30,9,5,14
24,2025-05-25T06:32:00+02:00,2025-05-25,14:32,2,31,33
24,2025-05-25T06:35:00+02:00,2025-05-25,14:35,7,3,10
24,2025-05-25T06:36:00+02:00,2025-05-25,14:36,3,7,10
24,2025-05-25T06:38:00+02:00,2025-05-25,14:38,3,10,13
25,2025-05-25T06:25:00+02:00,2025-05-25,14:25,75,110,185
25,2025-05-25T06:35:00+02:00,2025-05-25,14:35,69,51,120
27,2025-05-25T06:25:00+02:00,2025-05-25,14:25,3,1,4
27,2025-05-25T06:26:00+02:00,2025-05-25,14:26,7,1,8
27,2025-05-25T06:28:00+02:00,2025-05-25,14:28,5,6,11
27,2025-05-25T06:33:00+02:00,2025-05-25,14:33,6,5,11
27,2025-05-25T06:34:00+02:00,2025-05-25,14:34,3,7,10
27,2025-05-25T06:36:00+02:00,2025-05-25,14:36,4,0,4
27,2025-05-25T06:37:00+02:00,2025-05-25,14:37,5,1,6
27,2025-05-25T06:38:00+02:00,2025-05-25,14:38,5,3,8
30,2025-05-25T06:26:00+02:00,2025-05-25,14:26,16,1,17
30,2025-05-25T06:29:00+02:00,2025-05-25,14:29,11,4,15
30,2025-05-25T06:30:00+02:00,2025-05-25,14:30,1,3,4
30,2025-05-25T06:31:00+02:00,2025-05-25,14:31,9,4,13
35,2025-05-25T06:25:00+02:00,2025-05-25,14:25,36,27,63
35,2025-05-25T06:27:00+02:00,2025-05-25,14:27,13,21,34
35,2025-05-25T06:28:00+02:00,2025-05-25,14:28,35,25,60
35,2025-05-25T06:30:00+02:00,2025-05-25,14:30,20,30,50
35,2025-05-25T06:31:00+02:00,2025-05-25,14:31,17,30,47
35,2025-05-25T06:34:00+02:00,2025-05-25,14:34,20,35,55
35,2025-05-25T06:36:00+02:00,2025-05-25,14:36,27,24,51
46,2025-05-25T06:25:00+02:00,2025-05-25,14:25,3,6,9
46,2025-05-25T06:30:00+02:00,2025-05-25,14:30,6,4,10
46,2025-05-25T06:35:00+02:00,2025-05-25,14:35,11,5,16
48,2025-05-25T06:26:00+02:00,2025-05-25,14:26,17,1,18
48,2025-05-25T06:30:00+02:00,2025-05-25,14:30,25,5,30
48,2025-05-25T06:35:00+02:00,2025-05-25,14:35,18,8,26
48,2025-05-25T06:37:00+02:00,2025-05-25,14:37,15,7,22
48,2025-05-25T06:39:00+02:00,2025-05-25,14:39,7,9,16
49,2025-05-25T06:27:00+02:00,2025-05-25,14:27,3,9,12
49,2025-05-25T06:38:00+02:00,2025-05-25,14:38,6,3,9
51,2025-05-25T06:25:00+02:00,2025-05-25,14:25,1,0,1
51,2025-05-25T06:29:00+02:00,2025-05-25,14:29,0,4,4
51,2025-05-25T06:31:00+02:00,2025-05-25,14:31,1,3,4
51,2025-05-25T06:36:00+02:00,2025-05-25,14:36,5,1,6
51,2025-05-25T06:37:00+02:00,2025-05-25,14:37,3,3,6
52,2025-05-25T06:26:00+02:00,2025-05-25,14:26,4,15,19
52,2025-05-25T06:27:00+02:00,2025-05-25,14:27,6,3,9
52,2025-05-25T06:31:00+02:00,2025-05-25,14:31,3,7,10
52,2025-05-25T06:34:00+02:00,2025-05-25,14:34,11,2,13
52,2025-05-25T06:38:00+02:00,2025-05-25,14:38,9,7,16
52,2025-05-25T06:39:00+02:00,2025-05-25,14:39,1,5,6
53,2025-05-25T06:25:00+02:00,2025-05-25,14:25,20,8,28
53,2025-05-25T06:26:00+02:00,2025-05-25,14:26,14,5,19
53,2025-05-25T06:32:00+02:00,2025-05-25,14:32,16,5,21
53,2025-05-25T06:33:00+02:00,2025-05-25,14:33,11,4,15
53,2025-05-25T06:34:00+02:00,2025-05-25,14:34,10,6,16
53,2025-05-25T06:35:00+02:00,2025-05-25,14:35,8,8,16
53,2025-05-25T06:36:00+02:00,2025-05-25,14:36,8,16,24
53,2025-05-25T06:38:00+02:00,2025-05-25,14:38,16,3,19
53,2025-05-25T06:39:00+02:00,2025-05-25,14:39,14,6,20
56,2025-05-25T06:26:00+02:00,2025-05-25,14:26,5,10,15
56,2025-05-25T06:27:00+02:00,2025-05-25,14:27,5,5,10
56,2025-05-25T06:30:00+02:00,2025-05-25,14:30,6,7,13
56,2025-05-25T06:31:00+02:00,2025-05-25,14:31,7,7,14
56,2025-05-25T06:33:00+02:00,2025-05-25,14:33,7,7,14
58,2025-05-25T06:33:00+02:00,2025-05-25,14:33,12,3,15
58,2025-05-25T06:38:00+02:00,2025-05-25,14:38,7,2,9
62,2025-05-25T06:37:00+02:00,2025-05-25,14:37,7,4,11
62,2025-05-25T06:39:00+02:00,2025-05-25,14:39,3,3,6
63,2025-05-25T06:25:00+02:00,2025-05-25,14:25,3,8,11
63,2025-05-25T06:26:00+02:00,2025-05-25,14:26,5,6,11
63,2025-05-25T06:27:00+02:00,2025-05-25,14:27,12,7,19
63,2025-05-25T06:28:00+02:00,2025-05-25,14:28,2,2,4
63,2025-05-25T06:29:00+02:00,2025-05-25,14:29,2,3,5
63,2025-05-25T06:34:00+02:00,2025-05-25,14:34,14,6,20
63,2025-05-25T06:36:00+02:00,2025-05-25,14:36,9,4,13
63,2025-05-25T06:38:00+02:00,2025-05-25,14:38,0,4,4
67,2025-05-25T06:26:00+02:00,2025-05-25,14:26,5,10,15
67,2025-05-25T06:28:00+02:00,2025-05-25,14:28,5,9,14
67,2025-05-25T06:29:00+02:00,2025-05-25,14:29,7,11,18
67,2025-05-25T06:31:00+02:00,2025-05-25,14:31,5,11,16
67,2025-05-25T06:32:00+02:00,2025-05-25,14:32,9,7,16
67,2025-05-25T06:33:00+02:00,2025-05-25,14:33,10,11,21
67,2025-05-25T06:37:00+02:00,2025-05-25,14:37,18,14,32
67,2025-05-25T06:38:00+02:00,2025-05-25,14:38,7,8,15
68,2025-05-25T06:28:00+02:00,2025-05-25,14:28,5,9,14
68,2025-05-25T06:29:00+02:00,2025-05-25,14:29,3,8,11
68,2025-05-25T06:31:00+02:00,2025-05-25,14:31,2,3,5
68,2025-05-25T06:32:00+02:00,2025-05-25,14:32,6,5,11
68,2025-05-25T06:39:00+02:00,2025-05-25,14:39,8,4,12
72,2025-05-25T06:26:00+02:00,2025-05-25,14:26,1,7,8
72,2025-05-25T06:33:00+02:00,2025-05-25,14:33,6,10,16
76,2025-05-25T06:27:00+02:00,2025-05-25,14:27,1,3,4
76,2025-05-25T06:29:00+02:00,2025-05-25,14:29,1,0,1
79,2025-05-25T06:25:00+02:00,2025-05-25,14:25,8,5,13
79,2025-05-25T06:27:00+02:00,2025-05-25,14:27,24,10,34
79,2025-05-25T06:28:00+02:00,2025-05-25,14:28,9,13,22
79,2025-05-25T06:31:00+02:00,2025-05-25,14:31,10,4,14
85,2025-05-25T06:34:00+02:00,2025-05-25,14:34,3,1,4
85,2025-05-25T06:35:00+02:00,2025-05-25,14:35,0,1,1
85,2025-05-25T06:37:00+02:00,2025-05-25,14:37,2,0,2
86,2025-05-25T06:25:00+02:00,2025-05-25,14:25,2,0,2
86,2025-05-25T06:28:00+02:00,2025-05-25,14:28,0,4,4
86,2025-05-25T06:29:00+02:00,2025-05-25,14:29,1,1,2
86,2025-05-25T06:30:00+02:00,2025-05-25,14:30,1,0,1
86,2025-05-25T06:37:00+02:00,2025-05-25,14:37,2,0,2
109,2025-05-25T06:25:00+02:00,2025-05-25,14:25,9,10,19
109,2025-05-25T06:35:00+02:00,2025-05-25,14:35,12,3,15
123,2025-05-25T06:35:00+02:00,2025-05-25,14:35,8,7,15
130,2025-05-25T06:30:00+02:00,2025-05-25,14:30,15,2,17
136,2025-05-25T06:25:00+02:00,2025-05-25,14:25,149,7,156
136,2025-05-25T06:35:00+02:00,2025-05-25,14:35,145,12,157
138,2025-05-25T06:35:00+02:00,2025-05-25,14:35,0,1,1
141,2025-05-25T06:25:00+02:00,2025-05-25,14:25,13,19,32
141,2025-05-25T06:35:00+02:00,2025-05-25,14:35,21,17,38
161,2025-05-25T06:25:00+02:00,2025-05-25,14:25,163,9,172
161,2025-05-25T06:35:00+02:00,2025-05-25,14:35,104,15,119
164,2025-05-25T06:30:00+02:00,2025-05-25,14:30,10,2,12
181,2025-05-25T06:25:00+02:00,2025-05-25,14:25,14,17,31
181,2025-05-25T06:29:00+02:00,2025-05-25,14:29,6,31,37
181,2025-05-25T06:33:00+02:00,2025-05-25,14:33,10,21,31
181,2025-05-25T06:35:00+02:00,2025-05-25,14:35,8,17,25
181,2025-05-25T06:38:00+02:00,2025-05-25,14:38,16,35,51
182,2025-05-25T06:30:00+02:00,2025-05-25,14:30,12,21,33
180,2025-05-25T06:39:00+02:00,2025-05-25,14:39,0,1,1
3,2025-05-25T06:57:00+02:00,2025-05-25,14:57,22,29,51
3,2025-05-25T06:59:00+02:00,2025-05-25,14:59,14,11,25
3,2025-05-25T07:01:00+02:00,2025-05-25,15:01,35,17,52
3,2025-05-25T07:02:00+02:00,2025-05-25,15:02,12,24,36
4,2025-05-25T06:55:00+02:00,2025-05-25,14:55,38,22,60
4,2025-05-25T06:59:00+02:00,2025-05-25,14:59,36,33,69
4,2025-05-25T07:02:00+02:00,2025-05-25,15:02,28,25,53
5,2025-05-25T06:55:00+02:00,2025-05-25,14:55,69,98,167
5,2025-05-25T07:00:00+02:00,2025-05-25,15:00,78,93,171
6,2025-05-25T06:56:00+02:00,2025-05-25,14:56,14,19,33
6,2025-05-25T07:01:00+02:00,2025-05-25,15:01,18,24,42
6,2025-05-25T07:03:00+02:00,2025-05-25,15:03,22,8,30
6,2025-05-25T07:04:00+02:00,2025-05-25,15:04,12,6,18
6,2025-05-25T07:05:00+02:00,2025-05-25,15:05,14,20,34
8,2025-05-25T06:56:00+02:00,2025-05-25,14:56,4,4,8
8,2025-05-25T06:59:00+02:00,2025-05-25,14:59,2,6,8
8,2025-05-25T07:01:00+02:00,2025-05-25,15:01,13,1,14
8,2025-05-25T07:04:00+02:00,2025-05-25,15:04,6,4,10
28,2025-05-25T06:57:00+02:00,2025-05-25,14:57,6,12,18
28,2025-05-25T07:03:00+02:00,2025-05-25,15:03,8,20,28
28,2025-05-25T07:06:00+02:00,2025-05-25,15:06,6,11,17
28,2025-05-25T07:08:00+02:00,2025-05-25,15:08,10,6,16
28,2025-05-25T07:09:00+02:00,2025-05-25,15:09,11,9,20
29,2025-05-25T07:01:00+02:00,2025-05-25,15:01,11,10,21
31,2025-05-25T06:57:00+02:00,2025-05-25,14:57,3,3,6
31,2025-05-25T06:58:00+02:00,2025-05-25,14:58,2,5,7
31,2025-05-25T06:59:00+02:00,2025-05-25,14:59,7,0,7
31,2025-05-25T07:02:00+02:00,2025-05-25,15:02,5,5,10
31,2025-05-25T07:03:00+02:00,2025-05-25,15:03,7,3,10
31,2025-05-25T07:05:00+02:00,2025-05-25,15:05,6,4,10
31,2025-05-25T07:06:00+02:00,2025-05-25,15:06,3,1,4
31,2025-05-25T07:07:00+02:00,2025-05-25,15:07,0,1,1
36,2025-05-25T06:59:00+02:00,2025-05-25,14:59,4,0,4
36,2025-05-25T07:06:00+02:00,2025-05-25,15:06,2,1,3
36,2025-05-25T07:08:00+02:00,2025-05-25,15:08,2,0,2
39,2025-05-25T07:04:00+02:00,2025-05-25,15:04,3,4,7
39,2025-05-25T07:05:00+02:00,2025-05-25,15:05,4,1,5
39,2025-05-25T07:07:00+02:00,2025-05-25,15:07,3,2,5
40,2025-05-25T07:00:00+02:00,2025-05-25,15:00,8,1,9
40,2025-05-25T07:02:00+02:00,2025-05-25,15:02,1,1,2
40,2025-05-25T07:04:00+02:00,2025-05-25,15:04,4,1,5
40,2025-05-25T07:05:00+02:00,2025-05-25,15:05,9,1,10
41,2025-05-25T06:55:00+02:00,2025-05-25,14:55,13,11,24
41,2025-05-25T06:58:00+02:00,2025-05-25,14:58,18,6,24
41,2025-05-25T07:02:00+02:00,2025-05-25,15:02,21,17,38
41,2025-05-25T07:07:00+02:00,2025-05-25,15:07,7,10,17
41,2025-05-25T07:09:00+02:00,2025-05-25,15:09,12,12,24
43,2025-05-25T07:00:00+02:00,2025-05-25,15:00,4,11,15
44,2025-05-25T06:55:00+02:00,2025-05-25,14:55,6,3,9
45,2025-05-25T07:04:00+02:00,2025-05-25,15:04,13,19,32
45,2025-05-25T07:09:00+02:00,2025-05-25,15:09,9,19,28
47,2025-05-25T06:56:00+02:00,2025-05-25,14:56,25,26,51
47,2025-05-25T06:57:00+02:00,2025-05-25,14:57,17,20,37
47,2025-05-25T06:58:00+02:00,2025-05-25,14:58,17,28,45
47,2025-05-25T06:59:00+02:00,2025-05-25,14:59,23,13,36
47,2025-05-25T07:01:00+02:00,2025-05-25,15:01,10,28,38
47,2025-05-25T07:02:00+02:00,2025-05-25,15:02,16,13,29
47,2025-05-25T07:06:00+02:00,2025-05-25,15:06,18,24,42
47,2025-05-25T07:09:00+02:00,2025-05-25,15:09,3,15,18
50,2025-05-25T06:55:00+02:00,2025-05-25,14:55,0,1,1
50,2025-05-25T06:56:00+02:00,2025-05-25,14:56,4,4,8
50,2025-05-25T06:58:00+02:00,2025-05-25,14:58,2,6,8
50,2025-05-25T07:00:00+02:00,2025-05-25,15:00,7,2,9
50,2025-05-25T07:03:00+02:00,2025-05-25,15:03,4,12,16
50,2025-05-25T07:08:00+02:00,2025-05-25,15:08,3,1,4
50,2025-05-25T07:09:00+02:00,2025-05-25,15:09,6,8,14
54,2025-05-25T06:55:00+02:00,2025-05-25,14:55,2,0,2
54,2025-05-25T06:56:00+02:00,2025-05-25,14:56,1,1,2
54,2025-05-25T07:02:00+02:00,2025-05-25,15:02,2,1,3
54,2025-05-25T07:06:00+02:00,2025-05-25,15:06,1,0,1
61,2025-05-25T06:55:00+02:00,2025-05-25,14:55,6,9,15
61,2025-05-25T07:00:00+02:00,2025-05-25,15:00,5,5,10
61,2025-05-25T07:01:00+02:00,2025-05-25,15:01,7,3,10
61,2025-05-25T07:02:00+02:00,2025-05-25,15:02,8,10,18
61,2025-05-25T07:04:00+02:00,2025-05-25,15:04,6,7,13
61,2025-05-25T07:06:00+02:00,2025-05-25,15:06,11,2,13
61,2025-05-25T07:07:00+02:00,2025-05-25,15:07,7,14,21
66,2025-05-25T07:05:00+02:00,2025-05-25,15:05,23,30,53
66,2025-05-25T07:07:00+02:00,2025-05-25,15:07,23,27,50
66,2025-05-25T07:09:00+02:00,2025-05-25,15:09,32,21,53
69,2025-05-25T06:56:00+02:00,2025-05-25,14:56,4,3,7
69,2025-05-25T06:57:00+02:00,2025-05-25,14:57,5,3,8
69,2025-05-25T07:02:00+02:00,2025-05-25,15:02,7,0,7
69,2025-05-25T07:07:00+02:00,2025-05-25,15:07,0,4,4
69,2025-05-25T07:08:00+02:00,2025-05-25,15:08,1,8,9
69,2025-05-25T07:09:00+02:00,2025-05-25,15:09,0,5,5
70,2025-05-25T06:58:00+02:00,2025-05-25,14:58,2,2,4
70,2025-05-25T07:05:00+02:00,2025-05-25,15:05,0,2,2
70,2025-05-25T07:09:00+02:00,2025-05-25,15:09,3,4,7
71,2025-05-25T06:58:00+02:00,2025-05-25,14:58,0,1,1
75,2025-05-25T06:57:00+02:00,2025-05-25,14:57,0,5,5
75,2025-05-25T06:58:00+02:00,2025-05-25,14:58,0,5,5
75,2025-05-25T07:01:00+02:00,2025-05-25,15:01,0,7,7
75,2025-05-25T07:03:00+02:00,2025-05-25,15:03,2,1,3
75,2025-05-25T07:04:00+02:00,2025-05-25,15:04,0,2,2
75,2025-05-25T07:07:00+02:00,2025-05-25,15:07,1,2,3
75,2025-05-25T07:08:00+02:00,2025-05-25,15:08,2,1,3
77,2025-05-25T06:55:00+02:00,2025-05-25,14:55,23,18,41
78,2025-05-25T06:57:00+02:00,2025-05-25,14:57,0,1,1
78,2025-05-25T07:00:00+02:00,2025-05-25,15:00,1,0,1
78,2025-05-25T07:01:00+02:00,2025-05-25,15:01,0,1,1
78,2025-05-25T07:04:00+02:00,2025-05-25,15:04,3,5,8
78,2025-05-25T07:05:00+02:00,2025-05-25,15:05,4,2,6
78,2025-05-25T07:08:00+02:00,2025-05-25,15:08,1,3,4
87,2025-05-25T07:00:00+02:00,2025-05-25,15:00,2,1,3
87,2025-05-25T07:01:00+02:00,2025-05-25,15:01,1,0,1
87,2025-05-25T07:04:00+02:00,2025-05-25,15:04,0,2,2
87,2025-05-25T07:05:00+02:00,2025-05-25,15:05,3,3,6
87,2025-05-25T07:06:00+02:00,2025-05-25,15:06,1,1,2
108,2025-05-25T06:57:00+02:00,2025-05-25,14:57,4,4,8
108,2025-05-25T06:58:00+02:00,2025-05-25,14:58,3,9,12
108,2025-05-25T07:03:00+02:00,2025-05-25,15:03,1,1,2
108,2025-05-25T07:04:00+02:00,2025-05-25,15:04,2,2,4
108,2025-05-25T07:05:00+02:00,2025-05-25,15:05,3,1,4
118,2025-05-25T07:00:00+02:00,2025-05-25,15:00,1,2,3
131,2025-05-25T07:05:00+02:00,2025-05-25,15:05,18,4,22
132,2025-05-25T06:55:00+02:00,2025-05-25,14:55,14,10,24
133,2025-05-25T06:55:00+02:00,2025-05-25,14:55,32,56,88
133,2025-05-25T07:00:00+02:00,2025-05-25,15:00,50,25,75
134,2025-05-25T06:55:00+02:00,2025-05-25,14:55,45,23,68
134,2025-05-25T07:00:00+02:00,2025-05-25,15:00,20,28,48
135,2025-05-25T06:55:00+02:00,2025-05-25,14:55,37,32,69
135,2025-05-25T07:00:00+02:00,2025-05-25,15:00,34,24,58
166,2025-05-25T06:55:00+02:00,2025-05-25,14:55,5,5,10
166,2025-05-25T07:00:00+02:00,2025-05-25,15:00,6,3,9
166,2025-05-25T07:05:00+02:00,2025-05-25,15:05,1,5,6
167,2025-05-25T06:55:00+02:00,2025-05-25,14:55,2,2,4
167,2025-05-25T07:05:00+02:00,2025-05-25,15:05,6,3,9
179,2025-05-25T06:55:00+02:00,2025-05-25,14:55,1,3,4
1,2025-05-25T06:55:00+02:00,2025-05-25,14:55,20,35,55
1,2025-05-25T06:57:00+02:00,2025-05-25,14:57,15,22,37
1,2025-05-25T06:58:00+02:00,2025-05-25,14:58,21,15,36
1,2025-05-25T06:59:00+02:00,2025-05-25,14:59,25,21,46
1,2025-05-25T07:01:00+02:00,2025-05-25,15:01,36,21,57
1,2025-05-25T07:03:00+02:00,2025-05-25,15:03,26,29,55
1,2025-05-25T07:05:00+02:00,2025-05-25,15:05,34,21,55
1,2025-05-25T07:08:00+02:00,2025-05-25,15:08,28,14,42
2,2025-05-25T06:55:00+02:00,2025-05-25,14:55,20,15,35
2,2025-05-25T06:59:00+02:00,2025-05-25,14:59,25,22,47
2,2025-05-25T07:03:00+02:00,2025-05-25,15:03,6,15,21
2,2025-05-25T07:05:00+02:00,2025-05-25,15:05,16,19,35
2,2025-05-25T07:08:00+02:00,2025-05-25,15:08,21,13,34
9,2025-05-25T06:55:00+02:00,2025-05-25,14:55,3,0,3
9,2025-05-25T06:58:00+02:00,2025-05-25,14:58,0,3,3
9,2025-05-25T07:02:00+02:00,2025-05-25,15:02,1,0,1
10,2025-05-25T07:02:00+02:00,2025-05-25,15:02,4,2,6
10,2025-05-25T07:04:00+02:00,2025-05-25,15:04,0,1,1
10,2025-05-25T07:09:00+02:00,2025-05-25,15:09,2,1,3
11,2025-05-25T06:57:00+02:00,2025-05-25,14:57,2,0,2
11,2025-05-25T06:59:00+02:00,2025-05-25,14:59,3,2,5
11,2025-05-25T07:03:00+02:00,2025-05-25,15:03,1,1,2
11,2025-05-25T07:04:00+02:00,2025-05-25,15:04,0,2,2
11,2025-05-25T07:08:00+02:00,2025-05-25,15:08,1,0,1
12,2025-05-25T06:56:00+02:00,2025-05-25,14:56,19,3,22
12,2025-05-25T06:58:00+02:00,2025-05-25,14:58,2,7,9
12,2025-05-25T07:01:00+02:00,2025-05-25,15:01,8,8,16
12,2025-05-25T07:02:00+02:00,2025-05-25,15:02,7,9,16
12,2025-05-25T07:03:00+02:00,2025-05-25,15:03,4,12,16
12,2025-05-25T07:04:00+02:00,2025-05-25,15:04,5,3,8
12,2025-05-25T07:07:00+02:00,2025-05-25,15:07,8,2,10
12,2025-05-25T07:08:00+02:00,2025-05-25,15:08,6,2,8
12,2025-05-25T07:09:00+02:00,2025-05-25,15:09,2,8,10
17,2025-05-25T06:55:00+02:00,2025-05-25,14:55,5,0,5
17,2025-05-25T07:02:00+02:00,2025-05-25,15:02,1,1,2
17,2025-05-25T07:06:00+02:00,2025-05-25,15:06,1,6,7
17,2025-05-25T07:07:00+02:00,2025-05-25,15:07,2,11,13
17,2025-05-25T07:08:00+02:00,2025-05-25,15:08,2,4,6
18,2025-05-25T06:57:00+02:00,2025-05-25,14:57,0,4,4
18,2025-05-25T06:58:00+02:00,2025-05-25,14:58,3,0,3
18,2025-05-25T07:01:00+02:00,2025-05-25,15:01,1,1,2
18,2025-05-25T07:04:00+02:00,2025-05-25,15:04,0,1,1
18,2025-05-25T07:05:00+02:00,2025-05-25,15:05,0,1,1
18,2025-05-25T07:09:00+02:00,2025-05-25,15:09,1,0,1
19,2025-05-25T06:55:00+02:00,2025-05-25,14:55,7,16,23
19,2025-05-25T06:56:00+02:00,2025-05-25,14:56,3,4,7
19,2025-05-25T06:59:00+02:00,2025-05-25,14:59,13,6,19
19,2025-05-25T07:00:00+02:00,2025-05-25,15:00,7,10,17
19,2025-05-25T07:01:00+02:00,2025-05-25,15:01,12,11,23
19,2025-05-25T07:06:00+02:00,2025-05-25,15:06,13,12,25
19,2025-05-25T07:09:00+02:00,2025-05-25,15:09,9,7,16
20,2025-05-25T06:58:00+02:00,2025-05-25,14:58,1,7,8
20,2025-05-25T06:59:00+02:00,2025-05-25,14:59,4,8,12
20,2025-05-25T07:04:00+02:00,2025-05-25,15:04,0,4,4
23,2025-05-25T06:56:00+02:00,2025-05-25,14:56,1,0,1
23,2025-05-25T06:59:00+02:00,2025-05-25,14:59,2,3,5
23,2025-05-25T07:00:00+02:00,2025-05-25,15:00,0,2,2
24,2025-05-25T06:55:00+02:00,2025-05-25,14:55,3,20,23
24,2025-05-25T06:59:00+02:00,2025-05-25,14:59,5,6,11
24,2025-05-25T07:03:00+02:00,2025-05-25,15:03,14,15,29
24,2025-05-25T07:04:00+02:00,2025-05-25,15:04,8,7,15
24,2025-05-25T07:09:00+02:00,2025-05-25,15:09,12,9,21
25,2025-05-25T06:55:00+02:00,2025-05-25,14:55,109,60,169
27,2025-05-25T06:56:00+02:00,2025-05-25,14:56,4,3,7
27,2025-05-25T06:58:00+02:00,2025-05-25,14:58,0,1,1
27,2025-05-25T07:00:00+02:00,2025-05-25,15:00,6,0,6
27,2025-05-25T07:01:00+02:00,2025-05-25,15:01,3,4,7
27,2025-05-25T07:02:00+02:00,2025-05-25,15:02,7,5,12
30,2025-05-25T06:55:00+02:00,2025-05-25,14:55,5,8,13
30,2025-05-25T06:57:00+02:00,2025-05-25,14:57,3,2,5
30,2025-05-25T06:58:00+02:00,2025-05-25,14:58,6,17,23
30,2025-05-25T07:02:00+02:00,2025-05-25,15:02,5,11,16
30,2025-05-25T07:04:00+02:00,2025-05-25,15:04,3,7,10
30,2025-05-25T07:05:00+02:00,2025-05-25,15:05,11,9,20
30,2025-05-25T07:06:00+02:00,2025-05-25,15:06,7,10,17
30,2025-05-25T07:07:00+02:00,2025-05-25,15:07,4,6,10
35,2025-05-25T06:56:00+02:00,2025-05-25,14:56,21,17,38
35,2025-05-25T06:59:00+02:00,2025-05-25,14:59,27,29,56
35,2025-05-25T07:01:00+02:00,2025-05-25,15:01,11,24,35
35,2025-05-25T07:07:00+02:00,2025-05-25,15:07,31,33,64
35,2025-05-25T07:08:00+02:00,2025-05-25,15:08,6,31,37
35,2025-05-25T07:09:00+02:00,2025-05-25,15:09,28,17,45
48,2025-05-25T07:05:00+02:00,2025-05-25,15:05,16,8,24
48,2025-05-25T07:06:00+02:00,2025-05-25,15:06,19,7,26
48,2025-05-25T07:08:00+02:00,2025-05-25,15:08,15,4,19
49,2025-05-25T06:55:00+02:00,2025-05-25,14:55,4,3,7
49,2025-05-25T06:56:00+02:00,2025-05-25,14:56,8,13,21
49,2025-05-25T07:00:00+02:00,2025-05-25,15:00,1,3,4
49,2025-05-25T07:02:00+02:00,2025-05-25,15:02,8,4,12
49,2025-05-25T07:04:00+02:00,2025-05-25,15:04,9,19,28
51,2025-05-25T06:55:00+02:00,2025-05-25,14:55,3,0,3
51,2025-05-25T06:56:00+02:00,2025-05-25,14:56,2,4,6
52,2025-05-25T06:58:00+02:00,2025-05-25,14:58,9,2,11
52,2025-05-25T07:00:00+02:00,2025-05-25,15:00,7,10,17
52,2025-05-25T07:01:00+02:00,2025-05-25,15:01,8,5,13
52,2025-05-25T07:02:00+02:00,2025-05-25,15:02,3,9,12
52,2025-05-25T07:03:00+02:00,2025-05-25,15:03,11,5,16
52,2025-05-25T07:05:00+02:00,2025-05-25,15:05,10,11,21
52,2025-05-25T07:06:00+02:00,2025-05-25,15:06,6,13,19
52,2025-05-25T07:08:00+02:00,2025-05-25,15:08,2,10,12
53,2025-05-25T06:55:00+02:00,2025-05-25,14:55,10,9,19
53,2025-05-25T07:09:00+02:00,2025-05-25,15:09,11,13,24
56,2025-05-25T06:55:00+02:00,2025-05-25,14:55,8,11,19
56,2025-05-25T06:58:00+02:00,2025-05-25,14:58,4,10,14
58,2025-05-25T06:57:00+02:00,2025-05-25,14:57,10,10,20
58,2025-05-25T07:07:00+02:00,2025-05-25,15:07,19,6,25
58,2025-05-25T07:08:00+02:00,2025-05-25,15:08,8,8,16
62,2025-05-25T07:02:00+02:00,2025-05-25,15:02,3,5,8
62,2025-05-25T07:04:00+02:00,2025-05-25,15:04,6,1,7
62,2025-05-25T07:05:00+02:00,2025-05-25,15:05,6,3,9
62,2025-05-25T07:06:00+02:00,2025-05-25,15:06,3,5,8
62,2025-05-25T07:09:00+02:00,2025-05-25,15:09,5,3,8
63,2025-05-25T06:59:00+02:00,2025-05-25,14:59,4,8,12
63,2025-05-25T07:01:00+02:00,2025-05-25,15:01,8,6,14
63,2025-05-25T07:04:00+02:00,2025-05-25,15:04,4,4,8
63,2025-05-25T07:08:00+02:00,2025-05-25,15:08,10,4,14
63,2025-05-25T07:09:00+02:00,2025-05-25,15:09,8,6,14
67,2025-05-25T06:56:00+02:00,2025-05-25,14:56,10,12,22
67,2025-05-25T06:58:00+02:00,2025-05-25,14:58,6,7,13
67,2025-05-25T07:01:00+02:00,2025-05-25,15:01,10,7,17
67,2025-05-25T07:03:00+02:00,2025-05-25,15:03,6,9,15
67,2025-05-25T07:05:00+02:00,2025-05-25,15:05,9,9,18
67,2025-05-25T07:06:00+02:00,2025-05-25,15:06,10,3,13
67,2025-05-25T07:08:00+02:00,2025-05-25,15:08,9,5,14
68,2025-05-25T06:55:00+02:00,2025-05-25,14:55,5,5,10
68,2025-05-25T07:00:00+02:00,2025-05-25,15:00,10,4,14
68,2025-05-25T07:01:00+02:00,2025-05-25,15:01,5,10,15
72,2025-05-25T06:56:00+02:00,2025-05-25,14:56,8,11,19
72,2025-05-25T07:02:00+02:00,2025-05-25,15:02,11,17,28
72,2025-05-25T07:06:00+02:00,2025-05-25,15:06,4,16,20
72,2025-05-25T07:07:00+02:00,2025-05-25,15:07,6,11,17
72,2025-05-25T07:09:00+02:00,2025-05-25,15:09,11,10,21
76,2025-05-25T06:56:00+02:00,2025-05-25,14:56,0,1,1
76,2025-05-25T06:57:00+02:00,2025-05-25,14:57,1,0,1
76,2025-05-25T06:58:00+02:00,2025-05-25,14:58,0,1,1
76,2025-05-25T07:02:00+02:00,2025-05-25,15:02,1,0,1
79,2025-05-25T06:56:00+02:00,2025-05-25,14:56,13,5,18
79,2025-05-25T06:59:00+02:00,2025-05-25,14:59,5,7,12
79,2025-05-25T07:05:00+02:00,2025-05-25,15:05,13,4,17
79,2025-05-25T07:08:00+02:00,2025-05-25,15:08,12,13,25
79,2025-05-25T07:09:00+02:00,2025-05-25,15:09,19,7,26
85,2025-05-25T06:59:00+02:00,2025-05-25,14:59,3,0,3
85,2025-05-25T07:03:00+02:00,2025-05-25,15:03,1,0,1
85,2025-05-25T07:05:00+02:00,2025-05-25,15:05,1,0,1
85,2025-05-25T07:08:00+02:00,2025-05-25,15:08,1,4,5
86,2025-05-25T07:02:00+02:00,2025-05-25,15:02,1,0,1
86,2025-05-25T07:06:00+02:00,2025-05-25,15:06,2,5,7
117,2025-05-25T06:55:00+02:00,2025-05-25,14:55,22,34,56
130,2025-05-25T06:55:00+02:00,2025-05-25,14:55,1,3,4
130,2025-05-25T07:05:00+02:00,2025-05-25,15:05,4,0,4
137,2025-05-25T07:00:00+02:00,2025-05-25,15:00,3,0,3
139,2025-05-25T07:05:00+02:00,2025-05-25,15:05,10,4,14
141,2025-05-25T06:55:00+02:00,2025-05-25,14:55,19,8,27
141,2025-05-25T07:00:00+02:00,2025-05-25,15:00,31,5,36
3,2025-05-25T06:41:00+02:00,2025-05-25,14:41,24,15,39
3,2025-05-25T06:42:00+02:00,2025-05-25,14:42,12,16,28
3,2025-05-25T06:47:00+02:00,2025-05-25,14:47,26,14,40
3,2025-05-25T06:48:00+02:00,2025-05-25,14:48,24,35,59
3,2025-05-25T06:49:00+02:00,2025-05-25,14:49,31,30,61
3,2025-05-25T06:50:00+02:00,2025-05-25,14:50,13,16,29
3,2025-05-25T06:51:00+02:00,2025-05-25,14:51,8,16,24
4,2025-05-25T06:48:00+02:00,2025-05-25,14:48,25,17,42
4,2025-05-25T06:49:00+02:00,2025-05-25,14:49,25,28,53
4,2025-05-25T06:50:00+02:00,2025-05-25,14:50,47,16,63
5,2025-05-25T06:40:00+02:00,2025-05-25,14:40,101,94,195
6,2025-05-25T06:41:00+02:00,2025-05-25,14:41,13,13,26
6,2025-05-25T06:42:00+02:00,2025-05-25,14:42,16,8,24
6,2025-05-25T06:44:00+02:00,2025-05-25,14:44,16,10,26
6,2025-05-25T06:45:00+02:00,2025-05-25,14:45,23,13,36
6,2025-05-25T06:48:00+02:00,2025-05-25,14:48,15,19,34
8,2025-05-25T06:41:00+02:00,2025-05-25,14:41,2,2,4
8,2025-05-25T06:43:00+02:00,2025-05-25,14:43,2,4,6
8,2025-05-25T06:44:00+02:00,2025-05-25,14:44,4,4,8
8,2025-05-25T06:47:00+02:00,2025-05-25,14:47,9,1,10
8,2025-05-25T06:52:00+02:00,2025-05-25,14:52,1,2,3
8,2025-05-25T06:53:00+02:00,2025-05-25,14:53,3,5,8
8,2025-05-25T06:54:00+02:00,2025-05-25,14:54,3,7,10
28,2025-05-25T06:43:00+02:00,2025-05-25,14:43,13,14,27
28,2025-05-25T06:44:00+02:00,2025-05-25,14:44,13,4,17
28,2025-05-25T06:45:00+02:00,2025-05-25,14:45,10,4,14
28,2025-05-25T06:49:00+02:00,2025-05-25,14:49,10,17,27
28,2025-05-25T06:50:00+02:00,2025-05-25,14:50,5,10,15
28,2025-05-25T06:51:00+02:00,2025-05-25,14:51,9,5,14
28,2025-05-25T06:53:00+02:00,2025-05-25,14:53,9,8,17
29,2025-05-25T06:40:00+02:00,2025-05-25,14:40,10,4,14
29,2025-05-25T06:41:00+02:00,2025-05-25,14:41,18,23,41
29,2025-05-25T06:48:00+02:00,2025-05-25,14:48,7,12,19
29,2025-05-25T06:49:00+02:00,2025-05-25,14:49,33,15,48
29,2025-05-25T06:53:00+02:00,2025-05-25,14:53,15,3,18
29,2025-05-25T06:54:00+02:00,2025-05-25,14:54,5,13,18
31,2025-05-25T06:40:00+02:00,2025-05-25,14:40,4,3,7
31,2025-05-25T06:42:00+02:00,2025-05-25,14:42,4,2,6
31,2025-05-25T06:43:00+02:00,2025-05-25,14:43,2,5,7
31,2025-05-25T06:46:00+02:00,2025-05-25,14:46,6,7,13
36,2025-05-25T06:42:00+02:00,2025-05-25,14:42,0,4,4
36,2025-05-25T06:46:00+02:00,2025-05-25,14:46,3,1,4
36,2025-05-25T06:49:00+02:00,2025-05-25,14:49,0,2,2
36,2025-05-25T06:54:00+02:00,2025-05-25,14:54,0,3,3
39,2025-05-25T06:52:00+02:00,2025-05-25,14:52,2,1,3
39,2025-05-25T06:53:00+02:00,2025-05-25,14:53,4,0,4
40,2025-05-25T06:46:00+02:00,2025-05-25,14:46,3,0,3
40,2025-05-25T06:47:00+02:00,2025-05-25,14:47,3,0,3
40,2025-05-25T06:48:00+02:00,2025-05-25,14:48,2,1,3
40,2025-05-25T06:49:00+02:00,2025-05-25,14:49,2,0,2
41,2025-05-25T06:40:00+02:00,2025-05-25,14:40,5,8,13
41,2025-05-25T06:42:00+02:00,2025-05-25,14:42,8,2,10
41,2025-05-25T06:44:00+02:00,2025-05-25,14:44,7,15,22
41,2025-05-25T06:49:00+02:00,2025-05-25,14:49,15,21,36
41,2025-05-25T06:52:00+02:00,2025-05-25,14:52,10,17,27
43,2025-05-25T06:40:00+02:00,2025-05-25,14:40,8,4,12
43,2025-05-25T06:50:00+02:00,2025-05-25,14:50,15,4,19
44,2025-05-25T06:40:00+02:00,2025-05-25,14:40,5,2,7
44,2025-05-25T06:50:00+02:00,2025-05-25,14:50,4,3,7
45,2025-05-25T06:41:00+02:00,2025-05-25,14:41,16,23,39
45,2025-05-25T06:42:00+02:00,2025-05-25,14:42,20,23,43
45,2025-05-25T06:45:00+02:00,2025-05-25,14:45,20,22,42
45,2025-05-25T06:51:00+02:00,2025-05-25,14:51,12,24,36
45,2025-05-25T06:54:00+02:00,2025-05-25,14:54,20,15,35
47,2025-05-25T06:44:00+02:00,2025-05-25,14:44,16,30,46
47,2025-05-25T06:45:00+02:00,2025-05-25,14:45,19,8,27
47,2025-05-25T06:46:00+02:00,2025-05-25,14:46,11,39,50
47,2025-05-25T06:47:00+02:00,2025-05-25,14:47,22,27,49
47,2025-05-25T06:54:00+02:00,2025-05-25,14:54,34,20,54
50,2025-05-25T06:41:00+02:00,2025-05-25,14:41,5,5,10
50,2025-05-25T06:42:00+02:00,2025-05-25,14:42,2,1,3
50,2025-05-25T06:43:00+02:00,2025-05-25,14:43,6,1,7
50,2025-05-25T06:47:00+02:00,2025-05-25,14:47,4,8,12
50,2025-05-25T06:50:00+02:00,2025-05-25,14:50,9,3,12
50,2025-05-25T06:54:00+02:00,2025-05-25,14:54,5,3,8
54,2025-05-25T06:44:00+02:00,2025-05-25,14:44,2,4,6
54,2025-05-25T06:47:00+02:00,2025-05-25,14:47,2,1,3
54,2025-05-25T06:52:00+02:00,2025-05-25,14:52,0,2,2
54,2025-05-25T06:54:00+02:00,2025-05-25,14:54,2,1,3
59,2025-05-25T06:50:00+02:00,2025-05-25,14:50,24,27,51
61,2025-05-25T06:42:00+02:00,2025-05-25,14:42,9,7,16
66,2025-05-25T06:42:00+02:00,2025-05-25,14:42,36,26,62
66,2025-05-25T06:46:00+02:00,2025-05-25,14:46,29,24,53
66,2025-05-25T06:50:00+02:00,2025-05-25,14:50,26,22,48
66,2025-05-25T06:51:00+02:00,2025-05-25,14:51,38,27,65
66,2025-05-25T06:53:00+02:00,2025-05-25,14:53,26,27,53
66,2025-05-25T06:54:00+02:00,2025-05-25,14:54,17,33,50
69,2025-05-25T06:43:00+02:00,2025-05-25,14:43,2,7,9
69,2025-05-25T06:44:00+02:00,2025-05-25,14:44,0,3,3
69,2025-05-25T06:49:00+02:00,2025-05-25,14:49,2,1,3
69,2025-05-25T06:50:00+02:00,2025-05-25,14:50,9,4,13
69,2025-05-25T06:54:00+02:00,2025-05-25,14:54,6,2,8
70,2025-05-25T06:41:00+02:00,2025-05-25,14:41,1,5,6
70,2025-05-25T06:42:00+02:00,2025-05-25,14:42,2,0,2
70,2025-05-25T06:45:00+02:00,2025-05-25,14:45,1,3,4
70,2025-05-25T06:46:00+02:00,2025-05-25,14:46,0,1,1
70,2025-05-25T06:47:00+02:00,2025-05-25,14:47,2,7,9
70,2025-05-25T06:53:00+02:00,2025-05-25,14:53,5,3,8
70,2025-05-25T06:54:00+02:00,2025-05-25,14:54,3,2,5
75,2025-05-25T06:41:00+02:00,2025-05-25,14:41,0,1,1
75,2025-05-25T06:44:00+02:00,2025-05-25,14:44,7,2,9
75,2025-05-25T06:45:00+02:00,2025-05-25,14:45,1,4,5
75,2025-05-25T06:46:00+02:00,2025-05-25,14:46,1,1,2
75,2025-05-25T06:52:00+02:00,2025-05-25,14:52,0,2,2
77,2025-05-25T06:45:00+02:00,2025-05-25,14:45,25,11,36
78,2025-05-25T06:40:00+02:00,2025-05-25,14:40,2,0,2
78,2025-05-25T06:45:00+02:00,2025-05-25,14:45,1,2,3
78,2025-05-25T06:50:00+02:00,2025-05-25,14:50,0,1,1
87,2025-05-25T06:40:00+02:00,2025-05-25,14:40,3,1,4
87,2025-05-25T06:42:00+02:00,2025-05-25,14:42,1,3,4
87,2025-05-25T06:44:00+02:00,2025-05-25,14:44,2,2,4
87,2025-05-25T06:46:00+02:00,2025-05-25,14:46,1,1,2
108,2025-05-25T06:45:00+02:00,2025-05-25,14:45,1,4,5
108,2025-05-25T06:47:00+02:00,2025-05-25,14:47,1,0,1
108,2025-05-25T06:51:00+02:00,2025-05-25,14:51,10,4,14
118,2025-05-25T06:50:00+02:00,2025-05-25,14:50,1,3,4
124,2025-05-25T06:40:00+02:00,2025-05-25,14:40,0,4,4
124,2025-05-25T06:45:00+02:00,2025-05-25,14:45,0,5,5
132,2025-05-25T06:40:00+02:00,2025-05-25,14:40,11,21,32
135,2025-05-25T06:45:00+02:00,2025-05-25,14:45,46,51,97
140,2025-05-25T06:45:00+02:00,2025-05-25,14:45,9,5,14
165,2025-05-25T06:40:00+02:00,2025-05-25,14:40,6,0,6
167,2025-05-25T06:45:00+02:00,2025-05-25,14:45,1,0,1
167,2025-05-25T06:50:00+02:00,2025-05-25,14:50,3,1,4
179,2025-05-25T06:50:00+02:00,2025-05-25,14:50,2,6,8
1,2025-05-25T06:40:00+02:00,2025-05-25,14:40,19,28,47
1,2025-05-25T06:43:00+02:00,2025-05-25,14:43,45,21,66
1,2025-05-25T06:44:00+02:00,2025-05-25,14:44,21,10,31
1,2025-05-25T06:48:00+02:00,2025-05-25,14:48,25,36,61
2,2025-05-25T06:40:00+02:00,2025-05-25,14:40,11,14,25
2,2025-05-25T06:47:00+02:00,2025-05-25,14:47,13,20,33
2,2025-05-25T06:49:00+02:00,2025-05-25,14:49,18,9,27
2,2025-05-25T06:50:00+02:00,2025-05-25,14:50,8,4,12
2,2025-05-25T06:51:00+02:00,2025-05-25,14:51,19,8,27
2,2025-05-25T06:54:00+02:00,2025-05-25,14:54,13,16,29
9,2025-05-25T06:40:00+02:00,2025-05-25,14:40,0,2,2
9,2025-05-25T06:43:00+02:00,2025-05-25,14:43,2,0,2
9,2025-05-25T06:45:00+02:00,2025-05-25,14:45,4,3,7
9,2025-05-25T06:46:00+02:00,2025-05-25,14:46,0,3,3
9,2025-05-25T06:47:00+02:00,2025-05-25,14:47,0,4,4
9,2025-05-25T06:48:00+02:00,2025-05-25,14:48,3,3,6
9,2025-05-25T06:51:00+02:00,2025-05-25,14:51,0,1,1
10,2025-05-25T06:40:00+02:00,2025-05-25,14:40,0,2,2
10,2025-05-25T06:46:00+02:00,2025-05-25,14:46,1,0,1
10,2025-05-25T06:51:00+02:00,2025-05-25,14:51,0,1,1
11,2025-05-25T06:42:00+02:00,2025-05-25,14:42,8,0,8
11,2025-05-25T06:49:00+02:00,2025-05-25,14:49,0,3,3
11,2025-05-25T06:51:00+02:00,2025-05-25,14:51,5,0,5
11,2025-05-25T06:54:00+02:00,2025-05-25,14:54,1,1,2
12,2025-05-25T06:40:00+02:00,2025-05-25,14:40,2,7,9
12,2025-05-25T06:41:00+02:00,2025-05-25,14:41,4,11,15
12,2025-05-25T06:42:00+02:00,2025-05-25,14:42,4,5,9
12,2025-05-25T06:45:00+02:00,2025-05-25,14:45,18,3,21
12,2025-05-25T06:46:00+02:00,2025-05-25,14:46,6,7,13
12,2025-05-25T06:47:00+02:00,2025-05-25,14:47,5,3,8
12,2025-05-25T06:51:00+02:00,2025-05-25,14:51,7,2,9
12,2025-05-25T06:52:00+02:00,2025-05-25,14:52,5,1,6
17,2025-05-25T06:41:00+02:00,2025-05-25,14:41,2,4,6
17,2025-05-25T06:44:00+02:00,2025-05-25,14:44,2,1,3
17,2025-05-25T06:45:00+02:00,2025-05-25,14:45,5,2,7
17,2025-05-25T06:46:00+02:00,2025-05-25,14:46,5,3,8
17,2025-05-25T06:48:00+02:00,2025-05-25,14:48,4,0,4
17,2025-05-25T06:49:00+02:00,2025-05-25,14:49,1,5,6
17,2025-05-25T06:53:00+02:00,2025-05-25,14:53,4,0,4
17,2025-05-25T06:54:00+02:00,2025-05-25,14:54,0,2,2
18,2025-05-25T06:40:00+02:00,2025-05-25,14:40,1,0,1
18,2025-05-25T06:41:00+02:00,2025-05-25,14:41,5,0,5
18,2025-05-25T06:46:00+02:00,2025-05-25,14:46,4,0,4
18,2025-05-25T06:48:00+02:00,2025-05-25,14:48,0,1,1
19,2025-05-25T06:42:00+02:00,2025-05-25,14:42,6,9,15
19,2025-05-25T06:43:00+02:00,2025-05-25,14:43,10,16,26
19,2025-05-25T06:46:00+02:00,2025-05-25,14:46,4,14,18
19,2025-05-25T06:48:00+02:00,2025-05-25,14:48,6,12,18
19,2025-05-25T06:49:00+02:00,2025-05-25,14:49,9,10,19
19,2025-05-25T06:52:00+02:00,2025-05-25,14:52,9,7,16
19,2025-05-25T06:53:00+02:00,2025-05-25,14:53,7,11,18
19,2025-05-25T06:54:00+02:00,2025-05-25,14:54,3,16,19
20,2025-05-25T06:40:00+02:00,2025-05-25,14:40,1,1,2
20,2025-05-25T06:47:00+02:00,2025-05-25,14:47,5,7,12
20,2025-05-25T06:49:00+02:00,2025-05-25,14:49,2,13,15
20,2025-05-25T06:52:00+02:00,2025-05-25,14:52,2,5,7
23,2025-05-25T06:42:00+02:00,2025-05-25,14:42,0,6,6
23,2025-05-25T06:45:00+02:00,2025-05-25,14:45,0,3,3
23,2025-05-25T06:46:00+02:00,2025-05-25,14:46,4,5,9
23,2025-05-25T06:50:00+02:00,2025-05-25,14:50,3,5,8
23,2025-05-25T06:51:00+02:00,2025-05-25,14:51,4,2,6
23,2025-05-25T06:54:00+02:00,2025-05-25,14:54,0,4,4
24,2025-05-25T06:41:00+02:00,2025-05-25,14:41,1,3,4
24,2025-05-25T06:44:00+02:00,2025-05-25,14:44,4,22,26
24,2025-05-25T06:45:00+02:00,2025-05-25,14:45,14,8,22
24,2025-05-25T06:47:00+02:00,2025-05-25,14:47,1,3,4
24,2025-05-25T06:48:00+02:00,2025-05-25,14:48,24,4,28
24,2025-05-25T06:49:00+02:00,2025-05-25,14:49,3,16,19
24,2025-05-25T06:53:00+02:00,2025-05-25,14:53,7,12,19
25,2025-05-25T06:40:00+02:00,2025-05-25,14:40,69,75,144
25,2025-05-25T06:50:00+02:00,2025-05-25,14:50,97,105,202
27,2025-05-25T06:45:00+02:00,2025-05-25,14:45,5,5,10
27,2025-05-25T06:46:00+02:00,2025-05-25,14:46,7,2,9
30,2025-05-25T06:43:00+02:00,2025-05-25,14:43,5,8,13
30,2025-05-25T06:46:00+02:00,2025-05-25,14:46,14,0,14
30,2025-05-25T06:47:00+02:00,2025-05-25,14:47,6,7,13
30,2025-05-25T06:48:00+02:00,2025-05-25,14:48,8,10,18
30,2025-05-25T06:52:00+02:00,2025-05-25,14:52,3,4,7
30,2025-05-25T06:53:00+02:00,2025-05-25,14:53,5,23,28
35,2025-05-25T06:42:00+02:00,2025-05-25,14:42,24,22,46
35,2025-05-25T06:50:00+02:00,2025-05-25,14:50,13,19,32
35,2025-05-25T06:52:00+02:00,2025-05-25,14:52,5,38,43
48,2025-05-25T06:41:00+02:00,2025-05-25,14:41,10,7,17
48,2025-05-25T06:45:00+02:00,2025-05-25,14:45,25,5,30
48,2025-05-25T06:51:00+02:00,2025-05-25,14:51,15,8,23
48,2025-05-25T06:53:00+02:00,2025-05-25,14:53,11,5,16
48,2025-05-25T06:54:00+02:00,2025-05-25,14:54,8,2,10
49,2025-05-25T06:42:00+02:00,2025-05-25,14:42,9,7,16
49,2025-05-25T06:44:00+02:00,2025-05-25,14:44,11,11,22
49,2025-05-25T06:47:00+02:00,2025-05-25,14:47,7,12,19
49,2025-05-25T06:48:00+02:00,2025-05-25,14:48,3,3,6
49,2025-05-25T06:49:00+02:00,2025-05-25,14:49,5,9,14
49,2025-05-25T06:51:00+02:00,2025-05-25,14:51,7,4,11
51,2025-05-25T06:40:00+02:00,2025-05-25,14:40,4,1,5
51,2025-05-25T06:42:00+02:00,2025-05-25,14:42,2,7,9
51,2025-05-25T06:45:00+02:00,2025-05-25,14:45,0,1,1
51,2025-05-25T06:46:00+02:00,2025-05-25,14:46,6,2,8
51,2025-05-25T06:47:00+02:00,2025-05-25,14:47,3,1,4
51,2025-05-25T06:49:00+02:00,2025-05-25,14:49,3,1,4
51,2025-05-25T06:50:00+02:00,2025-05-25,14:50,2,1,3
51,2025-05-25T06:52:00+02:00,2025-05-25,14:52,3,1,4
52,2025-05-25T06:41:00+02:00,2025-05-25,14:41,4,6,10
52,2025-05-25T06:44:00+02:00,2025-05-25,14:44,8,7,15
52,2025-05-25T06:46:00+02:00,2025-05-25,14:46,6,5,11
52,2025-05-25T06:52:00+02:00,2025-05-25,14:52,8,2,10
53,2025-05-25T06:42:00+02:00,2025-05-25,14:42,15,9,24
53,2025-05-25T06:43:00+02:00,2025-05-25,14:43,19,1,20
53,2025-05-25T06:45:00+02:00,2025-05-25,14:45,9,3,12
53,2025-05-25T06:46:00+02:00,2025-05-25,14:46,11,4,15
53,2025-05-25T06:53:00+02:00,2025-05-25,14:53,5,4,9
56,2025-05-25T06:41:00+02:00,2025-05-25,14:41,5,10,15
56,2025-05-25T06:43:00+02:00,2025-05-25,14:43,14,4,18
56,2025-05-25T06:45:00+02:00,2025-05-25,14:45,4,5,9
58,2025-05-25T06:43:00+02:00,2025-05-25,14:43,20,8,28
58,2025-05-25T06:47:00+02:00,2025-05-25,14:47,14,13,27
58,2025-05-25T06:49:00+02:00,2025-05-25,14:49,7,15,22
58,2025-05-25T06:53:00+02:00,2025-05-25,14:53,13,2,15
62,2025-05-25T06:42:00+02:00,2025-05-25,14:42,5,6,11
62,2025-05-25T06:44:00+02:00,2025-05-25,14:44,9,1,10
62,2025-05-25T06:46:00+02:00,2025-05-25,14:46,3,5,8
62,2025-05-25T06:47:00+02:00,2025-05-25,14:47,4,1,5
62,2025-05-25T06:51:00+02:00,2025-05-25,14:51,10,7,17
63,2025-05-25T06:41:00+02:00,2025-05-25,14:41,13,15,28
63,2025-05-25T06:42:00+02:00,2025-05-25,14:42,6,4,10
63,2025-05-25T06:44:00+02:00,2025-05-25,14:44,2,4,6
63,2025-05-25T06:50:00+02:00,2025-05-25,14:50,7,2,9
63,2025-05-25T06:52:00+02:00,2025-05-25,14:52,3,10,13
63,2025-05-25T06:53:00+02:00,2025-05-25,14:53,9,5,14
67,2025-05-25T06:43:00+02:00,2025-05-25,14:43,6,14,20
67,2025-05-25T06:44:00+02:00,2025-05-25,14:44,1,14,15
67,2025-05-25T06:45:00+02:00,2025-05-25,14:45,4,13,17
67,2025-05-25T06:48:00+02:00,2025-05-25,14:48,5,20,25
67,2025-05-25T06:51:00+02:00,2025-05-25,14:51,5,17,22
67,2025-05-25T06:54:00+02:00,2025-05-25,14:54,1,17,18
68,2025-05-25T06:41:00+02:00,2025-05-25,14:41,0,2,2
68,2025-05-25T06:44:00+02:00,2025-05-25,14:44,3,3,6
68,2025-05-25T06:47:00+02:00,2025-05-25,14:47,2,2,4
72,2025-05-25T06:41:00+02:00,2025-05-25,14:41,7,4,11
72,2025-05-25T06:44:00+02:00,2025-05-25,14:44,2,14,16
72,2025-05-25T06:45:00+02:00,2025-05-25,14:45,9,8,17
72,2025-05-25T06:49:00+02:00,2025-05-25,14:49,6,4,10
72,2025-05-25T06:50:00+02:00,2025-05-25,14:50,12,6,18
72,2025-05-25T06:54:00+02:00,2025-05-25,14:54,5,8,13
76,2025-05-25T06:40:00+02:00,2025-05-25,14:40,2,1,3
76,2025-05-25T06:45:00+02:00,2025-05-25,14:45,2,2,4
76,2025-05-25T06:47:00+02:00,2025-05-25,14:47,0,1,1
76,2025-05-25T06:49:00+02:00,2025-05-25,14:49,0,2,2
76,2025-05-25T06:53:00+02:00,2025-05-25,14:53,0,2,2
76,2025-05-25T06:54:00+02:00,2025-05-25,14:54,0,3,3
79,2025-05-25T06:46:00+02:00,2025-05-25,14:46,11,23,34
79,2025-05-25T06:48:00+02:00,2025-05-25,14:48,24,8,32
79,2025-05-25T06:52:00+02:00,2025-05-25,14:52,13,8,21
85,2025-05-25T06:40:00+02:00,2025-05-25,14:40,4,0,4
85,2025-05-25T06:42:00+02:00,2025-05-25,14:42,0,4,4
85,2025-05-25T06:43:00+02:00,2025-05-25,14:43,0,1,1
85,2025-05-25T06:49:00+02:00,2025-05-25,14:49,5,3,8
85,2025-05-25T06:54:00+02:00,2025-05-25,14:54,0,1,1
86,2025-05-25T06:41:00+02:00,2025-05-25,14:41,2,1,3
86,2025-05-25T06:45:00+02:00,2025-05-25,14:45,3,0,3
86,2025-05-25T06:47:00+02:00,2025-05-25,14:47,0,1,1
109,2025-05-25T06:40:00+02:00,2025-05-25,14:40,7,6,13
109,2025-05-25T06:50:00+02:00,2025-05-25,14:50,15,10,25
117,2025-05-25T06:40:00+02:00,2025-05-25,14:40,39,20,59
117,2025-05-25T06:45:00+02:00,2025-05-25,14:45,31,11,42
123,2025-05-25T06:40:00+02:00,2025-05-25,14:40,8,3,11
123,2025-05-25T06:45:00+02:00,2025-05-25,14:45,10,15,25
130,2025-05-25T06:40:00+02:00,2025-05-25,14:40,10,0,10
130,2025-05-25T06:50:00+02:00,2025-05-25,14:50,4,2,6
137,2025-05-25T06:40:00+02:00,2025-05-25,14:40,0,2,2
138,2025-05-25T06:45:00+02:00,2025-05-25,14:45,2,1,3
141,2025-05-25T06:45:00+02:00,2025-05-25,14:45,11,18,29
142,2025-05-25T06:40:00+02:00,2025-05-25,14:40,65,36,101
142,2025-05-25T06:50:00+02:00,2025-05-25,14:50,58,24,82
164,2025-05-25T06:45:00+02:00,2025-05-25,14:45,9,4,13
164,2025-05-25T06:50:00+02:00,2025-05-25,14:50,13,7,20
181,2025-05-25T06:42:00+02:00,2025-05-25,14:42,6,21,27
181,2025-05-25T06:43:00+02:00,2025-05-25,14:43,20,27,47
181,2025-05-25T06:52:00+02:00,2025-05-25,14:52,13,21,34
181,2025-05-25T06:53:00+02:00,2025-05-25,14:53,13,17,30
182,2025-05-25T06:40:00+02:00,2025-05-25,14:40,18,21,39
180,2025-05-25T06:43:00+02:00,2025-05-25,14:43,0,3,3
180,2025-05-25T06:48:00+02:00,2025-05-25,14:48,2,4,6
181,2025-05-25T06:55:00+02:00,2025-05-25,14:55,33,10,43
181,2025-05-25T06:56:00+02:00,2025-05-25,14:56,4,14,18
181,2025-05-25T06:58:00+02:00,2025-05-25,14:58,29,16,45
181,2025-05-25T07:01:00+02:00,2025-05-25,15:01,2,26,28
181,2025-05-25T07:04:00+02:00,2025-05-25,15:04,36,18,54
181,2025-05-25T07:05:00+02:00,2025-05-25,15:05,10,17,27
181,2025-05-25T07:08:00+02:00,2025-05-25,15:08,18,16,34
182,2025-05-25T07:05:00+02:00,2025-05-25,15:05,10,8,18
180,2025-05-25T07:07:00+02:00,2025-05-25,15:07,0,4,4
3,2025-05-25T07:25:00+02:00,2025-05-25,15:25,28,19,47
3,2025-05-25T07:29:00+02:00,2025-05-25,15:29,15,18,33
3,2025-05-25T07:35:00+02:00,2025-05-25,15:35,21,25,46
4,2025-05-25T07:25:00+02:00,2025-05-25,15:25,35,28,63
4,2025-05-25T07:27:00+02:00,2025-05-25,15:27,37,43,80
4,2025-05-25T07:30:00+02:00,2025-05-25,15:30,32,17,49
4,2025-05-25T07:35:00+02:00,2025-05-25,15:35,27,24,51
4,2025-05-25T07:36:00+02:00,2025-05-25,15:36,27,19,46
4,2025-05-25T07:37:00+02:00,2025-05-25,15:37,16,26,42
6,2025-05-25T07:29:00+02:00,2025-05-25,15:29,13,13,26
6,2025-05-25T07:35:00+02:00,2025-05-25,15:35,19,14,33
8,2025-05-25T07:32:00+02:00,2025-05-25,15:32,10,5,15
8,2025-05-25T07:33:00+02:00,2025-05-25,15:33,0,2,2
8,2025-05-25T07:34:00+02:00,2025-05-25,15:34,4,4,8
8,2025-05-25T07:37:00+02:00,2025-05-25,15:37,2,0,2
8,2025-05-25T07:38:00+02:00,2025-05-25,15:38,4,1,5
8,2025-05-25T07:39:00+02:00,2025-05-25,15:39,21,7,28
28,2025-05-25T07:25:00+02:00,2025-05-25,15:25,8,15,23
28,2025-05-25T07:26:00+02:00,2025-05-25,15:26,13,10,23
28,2025-05-25T07:33:00+02:00,2025-05-25,15:33,24,8,32
28,2025-05-25T07:36:00+02:00,2025-05-25,15:36,10,4,14
28,2025-05-25T07:37:00+02:00,2025-05-25,15:37,12,3,15
29,2025-05-25T07:25:00+02:00,2025-05-25,15:25,12,10,22
29,2025-05-25T07:28:00+02:00,2025-05-25,15:28,12,16,28
29,2025-05-25T07:31:00+02:00,2025-05-25,15:31,10,12,22
29,2025-05-25T07:37:00+02:00,2025-05-25,15:37,12,19,31
29,2025-05-25T07:39:00+02:00,2025-05-25,15:39,6,13,19
31,2025-05-25T07:26:00+02:00,2025-05-25,15:26,4,3,7
31,2025-05-25T07:28:00+02:00,2025-05-25,15:28,7,8,15
31,2025-05-25T07:30:00+02:00,2025-05-25,15:30,1,2,3
31,2025-05-25T07:33:00+02:00,2025-05-25,15:33,4,3,7
31,2025-05-25T07:35:00+02:00,2025-05-25,15:35,7,6,13
31,2025-05-25T07:39:00+02:00,2025-05-25,15:39,3,1,4
36,2025-05-25T07:25:00+02:00,2025-05-25,15:25,0,2,2
36,2025-05-25T07:29:00+02:00,2025-05-25,15:29,1,0,1
36,2025-05-25T07:30:00+02:00,2025-05-25,15:30,4,2,6
36,2025-05-25T07:31:00+02:00,2025-05-25,15:31,3,3,6
36,2025-05-25T07:33:00+02:00,2025-05-25,15:33,0,5,5
36,2025-05-25T07:36:00+02:00,2025-05-25,15:36,0,1,1
36,2025-05-25T07:37:00+02:00,2025-05-25,15:37,3,1,4
36,2025-05-25T07:39:00+02:00,2025-05-25,15:39,2,1,3
39,2025-05-25T07:25:00+02:00,2025-05-25,15:25,0,3,3
39,2025-05-25T07:34:00+02:00,2025-05-25,15:34,0,1,1
39,2025-05-25T07:38:00+02:00,2025-05-25,15:38,0,2,2
40,2025-05-25T07:27:00+02:00,2025-05-25,15:27,1,2,3
41,2025-05-25T07:28:00+02:00,2025-05-25,15:28,10,16,26
41,2025-05-25T07:31:00+02:00,2025-05-25,15:31,11,18,29
41,2025-05-25T07:32:00+02:00,2025-05-25,15:32,17,12,29
41,2025-05-25T07:33:00+02:00,2025-05-25,15:33,14,11,25
41,2025-05-25T07:34:00+02:00,2025-05-25,15:34,4,10,14
41,2025-05-25T07:38:00+02:00,2025-05-25,15:38,5,15,20
41,2025-05-25T07:39:00+02:00,2025-05-25,15:39,8,9,17
43,2025-05-25T07:25:00+02:00,2025-05-25,15:25,8,6,14
43,2025-05-25T07:30:00+02:00,2025-05-25,15:30,9,3,12
45,2025-05-25T07:25:00+02:00,2025-05-25,15:25,26,22,48
45,2025-05-25T07:26:00+02:00,2025-05-25,15:26,12,44,56
45,2025-05-25T07:27:00+02:00,2025-05-25,15:27,16,24,40
45,2025-05-25T07:30:00+02:00,2025-05-25,15:30,10,24,34
45,2025-05-25T07:32:00+02:00,2025-05-25,15:32,34,31,65
47,2025-05-25T07:25:00+02:00,2025-05-25,15:25,5,44,49
47,2025-05-25T07:29:00+02:00,2025-05-25,15:29,18,23,41
47,2025-05-25T07:31:00+02:00,2025-05-25,15:31,13,27,40
47,2025-05-25T07:39:00+02:00,2025-05-25,15:39,20,13,33
50,2025-05-25T07:26:00+02:00,2025-05-25,15:26,0,5,5
50,2025-05-25T07:27:00+02:00,2025-05-25,15:27,3,3,6
50,2025-05-25T07:28:00+02:00,2025-05-25,15:28,9,4,13
50,2025-05-25T07:35:00+02:00,2025-05-25,15:35,4,1,5
50,2025-05-25T07:36:00+02:00,2025-05-25,15:36,10,3,13
54,2025-05-25T07:25:00+02:00,2025-05-25,15:25,2,5,7
54,2025-05-25T07:29:00+02:00,2025-05-25,15:29,3,5,8
54,2025-05-25T07:30:00+02:00,2025-05-25,15:30,0,2,2
54,2025-05-25T07:33:00+02:00,2025-05-25,15:33,4,3,7
54,2025-05-25T07:34:00+02:00,2025-05-25,15:34,4,3,7
54,2025-05-25T07:35:00+02:00,2025-05-25,15:35,3,3,6
54,2025-05-25T07:39:00+02:00,2025-05-25,15:39,0,4,4
59,2025-05-25T07:30:00+02:00,2025-05-25,15:30,33,37,70
61,2025-05-25T07:25:00+02:00,2025-05-25,15:25,12,14,26
61,2025-05-25T07:32:00+02:00,2025-05-25,15:32,9,8,17
61,2025-05-25T07:37:00+02:00,2025-05-25,15:37,8,10,18
61,2025-05-25T07:39:00+02:00,2025-05-25,15:39,6,9,15
66,2025-05-25T07:25:00+02:00,2025-05-25,15:25,23,22,45
66,2025-05-25T07:26:00+02:00,2025-05-25,15:26,19,22,41
66,2025-05-25T07:31:00+02:00,2025-05-25,15:31,47,23,70
66,2025-05-25T07:37:00+02:00,2025-05-25,15:37,18,30,48
66,2025-05-25T07:39:00+02:00,2025-05-25,15:39,31,27,58
69,2025-05-25T07:27:00+02:00,2025-05-25,15:27,2,1,3
69,2025-05-25T07:31:00+02:00,2025-05-25,15:31,1,3,4
69,2025-05-25T07:32:00+02:00,2025-05-25,15:32,10,5,15
69,2025-05-25T07:35:00+02:00,2025-05-25,15:35,4,8,12
69,2025-05-25T07:36:00+02:00,2025-05-25,15:36,1,6,7
69,2025-05-25T07:37:00+02:00,2025-05-25,15:37,7,2,9
70,2025-05-25T07:25:00+02:00,2025-05-25,15:25,1,0,1
70,2025-05-25T07:34:00+02:00,2025-05-25,15:34,7,3,10
70,2025-05-25T07:37:00+02:00,2025-05-25,15:37,5,7,12
70,2025-05-25T07:39:00+02:00,2025-05-25,15:39,2,0,2
75,2025-05-25T07:28:00+02:00,2025-05-25,15:28,0,1,1
75,2025-05-25T07:29:00+02:00,2025-05-25,15:29,2,0,2
75,2025-05-25T07:32:00+02:00,2025-05-25,15:32,1,0,1
75,2025-05-25T07:37:00+02:00,2025-05-25,15:37,0,2,2
77,2025-05-25T07:25:00+02:00,2025-05-25,15:25,15,29,44
78,2025-05-25T07:31:00+02:00,2025-05-25,15:31,1,0,1
78,2025-05-25T07:32:00+02:00,2025-05-25,15:32,0,1,1
78,2025-05-25T07:36:00+02:00,2025-05-25,15:36,4,4,8
78,2025-05-25T07:38:00+02:00,2025-05-25,15:38,0,1,1
87,2025-05-25T07:27:00+02:00,2025-05-25,15:27,1,0,1
87,2025-05-25T07:28:00+02:00,2025-05-25,15:28,0,4,4
87,2025-05-25T07:33:00+02:00,2025-05-25,15:33,3,1,4
87,2025-05-25T07:34:00+02:00,2025-05-25,15:34,0,1,1
87,2025-05-25T07:35:00+02:00,2025-05-25,15:35,0,1,1
87,2025-05-25T07:36:00+02:00,2025-05-25,15:36,1,1,2
107,2025-05-25T07:35:00+02:00,2025-05-25,15:35,12,14,26
108,2025-05-25T07:27:00+02:00,2025-05-25,15:27,3,1,4
108,2025-05-25T07:31:00+02:00,2025-05-25,15:31,3,1,4
108,2025-05-25T07:33:00+02:00,2025-05-25,15:33,0,1,1
108,2025-05-25T07:34:00+02:00,2025-05-25,15:34,2,3,5
108,2025-05-25T07:37:00+02:00,2025-05-25,15:37,2,2,4
118,2025-05-25T07:30:00+02:00,2025-05-25,15:30,1,3,4
124,2025-05-25T07:25:00+02:00,2025-05-25,15:25,1,1,2
131,2025-05-25T07:30:00+02:00,2025-05-25,15:30,15,4,19
134,2025-05-25T07:25:00+02:00,2025-05-25,15:25,24,23,47
134,2025-05-25T07:30:00+02:00,2025-05-25,15:30,30,35,65
134,2025-05-25T07:35:00+02:00,2025-05-25,15:35,38,39,77
135,2025-05-25T07:30:00+02:00,2025-05-25,15:30,38,31,69
140,2025-05-25T07:25:00+02:00,2025-05-25,15:25,15,5,20
165,2025-05-25T07:35:00+02:00,2025-05-25,15:35,2,3,5
166,2025-05-25T07:35:00+02:00,2025-05-25,15:35,6,8,14
179,2025-05-25T07:25:00+02:00,2025-05-25,15:25,5,3,8
179,2025-05-25T07:30:00+02:00,2025-05-25,15:30,6,3,9
1,2025-05-25T07:30:00+02:00,2025-05-25,15:30,15,30,45
1,2025-05-25T07:34:00+02:00,2025-05-25,15:34,1,2,3
1,2025-05-25T07:36:00+02:00,2025-05-25,15:36,22,27,49
1,2025-05-25T07:38:00+02:00,2025-05-25,15:38,8,25,33
1,2025-05-25T07:39:00+02:00,2025-05-25,15:39,18,31,49
2,2025-05-25T07:26:00+02:00,2025-05-25,15:26,26,10,36
2,2025-05-25T07:27:00+02:00,2025-05-25,15:27,7,23,30
2,2025-05-25T07:37:00+02:00,2025-05-25,15:37,3,11,14
9,2025-05-25T07:25:00+02:00,2025-05-25,15:25,3,1,4
9,2025-05-25T07:37:00+02:00,2025-05-25,15:37,1,1,2
10,2025-05-25T07:25:00+02:00,2025-05-25,15:25,5,3,8
10,2025-05-25T07:30:00+02:00,2025-05-25,15:30,2,2,4
10,2025-05-25T07:32:00+02:00,2025-05-25,15:32,1,0,1
10,2025-05-25T07:34:00+02:00,2025-05-25,15:34,2,1,3
11,2025-05-25T07:25:00+02:00,2025-05-25,15:25,9,6,15
11,2025-05-25T07:26:00+02:00,2025-05-25,15:26,3,0,3
11,2025-05-25T07:28:00+02:00,2025-05-25,15:28,1,2,3
11,2025-05-25T07:34:00+02:00,2025-05-25,15:34,7,4,11
11,2025-05-25T07:37:00+02:00,2025-05-25,15:37,0,3,3
12,2025-05-25T07:25:00+02:00,2025-05-25,15:25,9,1,10
12,2025-05-25T07:29:00+02:00,2025-05-25,15:29,7,2,9
12,2025-05-25T07:31:00+02:00,2025-05-25,15:31,0,15,15
12,2025-05-25T07:35:00+02:00,2025-05-25,15:35,2,4,6
12,2025-05-25T07:36:00+02:00,2025-05-25,15:36,0,1,1
12,2025-05-25T07:37:00+02:00,2025-05-25,15:37,5,5,10
17,2025-05-25T07:26:00+02:00,2025-05-25,15:26,10,3,13
17,2025-05-25T07:27:00+02:00,2025-05-25,15:27,3,1,4
17,2025-05-25T07:29:00+02:00,2025-05-25,15:29,8,0,8
17,2025-05-25T07:32:00+02:00,2025-05-25,15:32,6,1,7
17,2025-05-25T07:34:00+02:00,2025-05-25,15:34,1,2,3
17,2025-05-25T07:35:00+02:00,2025-05-25,15:35,2,3,5
17,2025-05-25T07:38:00+02:00,2025-05-25,15:38,0,8,8
18,2025-05-25T07:33:00+02:00,2025-05-25,15:33,1,2,3
18,2025-05-25T07:34:00+02:00,2025-05-25,15:34,3,2,5
18,2025-05-25T07:35:00+02:00,2025-05-25,15:35,0,3,3
18,2025-05-25T07:37:00+02:00,2025-05-25,15:37,1,0,1
19,2025-05-25T07:25:00+02:00,2025-05-25,15:25,7,11,18
19,2025-05-25T07:27:00+02:00,2025-05-25,15:27,7,14,21
19,2025-05-25T07:33:00+02:00,2025-05-25,15:33,5,8,13
19,2025-05-25T07:37:00+02:00,2025-05-25,15:37,8,7,15
19,2025-05-25T07:38:00+02:00,2025-05-25,15:38,6,7,13
20,2025-05-25T07:25:00+02:00,2025-05-25,15:25,0,1,1
20,2025-05-25T07:30:00+02:00,2025-05-25,15:30,2,2,4
20,2025-05-25T07:31:00+02:00,2025-05-25,15:31,1,8,9
20,2025-05-25T07:36:00+02:00,2025-05-25,15:36,8,5,13
20,2025-05-25T07:38:00+02:00,2025-05-25,15:38,6,7,13
23,2025-05-25T07:25:00+02:00,2025-05-25,15:25,0,1,1
23,2025-05-25T07:28:00+02:00,2025-05-25,15:28,6,2,8
23,2025-05-25T07:29:00+02:00,2025-05-25,15:29,2,10,12
23,2025-05-25T07:32:00+02:00,2025-05-25,15:32,0,1,1
23,2025-05-25T07:34:00+02:00,2025-05-25,15:34,0,3,3
23,2025-05-25T07:37:00+02:00,2025-05-25,15:37,1,3,4
23,2025-05-25T07:38:00+02:00,2025-05-25,15:38,3,1,4
24,2025-05-25T07:25:00+02:00,2025-05-25,15:25,3,14,17
24,2025-05-25T07:27:00+02:00,2025-05-25,15:27,0,21,21
24,2025-05-25T07:28:00+02:00,2025-05-25,15:28,8,5,13
24,2025-05-25T07:32:00+02:00,2025-05-25,15:32,5,15,20
24,2025-05-25T07:34:00+02:00,2025-05-25,15:34,0,27,27
24,2025-05-25T07:38:00+02:00,2025-05-25,15:38,7,14,21
25,2025-05-25T07:30:00+02:00,2025-05-25,15:30,99,31,130
25,2025-05-25T07:35:00+02:00,2025-05-25,15:35,97,78,175
27,2025-05-25T07:28:00+02:00,2025-05-25,15:28,3,0,3
30,2025-05-25T07:25:00+02:00,2025-05-25,15:25,1,10,11
30,2025-05-25T07:32:00+02:00,2025-05-25,15:32,3,5,8
30,2025-05-25T07:34:00+02:00,2025-05-25,15:34,10,14,24
30,2025-05-25T07:35:00+02:00,2025-05-25,15:35,1,16,17
30,2025-05-25T07:39:00+02:00,2025-05-25,15:39,5,9,14
35,2025-05-25T07:30:00+02:00,2025-05-25,15:30,17,20,37
35,2025-05-25T07:31:00+02:00,2025-05-25,15:31,26,11,37
35,2025-05-25T07:32:00+02:00,2025-05-25,15:32,32,31,63
35,2025-05-25T07:33:00+02:00,2025-05-25,15:33,12,33,45
35,2025-05-25T07:34:00+02:00,2025-05-25,15:34,5,32,37
35,2025-05-25T07:37:00+02:00,2025-05-25,15:37,13,30,43
48,2025-05-25T07:30:00+02:00,2025-05-25,15:30,16,8,24
48,2025-05-25T07:31:00+02:00,2025-05-25,15:31,13,3,16
48,2025-05-25T07:32:00+02:00,2025-05-25,15:32,6,4,10
48,2025-05-25T07:35:00+02:00,2025-05-25,15:35,12,2,14
48,2025-05-25T07:39:00+02:00,2025-05-25,15:39,8,6,14
49,2025-05-25T07:26:00+02:00,2025-05-25,15:26,6,5,11
49,2025-05-25T07:29:00+02:00,2025-05-25,15:29,3,6,9
49,2025-05-25T07:35:00+02:00,2025-05-25,15:35,6,6,12
49,2025-05-25T07:36:00+02:00,2025-05-25,15:36,2,4,6
51,2025-05-25T07:25:00+02:00,2025-05-25,15:25,1,2,3
51,2025-05-25T07:27:00+02:00,2025-05-25,15:27,3,1,4
51,2025-05-25T07:29:00+02:00,2025-05-25,15:29,1,0,1
51,2025-05-25T07:31:00+02:00,2025-05-25,15:31,0,5,5
51,2025-05-25T07:32:00+02:00,2025-05-25,15:32,2,3,5
51,2025-05-25T07:36:00+02:00,2025-05-25,15:36,2,0,2
51,2025-05-25T07:38:00+02:00,2025-05-25,15:38,1,5,6
52,2025-05-25T07:25:00+02:00,2025-05-25,15:25,4,2,6
52,2025-05-25T07:26:00+02:00,2025-05-25,15:26,9,4,13
52,2025-05-25T07:27:00+02:00,2025-05-25,15:27,5,10,15
52,2025-05-25T07:29:00+02:00,2025-05-25,15:29,14,1,15
52,2025-05-25T07:30:00+02:00,2025-05-25,15:30,1,6,7
53,2025-05-25T07:34:00+02:00,2025-05-25,15:34,15,9,24
53,2025-05-25T07:36:00+02:00,2025-05-25,15:36,17,16,33
53,2025-05-25T07:38:00+02:00,2025-05-25,15:38,22,6,28
56,2025-05-25T07:26:00+02:00,2025-05-25,15:26,9,10,19
56,2025-05-25T07:31:00+02:00,2025-05-25,15:31,6,13,19
56,2025-05-25T07:38:00+02:00,2025-05-25,15:38,21,12,33
58,2025-05-25T07:26:00+02:00,2025-05-25,15:26,8,9,17
58,2025-05-25T07:27:00+02:00,2025-05-25,15:27,13,7,20
58,2025-05-25T07:31:00+02:00,2025-05-25,15:31,9,6,15
58,2025-05-25T07:34:00+02:00,2025-05-25,15:34,6,8,14
58,2025-05-25T07:35:00+02:00,2025-05-25,15:35,5,12,17
58,2025-05-25T07:38:00+02:00,2025-05-25,15:38,21,3,24
58,2025-05-25T07:39:00+02:00,2025-05-25,15:39,0,4,4
62,2025-05-25T07:25:00+02:00,2025-05-25,15:25,0,1,1
62,2025-05-25T07:27:00+02:00,2025-05-25,15:27,7,0,7
62,2025-05-25T07:28:00+02:00,2025-05-25,15:28,0,4,4
62,2025-05-25T07:30:00+02:00,2025-05-25,15:30,3,1,4
62,2025-05-25T07:31:00+02:00,2025-05-25,15:31,9,3,12
62,2025-05-25T07:32:00+02:00,2025-05-25,15:32,1,3,4
62,2025-05-25T07:33:00+02:00,2025-05-25,15:33,2,3,5
63,2025-05-25T07:26:00+02:00,2025-05-25,15:26,9,7,16
63,2025-05-25T07:30:00+02:00,2025-05-25,15:30,5,10,15
63,2025-05-25T07:33:00+02:00,2025-05-25,15:33,7,12,19
63,2025-05-25T07:35:00+02:00,2025-05-25,15:35,5,7,12
63,2025-05-25T07:38:00+02:00,2025-05-25,15:38,4,12,16
67,2025-05-25T07:26:00+02:00,2025-05-25,15:26,5,8,13
67,2025-05-25T07:32:00+02:00,2025-05-25,15:32,3,15,18
67,2025-05-25T07:35:00+02:00,2025-05-25,15:35,9,23,32
67,2025-05-25T07:36:00+02:00,2025-05-25,15:36,4,15,19
67,2025-05-25T07:37:00+02:00,2025-05-25,15:37,14,8,22
68,2025-05-25T07:25:00+02:00,2025-05-25,15:25,8,3,11
68,2025-05-25T07:26:00+02:00,2025-05-25,15:26,8,7,15
68,2025-05-25T07:27:00+02:00,2025-05-25,15:27,5,1,6
68,2025-05-25T07:32:00+02:00,2025-05-25,15:32,5,3,8
68,2025-05-25T07:33:00+02:00,2025-05-25,15:33,5,9,14
72,2025-05-25T07:25:00+02:00,2025-05-25,15:25,13,9,22
72,2025-05-25T07:26:00+02:00,2025-05-25,15:26,2,8,10
72,2025-05-25T07:27:00+02:00,2025-05-25,15:27,9,21,30
72,2025-05-25T07:28:00+02:00,2025-05-25,15:28,0,17,17
72,2025-05-25T07:30:00+02:00,2025-05-25,15:30,7,6,13
72,2025-05-25T07:32:00+02:00,2025-05-25,15:32,6,5,11
72,2025-05-25T07:33:00+02:00,2025-05-25,15:33,4,18,22
72,2025-05-25T07:37:00+02:00,2025-05-25,15:37,7,10,17
76,2025-05-25T07:33:00+02:00,2025-05-25,15:33,0,1,1
79,2025-05-25T07:25:00+02:00,2025-05-25,15:25,7,3,10
79,2025-05-25T07:27:00+02:00,2025-05-25,15:27,17,8,25
79,2025-05-25T07:28:00+02:00,2025-05-25,15:28,13,5,18
79,2025-05-25T07:29:00+02:00,2025-05-25,15:29,11,12,23
79,2025-05-25T07:30:00+02:00,2025-05-25,15:30,12,5,17
79,2025-05-25T07:32:00+02:00,2025-05-25,15:32,23,20,43
85,2025-05-25T07:26:00+02:00,2025-05-25,15:26,2,1,3
85,2025-05-25T07:35:00+02:00,2025-05-25,15:35,1,2,3
85,2025-05-25T07:36:00+02:00,2025-05-25,15:36,1,2,3
86,2025-05-25T07:30:00+02:00,2025-05-25,15:30,0,4,4
86,2025-05-25T07:31:00+02:00,2025-05-25,15:31,0,2,2
86,2025-05-25T07:33:00+02:00,2025-05-25,15:33,3,1,4
109,2025-05-25T07:30:00+02:00,2025-05-25,15:30,4,6,10
109,2025-05-25T07:35:00+02:00,2025-05-25,15:35,5,7,12
123,2025-05-25T07:25:00+02:00,2025-05-25,15:25,4,2,6
123,2025-05-25T07:35:00+02:00,2025-05-25,15:35,9,6,15
130,2025-05-25T07:35:00+02:00,2025-05-25,15:35,1,7,8
136,2025-05-25T07:30:00+02:00,2025-05-25,15:30,21,6,27
141,2025-05-25T07:25:00+02:00,2025-05-25,15:25,3,8,11
142,2025-05-25T07:25:00+02:00,2025-05-25,15:25,76,54,130
142,2025-05-25T07:35:00+02:00,2025-05-25,15:35,54,66,120
161,2025-05-25T07:35:00+02:00,2025-05-25,15:35,24,15,39
164,2025-05-25T07:35:00+02:00,2025-05-25,15:35,10,15,25
3,2025-05-25T07:14:00+02:00,2025-05-25,15:14,7,23,30
3,2025-05-25T07:16:00+02:00,2025-05-25,15:16,33,19,52
3,2025-05-25T07:17:00+02:00,2025-05-25,15:17,10,25,35
3,2025-05-25T07:18:00+02:00,2025-05-25,15:18,22,18,40
3,2025-05-25T07:19:00+02:00,2025-05-25,15:19,13,18,31
3,2025-05-25T07:23:00+02:00,2025-05-25,15:23,17,15,32
4,2025-05-25T07:22:00+02:00,2025-05-25,15:22,32,26,58
4,2025-05-25T07:23:00+02:00,2025-05-25,15:23,43,15,58
6,2025-05-25T07:11:00+02:00,2025-05-25,15:11,34,2,36
6,2025-05-25T07:13:00+02:00,2025-05-25,15:13,16,9,25
6,2025-05-25T07:17:00+02:00,2025-05-25,15:17,11,15,26
6,2025-05-25T07:18:00+02:00,2025-05-25,15:18,17,20,37
6,2025-05-25T07:19:00+02:00,2025-05-25,15:19,22,12,34
6,2025-05-25T07:22:00+02:00,2025-05-25,15:22,18,8,26
6,2025-05-25T07:23:00+02:00,2025-05-25,15:23,13,18,31
8,2025-05-25T07:11:00+02:00,2025-05-25,15:11,13,8,21
8,2025-05-25T07:12:00+02:00,2025-05-25,15:12,7,5,12
8,2025-05-25T07:13:00+02:00,2025-05-25,15:13,2,3,5
8,2025-05-25T07:14:00+02:00,2025-05-25,15:14,4,8,12
8,2025-05-25T07:20:00+02:00,2025-05-25,15:20,0,8,8
8,2025-05-25T07:22:00+02:00,2025-05-25,15:22,2,0,2
8,2025-05-25T07:23:00+02:00,2025-05-25,15:23,5,6,11
8,2025-05-25T07:24:00+02:00,2025-05-25,15:24,2,2,4
28,2025-05-25T07:10:00+02:00,2025-05-25,15:10,5,6,11
28,2025-05-25T07:16:00+02:00,2025-05-25,15:16,9,18,27
28,2025-05-25T07:17:00+02:00,2025-05-25,15:17,12,11,23
28,2025-05-25T07:21:00+02:00,2025-05-25,15:21,7,8,15
28,2025-05-25T07:24:00+02:00,2025-05-25,15:24,11,3,14
29,2025-05-25T07:18:00+02:00,2025-05-25,15:18,9,11,20
29,2025-05-25T07:20:00+02:00,2025-05-25,15:20,18,3,21
29,2025-05-25T07:22:00+02:00,2025-05-25,15:22,9,10,19
29,2025-05-25T07:24:00+02:00,2025-05-25,15:24,13,12,25
31,2025-05-25T07:11:00+02:00,2025-05-25,15:11,0,6,6
31,2025-05-25T07:20:00+02:00,2025-05-25,15:20,11,3,14
31,2025-05-25T07:24:00+02:00,2025-05-25,15:24,3,2,5
36,2025-05-25T07:16:00+02:00,2025-05-25,15:16,1,1,2
36,2025-05-25T07:19:00+02:00,2025-05-25,15:19,4,5,9
39,2025-05-25T07:15:00+02:00,2025-05-25,15:15,3,1,4
39,2025-05-25T07:22:00+02:00,2025-05-25,15:22,1,2,3
40,2025-05-25T07:12:00+02:00,2025-05-25,15:12,7,2,9
40,2025-05-25T07:13:00+02:00,2025-05-25,15:13,4,1,5
40,2025-05-25T07:14:00+02:00,2025-05-25,15:14,10,6,16
40,2025-05-25T07:19:00+02:00,2025-05-25,15:19,1,1,2
40,2025-05-25T07:21:00+02:00,2025-05-25,15:21,3,1,4
41,2025-05-25T07:14:00+02:00,2025-05-25,15:14,9,7,16
41,2025-05-25T07:18:00+02:00,2025-05-25,15:18,18,8,26
43,2025-05-25T07:10:00+02:00,2025-05-25,15:10,17,5,22
43,2025-05-25T07:20:00+02:00,2025-05-25,15:20,1,5,6
44,2025-05-25T07:15:00+02:00,2025-05-25,15:15,3,4,7
45,2025-05-25T07:10:00+02:00,2025-05-25,15:10,24,20,44
45,2025-05-25T07:11:00+02:00,2025-05-25,15:11,16,24,40
45,2025-05-25T07:15:00+02:00,2025-05-25,15:15,14,11,25
45,2025-05-25T07:16:00+02:00,2025-05-25,15:16,7,10,17
45,2025-05-25T07:18:00+02:00,2025-05-25,15:18,12,19,31
45,2025-05-25T07:24:00+02:00,2025-05-25,15:24,19,14,33
47,2025-05-25T07:20:00+02:00,2025-05-25,15:20,22,18,40
47,2025-05-25T07:21:00+02:00,2025-05-25,15:21,11,31,42
47,2025-05-25T07:24:00+02:00,2025-05-25,15:24,23,16,39
50,2025-05-25T07:10:00+02:00,2025-05-25,15:10,2,3,5
50,2025-05-25T07:11:00+02:00,2025-05-25,15:11,7,3,10
50,2025-05-25T07:12:00+02:00,2025-05-25,15:12,6,5,11
50,2025-05-25T07:21:00+02:00,2025-05-25,15:21,5,9,14
54,2025-05-25T07:11:00+02:00,2025-05-25,15:11,3,2,5
54,2025-05-25T07:13:00+02:00,2025-05-25,15:13,0,1,1
54,2025-05-25T07:14:00+02:00,2025-05-25,15:14,0,1,1
54,2025-05-25T07:15:00+02:00,2025-05-25,15:15,0,4,4
54,2025-05-25T07:18:00+02:00,2025-05-25,15:18,3,2,5
54,2025-05-25T07:24:00+02:00,2025-05-25,15:24,6,1,7
59,2025-05-25T07:10:00+02:00,2025-05-25,15:10,25,33,58
59,2025-05-25T07:20:00+02:00,2025-05-25,15:20,37,37,74
61,2025-05-25T07:13:00+02:00,2025-05-25,15:13,17,1,18
61,2025-05-25T07:15:00+02:00,2025-05-25,15:15,12,6,18
61,2025-05-25T07:22:00+02:00,2025-05-25,15:22,5,9,14
61,2025-05-25T07:23:00+02:00,2025-05-25,15:23,6,7,13
66,2025-05-25T07:11:00+02:00,2025-05-25,15:11,26,19,45
66,2025-05-25T07:12:00+02:00,2025-05-25,15:12,15,35,50
66,2025-05-25T07:14:00+02:00,2025-05-25,15:14,30,21,51
66,2025-05-25T07:15:00+02:00,2025-05-25,15:15,23,36,59
66,2025-05-25T07:18:00+02:00,2025-05-25,15:18,21,30,51
66,2025-05-25T07:19:00+02:00,2025-05-25,15:19,18,19,37
66,2025-05-25T07:20:00+02:00,2025-05-25,15:20,17,34,51
69,2025-05-25T07:13:00+02:00,2025-05-25,15:13,3,3,6
69,2025-05-25T07:19:00+02:00,2025-05-25,15:19,4,3,7
69,2025-05-25T07:20:00+02:00,2025-05-25,15:20,4,3,7
69,2025-05-25T07:23:00+02:00,2025-05-25,15:23,11,4,15
69,2025-05-25T07:24:00+02:00,2025-05-25,15:24,8,8,16
70,2025-05-25T07:11:00+02:00,2025-05-25,15:11,1,12,13
70,2025-05-25T07:12:00+02:00,2025-05-25,15:12,0,3,3
70,2025-05-25T07:15:00+02:00,2025-05-25,15:15,2,5,7
70,2025-05-25T07:17:00+02:00,2025-05-25,15:17,1,1,2
70,2025-05-25T07:19:00+02:00,2025-05-25,15:19,3,1,4
71,2025-05-25T07:12:00+02:00,2025-05-25,15:12,0,3,3
75,2025-05-25T07:16:00+02:00,2025-05-25,15:16,0,2,2
75,2025-05-25T07:17:00+02:00,2025-05-25,15:17,1,0,1
75,2025-05-25T07:22:00+02:00,2025-05-25,15:22,1,1,2
77,2025-05-25T07:10:00+02:00,2025-05-25,15:10,18,14,32
77,2025-05-25T07:20:00+02:00,2025-05-25,15:20,16,15,31
78,2025-05-25T07:13:00+02:00,2025-05-25,15:13,2,0,2
78,2025-05-25T07:17:00+02:00,2025-05-25,15:17,1,1,2
78,2025-05-25T07:19:00+02:00,2025-05-25,15:19,0,1,1
78,2025-05-25T07:20:00+02:00,2025-05-25,15:20,0,2,2
84,2025-05-25T07:15:00+02:00,2025-05-25,15:15,70,114,184
87,2025-05-25T07:11:00+02:00,2025-05-25,15:11,0,4,4
87,2025-05-25T07:21:00+02:00,2025-05-25,15:21,3,5,8
87,2025-05-25T07:23:00+02:00,2025-05-25,15:23,3,0,3
108,2025-05-25T07:10:00+02:00,2025-05-25,15:10,5,3,8
108,2025-05-25T07:12:00+02:00,2025-05-25,15:12,3,0,3
108,2025-05-25T07:14:00+02:00,2025-05-25,15:14,4,0,4
108,2025-05-25T07:16:00+02:00,2025-05-25,15:16,0,2,2
108,2025-05-25T07:18:00+02:00,2025-05-25,15:18,6,3,9
108,2025-05-25T07:19:00+02:00,2025-05-25,15:19,14,1,15
108,2025-05-25T07:20:00+02:00,2025-05-25,15:20,0,1,1
108,2025-05-25T07:21:00+02:00,2025-05-25,15:21,4,3,7
118,2025-05-25T07:10:00+02:00,2025-05-25,15:10,2,3,5
118,2025-05-25T07:15:00+02:00,2025-05-25,15:15,2,4,6
118,2025-05-25T07:20:00+02:00,2025-05-25,15:20,0,7,7
124,2025-05-25T07:10:00+02:00,2025-05-25,15:10,0,5,5
131,2025-05-25T07:10:00+02:00,2025-05-25,15:10,7,5,12
131,2025-05-25T07:15:00+02:00,2025-05-25,15:15,16,7,23
132,2025-05-25T07:20:00+02:00,2025-05-25,15:20,20,6,26
133,2025-05-25T07:10:00+02:00,2025-05-25,15:10,36,37,73
133,2025-05-25T07:20:00+02:00,2025-05-25,15:20,24,27,51
134,2025-05-25T07:10:00+02:00,2025-05-25,15:10,43,28,71
134,2025-05-25T07:15:00+02:00,2025-05-25,15:15,30,27,57
140,2025-05-25T07:15:00+02:00,2025-05-25,15:15,8,12,20
162,2025-05-25T07:10:00+02:00,2025-05-25,15:10,48,57,105
166,2025-05-25T07:10:00+02:00,2025-05-25,15:10,6,6,12
167,2025-05-25T07:10:00+02:00,2025-05-25,15:10,3,4,7
167,2025-05-25T07:15:00+02:00,2025-05-25,15:15,7,8,15
1,2025-05-25T07:12:00+02:00,2025-05-25,15:12,32,17,49
1,2025-05-25T07:15:00+02:00,2025-05-25,15:15,29,24,53
1,2025-05-25T07:17:00+02:00,2025-05-25,15:17,28,26,54
2,2025-05-25T07:10:00+02:00,2025-05-25,15:10,7,8,15
2,2025-05-25T07:14:00+02:00,2025-05-25,15:14,10,14,24
2,2025-05-25T07:21:00+02:00,2025-05-25,15:21,8,12,20
2,2025-05-25T07:22:00+02:00,2025-05-25,15:22,9,14,23
2,2025-05-25T07:24:00+02:00,2025-05-25,15:24,7,14,21
9,2025-05-25T07:11:00+02:00,2025-05-25,15:11,1,2,3
9,2025-05-25T07:14:00+02:00,2025-05-25,15:14,1,2,3
9,2025-05-25T07:18:00+02:00,2025-05-25,15:18,2,3,5
9,2025-05-25T07:21:00+02:00,2025-05-25,15:21,0,3,3
10,2025-05-25T07:11:00+02:00,2025-05-25,15:11,0,1,1
10,2025-05-25T07:15:00+02:00,2025-05-25,15:15,2,0,2
10,2025-05-25T07:20:00+02:00,2025-05-25,15:20,2,2,4
11,2025-05-25T07:11:00+02:00,2025-05-25,15:11,2,1,3
11,2025-05-25T07:16:00+02:00,2025-05-25,15:16,0,2,2
11,2025-05-25T07:18:00+02:00,2025-05-25,15:18,0,3,3
11,2025-05-25T07:19:00+02:00,2025-05-25,15:19,2,0,2
11,2025-05-25T07:20:00+02:00,2025-05-25,15:20,13,15,28
11,2025-05-25T07:21:00+02:00,2025-05-25,15:21,4,0,4
12,2025-05-25T07:10:00+02:00,2025-05-25,15:10,2,4,6
12,2025-05-25T07:18:00+02:00,2025-05-25,15:18,3,3,6
12,2025-05-25T07:20:00+02:00,2025-05-25,15:20,12,6,18
12,2025-05-25T07:22:00+02:00,2025-05-25,15:22,5,1,6
17,2025-05-25T07:15:00+02:00,2025-05-25,15:15,6,0,6
17,2025-05-25T07:18:00+02:00,2025-05-25,15:18,4,5,9
17,2025-05-25T07:23:00+02:00,2025-05-25,15:23,3,1,4
18,2025-05-25T07:11:00+02:00,2025-05-25,15:11,0,4,4
18,2025-05-25T07:12:00+02:00,2025-05-25,15:12,0,2,2
18,2025-05-25T07:17:00+02:00,2025-05-25,15:17,1,1,2
18,2025-05-25T07:22:00+02:00,2025-05-25,15:22,2,0,2
19,2025-05-25T07:10:00+02:00,2025-05-25,15:10,8,12,20
19,2025-05-25T07:19:00+02:00,2025-05-25,15:19,12,7,19
19,2025-05-25T07:21:00+02:00,2025-05-25,15:21,7,12,19
20,2025-05-25T07:10:00+02:00,2025-05-25,15:10,0,14,14
20,2025-05-25T07:12:00+02:00,2025-05-25,15:12,3,11,14
20,2025-05-25T07:13:00+02:00,2025-05-25,15:13,0,10,10
20,2025-05-25T07:15:00+02:00,2025-05-25,15:15,6,4,10
20,2025-05-25T07:18:00+02:00,2025-05-25,15:18,3,4,7
20,2025-05-25T07:19:00+02:00,2025-05-25,15:19,1,9,10
20,2025-05-25T07:22:00+02:00,2025-05-25,15:22,2,6,8
20,2025-05-25T07:24:00+02:00,2025-05-25,15:24,4,13,17
23,2025-05-25T07:10:00+02:00,2025-05-25,15:10,0,5,5
23,2025-05-25T07:20:00+02:00,2025-05-25,15:20,0,1,1
23,2025-05-25T07:21:00+02:00,2025-05-25,15:21,0,4,4
24,2025-05-25T07:15:00+02:00,2025-05-25,15:15,26,10,36
24,2025-05-25T07:16:00+02:00,2025-05-25,15:16,8,2,10
24,2025-05-25T07:17:00+02:00,2025-05-25,15:17,5,13,18
24,2025-05-25T07:19:00+02:00,2025-05-25,15:19,4,3,7
24,2025-05-25T07:21:00+02:00,2025-05-25,15:21,6,9,15
24,2025-05-25T07:24:00+02:00,2025-05-25,15:24,13,9,22
25,2025-05-25T07:10:00+02:00,2025-05-25,15:10,63,62,125
27,2025-05-25T07:10:00+02:00,2025-05-25,15:10,7,7,14
27,2025-05-25T07:14:00+02:00,2025-05-25,15:14,2,5,7
27,2025-05-25T07:16:00+02:00,2025-05-25,15:16,10,4,14
27,2025-05-25T07:21:00+02:00,2025-05-25,15:21,5,3,8
27,2025-05-25T07:23:00+02:00,2025-05-25,15:23,6,3,9
30,2025-05-25T07:11:00+02:00,2025-05-25,15:11,12,12,24
30,2025-05-25T07:12:00+02:00,2025-05-25,15:12,0,2,2
30,2025-05-25T07:13:00+02:00,2025-05-25,15:13,3,4,7
30,2025-05-25T07:16:00+02:00,2025-05-25,15:16,2,0,2
30,2025-05-25T07:17:00+02:00,2025-05-25,15:17,4,5,9
30,2025-05-25T07:20:00+02:00,2025-05-25,15:20,4,5,9
35,2025-05-25T07:11:00+02:00,2025-05-25,15:11,21,35,56
35,2025-05-25T07:12:00+02:00,2025-05-25,15:12,19,20,39
35,2025-05-25T07:13:00+02:00,2025-05-25,15:13,21,19,40
35,2025-05-25T07:16:00+02:00,2025-05-25,15:16,12,26,38
35,2025-05-25T07:24:00+02:00,2025-05-25,15:24,9,32,41
46,2025-05-25T07:20:00+02:00,2025-05-25,15:20,7,2,9
48,2025-05-25T07:11:00+02:00,2025-05-25,15:11,10,3,13
48,2025-05-25T07:12:00+02:00,2025-05-25,15:12,6,3,9
48,2025-05-25T07:13:00+02:00,2025-05-25,15:13,7,1,8
48,2025-05-25T07:17:00+02:00,2025-05-25,15:17,14,9,23
48,2025-05-25T07:18:00+02:00,2025-05-25,15:18,10,15,25
48,2025-05-25T07:20:00+02:00,2025-05-25,15:20,12,1,13
48,2025-05-25T07:23:00+02:00,2025-05-25,15:23,12,0,12
49,2025-05-25T07:10:00+02:00,2025-05-25,15:10,7,2,9
49,2025-05-25T07:14:00+02:00,2025-05-25,15:14,16,5,21
49,2025-05-25T07:24:00+02:00,2025-05-25,15:24,4,9,13
51,2025-05-25T07:14:00+02:00,2025-05-25,15:14,2,6,8
51,2025-05-25T07:15:00+02:00,2025-05-25,15:15,4,1,5
51,2025-05-25T07:18:00+02:00,2025-05-25,15:18,2,1,3
51,2025-05-25T07:22:00+02:00,2025-05-25,15:22,2,2,4
52,2025-05-25T07:14:00+02:00,2025-05-25,15:14,11,10,21
52,2025-05-25T07:18:00+02:00,2025-05-25,15:18,5,5,10
53,2025-05-25T07:12:00+02:00,2025-05-25,15:12,9,6,15
53,2025-05-25T07:15:00+02:00,2025-05-25,15:15,12,3,15
53,2025-05-25T07:17:00+02:00,2025-05-25,15:17,14,13,27
53,2025-05-25T07:21:00+02:00,2025-05-25,15:21,15,0,15
53,2025-05-25T07:22:00+02:00,2025-05-25,15:22,5,5,10
56,2025-05-25T07:11:00+02:00,2025-05-25,15:11,13,6,19
56,2025-05-25T07:13:00+02:00,2025-05-25,15:13,5,10,15
56,2025-05-25T07:15:00+02:00,2025-05-25,15:15,10,3,13
56,2025-05-25T07:18:00+02:00,2025-05-25,15:18,9,7,16
56,2025-05-25T07:23:00+02:00,2025-05-25,15:23,5,8,13
58,2025-05-25T07:10:00+02:00,2025-05-25,15:10,6,2,8
58,2025-05-25T07:11:00+02:00,2025-05-25,15:11,10,2,12
58,2025-05-25T07:14:00+02:00,2025-05-25,15:14,7,9,16
58,2025-05-25T07:15:00+02:00,2025-05-25,15:15,10,15,25
58,2025-05-25T07:17:00+02:00,2025-05-25,15:17,17,12,29
58,2025-05-25T07:19:00+02:00,2025-05-25,15:19,21,3,24
58,2025-05-25T07:22:00+02:00,2025-05-25,15:22,9,7,16
62,2025-05-25T07:20:00+02:00,2025-05-25,15:20,0,7,7
62,2025-05-25T07:22:00+02:00,2025-05-25,15:22,5,3,8
63,2025-05-25T07:11:00+02:00,2025-05-25,15:11,8,8,16
63,2025-05-25T07:16:00+02:00,2025-05-25,15:16,10,3,13
63,2025-05-25T07:22:00+02:00,2025-05-25,15:22,3,4,7
67,2025-05-25T07:14:00+02:00,2025-05-25,15:14,1,10,11
67,2025-05-25T07:17:00+02:00,2025-05-25,15:17,10,15,25
67,2025-05-25T07:19:00+02:00,2025-05-25,15:19,10,11,21
67,2025-05-25T07:21:00+02:00,2025-05-25,15:21,2,7,9
67,2025-05-25T07:22:00+02:00,2025-05-25,15:22,6,15,21
67,2025-05-25T07:24:00+02:00,2025-05-25,15:24,8,11,19
68,2025-05-25T07:13:00+02:00,2025-05-25,15:13,4,6,10
68,2025-05-25T07:14:00+02:00,2025-05-25,15:14,7,4,11
68,2025-05-25T07:16:00+02:00,2025-05-25,15:16,8,7,15
68,2025-05-25T07:17:00+02:00,2025-05-25,15:17,10,4,14
68,2025-05-25T07:22:00+02:00,2025-05-25,15:22,2,8,10
68,2025-05-25T07:24:00+02:00,2025-05-25,15:24,6,15,21
72,2025-05-25T07:10:00+02:00,2025-05-25,15:10,10,7,17
72,2025-05-25T07:11:00+02:00,2025-05-25,15:11,7,7,14
72,2025-05-25T07:13:00+02:00,2025-05-25,15:13,8,7,15
72,2025-05-25T07:14:00+02:00,2025-05-25,15:14,2,15,17
72,2025-05-25T07:20:00+02:00,2025-05-25,15:20,14,11,25
72,2025-05-25T07:22:00+02:00,2025-05-25,15:22,0,12,12
72,2025-05-25T07:23:00+02:00,2025-05-25,15:23,10,5,15
76,2025-05-25T07:10:00+02:00,2025-05-25,15:10,0,3,3
76,2025-05-25T07:11:00+02:00,2025-05-25,15:11,1,1,2
76,2025-05-25T07:21:00+02:00,2025-05-25,15:21,2,1,3
79,2025-05-25T07:17:00+02:00,2025-05-25,15:17,15,10,25
79,2025-05-25T07:19:00+02:00,2025-05-25,15:19,10,5,15
79,2025-05-25T07:21:00+02:00,2025-05-25,15:21,20,5,25
79,2025-05-25T07:23:00+02:00,2025-05-25,15:23,23,5,28
79,2025-05-25T07:24:00+02:00,2025-05-25,15:24,10,14,24
85,2025-05-25T07:10:00+02:00,2025-05-25,15:10,4,4,8
85,2025-05-25T07:14:00+02:00,2025-05-25,15:14,2,1,3
85,2025-05-25T07:15:00+02:00,2025-05-25,15:15,3,0,3
85,2025-05-25T07:16:00+02:00,2025-05-25,15:16,2,0,2
86,2025-05-25T07:17:00+02:00,2025-05-25,15:17,4,0,4
86,2025-05-25T07:18:00+02:00,2025-05-25,15:18,0,1,1
86,2025-05-25T07:22:00+02:00,2025-05-25,15:22,1,1,2
109,2025-05-25T07:10:00+02:00,2025-05-25,15:10,4,9,13
117,2025-05-25T07:15:00+02:00,2025-05-25,15:15,13,11,24
123,2025-05-25T07:15:00+02:00,2025-05-25,15:15,10,5,15
130,2025-05-25T07:15:00+02:00,2025-05-25,15:15,18,3,21
136,2025-05-25T07:10:00+02:00,2025-05-25,15:10,85,2,87
136,2025-05-25T07:15:00+02:00,2025-05-25,15:15,72,1,73
137,2025-05-25T07:15:00+02:00,2025-05-25,15:15,1,1,2
138,2025-05-25T07:20:00+02:00,2025-05-25,15:20,1,0,1
139,2025-05-25T07:10:00+02:00,2025-05-25,15:10,3,2,5
139,2025-05-25T07:15:00+02:00,2025-05-25,15:15,3,12,15
141,2025-05-25T07:20:00+02:00,2025-05-25,15:20,13,13,26
161,2025-05-25T07:15:00+02:00,2025-05-25,15:15,70,9,79
164,2025-05-25T07:10:00+02:00,2025-05-25,15:10,3,4,7
164,2025-05-25T07:15:00+02:00,2025-05-25,15:15,13,0,13
181,2025-05-25T07:11:00+02:00,2025-05-25,15:11,2,17,19
181,2025-05-25T07:12:00+02:00,2025-05-25,15:12,13,11,24
181,2025-05-25T07:14:00+02:00,2025-05-25,15:14,21,17,38
181,2025-05-25T07:22:00+02:00,2025-05-25,15:22,9,28,37
181,2025-05-25T07:23:00+02:00,2025-05-25,15:23,9,22,31
182,2025-05-25T07:10:00+02:00,2025-05-25,15:10,13,10,23
180,2025-05-25T07:15:00+02:00,2025-05-25,15:15,1,1,2
180,2025-05-25T07:20:00+02:00,2025-05-25,15:20,3,0,3
180,2025-05-25T07:23:00+02:00,2025-05-25,15:23,0,2,2
181,2025-05-25T07:30:00+02:00,2025-05-25,15:30,6,12,18
181,2025-05-25T07:33:00+02:00,2025-05-25,15:33,17,26,43
181,2025-05-25T07:36:00+02:00,2025-05-25,15:36,19,30,49
181,2025-05-25T07:37:00+02:00,2025-05-25,15:37,13,27,40
181,2025-05-25T07:38:00+02:00,2025-05-25,15:38,13,20,33
180,2025-05-25T07:30:00+02:00,2025-05-25,15:30,0,1,1
180,2025-05-25T07:39:00+02:00,2025-05-25,15:39,1,2,3
3,2025-05-25T07:40:00+02:00,2025-05-25,15:40,20,25,45
3,2025-05-25T07:42:00+02:00,2025-05-25,15:42,10,14,24
3,2025-05-25T07:45:00+02:00,2025-05-25,15:45,24,30,54
3,2025-05-25T07:50:00+02:00,2025-05-25,15:50,16,19,35
3,2025-05-25T07:51:00+02:00,2025-05-25,15:51,32,23,55
3,2025-05-25T07:53:00+02:00,2025-05-25,15:53,17,23,40
4,2025-05-25T07:41:00+02:00,2025-05-25,15:41,44,37,81
4,2025-05-25T07:42:00+02:00,2025-05-25,15:42,46,34,80
4,2025-05-25T07:44:00+02:00,2025-05-25,15:44,45,17,62
5,2025-05-25T07:45:00+02:00,2025-05-25,15:45,82,125,207
6,2025-05-25T07:47:00+02:00,2025-05-25,15:47,11,15,26
6,2025-05-25T07:49:00+02:00,2025-05-25,15:49,28,26,54
6,2025-05-25T07:50:00+02:00,2025-05-25,15:50,10,27,37
6,2025-05-25T07:52:00+02:00,2025-05-25,15:52,12,15,27
6,2025-05-25T07:53:00+02:00,2025-05-25,15:53,17,12,29
8,2025-05-25T07:43:00+02:00,2025-05-25,15:43,1,5,6
8,2025-05-25T07:48:00+02:00,2025-05-25,15:48,4,3,7
8,2025-05-25T07:49:00+02:00,2025-05-25,15:49,7,1,8
8,2025-05-25T07:51:00+02:00,2025-05-25,15:51,0,7,7
28,2025-05-25T07:44:00+02:00,2025-05-25,15:44,20,11,31
28,2025-05-25T07:47:00+02:00,2025-05-25,15:47,16,9,25
28,2025-05-25T07:48:00+02:00,2025-05-25,15:48,17,15,32
28,2025-05-25T07:49:00+02:00,2025-05-25,15:49,12,4,16
28,2025-05-25T07:50:00+02:00,2025-05-25,15:50,19,8,27
28,2025-05-25T07:54:00+02:00,2025-05-25,15:54,16,3,19
29,2025-05-25T07:40:00+02:00,2025-05-25,15:40,7,26,33
29,2025-05-25T07:45:00+02:00,2025-05-25,15:45,7,31,38
29,2025-05-25T07:50:00+02:00,2025-05-25,15:50,5,21,26
29,2025-05-25T07:53:00+02:00,2025-05-25,15:53,8,16,24
31,2025-05-25T07:44:00+02:00,2025-05-25,15:44,3,2,5
31,2025-05-25T07:48:00+02:00,2025-05-25,15:48,3,3,6
31,2025-05-25T07:50:00+02:00,2025-05-25,15:50,9,2,11
31,2025-05-25T07:54:00+02:00,2025-05-25,15:54,0,2,2
36,2025-05-25T07:41:00+02:00,2025-05-25,15:41,1,0,1
36,2025-05-25T07:43:00+02:00,2025-05-25,15:43,1,0,1
36,2025-05-25T07:54:00+02:00,2025-05-25,15:54,1,1,2
39,2025-05-25T07:46:00+02:00,2025-05-25,15:46,1,0,1
39,2025-05-25T07:49:00+02:00,2025-05-25,15:49,0,2,2
39,2025-05-25T07:52:00+02:00,2025-05-25,15:52,2,1,3
40,2025-05-25T07:43:00+02:00,2025-05-25,15:43,0,1,1
40,2025-05-25T07:44:00+02:00,2025-05-25,15:44,2,0,2
40,2025-05-25T07:47:00+02:00,2025-05-25,15:47,0,2,2
40,2025-05-25T07:48:00+02:00,2025-05-25,15:48,1,1,2
40,2025-05-25T07:54:00+02:00,2025-05-25,15:54,0,1,1
41,2025-05-25T07:40:00+02:00,2025-05-25,15:40,16,7,23
41,2025-05-25T07:42:00+02:00,2025-05-25,15:42,5,27,32
41,2025-05-25T07:43:00+02:00,2025-05-25,15:43,7,6,13
41,2025-05-25T07:46:00+02:00,2025-05-25,15:46,4,8,12
41,2025-05-25T07:49:00+02:00,2025-05-25,15:49,8,10,18
41,2025-05-25T07:51:00+02:00,2025-05-25,15:51,8,17,25
41,2025-05-25T07:52:00+02:00,2025-05-25,15:52,6,11,17
43,2025-05-25T07:40:00+02:00,2025-05-25,15:40,10,2,12
45,2025-05-25T07:43:00+02:00,2025-05-25,15:43,32,17,49
45,2025-05-25T07:44:00+02:00,2025-05-25,15:44,20,12,32
45,2025-05-25T07:48:00+02:00,2025-05-25,15:48,34,18,52
45,2025-05-25T07:49:00+02:00,2025-05-25,15:49,25,24,49
47,2025-05-25T07:43:00+02:00,2025-05-25,15:43,16,19,35
47,2025-05-25T07:47:00+02:00,2025-05-25,15:47,20,17,37
47,2025-05-25T07:48:00+02:00,2025-05-25,15:48,17,29,46
47,2025-05-25T07:49:00+02:00,2025-05-25,15:49,13,27,40
47,2025-05-25T07:51:00+02:00,2025-05-25,15:51,20,16,36
50,2025-05-25T07:42:00+02:00,2025-05-25,15:42,5,3,8
50,2025-05-25T07:44:00+02:00,2025-05-25,15:44,2,3,5
50,2025-05-25T07:48:00+02:00,2025-05-25,15:48,2,4,6
50,2025-05-25T07:49:00+02:00,2025-05-25,15:49,3,1,4
50,2025-05-25T07:53:00+02:00,2025-05-25,15:53,4,6,10
54,2025-05-25T07:51:00+02:00,2025-05-25,15:51,7,2,9
59,2025-05-25T07:50:00+02:00,2025-05-25,15:50,14,15,29
61,2025-05-25T07:41:00+02:00,2025-05-25,15:41,5,7,12
61,2025-05-25T07:47:00+02:00,2025-05-25,15:47,14,18,32
61,2025-05-25T07:50:00+02:00,2025-05-25,15:50,10,18,28
61,2025-05-25T07:51:00+02:00,2025-05-25,15:51,4,10,14
61,2025-05-25T07:54:00+02:00,2025-05-25,15:54,13,12,25
66,2025-05-25T07:41:00+02:00,2025-05-25,15:41,33,25,58
66,2025-05-25T07:44:00+02:00,2025-05-25,15:44,30,28,58
66,2025-05-25T07:46:00+02:00,2025-05-25,15:46,29,13,42
66,2025-05-25T07:50:00+02:00,2025-05-25,15:50,31,27,58
66,2025-05-25T07:51:00+02:00,2025-05-25,15:51,26,25,51
66,2025-05-25T07:54:00+02:00,2025-05-25,15:54,18,29,47
69,2025-05-25T07:41:00+02:00,2025-05-25,15:41,5,4,9
69,2025-05-25T07:42:00+02:00,2025-05-25,15:42,2,4,6
69,2025-05-25T07:43:00+02:00,2025-05-25,15:43,4,2,6
69,2025-05-25T07:49:00+02:00,2025-05-25,15:49,0,5,5
69,2025-05-25T07:51:00+02:00,2025-05-25,15:51,2,3,5
69,2025-05-25T07:54:00+02:00,2025-05-25,15:54,3,4,7
70,2025-05-25T07:46:00+02:00,2025-05-25,15:46,0,1,1
70,2025-05-25T07:48:00+02:00,2025-05-25,15:48,3,2,5
70,2025-05-25T07:53:00+02:00,2025-05-25,15:53,3,3,6
70,2025-05-25T07:54:00+02:00,2025-05-25,15:54,3,2,5
75,2025-05-25T07:50:00+02:00,2025-05-25,15:50,0,2,2
75,2025-05-25T07:54:00+02:00,2025-05-25,15:54,0,1,1
78,2025-05-25T07:43:00+02:00,2025-05-25,15:43,0,1,1
78,2025-05-25T07:45:00+02:00,2025-05-25,15:45,0,3,3
78,2025-05-25T07:46:00+02:00,2025-05-25,15:46,1,1,2
84,2025-05-25T07:50:00+02:00,2025-05-25,15:50,71,139,210
87,2025-05-25T07:44:00+02:00,2025-05-25,15:44,0,3,3
87,2025-05-25T07:50:00+02:00,2025-05-25,15:50,4,2,6
107,2025-05-25T07:50:00+02:00,2025-05-25,15:50,12,21,33
108,2025-05-25T07:40:00+02:00,2025-05-25,15:40,1,2,3
108,2025-05-25T07:44:00+02:00,2025-05-25,15:44,0,7,7
108,2025-05-25T07:45:00+02:00,2025-05-25,15:45,2,2,4
108,2025-05-25T07:46:00+02:00,2025-05-25,15:46,3,1,4
108,2025-05-25T07:47:00+02:00,2025-05-25,15:47,0,1,1
108,2025-05-25T07:48:00+02:00,2025-05-25,15:48,3,0,3
108,2025-05-25T07:50:00+02:00,2025-05-25,15:50,2,6,8
108,2025-05-25T07:53:00+02:00,2025-05-25,15:53,7,5,12
118,2025-05-25T07:40:00+02:00,2025-05-25,15:40,0,2,2
124,2025-05-25T07:40:00+02:00,2025-05-25,15:40,1,1,2
124,2025-05-25T07:45:00+02:00,2025-05-25,15:45,0,1,1
131,2025-05-25T07:50:00+02:00,2025-05-25,15:50,8,2,10
132,2025-05-25T07:50:00+02:00,2025-05-25,15:50,7,10,17
133,2025-05-25T07:45:00+02:00,2025-05-25,15:45,17,13,30
134,2025-05-25T07:40:00+02:00,2025-05-25,15:40,24,22,46
134,2025-05-25T07:45:00+02:00,2025-05-25,15:45,41,39,80
134,2025-05-25T07:50:00+02:00,2025-05-25,15:50,32,34,66
140,2025-05-25T07:50:00+02:00,2025-05-25,15:50,8,8,16
162,2025-05-25T07:45:00+02:00,2025-05-25,15:45,37,66,103
162,2025-05-25T07:50:00+02:00,2025-05-25,15:50,28,55,83
165,2025-05-25T07:50:00+02:00,2025-05-25,15:50,0,2,2
166,2025-05-25T07:45:00+02:00,2025-05-25,15:45,2,7,9
167,2025-05-25T07:50:00+02:00,2025-05-25,15:50,4,6,10
179,2025-05-25T07:40:00+02:00,2025-05-25,15:40,4,4,8
1,2025-05-25T07:42:00+02:00,2025-05-25,15:42,21,28,49
1,2025-05-25T07:43:00+02:00,2025-05-25,15:43,38,16,54
1,2025-05-25T07:52:00+02:00,2025-05-25,15:52,19,28,47
2,2025-05-25T07:40:00+02:00,2025-05-25,15:40,1,15,16
2,2025-05-25T07:45:00+02:00,2025-05-25,15:45,15,15,30
2,2025-05-25T07:49:00+02:00,2025-05-25,15:49,13,8,21
9,2025-05-25T07:41:00+02:00,2025-05-25,15:41,2,2,4
9,2025-05-25T07:42:00+02:00,2025-05-25,15:42,0,5,5
9,2025-05-25T07:47:00+02:00,2025-05-25,15:47,2,3,5
9,2025-05-25T07:49:00+02:00,2025-05-25,15:49,0,1,1
10,2025-05-25T07:41:00+02:00,2025-05-25,15:41,2,2,4
10,2025-05-25T07:47:00+02:00,2025-05-25,15:47,0,3,3
10,2025-05-25T07:48:00+02:00,2025-05-25,15:48,0,3,3
11,2025-05-25T07:43:00+02:00,2025-05-25,15:43,0,1,1
11,2025-05-25T07:47:00+02:00,2025-05-25,15:47,2,3,5
11,2025-05-25T07:49:00+02:00,2025-05-25,15:49,0,3,3
11,2025-05-25T07:54:00+02:00,2025-05-25,15:54,0,2,2
12,2025-05-25T07:42:00+02:00,2025-05-25,15:42,3,9,12
12,2025-05-25T07:46:00+02:00,2025-05-25,15:46,8,4,12
12,2025-05-25T07:51:00+02:00,2025-05-25,15:51,10,0,10
12,2025-05-25T07:52:00+02:00,2025-05-25,15:52,15,10,25
17,2025-05-25T07:44:00+02:00,2025-05-25,15:44,5,1,6
17,2025-05-25T07:45:00+02:00,2025-05-25,15:45,2,3,5
17,2025-05-25T07:51:00+02:00,2025-05-25,15:51,1,0,1
17,2025-05-25T07:52:00+02:00,2025-05-25,15:52,1,3,4
18,2025-05-25T07:47:00+02:00,2025-05-25,15:47,1,0,1
18,2025-05-25T07:50:00+02:00,2025-05-25,15:50,0,1,1
18,2025-05-25T07:53:00+02:00,2025-05-25,15:53,4,0,4
19,2025-05-25T07:40:00+02:00,2025-05-25,15:40,15,5,20
19,2025-05-25T07:42:00+02:00,2025-05-25,15:42,7,12,19
19,2025-05-25T07:43:00+02:00,2025-05-25,15:43,7,9,16
19,2025-05-25T07:44:00+02:00,2025-05-25,15:44,8,12,20
19,2025-05-25T07:45:00+02:00,2025-05-25,15:45,10,6,16
19,2025-05-25T07:48:00+02:00,2025-05-25,15:48,15,5,20
19,2025-05-25T07:53:00+02:00,2025-05-25,15:53,15,9,24
19,2025-05-25T07:54:00+02:00,2025-05-25,15:54,9,2,11
20,2025-05-25T07:40:00+02:00,2025-05-25,15:40,6,2,8
20,2025-05-25T07:42:00+02:00,2025-05-25,15:42,2,12,14
20,2025-05-25T07:43:00+02:00,2025-05-25,15:43,3,8,11
20,2025-05-25T07:44:00+02:00,2025-05-25,15:44,3,1,4
20,2025-05-25T07:45:00+02:00,2025-05-25,15:45,5,5,10
20,2025-05-25T07:46:00+02:00,2025-05-25,15:46,2,7,9
20,2025-05-25T07:48:00+02:00,2025-05-25,15:48,2,0,2
20,2025-05-25T07:50:00+02:00,2025-05-25,15:50,1,1,2
20,2025-05-25T07:51:00+02:00,2025-05-25,15:51,2,4,6
20,2025-05-25T07:53:00+02:00,2025-05-25,15:53,10,4,14
23,2025-05-25T07:41:00+02:00,2025-05-25,15:41,2,2,4
23,2025-05-25T07:48:00+02:00,2025-05-25,15:48,1,7,8
23,2025-05-25T07:54:00+02:00,2025-05-25,15:54,0,5,5
24,2025-05-25T07:40:00+02:00,2025-05-25,15:40,7,31,38
24,2025-05-25T07:42:00+02:00,2025-05-25,15:42,5,3,8
24,2025-05-25T07:51:00+02:00,2025-05-25,15:51,6,21,27
24,2025-05-25T07:54:00+02:00,2025-05-25,15:54,11,17,28
25,2025-05-25T07:40:00+02:00,2025-05-25,15:40,84,62,146
25,2025-05-25T07:45:00+02:00,2025-05-25,15:45,70,32,102
25,2025-05-25T07:50:00+02:00,2025-05-25,15:50,79,55,134
27,2025-05-25T07:43:00+02:00,2025-05-25,15:43,3,3,6
27,2025-05-25T07:46:00+02:00,2025-05-25,15:46,0,3,3
27,2025-05-25T07:47:00+02:00,2025-05-25,15:47,5,5,10
27,2025-05-25T07:50:00+02:00,2025-05-25,15:50,2,0,2
27,2025-05-25T07:51:00+02:00,2025-05-25,15:51,1,7,8
27,2025-05-25T07:53:00+02:00,2025-05-25,15:53,5,1,6
30,2025-05-25T07:44:00+02:00,2025-05-25,15:44,4,14,18
30,2025-05-25T07:47:00+02:00,2025-05-25,15:47,3,5,8
30,2025-05-25T07:49:00+02:00,2025-05-25,15:49,3,11,14
30,2025-05-25T07:51:00+02:00,2025-05-25,15:51,7,7,14
35,2025-05-25T07:42:00+02:00,2025-05-25,15:42,25,20,45
35,2025-05-25T07:46:00+02:00,2025-05-25,15:46,16,24,40
35,2025-05-25T07:49:00+02:00,2025-05-25,15:49,10,46,56
35,2025-05-25T07:50:00+02:00,2025-05-25,15:50,23,21,44
35,2025-05-25T07:53:00+02:00,2025-05-25,15:53,8,27,35
48,2025-05-25T07:41:00+02:00,2025-05-25,15:41,10,15,25
48,2025-05-25T07:42:00+02:00,2025-05-25,15:42,18,17,35
48,2025-05-25T07:50:00+02:00,2025-05-25,15:50,7,4,11
49,2025-05-25T07:41:00+02:00,2025-05-25,15:41,6,12,18
49,2025-05-25T07:44:00+02:00,2025-05-25,15:44,1,3,4
49,2025-05-25T07:51:00+02:00,2025-05-25,15:51,3,10,13
49,2025-05-25T07:52:00+02:00,2025-05-25,15:52,0,9,9
51,2025-05-25T07:44:00+02:00,2025-05-25,15:44,2,2,4
51,2025-05-25T07:46:00+02:00,2025-05-25,15:46,1,0,1
51,2025-05-25T07:47:00+02:00,2025-05-25,15:47,4,1,5
51,2025-05-25T07:49:00+02:00,2025-05-25,15:49,4,2,6
51,2025-05-25T07:54:00+02:00,2025-05-25,15:54,0,5,5
52,2025-05-25T07:43:00+02:00,2025-05-25,15:43,4,6,10
52,2025-05-25T07:49:00+02:00,2025-05-25,15:49,2,8,10
52,2025-05-25T07:51:00+02:00,2025-05-25,15:51,4,7,11
52,2025-05-25T07:52:00+02:00,2025-05-25,15:52,8,7,15
52,2025-05-25T07:54:00+02:00,2025-05-25,15:54,0,7,7
53,2025-05-25T07:41:00+02:00,2025-05-25,15:41,9,12,21
53,2025-05-25T07:42:00+02:00,2025-05-25,15:42,8,19,27
53,2025-05-25T07:43:00+02:00,2025-05-25,15:43,11,16,27
53,2025-05-25T07:44:00+02:00,2025-05-25,15:44,10,4,14
53,2025-05-25T07:45:00+02:00,2025-05-25,15:45,12,12,24
53,2025-05-25T07:47:00+02:00,2025-05-25,15:47,8,2,10
53,2025-05-25T07:51:00+02:00,2025-05-25,15:51,4,5,9
53,2025-05-25T07:53:00+02:00,2025-05-25,15:53,4,12,16
53,2025-05-25T07:54:00+02:00,2025-05-25,15:54,17,12,29
56,2025-05-25T07:47:00+02:00,2025-05-25,15:47,4,21,25
56,2025-05-25T07:48:00+02:00,2025-05-25,15:48,8,5,13
56,2025-05-25T07:49:00+02:00,2025-05-25,15:49,3,8,11
56,2025-05-25T07:50:00+02:00,2025-05-25,15:50,5,4,9
56,2025-05-25T07:51:00+02:00,2025-05-25,15:51,5,0,5
58,2025-05-25T07:40:00+02:00,2025-05-25,15:40,6,14,20
58,2025-05-25T07:41:00+02:00,2025-05-25,15:41,8,17,25
58,2025-05-25T07:43:00+02:00,2025-05-25,15:43,12,5,17
58,2025-05-25T07:46:00+02:00,2025-05-25,15:46,15,6,21
58,2025-05-25T07:47:00+02:00,2025-05-25,15:47,10,11,21
58,2025-05-25T07:52:00+02:00,2025-05-25,15:52,10,10,20
62,2025-05-25T07:41:00+02:00,2025-05-25,15:41,8,3,11
62,2025-05-25T07:45:00+02:00,2025-05-25,15:45,4,2,6
62,2025-05-25T07:49:00+02:00,2025-05-25,15:49,2,0,2
62,2025-05-25T07:54:00+02:00,2025-05-25,15:54,3,2,5
63,2025-05-25T07:40:00+02:00,2025-05-25,15:40,5,8,13
63,2025-05-25T07:42:00+02:00,2025-05-25,15:42,7,10,17
63,2025-05-25T07:44:00+02:00,2025-05-25,15:44,16,9,25
63,2025-05-25T07:45:00+02:00,2025-05-25,15:45,9,6,15
63,2025-05-25T07:46:00+02:00,2025-05-25,15:46,9,7,16
63,2025-05-25T07:49:00+02:00,2025-05-25,15:49,12,4,16
63,2025-05-25T07:51:00+02:00,2025-05-25,15:51,7,6,13
63,2025-05-25T07:53:00+02:00,2025-05-25,15:53,8,15,23
67,2025-05-25T07:45:00+02:00,2025-05-25,15:45,8,17,25
67,2025-05-25T07:46:00+02:00,2025-05-25,15:46,17,9,26
67,2025-05-25T07:47:00+02:00,2025-05-25,15:47,7,13,20
67,2025-05-25T07:48:00+02:00,2025-05-25,15:48,5,9,14
67,2025-05-25T07:51:00+02:00,2025-05-25,15:51,7,21,28
68,2025-05-25T07:42:00+02:00,2025-05-25,15:42,5,9,14
68,2025-05-25T07:53:00+02:00,2025-05-25,15:53,13,12,25
68,2025-05-25T07:54:00+02:00,2025-05-25,15:54,9,8,17
72,2025-05-25T07:44:00+02:00,2025-05-25,15:44,1,13,14
72,2025-05-25T07:46:00+02:00,2025-05-25,15:46,12,21,33
72,2025-05-25T07:49:00+02:00,2025-05-25,15:49,3,7,10
72,2025-05-25T07:50:00+02:00,2025-05-25,15:50,5,3,8
72,2025-05-25T07:51:00+02:00,2025-05-25,15:51,6,22,28
76,2025-05-25T07:40:00+02:00,2025-05-25,15:40,1,1,2
76,2025-05-25T07:41:00+02:00,2025-05-25,15:41,1,0,1
76,2025-05-25T07:42:00+02:00,2025-05-25,15:42,1,0,1
76,2025-05-25T07:48:00+02:00,2025-05-25,15:48,0,1,1
76,2025-05-25T07:54:00+02:00,2025-05-25,15:54,1,0,1
79,2025-05-25T07:40:00+02:00,2025-05-25,15:40,11,12,23
79,2025-05-25T07:43:00+02:00,2025-05-25,15:43,0,9,9
79,2025-05-25T07:44:00+02:00,2025-05-25,15:44,8,11,19
79,2025-05-25T07:47:00+02:00,2025-05-25,15:47,8,9,17
79,2025-05-25T07:52:00+02:00,2025-05-25,15:52,16,15,31
85,2025-05-25T07:41:00+02:00,2025-05-25,15:41,4,0,4
85,2025-05-25T07:44:00+02:00,2025-05-25,15:44,0,3,3
85,2025-05-25T07:45:00+02:00,2025-05-25,15:45,2,1,3
85,2025-05-25T07:46:00+02:00,2025-05-25,15:46,2,4,6
85,2025-05-25T07:51:00+02:00,2025-05-25,15:51,0,2,2
86,2025-05-25T07:48:00+02:00,2025-05-25,15:48,3,0,3
86,2025-05-25T07:51:00+02:00,2025-05-25,15:51,1,1,2
86,2025-05-25T07:52:00+02:00,2025-05-25,15:52,0,4,4
117,2025-05-25T07:45:00+02:00,2025-05-25,15:45,20,20,40
117,2025-05-25T07:50:00+02:00,2025-05-25,15:50,29,22,51
123,2025-05-25T07:40:00+02:00,2025-05-25,15:40,6,4,10
123,2025-05-25T07:50:00+02:00,2025-05-25,15:50,8,0,8
130,2025-05-25T07:40:00+02:00,2025-05-25,15:40,4,7,11
130,2025-05-25T07:45:00+02:00,2025-05-25,15:45,1,13,14
137,2025-05-25T07:40:00+02:00,2025-05-25,15:40,0,3,3
137,2025-05-25T07:45:00+02:00,2025-05-25,15:45,0,2,2
138,2025-05-25T07:40:00+02:00,2025-05-25,15:40,0,1,1
138,2025-05-25T07:45:00+02:00,2025-05-25,15:45,3,6,9
141,2025-05-25T07:50:00+02:00,2025-05-25,15:50,11,11,22
142,2025-05-25T07:40:00+02:00,2025-05-25,15:40,43,37,80
142,2025-05-25T07:45:00+02:00,2025-05-25,15:45,63,44,107
161,2025-05-25T07:50:00+02:00,2025-05-25,15:50,18,19,37
164,2025-05-25T07:50:00+02:00,2025-05-25,15:50,10,2,12
181,2025-05-25T07:43:00+02:00,2025-05-25,15:43,8,22,30
181,2025-05-25T07:44:00+02:00,2025-05-25,15:44,15,15,30
181,2025-05-25T07:48:00+02:00,2025-05-25,15:48,16,19,35
181,2025-05-25T07:52:00+02:00,2025-05-25,15:52,14,38,52
181,2025-05-25T07:53:00+02:00,2025-05-25,15:53,16,13,29
180,2025-05-25T07:40:00+02:00,2025-05-25,15:40,0,1,1
180,2025-05-25T07:41:00+02:00,2025-05-25,15:41,1,1,2
180,2025-05-25T07:44:00+02:00,2025-05-25,15:44,0,5,5
180,2025-05-25T07:47:00+02:00,2025-05-25,15:47,1,0,1
180,2025-05-25T07:48:00+02:00,2025-05-25,15:48,0,2,2
180,2025-05-25T07:50:00+02:00,2025-05-25,15:50,4,0,4
3,2025-05-25T08:03:00+02:00,2025-05-25,16:03,18,20,38
3,2025-05-25T08:05:00+02:00,2025-05-25,16:05,10,24,34
4,2025-05-25T08:01:00+02:00,2025-05-25,16:01,30,18,48
4,2025-05-25T08:02:00+02:00,2025-05-25,16:02,17,31,48
5,2025-05-25T08:00:00+02:00,2025-05-25,16:00,95,118,213
5,2025-05-25T08:05:00+02:00,2025-05-25,16:05,63,121,184
6,2025-05-25T07:56:00+02:00,2025-05-25,15:56,13,12,25
6,2025-05-25T07:57:00+02:00,2025-05-25,15:57,16,18,34
6,2025-05-25T07:59:00+02:00,2025-05-25,15:59,8,8,16
6,2025-05-25T08:03:00+02:00,2025-05-25,16:03,12,12,24
6,2025-05-25T08:07:00+02:00,2025-05-25,16:07,18,16,34
8,2025-05-25T07:57:00+02:00,2025-05-25,15:57,7,4,11
8,2025-05-25T08:00:00+02:00,2025-05-25,16:00,10,1,11
8,2025-05-25T08:07:00+02:00,2025-05-25,16:07,6,14,20
28,2025-05-25T07:56:00+02:00,2025-05-25,15:56,8,12,20
28,2025-05-25T07:59:00+02:00,2025-05-25,15:59,6,8,14
28,2025-05-25T08:01:00+02:00,2025-05-25,16:01,4,5,9
28,2025-05-25T08:04:00+02:00,2025-05-25,16:04,15,10,25
28,2025-05-25T08:08:00+02:00,2025-05-25,16:08,11,12,23
28,2025-05-25T08:09:00+02:00,2025-05-25,16:09,12,17,29
29,2025-05-25T07:57:00+02:00,2025-05-25,15:57,7,10,17
29,2025-05-25T08:02:00+02:00,2025-05-25,16:02,15,17,32
29,2025-05-25T08:06:00+02:00,2025-05-25,16:06,17,19,36
29,2025-05-25T08:08:00+02:00,2025-05-25,16:08,13,14,27
31,2025-05-25T07:59:00+02:00,2025-05-25,15:59,8,1,9
31,2025-05-25T08:02:00+02:00,2025-05-25,16:02,11,3,14
31,2025-05-25T08:03:00+02:00,2025-05-25,16:03,4,11,15
31,2025-05-25T08:05:00+02:00,2025-05-25,16:05,11,2,13
31,2025-05-25T08:06:00+02:00,2025-05-25,16:06,3,5,8
31,2025-05-25T08:07:00+02:00,2025-05-25,16:07,5,0,5
36,2025-05-25T07:58:00+02:00,2025-05-25,15:58,1,3,4
36,2025-05-25T08:00:00+02:00,2025-05-25,16:00,1,2,3
36,2025-05-25T08:01:00+02:00,2025-05-25,16:01,5,3,8
36,2025-05-25T08:04:00+02:00,2025-05-25,16:04,0,7,7
36,2025-05-25T08:07:00+02:00,2025-05-25,16:07,3,7,10
39,2025-05-25T07:56:00+02:00,2025-05-25,15:56,1,0,1
39,2025-05-25T07:57:00+02:00,2025-05-25,15:57,0,2,2
40,2025-05-25T07:59:00+02:00,2025-05-25,15:59,6,1,7
40,2025-05-25T08:00:00+02:00,2025-05-25,16:00,5,0,5
40,2025-05-25T08:03:00+02:00,2025-05-25,16:03,3,2,5
40,2025-05-25T08:06:00+02:00,2025-05-25,16:06,2,2,4
40,2025-05-25T08:07:00+02:00,2025-05-25,16:07,4,0,4
41,2025-05-25T07:55:00+02:00,2025-05-25,15:55,16,1,17
41,2025-05-25T07:56:00+02:00,2025-05-25,15:56,14,2,16
41,2025-05-25T08:01:00+02:00,2025-05-25,16:01,3,8,11
41,2025-05-25T08:06:00+02:00,2025-05-25,16:06,5,7,12
41,2025-05-25T08:08:00+02:00,2025-05-25,16:08,8,10,18
41,2025-05-25T08:09:00+02:00,2025-05-25,16:09,7,1,8
43,2025-05-25T08:00:00+02:00,2025-05-25,16:00,10,1,11
43,2025-05-25T08:05:00+02:00,2025-05-25,16:05,13,6,19
44,2025-05-25T07:55:00+02:00,2025-05-25,15:55,4,1,5
44,2025-05-25T08:00:00+02:00,2025-05-25,16:00,7,2,9
45,2025-05-25T07:58:00+02:00,2025-05-25,15:58,21,15,36
45,2025-05-25T08:01:00+02:00,2025-05-25,16:01,29,13,42
45,2025-05-25T08:03:00+02:00,2025-05-25,16:03,7,20,27
47,2025-05-25T07:56:00+02:00,2025-05-25,15:56,27,12,39
47,2025-05-25T07:57:00+02:00,2025-05-25,15:57,33,14,47
47,2025-05-25T08:04:00+02:00,2025-05-25,16:04,22,14,36
47,2025-05-25T08:07:00+02:00,2025-05-25,16:07,17,9,26
50,2025-05-25T07:57:00+02:00,2025-05-25,15:57,3,1,4
50,2025-05-25T07:58:00+02:00,2025-05-25,15:58,7,0,7
50,2025-05-25T08:00:00+02:00,2025-05-25,16:00,6,4,10
50,2025-05-25T08:01:00+02:00,2025-05-25,16:01,7,4,11
50,2025-05-25T08:04:00+02:00,2025-05-25,16:04,2,5,7
50,2025-05-25T08:06:00+02:00,2025-05-25,16:06,6,2,8
50,2025-05-25T08:09:00+02:00,2025-05-25,16:09,3,2,5
54,2025-05-25T08:01:00+02:00,2025-05-25,16:01,3,0,3
54,2025-05-25T08:04:00+02:00,2025-05-25,16:04,2,0,2
54,2025-05-25T08:08:00+02:00,2025-05-25,16:08,3,2,5
54,2025-05-25T08:09:00+02:00,2025-05-25,16:09,3,1,4
59,2025-05-25T07:55:00+02:00,2025-05-25,15:55,23,23,46
59,2025-05-25T08:05:00+02:00,2025-05-25,16:05,30,31,61
61,2025-05-25T07:59:00+02:00,2025-05-25,15:59,9,7,16
61,2025-05-25T08:03:00+02:00,2025-05-25,16:03,7,5,12
61,2025-05-25T08:05:00+02:00,2025-05-25,16:05,6,8,14
61,2025-05-25T08:08:00+02:00,2025-05-25,16:08,4,3,7
66,2025-05-25T07:59:00+02:00,2025-05-25,15:59,21,9,30
66,2025-05-25T08:01:00+02:00,2025-05-25,16:01,22,32,54
66,2025-05-25T08:02:00+02:00,2025-05-25,16:02,37,11,48
66,2025-05-25T08:03:00+02:00,2025-05-25,16:03,29,46,75
66,2025-05-25T08:09:00+02:00,2025-05-25,16:09,27,33,60
69,2025-05-25T07:55:00+02:00,2025-05-25,15:55,5,4,9
69,2025-05-25T07:56:00+02:00,2025-05-25,15:56,4,5,9
69,2025-05-25T07:59:00+02:00,2025-05-25,15:59,3,6,9
69,2025-05-25T08:01:00+02:00,2025-05-25,16:01,1,9,10
69,2025-05-25T08:09:00+02:00,2025-05-25,16:09,1,1,2
70,2025-05-25T07:59:00+02:00,2025-05-25,15:59,1,0,1
70,2025-05-25T08:06:00+02:00,2025-05-25,16:06,6,2,8
75,2025-05-25T07:58:00+02:00,2025-05-25,15:58,0,3,3
75,2025-05-25T08:03:00+02:00,2025-05-25,16:03,0,2,2
75,2025-05-25T08:05:00+02:00,2025-05-25,16:05,0,1,1
75,2025-05-25T08:08:00+02:00,2025-05-25,16:08,2,0,2
77,2025-05-25T08:00:00+02:00,2025-05-25,16:00,20,13,33
78,2025-05-25T07:55:00+02:00,2025-05-25,15:55,1,1,2
78,2025-05-25T07:56:00+02:00,2025-05-25,15:56,0,2,2
78,2025-05-25T07:57:00+02:00,2025-05-25,15:57,1,2,3
78,2025-05-25T08:00:00+02:00,2025-05-25,16:00,0,1,1
78,2025-05-25T08:08:00+02:00,2025-05-25,16:08,2,4,6
84,2025-05-25T08:00:00+02:00,2025-05-25,16:00,77,106,183
87,2025-05-25T07:58:00+02:00,2025-05-25,15:58,2,1,3
87,2025-05-25T08:02:00+02:00,2025-05-25,16:02,1,2,3
107,2025-05-25T07:55:00+02:00,2025-05-25,15:55,10,7,17
108,2025-05-25T07:55:00+02:00,2025-05-25,15:55,1,0,1
108,2025-05-25T07:56:00+02:00,2025-05-25,15:56,0,5,5
108,2025-05-25T07:57:00+02:00,2025-05-25,15:57,1,4,5
108,2025-05-25T07:59:00+02:00,2025-05-25,15:59,2,2,4
124,2025-05-25T08:00:00+02:00,2025-05-25,16:00,1,1,2
132,2025-05-25T08:00:00+02:00,2025-05-25,16:00,7,15,22
133,2025-05-25T08:00:00+02:00,2025-05-25,16:00,21,42,63
135,2025-05-25T07:55:00+02:00,2025-05-25,15:55,31,25,56
135,2025-05-25T08:05:00+02:00,2025-05-25,16:05,71,32,103
162,2025-05-25T07:55:00+02:00,2025-05-25,15:55,36,76,112
162,2025-05-25T08:00:00+02:00,2025-05-25,16:00,34,83,117
166,2025-05-25T08:05:00+02:00,2025-05-25,16:05,2,6,8
167,2025-05-25T08:00:00+02:00,2025-05-25,16:00,4,12,16
179,2025-05-25T08:00:00+02:00,2025-05-25,16:00,5,7,12
1,2025-05-25T07:55:00+02:00,2025-05-25,15:55,29,18,47
1,2025-05-25T07:58:00+02:00,2025-05-25,15:58,26,32,58
1,2025-05-25T07:59:00+02:00,2025-05-25,15:59,28,11,39
1,2025-05-25T08:00:00+02:00,2025-05-25,16:00,26,18,44
1,2025-05-25T08:03:00+02:00,2025-05-25,16:03,29,26,55
1,2025-05-25T08:04:00+02:00,2025-05-25,16:04,26,12,38
2,2025-05-25T07:57:00+02:00,2025-05-25,15:57,8,14,22
2,2025-05-25T07:58:00+02:00,2025-05-25,15:58,7,21,28
2,2025-05-25T08:00:00+02:00,2025-05-25,16:00,9,15,24
2,2025-05-25T08:03:00+02:00,2025-05-25,16:03,16,9,25
2,2025-05-25T08:05:00+02:00,2025-05-25,16:05,4,4,8
2,2025-05-25T08:06:00+02:00,2025-05-25,16:06,7,15,22
2,2025-05-25T08:07:00+02:00,2025-05-25,16:07,9,4,13
2,2025-05-25T08:09:00+02:00,2025-05-25,16:09,6,7,13
9,2025-05-25T07:58:00+02:00,2025-05-25,15:58,2,1,3
9,2025-05-25T07:59:00+02:00,2025-05-25,15:59,0,3,3
9,2025-05-25T08:00:00+02:00,2025-05-25,16:00,0,2,2
9,2025-05-25T08:04:00+02:00,2025-05-25,16:04,1,3,4
9,2025-05-25T08:07:00+02:00,2025-05-25,16:07,1,1,2
10,2025-05-25T07:55:00+02:00,2025-05-25,15:55,0,1,1
10,2025-05-25T07:59:00+02:00,2025-05-25,15:59,1,0,1
10,2025-05-25T08:01:00+02:00,2025-05-25,16:01,6,0,6
10,2025-05-25T08:06:00+02:00,2025-05-25,16:06,2,0,2
11,2025-05-25T07:56:00+02:00,2025-05-25,15:56,0,2,2
11,2025-05-25T08:05:00+02:00,2025-05-25,16:05,11,1,12
11,2025-05-25T08:09:00+02:00,2025-05-25,16:09,0,2,2
12,2025-05-25T07:55:00+02:00,2025-05-25,15:55,4,0,4
12,2025-05-25T07:57:00+02:00,2025-05-25,15:57,3,6,9
12,2025-05-25T07:59:00+02:00,2025-05-25,15:59,1,0,1
12,2025-05-25T08:01:00+02:00,2025-05-25,16:01,6,4,10
12,2025-05-25T08:03:00+02:00,2025-05-25,16:03,2,5,7
12,2025-05-25T08:04:00+02:00,2025-05-25,16:04,5,7,12
12,2025-05-25T08:08:00+02:00,2025-05-25,16:08,12,8,20
17,2025-05-25T08:00:00+02:00,2025-05-25,16:00,3,5,8
17,2025-05-25T08:05:00+02:00,2025-05-25,16:05,5,0,5
17,2025-05-25T08:07:00+02:00,2025-05-25,16:07,4,1,5
18,2025-05-25T07:55:00+02:00,2025-05-25,15:55,5,0,5
18,2025-05-25T07:56:00+02:00,2025-05-25,15:56,4,0,4
18,2025-05-25T07:57:00+02:00,2025-05-25,15:57,2,3,5
18,2025-05-25T08:00:00+02:00,2025-05-25,16:00,0,2,2
18,2025-05-25T08:06:00+02:00,2025-05-25,16:06,1,0,1
18,2025-05-25T08:07:00+02:00,2025-05-25,16:07,1,0,1
18,2025-05-25T08:09:00+02:00,2025-05-25,16:09,1,0,1
19,2025-05-25T07:55:00+02:00,2025-05-25,15:55,8,6,14
19,2025-05-25T07:59:00+02:00,2025-05-25,15:59,17,7,24
19,2025-05-25T08:04:00+02:00,2025-05-25,16:04,10,9,19
19,2025-05-25T08:08:00+02:00,2025-05-25,16:08,16,5,21
19,2025-05-25T08:09:00+02:00,2025-05-25,16:09,9,6,15
20,2025-05-25T07:55:00+02:00,2025-05-25,15:55,6,7,13
20,2025-05-25T07:57:00+02:00,2025-05-25,15:57,5,3,8
20,2025-05-25T07:59:00+02:00,2025-05-25,15:59,4,3,7
20,2025-05-25T08:00:00+02:00,2025-05-25,16:00,5,6,11
20,2025-05-25T08:04:00+02:00,2025-05-25,16:04,2,6,8
20,2025-05-25T08:06:00+02:00,2025-05-25,16:06,17,1,18
20,2025-05-25T08:07:00+02:00,2025-05-25,16:07,5,0,5
20,2025-05-25T08:08:00+02:00,2025-05-25,16:08,6,0,6
23,2025-05-25T07:55:00+02:00,2025-05-25,15:55,1,7,8
23,2025-05-25T07:56:00+02:00,2025-05-25,15:56,2,6,8
23,2025-05-25T07:59:00+02:00,2025-05-25,15:59,0,3,3
23,2025-05-25T08:03:00+02:00,2025-05-25,16:03,0,5,5
24,2025-05-25T07:57:00+02:00,2025-05-25,15:57,6,20,26
24,2025-05-25T08:03:00+02:00,2025-05-25,16:03,2,32,34
24,2025-05-25T08:05:00+02:00,2025-05-25,16:05,3,6,9
24,2025-05-25T08:09:00+02:00,2025-05-25,16:09,1,21,22
27,2025-05-25T07:59:00+02:00,2025-05-25,15:59,2,2,4
27,2025-05-25T08:03:00+02:00,2025-05-25,16:03,5,14,19
27,2025-05-25T08:04:00+02:00,2025-05-25,16:04,7,1,8
30,2025-05-25T07:55:00+02:00,2025-05-25,15:55,10,7,17
30,2025-05-25T07:57:00+02:00,2025-05-25,15:57,3,5,8
30,2025-05-25T07:59:00+02:00,2025-05-25,15:59,4,6,10
30,2025-05-25T08:01:00+02:00,2025-05-25,16:01,13,7,20
30,2025-05-25T08:07:00+02:00,2025-05-25,16:07,4,8,12
35,2025-05-25T07:56:00+02:00,2025-05-25,15:56,30,23,53
35,2025-05-25T07:57:00+02:00,2025-05-25,15:57,18,32,50
35,2025-05-25T08:09:00+02:00,2025-05-25,16:09,33,16,49
46,2025-05-25T08:00:00+02:00,2025-05-25,16:00,8,5,13
48,2025-05-25T07:55:00+02:00,2025-05-25,15:55,8,2,10
48,2025-05-25T07:59:00+02:00,2025-05-25,15:59,13,3,16
48,2025-05-25T08:01:00+02:00,2025-05-25,16:01,13,13,26
48,2025-05-25T08:02:00+02:00,2025-05-25,16:02,10,1,11
48,2025-05-25T08:04:00+02:00,2025-05-25,16:04,18,3,21
48,2025-05-25T08:05:00+02:00,2025-05-25,16:05,3,6,9
48,2025-05-25T08:08:00+02:00,2025-05-25,16:08,8,1,9
49,2025-05-25T07:56:00+02:00,2025-05-25,15:56,0,18,18
49,2025-05-25T08:04:00+02:00,2025-05-25,16:04,3,6,9
49,2025-05-25T08:06:00+02:00,2025-05-25,16:06,6,11,17
49,2025-05-25T08:07:00+02:00,2025-05-25,16:07,6,10,16
49,2025-05-25T08:09:00+02:00,2025-05-25,16:09,3,16,19
51,2025-05-25T08:01:00+02:00,2025-05-25,16:01,0,1,1
51,2025-05-25T08:02:00+02:00,2025-05-25,16:02,2,4,6
52,2025-05-25T07:55:00+02:00,2025-05-25,15:55,3,5,8
52,2025-05-25T08:00:00+02:00,2025-05-25,16:00,5,6,11
52,2025-05-25T08:03:00+02:00,2025-05-25,16:03,7,7,14
52,2025-05-25T08:07:00+02:00,2025-05-25,16:07,3,19,22
52,2025-05-25T08:09:00+02:00,2025-05-25,16:09,1,5,6
53,2025-05-25T07:57:00+02:00,2025-05-25,15:57,4,4,8
53,2025-05-25T07:58:00+02:00,2025-05-25,15:58,16,6,22
53,2025-05-25T08:00:00+02:00,2025-05-25,16:00,10,13,23
56,2025-05-25T07:56:00+02:00,2025-05-25,15:56,7,2,9
56,2025-05-25T07:57:00+02:00,2025-05-25,15:57,8,10,18
56,2025-05-25T07:59:00+02:00,2025-05-25,15:59,6,2,8
56,2025-05-25T08:05:00+02:00,2025-05-25,16:05,4,7,11
56,2025-05-25T08:08:00+02:00,2025-05-25,16:08,4,13,17
58,2025-05-25T07:59:00+02:00,2025-05-25,15:59,16,7,23
58,2025-05-25T08:00:00+02:00,2025-05-25,16:00,8,8,16
58,2025-05-25T08:01:00+02:00,2025-05-25,16:01,6,6,12
58,2025-05-25T08:03:00+02:00,2025-05-25,16:03,13,5,18
58,2025-05-25T08:05:00+02:00,2025-05-25,16:05,3,8,11
58,2025-05-25T08:07:00+02:00,2025-05-25,16:07,14,13,27
58,2025-05-25T08:08:00+02:00,2025-05-25,16:08,4,28,32
62,2025-05-25T07:56:00+02:00,2025-05-25,15:56,4,2,6
62,2025-05-25T07:57:00+02:00,2025-05-25,15:57,1,5,6
62,2025-05-25T07:59:00+02:00,2025-05-25,15:59,3,2,5
62,2025-05-25T08:01:00+02:00,2025-05-25,16:01,5,6,11
62,2025-05-25T08:02:00+02:00,2025-05-25,16:02,6,6,12
63,2025-05-25T07:55:00+02:00,2025-05-25,15:55,5,4,9
63,2025-05-25T08:02:00+02:00,2025-05-25,16:02,10,6,16
63,2025-05-25T08:07:00+02:00,2025-05-25,16:07,7,3,10
67,2025-05-25T08:03:00+02:00,2025-05-25,16:03,7,10,17
67,2025-05-25T08:04:00+02:00,2025-05-25,16:04,2,13,15
67,2025-05-25T08:05:00+02:00,2025-05-25,16:05,1,13,14
67,2025-05-25T08:06:00+02:00,2025-05-25,16:06,3,10,13
68,2025-05-25T07:56:00+02:00,2025-05-25,15:56,7,2,9
68,2025-05-25T07:58:00+02:00,2025-05-25,15:58,8,4,12
68,2025-05-25T08:02:00+02:00,2025-05-25,16:02,7,7,14
68,2025-05-25T08:07:00+02:00,2025-05-25,16:07,3,5,8
72,2025-05-25T08:07:00+02:00,2025-05-25,16:07,6,12,18
76,2025-05-25T08:03:00+02:00,2025-05-25,16:03,1,0,1
76,2025-05-25T08:07:00+02:00,2025-05-25,16:07,1,1,2
79,2025-05-25T07:59:00+02:00,2025-05-25,15:59,8,12,20
79,2025-05-25T08:02:00+02:00,2025-05-25,16:02,7,17,24
79,2025-05-25T08:04:00+02:00,2025-05-25,16:04,3,5,8
79,2025-05-25T08:09:00+02:00,2025-05-25,16:09,9,12,21
85,2025-05-25T07:57:00+02:00,2025-05-25,15:57,3,2,5
85,2025-05-25T07:59:00+02:00,2025-05-25,15:59,1,2,3
85,2025-05-25T08:00:00+02:00,2025-05-25,16:00,1,3,4
85,2025-05-25T08:02:00+02:00,2025-05-25,16:02,1,1,2
85,2025-05-25T08:04:00+02:00,2025-05-25,16:04,1,1,2
85,2025-05-25T08:06:00+02:00,2025-05-25,16:06,1,0,1
85,2025-05-25T08:07:00+02:00,2025-05-25,16:07,0,1,1
86,2025-05-25T07:58:00+02:00,2025-05-25,15:58,3,0,3
86,2025-05-25T07:59:00+02:00,2025-05-25,15:59,1,4,5
86,2025-05-25T08:01:00+02:00,2025-05-25,16:01,0,1,1
86,2025-05-25T08:02:00+02:00,2025-05-25,16:02,0,4,4
109,2025-05-25T08:00:00+02:00,2025-05-25,16:00,6,16,22
117,2025-05-25T07:55:00+02:00,2025-05-25,15:55,15,14,29
123,2025-05-25T07:55:00+02:00,2025-05-25,15:55,12,5,17
130,2025-05-25T08:00:00+02:00,2025-05-25,16:00,5,7,12
136,2025-05-25T08:05:00+02:00,2025-05-25,16:05,9,78,87
139,2025-05-25T08:05:00+02:00,2025-05-25,16:05,6,1,7
141,2025-05-25T07:55:00+02:00,2025-05-25,15:55,13,14,27
142,2025-05-25T07:55:00+02:00,2025-05-25,15:55,43,42,85
142,2025-05-25T08:05:00+02:00,2025-05-25,16:05,49,65,114
161,2025-05-25T07:55:00+02:00,2025-05-25,15:55,27,69,96
181,2025-05-25T07:57:00+02:00,2025-05-25,15:57,7,20,27
181,2025-05-25T08:00:00+02:00,2025-05-25,16:00,13,15,28
181,2025-05-25T08:02:00+02:00,2025-05-25,16:02,7,26,33
181,2025-05-25T08:06:00+02:00,2025-05-25,16:06,12,19,31
180,2025-05-25T07:55:00+02:00,2025-05-25,15:55,2,2,4
181,2025-05-25T08:11:00+02:00,2025-05-25,16:11,9,19,28
181,2025-05-25T08:14:00+02:00,2025-05-25,16:14,22,12,34
181,2025-05-25T08:16:00+02:00,2025-05-25,16:16,10,16,26
181,2025-05-25T08:17:00+02:00,2025-05-25,16:17,7,34,41
181,2025-05-25T08:20:00+02:00,2025-05-25,16:20,23,20,43
181,2025-05-25T08:22:00+02:00,2025-05-25,16:22,11,10,21
182,2025-05-25T08:15:00+02:00,2025-05-25,16:15,16,20,36
180,2025-05-25T08:17:00+02:00,2025-05-25,16:17,6,1,7
180,2025-05-25T08:24:00+02:00,2025-05-25,16:24,0,4,4
3,2025-05-25T08:10:00+02:00,2025-05-25,16:10,15,20,35
3,2025-05-25T08:15:00+02:00,2025-05-25,16:15,6,11,17
3,2025-05-25T08:17:00+02:00,2025-05-25,16:17,17,26,43
4,2025-05-25T08:19:00+02:00,2025-05-25,16:19,30,21,51
4,2025-05-25T08:21:00+02:00,2025-05-25,16:21,27,27,54
4,2025-05-25T08:24:00+02:00,2025-05-25,16:24,26,24,50
6,2025-05-25T08:12:00+02:00,2025-05-25,16:12,16,8,24
6,2025-05-25T08:19:00+02:00,2025-05-25,16:19,25,16,41
6,2025-05-25T08:20:00+02:00,2025-05-25,16:20,15,5,20
6,2025-05-25T08:21:00+02:00,2025-05-25,16:21,9,13,22
6,2025-05-25T08:22:00+02:00,2025-05-25,16:22,17,16,33
6,2025-05-25T08:23:00+02:00,2025-05-25,16:23,25,14,39
6,2025-05-25T08:24:00+02:00,2025-05-25,16:24,8,24,32
8,2025-05-25T08:12:00+02:00,2025-05-25,16:12,6,4,10
8,2025-05-25T08:13:00+02:00,2025-05-25,16:13,6,1,7
8,2025-05-25T08:17:00+02:00,2025-05-25,16:17,9,0,9
8,2025-05-25T08:18:00+02:00,2025-05-25,16:18,5,4,9
8,2025-05-25T08:22:00+02:00,2025-05-25,16:22,4,6,10
28,2025-05-25T08:10:00+02:00,2025-05-25,16:10,5,9,14
28,2025-05-25T08:12:00+02:00,2025-05-25,16:12,9,15,24
28,2025-05-25T08:17:00+02:00,2025-05-25,16:17,13,8,21
28,2025-05-25T08:19:00+02:00,2025-05-25,16:19,9,15,24
28,2025-05-25T08:24:00+02:00,2025-05-25,16:24,9,3,12
29,2025-05-25T08:12:00+02:00,2025-05-25,16:12,9,17,26
29,2025-05-25T08:15:00+02:00,2025-05-25,16:15,21,40,61
29,2025-05-25T08:17:00+02:00,2025-05-25,16:17,13,18,31
29,2025-05-25T08:19:00+02:00,2025-05-25,16:19,11,19,30
29,2025-05-25T08:23:00+02:00,2025-05-25,16:23,11,12,23
29,2025-05-25T08:24:00+02:00,2025-05-25,16:24,15,2,17
31,2025-05-25T08:20:00+02:00,2025-05-25,16:20,3,2,5
31,2025-05-25T08:24:00+02:00,2025-05-25,16:24,3,5,8
36,2025-05-25T08:11:00+02:00,2025-05-25,16:11,3,1,4
36,2025-05-25T08:13:00+02:00,2025-05-25,16:13,1,3,4
36,2025-05-25T08:16:00+02:00,2025-05-25,16:16,1,4,5
36,2025-05-25T08:17:00+02:00,2025-05-25,16:17,0,1,1
36,2025-05-25T08:18:00+02:00,2025-05-25,16:18,0,7,7
36,2025-05-25T08:19:00+02:00,2025-05-25,16:19,0,3,3
36,2025-05-25T08:20:00+02:00,2025-05-25,16:20,2,2,4
36,2025-05-25T08:24:00+02:00,2025-05-25,16:24,0,4,4
39,2025-05-25T08:17:00+02:00,2025-05-25,16:17,1,1,2
40,2025-05-25T08:11:00+02:00,2025-05-25,16:11,2,1,3
40,2025-05-25T08:12:00+02:00,2025-05-25,16:12,3,5,8
40,2025-05-25T08:13:00+02:00,2025-05-25,16:13,2,2,4
40,2025-05-25T08:20:00+02:00,2025-05-25,16:20,1,4,5
40,2025-05-25T08:21:00+02:00,2025-05-25,16:21,6,3,9
40,2025-05-25T08:22:00+02:00,2025-05-25,16:22,2,0,2
40,2025-05-25T08:23:00+02:00,2025-05-25,16:23,2,3,5
41,2025-05-25T08:10:00+02:00,2025-05-25,16:10,5,1,6
41,2025-05-25T08:11:00+02:00,2025-05-25,16:11,13,6,19
41,2025-05-25T08:14:00+02:00,2025-05-25,16:14,4,1,5
41,2025-05-25T08:15:00+02:00,2025-05-25,16:15,6,9,15
41,2025-05-25T08:18:00+02:00,2025-05-25,16:18,2,7,9
41,2025-05-25T08:19:00+02:00,2025-05-25,16:19,4,11,15
41,2025-05-25T08:20:00+02:00,2025-05-25,16:20,12,5,17
41,2025-05-25T08:24:00+02:00,2025-05-25,16:24,10,4,14
43,2025-05-25T08:15:00+02:00,2025-05-25,16:15,7,5,12
44,2025-05-25T08:20:00+02:00,2025-05-25,16:20,6,5,11
45,2025-05-25T08:15:00+02:00,2025-05-25,16:15,29,26,55
45,2025-05-25T08:19:00+02:00,2025-05-25,16:19,10,12,22
45,2025-05-25T08:23:00+02:00,2025-05-25,16:23,17,24,41
47,2025-05-25T08:13:00+02:00,2025-05-25,16:13,19,26,45
47,2025-05-25T08:14:00+02:00,2025-05-25,16:14,15,21,36
47,2025-05-25T08:17:00+02:00,2025-05-25,16:17,28,25,53
47,2025-05-25T08:22:00+02:00,2025-05-25,16:22,9,29,38
50,2025-05-25T08:15:00+02:00,2025-05-25,16:15,8,5,13
50,2025-05-25T08:23:00+02:00,2025-05-25,16:23,5,4,9
50,2025-05-25T08:24:00+02:00,2025-05-25,16:24,2,0,2
54,2025-05-25T08:10:00+02:00,2025-05-25,16:10,1,0,1
54,2025-05-25T08:11:00+02:00,2025-05-25,16:11,7,7,14
54,2025-05-25T08:12:00+02:00,2025-05-25,16:12,1,2,3
54,2025-05-25T08:15:00+02:00,2025-05-25,16:15,1,2,3
54,2025-05-25T08:16:00+02:00,2025-05-25,16:16,1,4,5
54,2025-05-25T08:17:00+02:00,2025-05-25,16:17,2,3,5
54,2025-05-25T08:21:00+02:00,2025-05-25,16:21,2,1,3
59,2025-05-25T08:15:00+02:00,2025-05-25,16:15,17,28,45
59,2025-05-25T08:20:00+02:00,2025-05-25,16:20,18,33,51
61,2025-05-25T08:14:00+02:00,2025-05-25,16:14,8,8,16
61,2025-05-25T08:15:00+02:00,2025-05-25,16:15,7,4,11
61,2025-05-25T08:16:00+02:00,2025-05-25,16:16,6,11,17
61,2025-05-25T08:17:00+02:00,2025-05-25,16:17,8,5,13
61,2025-05-25T08:21:00+02:00,2025-05-25,16:21,10,12,22
61,2025-05-25T08:22:00+02:00,2025-05-25,16:22,6,10,16
66,2025-05-25T08:10:00+02:00,2025-05-25,16:10,20,14,34
66,2025-05-25T08:14:00+02:00,2025-05-25,16:14,48,22,70
66,2025-05-25T08:15:00+02:00,2025-05-25,16:15,25,31,56
66,2025-05-25T08:18:00+02:00,2025-05-25,16:18,14,31,45
66,2025-05-25T08:20:00+02:00,2025-05-25,16:20,33,7,40
66,2025-05-25T08:21:00+02:00,2025-05-25,16:21,31,37,68
66,2025-05-25T08:22:00+02:00,2025-05-25,16:22,14,33,47
66,2025-05-25T08:23:00+02:00,2025-05-25,16:23,24,21,45
69,2025-05-25T08:14:00+02:00,2025-05-25,16:14,2,3,5
69,2025-05-25T08:18:00+02:00,2025-05-25,16:18,4,1,5
69,2025-05-25T08:19:00+02:00,2025-05-25,16:19,8,4,12
69,2025-05-25T08:23:00+02:00,2025-05-25,16:23,5,4,9
70,2025-05-25T08:10:00+02:00,2025-05-25,16:10,1,6,7
70,2025-05-25T08:14:00+02:00,2025-05-25,16:14,4,3,7
70,2025-05-25T08:18:00+02:00,2025-05-25,16:18,3,5,8
70,2025-05-25T08:19:00+02:00,2025-05-25,16:19,0,3,3
70,2025-05-25T08:21:00+02:00,2025-05-25,16:21,3,3,6
75,2025-05-25T08:12:00+02:00,2025-05-25,16:12,0,2,2
75,2025-05-25T08:20:00+02:00,2025-05-25,16:20,1,1,2
75,2025-05-25T08:24:00+02:00,2025-05-25,16:24,3,3,6
77,2025-05-25T08:10:00+02:00,2025-05-25,16:10,19,10,29
77,2025-05-25T08:15:00+02:00,2025-05-25,16:15,17,15,32
78,2025-05-25T08:11:00+02:00,2025-05-25,16:11,4,2,6
78,2025-05-25T08:21:00+02:00,2025-05-25,16:21,0,2,2
78,2025-05-25T08:23:00+02:00,2025-05-25,16:23,0,1,1
78,2025-05-25T08:24:00+02:00,2025-05-25,16:24,0,1,1
84,2025-05-25T08:15:00+02:00,2025-05-25,16:15,83,138,221
87,2025-05-25T08:17:00+02:00,2025-05-25,16:17,0,3,3
87,2025-05-25T08:22:00+02:00,2025-05-25,16:22,0,1,1
87,2025-05-25T08:24:00+02:00,2025-05-25,16:24,0,1,1
108,2025-05-25T08:10:00+02:00,2025-05-25,16:10,3,7,10
108,2025-05-25T08:12:00+02:00,2025-05-25,16:12,1,3,4
108,2025-05-25T08:15:00+02:00,2025-05-25,16:15,3,3,6
108,2025-05-25T08:16:00+02:00,2025-05-25,16:16,5,3,8
108,2025-05-25T08:23:00+02:00,2025-05-25,16:23,3,5,8
118,2025-05-25T08:15:00+02:00,2025-05-25,16:15,1,1,2
124,2025-05-25T08:20:00+02:00,2025-05-25,16:20,1,0,1
131,2025-05-25T08:10:00+02:00,2025-05-25,16:10,28,7,35
131,2025-05-25T08:20:00+02:00,2025-05-25,16:20,9,2,11
132,2025-05-25T08:15:00+02:00,2025-05-25,16:15,11,21,32
132,2025-05-25T08:20:00+02:00,2025-05-25,16:20,11,14,25
133,2025-05-25T08:20:00+02:00,2025-05-25,16:20,32,30,62
134,2025-05-25T08:10:00+02:00,2025-05-25,16:10,34,27,61
140,2025-05-25T08:20:00+02:00,2025-05-25,16:20,16,8,24
162,2025-05-25T08:15:00+02:00,2025-05-25,16:15,24,57,81
165,2025-05-25T08:20:00+02:00,2025-05-25,16:20,2,6,8
166,2025-05-25T08:15:00+02:00,2025-05-25,16:15,6,11,17
167,2025-05-25T08:15:00+02:00,2025-05-25,16:15,6,14,20
167,2025-05-25T08:20:00+02:00,2025-05-25,16:20,3,10,13
1,2025-05-25T08:10:00+02:00,2025-05-25,16:10,22,17,39
1,2025-05-25T08:16:00+02:00,2025-05-25,16:16,30,14,44
1,2025-05-25T08:19:00+02:00,2025-05-25,16:19,31,23,54
1,2025-05-25T08:24:00+02:00,2025-05-25,16:24,21,18,39
2,2025-05-25T08:10:00+02:00,2025-05-25,16:10,9,6,15
2,2025-05-25T08:13:00+02:00,2025-05-25,16:13,12,6,18
2,2025-05-25T08:17:00+02:00,2025-05-25,16:17,10,10,20
2,2025-05-25T08:19:00+02:00,2025-05-25,16:19,18,4,22
9,2025-05-25T08:11:00+02:00,2025-05-25,16:11,3,0,3
9,2025-05-25T08:12:00+02:00,2025-05-25,16:12,0,3,3
9,2025-05-25T08:17:00+02:00,2025-05-25,16:17,3,4,7
9,2025-05-25T08:20:00+02:00,2025-05-25,16:20,4,2,6
11,2025-05-25T08:10:00+02:00,2025-05-25,16:10,13,20,33
11,2025-05-25T08:12:00+02:00,2025-05-25,16:12,0,1,1
11,2025-05-25T08:14:00+02:00,2025-05-25,16:14,0,9,9
11,2025-05-25T08:20:00+02:00,2025-05-25,16:20,8,8,16
12,2025-05-25T08:16:00+02:00,2025-05-25,16:16,11,2,13
12,2025-05-25T08:21:00+02:00,2025-05-25,16:21,1,6,7
17,2025-05-25T08:11:00+02:00,2025-05-25,16:11,1,3,4
17,2025-05-25T08:17:00+02:00,2025-05-25,16:17,1,0,1
17,2025-05-25T08:19:00+02:00,2025-05-25,16:19,1,2,3
17,2025-05-25T08:24:00+02:00,2025-05-25,16:24,9,4,13
18,2025-05-25T08:11:00+02:00,2025-05-25,16:11,5,0,5
18,2025-05-25T08:12:00+02:00,2025-05-25,16:12,0,2,2
18,2025-05-25T08:18:00+02:00,2025-05-25,16:18,2,0,2
18,2025-05-25T08:19:00+02:00,2025-05-25,16:19,2,2,4
18,2025-05-25T08:23:00+02:00,2025-05-25,16:23,1,2,3
19,2025-05-25T08:17:00+02:00,2025-05-25,16:17,12,14,26
19,2025-05-25T08:18:00+02:00,2025-05-25,16:18,4,15,19
20,2025-05-25T08:12:00+02:00,2025-05-25,16:12,9,9,18
20,2025-05-25T08:13:00+02:00,2025-05-25,16:13,6,8,14
20,2025-05-25T08:18:00+02:00,2025-05-25,16:18,7,1,8
20,2025-05-25T08:21:00+02:00,2025-05-25,16:21,8,1,9
23,2025-05-25T08:13:00+02:00,2025-05-25,16:13,3,4,7
23,2025-05-25T08:15:00+02:00,2025-05-25,16:15,3,2,5
23,2025-05-25T08:16:00+02:00,2025-05-25,16:16,2,1,3
23,2025-05-25T08:19:00+02:00,2025-05-25,16:19,2,3,5
23,2025-05-25T08:21:00+02:00,2025-05-25,16:21,1,1,2
23,2025-05-25T08:24:00+02:00,2025-05-25,16:24,4,1,5
24,2025-05-25T08:10:00+02:00,2025-05-25,16:10,7,21,28
24,2025-05-25T08:17:00+02:00,2025-05-25,16:17,8,10,18
24,2025-05-25T08:19:00+02:00,2025-05-25,16:19,2,18,20
24,2025-05-25T08:20:00+02:00,2025-05-25,16:20,10,22,32
25,2025-05-25T08:20:00+02:00,2025-05-25,16:20,97,36,133
27,2025-05-25T08:10:00+02:00,2025-05-25,16:10,0,1,1
27,2025-05-25T08:15:00+02:00,2025-05-25,16:15,5,2,7
27,2025-05-25T08:16:00+02:00,2025-05-25,16:16,4,1,5
27,2025-05-25T08:19:00+02:00,2025-05-25,16:19,1,2,3
30,2025-05-25T08:19:00+02:00,2025-05-25,16:19,9,3,12
30,2025-05-25T08:21:00+02:00,2025-05-25,16:21,7,16,23
30,2025-05-25T08:23:00+02:00,2025-05-25,16:23,9,10,19
35,2025-05-25T08:10:00+02:00,2025-05-25,16:10,16,19,35
35,2025-05-25T08:12:00+02:00,2025-05-25,16:12,19,26,45
35,2025-05-25T08:15:00+02:00,2025-05-25,16:15,13,40,53
35,2025-05-25T08:16:00+02:00,2025-05-25,16:16,18,24,42
35,2025-05-25T08:17:00+02:00,2025-05-25,16:17,23,28,51
35,2025-05-25T08:24:00+02:00,2025-05-25,16:24,7,29,36
48,2025-05-25T08:10:00+02:00,2025-05-25,16:10,9,6,15
48,2025-05-25T08:14:00+02:00,2025-05-25,16:14,14,10,24
48,2025-05-25T08:16:00+02:00,2025-05-25,16:16,9,5,14
48,2025-05-25T08:18:00+02:00,2025-05-25,16:18,7,3,10
48,2025-05-25T08:21:00+02:00,2025-05-25,16:21,12,2,14
49,2025-05-25T08:12:00+02:00,2025-05-25,16:12,2,12,14
49,2025-05-25T08:15:00+02:00,2025-05-25,16:15,3,14,17
49,2025-05-25T08:17:00+02:00,2025-05-25,16:17,1,5,6
49,2025-05-25T08:19:00+02:00,2025-05-25,16:19,4,1,5
49,2025-05-25T08:22:00+02:00,2025-05-25,16:22,2,9,11
51,2025-05-25T08:14:00+02:00,2025-05-25,16:14,0,1,1
51,2025-05-25T08:15:00+02:00,2025-05-25,16:15,0,2,2
51,2025-05-25T08:16:00+02:00,2025-05-25,16:16,3,0,3
51,2025-05-25T08:23:00+02:00,2025-05-25,16:23,3,2,5
51,2025-05-25T08:24:00+02:00,2025-05-25,16:24,6,1,7
52,2025-05-25T08:21:00+02:00,2025-05-25,16:21,4,14,18
52,2025-05-25T08:23:00+02:00,2025-05-25,16:23,9,2,11
53,2025-05-25T08:10:00+02:00,2025-05-25,16:10,10,6,16
53,2025-05-25T08:16:00+02:00,2025-05-25,16:16,0,6,6
53,2025-05-25T08:24:00+02:00,2025-05-25,16:24,10,6,16
56,2025-05-25T08:10:00+02:00,2025-05-25,16:10,2,6,8
56,2025-05-25T08:17:00+02:00,2025-05-25,16:17,10,3,13
56,2025-05-25T08:19:00+02:00,2025-05-25,16:19,3,5,8
56,2025-05-25T08:23:00+02:00,2025-05-25,16:23,5,9,14
56,2025-05-25T08:24:00+02:00,2025-05-25,16:24,10,8,18
58,2025-05-25T08:10:00+02:00,2025-05-25,16:10,10,10,20
58,2025-05-25T08:11:00+02:00,2025-05-25,16:11,11,14,25
58,2025-05-25T08:13:00+02:00,2025-05-25,16:13,7,6,13
58,2025-05-25T08:21:00+02:00,2025-05-25,16:21,4,3,7
58,2025-05-25T08:24:00+02:00,2025-05-25,16:24,9,5,14
62,2025-05-25T08:15:00+02:00,2025-05-25,16:15,3,3,6
62,2025-05-25T08:16:00+02:00,2025-05-25,16:16,0,1,1
62,2025-05-25T08:21:00+02:00,2025-05-25,16:21,3,2,5
62,2025-05-25T08:24:00+02:00,2025-05-25,16:24,5,3,8
63,2025-05-25T08:12:00+02:00,2025-05-25,16:12,7,5,12
63,2025-05-25T08:13:00+02:00,2025-05-25,16:13,2,5,7
63,2025-05-25T08:23:00+02:00,2025-05-25,16:23,7,4,11
67,2025-05-25T08:14:00+02:00,2025-05-25,16:14,13,14,27
67,2025-05-25T08:15:00+02:00,2025-05-25,16:15,3,24,27
67,2025-05-25T08:18:00+02:00,2025-05-25,16:18,4,5,9
67,2025-05-25T08:19:00+02:00,2025-05-25,16:19,8,13,21
67,2025-05-25T08:22:00+02:00,2025-05-25,16:22,8,11,19
67,2025-05-25T08:24:00+02:00,2025-05-25,16:24,7,8,15
68,2025-05-25T08:19:00+02:00,2025-05-25,16:19,7,5,12
68,2025-05-25T08:20:00+02:00,2025-05-25,16:20,9,4,13
68,2025-05-25T08:22:00+02:00,2025-05-25,16:22,4,4,8
68,2025-05-25T08:23:00+02:00,2025-05-25,16:23,6,6,12
72,2025-05-25T08:13:00+02:00,2025-05-25,16:13,10,23,33
72,2025-05-25T08:14:00+02:00,2025-05-25,16:14,2,24,26
72,2025-05-25T08:15:00+02:00,2025-05-25,16:15,11,12,23
72,2025-05-25T08:17:00+02:00,2025-05-25,16:17,20,6,26
72,2025-05-25T08:19:00+02:00,2025-05-25,16:19,15,24,39
72,2025-05-25T08:23:00+02:00,2025-05-25,16:23,7,24,31
76,2025-05-25T08:11:00+02:00,2025-05-25,16:11,1,1,2
76,2025-05-25T08:13:00+02:00,2025-05-25,16:13,0,1,1
76,2025-05-25T08:15:00+02:00,2025-05-25,16:15,2,1,3
76,2025-05-25T08:17:00+02:00,2025-05-25,16:17,0,1,1
76,2025-05-25T08:20:00+02:00,2025-05-25,16:20,1,0,1
76,2025-05-25T08:22:00+02:00,2025-05-25,16:22,0,2,2
79,2025-05-25T08:11:00+02:00,2025-05-25,16:11,12,11,23
79,2025-05-25T08:14:00+02:00,2025-05-25,16:14,11,4,15
79,2025-05-25T08:15:00+02:00,2025-05-25,16:15,2,19,21
79,2025-05-25T08:16:00+02:00,2025-05-25,16:16,8,9,17
79,2025-05-25T08:17:00+02:00,2025-05-25,16:17,8,13,21
79,2025-05-25T08:18:00+02:00,2025-05-25,16:18,9,19,28
79,2025-05-25T08:21:00+02:00,2025-05-25,16:21,13,18,31
79,2025-05-25T08:22:00+02:00,2025-05-25,16:22,7,21,28
85,2025-05-25T08:14:00+02:00,2025-05-25,16:14,1,2,3
85,2025-05-25T08:17:00+02:00,2025-05-25,16:17,1,0,1
85,2025-05-25T08:18:00+02:00,2025-05-25,16:18,0,1,1
85,2025-05-25T08:20:00+02:00,2025-05-25,16:20,1,1,2
85,2025-05-25T08:24:00+02:00,2025-05-25,16:24,0,1,1
86,2025-05-25T08:11:00+02:00,2025-05-25,16:11,0,1,1
86,2025-05-25T08:15:00+02:00,2025-05-25,16:15,3,0,3
86,2025-05-25T08:22:00+02:00,2025-05-25,16:22,1,1,2
86,2025-05-25T08:23:00+02:00,2025-05-25,16:23,1,0,1
109,2025-05-25T08:15:00+02:00,2025-05-25,16:15,8,1,9
123,2025-05-25T08:15:00+02:00,2025-05-25,16:15,18,1,19
130,2025-05-25T08:20:00+02:00,2025-05-25,16:20,3,0,3
137,2025-05-25T08:10:00+02:00,2025-05-25,16:10,1,1,2
138,2025-05-25T08:10:00+02:00,2025-05-25,16:10,0,1,1
161,2025-05-25T08:15:00+02:00,2025-05-25,16:15,25,74,99
161,2025-05-25T08:20:00+02:00,2025-05-25,16:20,23,22,45
164,2025-05-25T08:20:00+02:00,2025-05-25,16:20,8,12,20
181,2025-05-25T08:26:00+02:00,2025-05-25,16:26,11,8,19
181,2025-05-25T08:27:00+02:00,2025-05-25,16:27,7,17,24
181,2025-05-25T08:32:00+02:00,2025-05-25,16:32,13,14,27
181,2025-05-25T08:35:00+02:00,2025-05-25,16:35,25,10,35
181,2025-05-25T08:36:00+02:00,2025-05-25,16:36,4,14,18
180,2025-05-25T08:31:00+02:00,2025-05-25,16:31,1,0,1
180,2025-05-25T08:33:00+02:00,2025-05-25,16:33,2,4,6
180,2025-05-25T08:34:00+02:00,2025-05-25,16:34,1,1,2
3,2025-05-25T08:25:00+02:00,2025-05-25,16:25,24,20,44
3,2025-05-25T08:30:00+02:00,2025-05-25,16:30,19,14,33
3,2025-05-25T08:34:00+02:00,2025-05-25,16:34,17,23,40
3,2025-05-25T08:36:00+02:00,2025-05-25,16:36,15,10,25
3,2025-05-25T08:39:00+02:00,2025-05-25,16:39,14,12,26
4,2025-05-25T08:25:00+02:00,2025-05-25,16:25,28,15,43
4,2025-05-25T08:26:00+02:00,2025-05-25,16:26,23,22,45
4,2025-05-25T08:30:00+02:00,2025-05-25,16:30,32,22,54
4,2025-05-25T08:35:00+02:00,2025-05-25,16:35,20,16,36
4,2025-05-25T08:38:00+02:00,2025-05-25,16:38,31,25,56
6,2025-05-25T08:26:00+02:00,2025-05-25,16:26,20,28,48
6,2025-05-25T08:30:00+02:00,2025-05-25,16:30,17,26,43
6,2025-05-25T08:34:00+02:00,2025-05-25,16:34,21,12,33
6,2025-05-25T08:39:00+02:00,2025-05-25,16:39,30,20,50
8,2025-05-25T08:25:00+02:00,2025-05-25,16:25,5,3,8
8,2025-05-25T08:26:00+02:00,2025-05-25,16:26,12,0,12
8,2025-05-25T08:27:00+02:00,2025-05-25,16:27,8,3,11
8,2025-05-25T08:28:00+02:00,2025-05-25,16:28,4,4,8
8,2025-05-25T08:30:00+02:00,2025-05-25,16:30,9,9,18
8,2025-05-25T08:31:00+02:00,2025-05-25,16:31,1,12,13
8,2025-05-25T08:33:00+02:00,2025-05-25,16:33,7,4,11
8,2025-05-25T08:39:00+02:00,2025-05-25,16:39,3,4,7
28,2025-05-25T08:26:00+02:00,2025-05-25,16:26,4,6,10
28,2025-05-25T08:29:00+02:00,2025-05-25,16:29,10,12,22
28,2025-05-25T08:30:00+02:00,2025-05-25,16:30,6,2,8
28,2025-05-25T08:31:00+02:00,2025-05-25,16:31,11,14,25
28,2025-05-25T08:33:00+02:00,2025-05-25,16:33,2,15,17
28,2025-05-25T08:34:00+02:00,2025-05-25,16:34,3,14,17
28,2025-05-25T08:39:00+02:00,2025-05-25,16:39,3,20,23
29,2025-05-25T08:27:00+02:00,2025-05-25,16:27,10,17,27
29,2025-05-25T08:28:00+02:00,2025-05-25,16:28,4,14,18
29,2025-05-25T08:29:00+02:00,2025-05-25,16:29,15,18,33
29,2025-05-25T08:30:00+02:00,2025-05-25,16:30,5,13,18
29,2025-05-25T08:34:00+02:00,2025-05-25,16:34,13,10,23
29,2025-05-25T08:36:00+02:00,2025-05-25,16:36,8,12,20
29,2025-05-25T08:37:00+02:00,2025-05-25,16:37,6,11,17
29,2025-05-25T08:39:00+02:00,2025-05-25,16:39,22,17,39
31,2025-05-25T08:26:00+02:00,2025-05-25,16:26,4,8,12
31,2025-05-25T08:28:00+02:00,2025-05-25,16:28,1,2,3
31,2025-05-25T08:29:00+02:00,2025-05-25,16:29,5,0,5
31,2025-05-25T08:37:00+02:00,2025-05-25,16:37,12,6,18
36,2025-05-25T08:33:00+02:00,2025-05-25,16:33,0,7,7
36,2025-05-25T08:34:00+02:00,2025-05-25,16:34,1,1,2
36,2025-05-25T08:39:00+02:00,2025-05-25,16:39,2,5,7
39,2025-05-25T08:25:00+02:00,2025-05-25,16:25,0,2,2
40,2025-05-25T08:26:00+02:00,2025-05-25,16:26,1,3,4
40,2025-05-25T08:28:00+02:00,2025-05-25,16:28,0,1,1
41,2025-05-25T08:25:00+02:00,2025-05-25,16:25,8,15,23
41,2025-05-25T08:26:00+02:00,2025-05-25,16:26,3,9,12
41,2025-05-25T08:27:00+02:00,2025-05-25,16:27,6,8,14
41,2025-05-25T08:29:00+02:00,2025-05-25,16:29,8,8,16
41,2025-05-25T08:30:00+02:00,2025-05-25,16:30,3,13,16
41,2025-05-25T08:32:00+02:00,2025-05-25,16:32,18,1,19
41,2025-05-25T08:33:00+02:00,2025-05-25,16:33,6,13,19
41,2025-05-25T08:38:00+02:00,2025-05-25,16:38,9,5,14
44,2025-05-25T08:35:00+02:00,2025-05-25,16:35,3,5,8
45,2025-05-25T08:25:00+02:00,2025-05-25,16:25,19,12,31
45,2025-05-25T08:30:00+02:00,2025-05-25,16:30,30,18,48
45,2025-05-25T08:32:00+02:00,2025-05-25,16:32,16,24,40
45,2025-05-25T08:34:00+02:00,2025-05-25,16:34,24,12,36
45,2025-05-25T08:37:00+02:00,2025-05-25,16:37,19,16,35
45,2025-05-25T08:38:00+02:00,2025-05-25,16:38,20,14,34
47,2025-05-25T08:25:00+02:00,2025-05-25,16:25,21,20,41
47,2025-05-25T08:30:00+02:00,2025-05-25,16:30,11,22,33
47,2025-05-25T08:31:00+02:00,2025-05-25,16:31,30,13,43
47,2025-05-25T08:33:00+02:00,2025-05-25,16:33,18,10,28
47,2025-05-25T08:34:00+02:00,2025-05-25,16:34,14,13,27
47,2025-05-25T08:37:00+02:00,2025-05-25,16:37,11,15,26
50,2025-05-25T08:27:00+02:00,2025-05-25,16:27,1,2,3
50,2025-05-25T08:29:00+02:00,2025-05-25,16:29,2,2,4
50,2025-05-25T08:33:00+02:00,2025-05-25,16:33,4,3,7
50,2025-05-25T08:36:00+02:00,2025-05-25,16:36,12,4,16
54,2025-05-25T08:26:00+02:00,2025-05-25,16:26,1,3,4
54,2025-05-25T08:29:00+02:00,2025-05-25,16:29,1,3,4
54,2025-05-25T08:33:00+02:00,2025-05-25,16:33,5,0,5
59,2025-05-25T08:25:00+02:00,2025-05-25,16:25,13,30,43
59,2025-05-25T08:30:00+02:00,2025-05-25,16:30,32,38,70
61,2025-05-25T08:25:00+02:00,2025-05-25,16:25,3,10,13
61,2025-05-25T08:26:00+02:00,2025-05-25,16:26,9,1,10
61,2025-05-25T08:29:00+02:00,2025-05-25,16:29,6,18,24
61,2025-05-25T08:30:00+02:00,2025-05-25,16:30,12,3,15
61,2025-05-25T08:31:00+02:00,2025-05-25,16:31,8,6,14
61,2025-05-25T08:35:00+02:00,2025-05-25,16:35,13,5,18
61,2025-05-25T08:37:00+02:00,2025-05-25,16:37,7,9,16
61,2025-05-25T08:38:00+02:00,2025-05-25,16:38,18,4,22
66,2025-05-25T08:28:00+02:00,2025-05-25,16:28,21,30,51
66,2025-05-25T08:30:00+02:00,2025-05-25,16:30,28,17,45
66,2025-05-25T08:32:00+02:00,2025-05-25,16:32,14,23,37
66,2025-05-25T08:34:00+02:00,2025-05-25,16:34,22,41,63
66,2025-05-25T08:37:00+02:00,2025-05-25,16:37,12,20,32
69,2025-05-25T08:27:00+02:00,2025-05-25,16:27,5,2,7
69,2025-05-25T08:31:00+02:00,2025-05-25,16:31,2,0,2
69,2025-05-25T08:32:00+02:00,2025-05-25,16:32,3,3,6
69,2025-05-25T08:34:00+02:00,2025-05-25,16:34,0,4,4
69,2025-05-25T08:35:00+02:00,2025-05-25,16:35,1,2,3
69,2025-05-25T08:38:00+02:00,2025-05-25,16:38,1,1,2
70,2025-05-25T08:25:00+02:00,2025-05-25,16:25,6,0,6
70,2025-05-25T08:26:00+02:00,2025-05-25,16:26,2,3,5
70,2025-05-25T08:33:00+02:00,2025-05-25,16:33,3,4,7
70,2025-05-25T08:34:00+02:00,2025-05-25,16:34,2,1,3
70,2025-05-25T08:38:00+02:00,2025-05-25,16:38,0,1,1
70,2025-05-25T08:39:00+02:00,2025-05-25,16:39,0,3,3
71,2025-05-25T08:36:00+02:00,2025-05-25,16:36,1,0,1
71,2025-05-25T08:39:00+02:00,2025-05-25,16:39,1,0,1
75,2025-05-25T08:30:00+02:00,2025-05-25,16:30,1,0,1
75,2025-05-25T08:36:00+02:00,2025-05-25,16:36,2,0,2
75,2025-05-25T08:38:00+02:00,2025-05-25,16:38,1,0,1
78,2025-05-25T08:26:00+02:00,2025-05-25,16:26,0,1,1
78,2025-05-25T08:37:00+02:00,2025-05-25,16:37,0,1,1
84,2025-05-25T08:35:00+02:00,2025-05-25,16:35,93,101,194
87,2025-05-25T08:25:00+02:00,2025-05-25,16:25,1,1,2
87,2025-05-25T08:33:00+02:00,2025-05-25,16:33,2,1,3
87,2025-05-25T08:34:00+02:00,2025-05-25,16:34,0,6,6
87,2025-05-25T08:35:00+02:00,2025-05-25,16:35,5,0,5
87,2025-05-25T08:36:00+02:00,2025-05-25,16:36,1,3,4
87,2025-05-25T08:37:00+02:00,2025-05-25,16:37,0,1,1
108,2025-05-25T08:29:00+02:00,2025-05-25,16:29,2,1,3
108,2025-05-25T08:31:00+02:00,2025-05-25,16:31,5,3,8
108,2025-05-25T08:36:00+02:00,2025-05-25,16:36,2,6,8
108,2025-05-25T08:37:00+02:00,2025-05-25,16:37,1,0,1
118,2025-05-25T08:35:00+02:00,2025-05-25,16:35,6,2,8
131,2025-05-25T08:25:00+02:00,2025-05-25,16:25,10,0,10
131,2025-05-25T08:30:00+02:00,2025-05-25,16:30,20,3,23
132,2025-05-25T08:30:00+02:00,2025-05-25,16:30,12,6,18
133,2025-05-25T08:30:00+02:00,2025-05-25,16:30,26,43,69
133,2025-05-25T08:35:00+02:00,2025-05-25,16:35,57,49,106
135,2025-05-25T08:25:00+02:00,2025-05-25,16:25,63,34,97
135,2025-05-25T08:35:00+02:00,2025-05-25,16:35,71,66,137
140,2025-05-25T08:25:00+02:00,2025-05-25,16:25,8,15,23
162,2025-05-25T08:25:00+02:00,2025-05-25,16:25,31,60,91
166,2025-05-25T08:25:00+02:00,2025-05-25,16:25,5,4,9
166,2025-05-25T08:30:00+02:00,2025-05-25,16:30,6,8,14
167,2025-05-25T08:30:00+02:00,2025-05-25,16:30,5,4,9
167,2025-05-25T08:35:00+02:00,2025-05-25,16:35,9,8,17
179,2025-05-25T08:25:00+02:00,2025-05-25,16:25,6,1,7
1,2025-05-25T08:28:00+02:00,2025-05-25,16:28,24,17,41
1,2025-05-25T08:30:00+02:00,2025-05-25,16:30,26,19,45
1,2025-05-25T08:32:00+02:00,2025-05-25,16:32,26,25,51
1,2025-05-25T08:36:00+02:00,2025-05-25,16:36,32,11,43
1,2025-05-25T08:39:00+02:00,2025-05-25,16:39,31,33,64
2,2025-05-25T08:25:00+02:00,2025-05-25,16:25,18,8,26
2,2025-05-25T08:26:00+02:00,2025-05-25,16:26,8,6,14
2,2025-05-25T08:27:00+02:00,2025-05-25,16:27,9,12,21
2,2025-05-25T08:31:00+02:00,2025-05-25,16:31,6,12,18
2,2025-05-25T08:35:00+02:00,2025-05-25,16:35,10,1,11
2,2025-05-25T08:37:00+02:00,2025-05-25,16:37,7,12,19
2,2025-05-25T08:38:00+02:00,2025-05-25,16:38,5,9,14
9,2025-05-25T08:25:00+02:00,2025-05-25,16:25,1,2,3
9,2025-05-25T08:27:00+02:00,2025-05-25,16:27,1,2,3
9,2025-05-25T08:28:00+02:00,2025-05-25,16:28,2,0,2
9,2025-05-25T08:32:00+02:00,2025-05-25,16:32,0,1,1
9,2025-05-25T08:33:00+02:00,2025-05-25,16:33,1,1,2
9,2025-05-25T08:35:00+02:00,2025-05-25,16:35,0,2,2
9,2025-05-25T08:37:00+02:00,2025-05-25,16:37,0,1,1
10,2025-05-25T08:29:00+02:00,2025-05-25,16:29,1,0,1
10,2025-05-25T08:34:00+02:00,2025-05-25,16:34,2,2,4
10,2025-05-25T08:37:00+02:00,2025-05-25,16:37,3,2,5
11,2025-05-25T08:25:00+02:00,2025-05-25,16:25,3,6,9
11,2025-05-25T08:27:00+02:00,2025-05-25,16:27,4,2,6
11,2025-05-25T08:29:00+02:00,2025-05-25,16:29,10,6,16
11,2025-05-25T08:32:00+02:00,2025-05-25,16:32,7,0,7
11,2025-05-25T08:35:00+02:00,2025-05-25,16:35,17,4,21
11,2025-05-25T08:37:00+02:00,2025-05-25,16:37,1,2,3
12,2025-05-25T08:28:00+02:00,2025-05-25,16:28,4,0,4
12,2025-05-25T08:30:00+02:00,2025-05-25,16:30,11,2,13
12,2025-05-25T08:33:00+02:00,2025-05-25,16:33,10,0,10
12,2025-05-25T08:34:00+02:00,2025-05-25,16:34,4,0,4
12,2025-05-25T08:35:00+02:00,2025-05-25,16:35,3,10,13
12,2025-05-25T08:37:00+02:00,2025-05-25,16:37,7,0,7
17,2025-05-25T08:30:00+02:00,2025-05-25,16:30,6,2,8
17,2025-05-25T08:31:00+02:00,2025-05-25,16:31,1,1,2
17,2025-05-25T08:35:00+02:00,2025-05-25,16:35,5,0,5
17,2025-05-25T08:37:00+02:00,2025-05-25,16:37,3,2,5
18,2025-05-25T08:26:00+02:00,2025-05-25,16:26,1,0,1
18,2025-05-25T08:29:00+02:00,2025-05-25,16:29,3,0,3
18,2025-05-25T08:32:00+02:00,2025-05-25,16:32,0,1,1
19,2025-05-25T08:30:00+02:00,2025-05-25,16:30,16,11,27
19,2025-05-25T08:31:00+02:00,2025-05-25,16:31,23,3,26
19,2025-05-25T08:32:00+02:00,2025-05-25,16:32,6,9,15
19,2025-05-25T08:37:00+02:00,2025-05-25,16:37,21,7,28
19,2025-05-25T08:39:00+02:00,2025-05-25,16:39,17,13,30
20,2025-05-25T08:36:00+02:00,2025-05-25,16:36,4,4,8
20,2025-05-25T08:37:00+02:00,2025-05-25,16:37,7,7,14
24,2025-05-25T08:26:00+02:00,2025-05-25,16:26,3,46,49
24,2025-05-25T08:28:00+02:00,2025-05-25,16:28,6,4,10
24,2025-05-25T08:29:00+02:00,2025-05-25,16:29,5,9,14
24,2025-05-25T08:30:00+02:00,2025-05-25,16:30,4,8,12
24,2025-05-25T08:38:00+02:00,2025-05-25,16:38,9,16,25
24,2025-05-25T08:39:00+02:00,2025-05-25,16:39,11,11,22
25,2025-05-25T08:35:00+02:00,2025-05-25,16:35,111,42,153
27,2025-05-25T08:34:00+02:00,2025-05-25,16:34,2,4,6
27,2025-05-25T08:37:00+02:00,2025-05-25,16:37,0,3,3
30,2025-05-25T08:25:00+02:00,2025-05-25,16:25,3,11,14
30,2025-05-25T08:27:00+02:00,2025-05-25,16:27,2,6,8
30,2025-05-25T08:31:00+02:00,2025-05-25,16:31,2,8,10
35,2025-05-25T08:28:00+02:00,2025-05-25,16:28,24,26,50
35,2025-05-25T08:31:00+02:00,2025-05-25,16:31,27,18,45
35,2025-05-25T08:33:00+02:00,2025-05-25,16:33,15,16,31
35,2025-05-25T08:34:00+02:00,2025-05-25,16:34,18,29,47
35,2025-05-25T08:35:00+02:00,2025-05-25,16:35,10,26,36
35,2025-05-25T08:38:00+02:00,2025-05-25,16:38,27,21,48
35,2025-05-25T08:39:00+02:00,2025-05-25,16:39,18,22,40
48,2025-05-25T08:27:00+02:00,2025-05-25,16:27,9,6,15
48,2025-05-25T08:31:00+02:00,2025-05-25,16:31,6,2,8
48,2025-05-25T08:33:00+02:00,2025-05-25,16:33,10,1,11
49,2025-05-25T08:28:00+02:00,2025-05-25,16:28,1,8,9
49,2025-05-25T08:29:00+02:00,2025-05-25,16:29,3,3,6
49,2025-05-25T08:30:00+02:00,2025-05-25,16:30,4,9,13
49,2025-05-25T08:31:00+02:00,2025-05-25,16:31,5,2,7
49,2025-05-25T08:32:00+02:00,2025-05-25,16:32,1,10,11
49,2025-05-25T08:33:00+02:00,2025-05-25,16:33,1,1,2
49,2025-05-25T08:37:00+02:00,2025-05-25,16:37,0,6,6
49,2025-05-25T08:39:00+02:00,2025-05-25,16:39,4,8,12
51,2025-05-25T08:26:00+02:00,2025-05-25,16:26,3,0,3
51,2025-05-25T08:29:00+02:00,2025-05-25,16:29,2,4,6
51,2025-05-25T08:32:00+02:00,2025-05-25,16:32,1,2,3
51,2025-05-25T08:33:00+02:00,2025-05-25,16:33,2,1,3
51,2025-05-25T08:37:00+02:00,2025-05-25,16:37,4,0,4
51,2025-05-25T08:38:00+02:00,2025-05-25,16:38,2,2,4
51,2025-05-25T08:39:00+02:00,2025-05-25,16:39,1,1,2
52,2025-05-25T08:25:00+02:00,2025-05-25,16:25,7,8,15
52,2025-05-25T08:26:00+02:00,2025-05-25,16:26,2,0,2
52,2025-05-25T08:27:00+02:00,2025-05-25,16:27,8,3,11
52,2025-05-25T08:29:00+02:00,2025-05-25,16:29,9,1,10
52,2025-05-25T08:30:00+02:00,2025-05-25,16:30,11,6,17
52,2025-05-25T08:31:00+02:00,2025-05-25,16:31,5,9,14
52,2025-05-25T08:32:00+02:00,2025-05-25,16:32,0,2,2
52,2025-05-25T08:34:00+02:00,2025-05-25,16:34,2,4,6
52,2025-05-25T08:36:00+02:00,2025-05-25,16:36,3,6,9
52,2025-05-25T08:37:00+02:00,2025-05-25,16:37,3,11,14
52,2025-05-25T08:39:00+02:00,2025-05-25,16:39,1,11,12
53,2025-05-25T08:25:00+02:00,2025-05-25,16:25,9,2,11
53,2025-05-25T08:27:00+02:00,2025-05-25,16:27,7,3,10
53,2025-05-25T08:30:00+02:00,2025-05-25,16:30,25,7,32
53,2025-05-25T08:32:00+02:00,2025-05-25,16:32,6,2,8
56,2025-05-25T08:26:00+02:00,2025-05-25,16:26,3,6,9
56,2025-05-25T08:29:00+02:00,2025-05-25,16:29,3,8,11
56,2025-05-25T08:31:00+02:00,2025-05-25,16:31,7,9,16
56,2025-05-25T08:37:00+02:00,2025-05-25,16:37,10,18,28
56,2025-05-25T08:38:00+02:00,2025-05-25,16:38,4,15,19
58,2025-05-25T08:27:00+02:00,2025-05-25,16:27,4,1,5
58,2025-05-25T08:29:00+02:00,2025-05-25,16:29,13,7,20
58,2025-05-25T08:30:00+02:00,2025-05-25,16:30,7,5,12
58,2025-05-25T08:31:00+02:00,2025-05-25,16:31,13,3,16
58,2025-05-25T08:38:00+02:00,2025-05-25,16:38,18,8,26
62,2025-05-25T08:29:00+02:00,2025-05-25,16:29,2,1,3
62,2025-05-25T08:33:00+02:00,2025-05-25,16:33,8,2,10
62,2025-05-25T08:36:00+02:00,2025-05-25,16:36,5,2,7
62,2025-05-25T08:37:00+02:00,2025-05-25,16:37,9,2,11
62,2025-05-25T08:39:00+02:00,2025-05-25,16:39,3,1,4
63,2025-05-25T08:27:00+02:00,2025-05-25,16:27,3,1,4
63,2025-05-25T08:34:00+02:00,2025-05-25,16:34,5,5,10
63,2025-05-25T08:35:00+02:00,2025-05-25,16:35,6,4,10
67,2025-05-25T08:25:00+02:00,2025-05-25,16:25,5,9,14
67,2025-05-25T08:26:00+02:00,2025-05-25,16:26,7,11,18
67,2025-05-25T08:28:00+02:00,2025-05-25,16:28,5,14,19
67,2025-05-25T08:36:00+02:00,2025-05-25,16:36,2,6,8
67,2025-05-25T08:37:00+02:00,2025-05-25,16:37,1,6,7
68,2025-05-25T08:34:00+02:00,2025-05-25,16:34,5,3,8
68,2025-05-25T08:39:00+02:00,2025-05-25,16:39,7,3,10
72,2025-05-25T08:25:00+02:00,2025-05-25,16:25,10,9,19
72,2025-05-25T08:26:00+02:00,2025-05-25,16:26,8,13,21
72,2025-05-25T08:29:00+02:00,2025-05-25,16:29,9,19,28
72,2025-05-25T08:30:00+02:00,2025-05-25,16:30,7,18,25
72,2025-05-25T08:32:00+02:00,2025-05-25,16:32,10,14,24
72,2025-05-25T08:34:00+02:00,2025-05-25,16:34,5,22,27
76,2025-05-25T08:31:00+02:00,2025-05-25,16:31,1,1,2
76,2025-05-25T08:32:00+02:00,2025-05-25,16:32,2,3,5
76,2025-05-25T08:38:00+02:00,2025-05-25,16:38,5,0,5
79,2025-05-25T08:25:00+02:00,2025-05-25,16:25,11,8,19
79,2025-05-25T08:28:00+02:00,2025-05-25,16:28,8,14,22
79,2025-05-25T08:33:00+02:00,2025-05-25,16:33,15,9,24
85,2025-05-25T08:25:00+02:00,2025-05-25,16:25,1,5,6
85,2025-05-25T08:26:00+02:00,2025-05-25,16:26,3,1,4
85,2025-05-25T08:31:00+02:00,2025-05-25,16:31,0,3,3
85,2025-05-25T08:39:00+02:00,2025-05-25,16:39,0,1,1
86,2025-05-25T08:28:00+02:00,2025-05-25,16:28,0,2,2
86,2025-05-25T08:30:00+02:00,2025-05-25,16:30,0,3,3
86,2025-05-25T08:34:00+02:00,2025-05-25,16:34,0,3,3
109,2025-05-25T08:30:00+02:00,2025-05-25,16:30,5,5,10
117,2025-05-25T08:35:00+02:00,2025-05-25,16:35,19,19,38
123,2025-05-25T08:25:00+02:00,2025-05-25,16:25,15,2,17
123,2025-05-25T08:30:00+02:00,2025-05-25,16:30,6,2,8
123,2025-05-25T08:35:00+02:00,2025-05-25,16:35,6,2,8
138,2025-05-25T08:35:00+02:00,2025-05-25,16:35,2,2,4
141,2025-05-25T08:25:00+02:00,2025-05-25,16:25,5,15,20
141,2025-05-25T08:35:00+02:00,2025-05-25,16:35,11,11,22
142,2025-05-25T08:30:00+02:00,2025-05-25,16:30,53,63,116
161,2025-05-25T08:30:00+02:00,2025-05-25,16:30,20,23,43
181,2025-05-25T08:41:00+02:00,2025-05-25,16:41,3,17,20
181,2025-05-25T08:44:00+02:00,2025-05-25,16:44,22,18,40
181,2025-05-25T08:46:00+02:00,2025-05-25,16:46,8,15,23
181,2025-05-25T08:54:00+02:00,2025-05-25,16:54,11,17,28
182,2025-05-25T08:45:00+02:00,2025-05-25,16:45,13,10,23
3,2025-05-25T08:40:00+02:00,2025-05-25,16:40,34,17,51
3,2025-05-25T08:43:00+02:00,2025-05-25,16:43,21,32,53
3,2025-05-25T08:49:00+02:00,2025-05-25,16:49,16,18,34
3,2025-05-25T08:52:00+02:00,2025-05-25,16:52,29,28,57
3,2025-05-25T08:53:00+02:00,2025-05-25,16:53,11,27,38
4,2025-05-25T08:41:00+02:00,2025-05-25,16:41,32,22,54
4,2025-05-25T08:42:00+02:00,2025-05-25,16:42,33,18,51
4,2025-05-25T08:44:00+02:00,2025-05-25,16:44,21,34,55
4,2025-05-25T08:45:00+02:00,2025-05-25,16:45,38,16,54
4,2025-05-25T08:51:00+02:00,2025-05-25,16:51,22,21,43
4,2025-05-25T08:52:00+02:00,2025-05-25,16:52,34,29,63
6,2025-05-25T08:40:00+02:00,2025-05-25,16:40,15,16,31
6,2025-05-25T08:41:00+02:00,2025-05-25,16:41,24,4,28
6,2025-05-25T08:43:00+02:00,2025-05-25,16:43,12,7,19
6,2025-05-25T08:44:00+02:00,2025-05-25,16:44,12,14,26
6,2025-05-25T08:48:00+02:00,2025-05-25,16:48,13,16,29
6,2025-05-25T08:52:00+02:00,2025-05-25,16:52,15,16,31
6,2025-05-25T08:53:00+02:00,2025-05-25,16:53,26,6,32
6,2025-05-25T08:54:00+02:00,2025-05-25,16:54,14,18,32
8,2025-05-25T08:41:00+02:00,2025-05-25,16:41,2,6,8
8,2025-05-25T08:43:00+02:00,2025-05-25,16:43,0,1,1
8,2025-05-25T08:44:00+02:00,2025-05-25,16:44,3,3,6
8,2025-05-25T08:47:00+02:00,2025-05-25,16:47,2,2,4
8,2025-05-25T08:48:00+02:00,2025-05-25,16:48,1,2,3
28,2025-05-25T08:40:00+02:00,2025-05-25,16:40,8,9,17
28,2025-05-25T08:44:00+02:00,2025-05-25,16:44,7,15,22
28,2025-05-25T08:47:00+02:00,2025-05-25,16:47,3,13,16
28,2025-05-25T08:50:00+02:00,2025-05-25,16:50,6,23,29
29,2025-05-25T08:40:00+02:00,2025-05-25,16:40,17,8,25
29,2025-05-25T08:41:00+02:00,2025-05-25,16:41,19,10,29
29,2025-05-25T08:42:00+02:00,2025-05-25,16:42,13,12,25
29,2025-05-25T08:46:00+02:00,2025-05-25,16:46,6,4,10
29,2025-05-25T08:47:00+02:00,2025-05-25,16:47,16,18,34
29,2025-05-25T08:49:00+02:00,2025-05-25,16:49,9,14,23
29,2025-05-25T08:50:00+02:00,2025-05-25,16:50,7,7,14
29,2025-05-25T08:53:00+02:00,2025-05-25,16:53,1,15,16
31,2025-05-25T08:41:00+02:00,2025-05-25,16:41,0,1,1
31,2025-05-25T08:45:00+02:00,2025-05-25,16:45,12,4,16
31,2025-05-25T08:46:00+02:00,2025-05-25,16:46,1,7,8
36,2025-05-25T08:40:00+02:00,2025-05-25,16:40,2,2,4
36,2025-05-25T08:41:00+02:00,2025-05-25,16:41,2,2,4
36,2025-05-25T08:42:00+02:00,2025-05-25,16:42,0,5,5
36,2025-05-25T08:47:00+02:00,2025-05-25,16:47,0,6,6
36,2025-05-25T08:50:00+02:00,2025-05-25,16:50,0,1,1
36,2025-05-25T08:51:00+02:00,2025-05-25,16:51,2,4,6
39,2025-05-25T08:42:00+02:00,2025-05-25,16:42,0,1,1
39,2025-05-25T08:44:00+02:00,2025-05-25,16:44,1,0,1
39,2025-05-25T08:51:00+02:00,2025-05-25,16:51,4,1,5
40,2025-05-25T08:43:00+02:00,2025-05-25,16:43,0,3,3
40,2025-05-25T08:44:00+02:00,2025-05-25,16:44,4,3,7
40,2025-05-25T08:50:00+02:00,2025-05-25,16:50,1,2,3
40,2025-05-25T08:53:00+02:00,2025-05-25,16:53,4,1,5
41,2025-05-25T08:41:00+02:00,2025-05-25,16:41,3,3,6
41,2025-05-25T08:46:00+02:00,2025-05-25,16:46,9,7,16
41,2025-05-25T08:47:00+02:00,2025-05-25,16:47,0,2,2
41,2025-05-25T08:48:00+02:00,2025-05-25,16:48,10,1,11
41,2025-05-25T08:49:00+02:00,2025-05-25,16:49,4,5,9
41,2025-05-25T08:50:00+02:00,2025-05-25,16:50,3,5,8
41,2025-05-25T08:51:00+02:00,2025-05-25,16:51,2,1,3
41,2025-05-25T08:54:00+02:00,2025-05-25,16:54,15,4,19
43,2025-05-25T08:45:00+02:00,2025-05-25,16:45,8,9,17
44,2025-05-25T08:40:00+02:00,2025-05-25,16:40,3,2,5
44,2025-05-25T08:50:00+02:00,2025-05-25,16:50,4,5,9
45,2025-05-25T08:41:00+02:00,2025-05-25,16:41,27,32,59
45,2025-05-25T08:42:00+02:00,2025-05-25,16:42,27,31,58
45,2025-05-25T08:43:00+02:00,2025-05-25,16:43,12,25,37
45,2025-05-25T08:47:00+02:00,2025-05-25,16:47,14,20,34
45,2025-05-25T08:50:00+02:00,2025-05-25,16:50,19,9,28
45,2025-05-25T08:51:00+02:00,2025-05-25,16:51,19,28,47
45,2025-05-25T08:52:00+02:00,2025-05-25,16:52,17,22,39
47,2025-05-25T08:40:00+02:00,2025-05-25,16:40,17,14,31
47,2025-05-25T08:41:00+02:00,2025-05-25,16:41,28,18,46
47,2025-05-25T08:44:00+02:00,2025-05-25,16:44,13,11,24
47,2025-05-25T08:45:00+02:00,2025-05-25,16:45,23,7,30
47,2025-05-25T08:50:00+02:00,2025-05-25,16:50,11,22,33
47,2025-05-25T08:51:00+02:00,2025-05-25,16:51,22,21,43
47,2025-05-25T08:53:00+02:00,2025-05-25,16:53,10,13,23
47,2025-05-25T08:54:00+02:00,2025-05-25,16:54,19,9,28
50,2025-05-25T08:40:00+02:00,2025-05-25,16:40,0,3,3
50,2025-05-25T08:43:00+02:00,2025-05-25,16:43,4,3,7
50,2025-05-25T08:44:00+02:00,2025-05-25,16:44,8,3,11
50,2025-05-25T08:45:00+02:00,2025-05-25,16:45,4,5,9
50,2025-05-25T08:50:00+02:00,2025-05-25,16:50,2,2,4
50,2025-05-25T08:51:00+02:00,2025-05-25,16:51,1,0,1
54,2025-05-25T08:40:00+02:00,2025-05-25,16:40,0,2,2
54,2025-05-25T08:42:00+02:00,2025-05-25,16:42,1,1,2
54,2025-05-25T08:46:00+02:00,2025-05-25,16:46,1,1,2
54,2025-05-25T08:51:00+02:00,2025-05-25,16:51,3,3,6
54,2025-05-25T08:53:00+02:00,2025-05-25,16:53,1,2,3
54,2025-05-25T08:54:00+02:00,2025-05-25,16:54,1,6,7
59,2025-05-25T08:40:00+02:00,2025-05-25,16:40,20,24,44
61,2025-05-25T08:42:00+02:00,2025-05-25,16:42,14,8,22
61,2025-05-25T08:46:00+02:00,2025-05-25,16:46,7,9,16
61,2025-05-25T08:48:00+02:00,2025-05-25,16:48,3,6,9
61,2025-05-25T08:49:00+02:00,2025-05-25,16:49,17,2,19
66,2025-05-25T08:43:00+02:00,2025-05-25,16:43,24,25,49
66,2025-05-25T08:44:00+02:00,2025-05-25,16:44,25,22,47
66,2025-05-25T08:47:00+02:00,2025-05-25,16:47,32,21,53
66,2025-05-25T08:50:00+02:00,2025-05-25,16:50,19,11,30
66,2025-05-25T08:51:00+02:00,2025-05-25,16:51,27,45,72
69,2025-05-25T08:45:00+02:00,2025-05-25,16:45,1,5,6
69,2025-05-25T08:49:00+02:00,2025-05-25,16:49,0,6,6
69,2025-05-25T08:51:00+02:00,2025-05-25,16:51,1,5,6
69,2025-05-25T08:53:00+02:00,2025-05-25,16:53,4,2,6
70,2025-05-25T08:49:00+02:00,2025-05-25,16:49,4,1,5
70,2025-05-25T08:52:00+02:00,2025-05-25,16:52,2,9,11
71,2025-05-25T08:49:00+02:00,2025-05-25,16:49,0,1,1
75,2025-05-25T08:52:00+02:00,2025-05-25,16:52,2,0,2
75,2025-05-25T08:53:00+02:00,2025-05-25,16:53,0,1,1
77,2025-05-25T08:50:00+02:00,2025-05-25,16:50,13,9,22
87,2025-05-25T08:41:00+02:00,2025-05-25,16:41,2,1,3
87,2025-05-25T08:48:00+02:00,2025-05-25,16:48,0,2,2
87,2025-05-25T08:50:00+02:00,2025-05-25,16:50,4,3,7
107,2025-05-25T08:50:00+02:00,2025-05-25,16:50,2,8,10
108,2025-05-25T08:41:00+02:00,2025-05-25,16:41,2,1,3
108,2025-05-25T08:44:00+02:00,2025-05-25,16:44,0,3,3
108,2025-05-25T08:45:00+02:00,2025-05-25,16:45,3,3,6
108,2025-05-25T08:47:00+02:00,2025-05-25,16:47,1,2,3
124,2025-05-25T08:50:00+02:00,2025-05-25,16:50,0,1,1
131,2025-05-25T08:45:00+02:00,2025-05-25,16:45,12,5,17
132,2025-05-25T08:50:00+02:00,2025-05-25,16:50,9,14,23
134,2025-05-25T08:40:00+02:00,2025-05-25,16:40,53,25,78
140,2025-05-25T08:40:00+02:00,2025-05-25,16:40,9,6,15
166,2025-05-25T08:45:00+02:00,2025-05-25,16:45,4,4,8
1,2025-05-25T08:41:00+02:00,2025-05-25,16:41,15,18,33
1,2025-05-25T08:42:00+02:00,2025-05-25,16:42,17,20,37
1,2025-05-25T08:47:00+02:00,2025-05-25,16:47,21,13,34
1,2025-05-25T08:48:00+02:00,2025-05-25,16:48,29,24,53
1,2025-05-25T08:51:00+02:00,2025-05-25,16:51,28,15,43
2,2025-05-25T08:45:00+02:00,2025-05-25,16:45,4,1,5
2,2025-05-25T08:46:00+02:00,2025-05-25,16:46,14,6,20
2,2025-05-25T08:53:00+02:00,2025-05-25,16:53,10,9,19
9,2025-05-25T08:45:00+02:00,2025-05-25,16:45,2,2,4
9,2025-05-25T08:52:00+02:00,2025-05-25,16:52,3,1,4
9,2025-05-25T08:53:00+02:00,2025-05-25,16:53,1,2,3
10,2025-05-25T08:41:00+02:00,2025-05-25,16:41,1,0,1
10,2025-05-25T08:45:00+02:00,2025-05-25,16:45,2,0,2
10,2025-05-25T08:51:00+02:00,2025-05-25,16:51,1,0,1
11,2025-05-25T08:45:00+02:00,2025-05-25,16:45,6,1,7
11,2025-05-25T08:47:00+02:00,2025-05-25,16:47,2,0,2
11,2025-05-25T08:48:00+02:00,2025-05-25,16:48,6,1,7
12,2025-05-25T08:40:00+02:00,2025-05-25,16:40,15,6,21
12,2025-05-25T08:46:00+02:00,2025-05-25,16:46,1,3,4
17,2025-05-25T08:45:00+02:00,2025-05-25,16:45,0,5,5
17,2025-05-25T08:49:00+02:00,2025-05-25,16:49,1,0,1
18,2025-05-25T08:54:00+02:00,2025-05-25,16:54,3,0,3
19,2025-05-25T08:41:00+02:00,2025-05-25,16:41,16,2,18
19,2025-05-25T08:44:00+02:00,2025-05-25,16:44,5,7,12
19,2025-05-25T08:45:00+02:00,2025-05-25,16:45,5,10,15
19,2025-05-25T08:48:00+02:00,2025-05-25,16:48,6,21,27
19,2025-05-25T08:50:00+02:00,2025-05-25,16:50,13,7,20
19,2025-05-25T08:54:00+02:00,2025-05-25,16:54,6,1,7
20,2025-05-25T08:40:00+02:00,2025-05-25,16:40,0,1,1
20,2025-05-25T08:42:00+02:00,2025-05-25,16:42,6,3,9
20,2025-05-25T08:51:00+02:00,2025-05-25,16:51,6,2,8
20,2025-05-25T08:54:00+02:00,2025-05-25,16:54,16,2,18
23,2025-05-25T08:40:00+02:00,2025-05-25,16:40,0,2,2
23,2025-05-25T08:45:00+02:00,2025-05-25,16:45,0,10,10
23,2025-05-25T08:46:00+02:00,2025-05-25,16:46,0,3,3
23,2025-05-25T08:50:00+02:00,2025-05-25,16:50,1,4,5
23,2025-05-25T08:51:00+02:00,2025-05-25,16:51,0,3,3
23,2025-05-25T08:53:00+02:00,2025-05-25,16:53,6,1,7
23,2025-05-25T08:54:00+02:00,2025-05-25,16:54,2,3,5
24,2025-05-25T08:44:00+02:00,2025-05-25,16:44,6,2,8
24,2025-05-25T08:46:00+02:00,2025-05-25,16:46,7,2,9
24,2025-05-25T08:47:00+02:00,2025-05-25,16:47,15,1,16
24,2025-05-25T08:49:00+02:00,2025-05-25,16:49,11,3,14
24,2025-05-25T08:51:00+02:00,2025-05-25,16:51,4,11,15
24,2025-05-25T08:52:00+02:00,2025-05-25,16:52,11,23,34
25,2025-05-25T08:40:00+02:00,2025-05-25,16:40,71,88,159
27,2025-05-25T08:41:00+02:00,2025-05-25,16:41,2,1,3
27,2025-05-25T08:45:00+02:00,2025-05-25,16:45,1,0,1
27,2025-05-25T08:47:00+02:00,2025-05-25,16:47,2,1,3
27,2025-05-25T08:48:00+02:00,2025-05-25,16:48,0,3,3
27,2025-05-25T08:49:00+02:00,2025-05-25,16:49,4,0,4
27,2025-05-25T08:50:00+02:00,2025-05-25,16:50,8,4,12
27,2025-05-25T08:51:00+02:00,2025-05-25,16:51,2,0,2
27,2025-05-25T08:53:00+02:00,2025-05-25,16:53,1,0,1
30,2025-05-25T08:40:00+02:00,2025-05-25,16:40,3,12,15
30,2025-05-25T08:41:00+02:00,2025-05-25,16:41,7,3,10
30,2025-05-25T08:42:00+02:00,2025-05-25,16:42,2,10,12
30,2025-05-25T08:43:00+02:00,2025-05-25,16:43,4,3,7
30,2025-05-25T08:48:00+02:00,2025-05-25,16:48,6,9,15
30,2025-05-25T08:50:00+02:00,2025-05-25,16:50,7,3,10
30,2025-05-25T08:53:00+02:00,2025-05-25,16:53,7,5,12
35,2025-05-25T08:42:00+02:00,2025-05-25,16:42,11,19,30
35,2025-05-25T08:44:00+02:00,2025-05-25,16:44,8,18,26
48,2025-05-25T08:40:00+02:00,2025-05-25,16:40,3,3,6
48,2025-05-25T08:41:00+02:00,2025-05-25,16:41,4,1,5
48,2025-05-25T08:46:00+02:00,2025-05-25,16:46,1,3,4
48,2025-05-25T08:48:00+02:00,2025-05-25,16:48,1,5,6
48,2025-05-25T08:51:00+02:00,2025-05-25,16:51,5,1,6
48,2025-05-25T08:54:00+02:00,2025-05-25,16:54,0,2,2
49,2025-05-25T08:48:00+02:00,2025-05-25,16:48,3,4,7
49,2025-05-25T08:51:00+02:00,2025-05-25,16:51,4,6,10
49,2025-05-25T08:52:00+02:00,2025-05-25,16:52,6,3,9
49,2025-05-25T08:54:00+02:00,2025-05-25,16:54,1,4,5
51,2025-05-25T08:44:00+02:00,2025-05-25,16:44,2,2,4
51,2025-05-25T08:45:00+02:00,2025-05-25,16:45,8,0,8
51,2025-05-25T08:47:00+02:00,2025-05-25,16:47,1,3,4
51,2025-05-25T08:51:00+02:00,2025-05-25,16:51,3,4,7
51,2025-05-25T08:52:00+02:00,2025-05-25,16:52,6,0,6
52,2025-05-25T08:54:00+02:00,2025-05-25,16:54,7,5,12
53,2025-05-25T08:43:00+02:00,2025-05-25,16:43,8,9,17
53,2025-05-25T08:51:00+02:00,2025-05-25,16:51,3,7,10
56,2025-05-25T08:40:00+02:00,2025-05-25,16:40,14,5,19
56,2025-05-25T08:41:00+02:00,2025-05-25,16:41,6,3,9
56,2025-05-25T08:42:00+02:00,2025-05-25,16:42,4,8,12
56,2025-05-25T08:43:00+02:00,2025-05-25,16:43,5,12,17
56,2025-05-25T08:44:00+02:00,2025-05-25,16:44,4,10,14
56,2025-05-25T08:45:00+02:00,2025-05-25,16:45,6,6,12
56,2025-05-25T08:51:00+02:00,2025-05-25,16:51,4,2,6
58,2025-05-25T08:40:00+02:00,2025-05-25,16:40,6,3,9
58,2025-05-25T08:45:00+02:00,2025-05-25,16:45,1,4,5
58,2025-05-25T08:46:00+02:00,2025-05-25,16:46,13,6,19
58,2025-05-25T08:49:00+02:00,2025-05-25,16:49,10,6,16
62,2025-05-25T08:43:00+02:00,2025-05-25,16:43,1,0,1
62,2025-05-25T08:44:00+02:00,2025-05-25,16:44,2,0,2
62,2025-05-25T08:54:00+02:00,2025-05-25,16:54,6,3,9
63,2025-05-25T08:40:00+02:00,2025-05-25,16:40,9,10,19
63,2025-05-25T08:42:00+02:00,2025-05-25,16:42,7,2,9
63,2025-05-25T08:45:00+02:00,2025-05-25,16:45,4,4,8
63,2025-05-25T08:48:00+02:00,2025-05-25,16:48,11,6,17
67,2025-05-25T08:45:00+02:00,2025-05-25,16:45,6,17,23
67,2025-05-25T08:46:00+02:00,2025-05-25,16:46,9,8,17
67,2025-05-25T08:48:00+02:00,2025-05-25,16:48,8,19,27
67,2025-05-25T08:49:00+02:00,2025-05-25,16:49,2,9,11
67,2025-05-25T08:50:00+02:00,2025-05-25,16:50,6,7,13
67,2025-05-25T08:51:00+02:00,2025-05-25,16:51,5,8,13
67,2025-05-25T08:54:00+02:00,2025-05-25,16:54,5,6,11
68,2025-05-25T08:48:00+02:00,2025-05-25,16:48,1,3,4
68,2025-05-25T08:52:00+02:00,2025-05-25,16:52,2,2,4
68,2025-05-25T08:53:00+02:00,2025-05-25,16:53,5,4,9
72,2025-05-25T08:41:00+02:00,2025-05-25,16:41,4,5,9
72,2025-05-25T08:44:00+02:00,2025-05-25,16:44,10,11,21
72,2025-05-25T08:49:00+02:00,2025-05-25,16:49,9,5,14
72,2025-05-25T08:50:00+02:00,2025-05-25,16:50,4,6,10
72,2025-05-25T08:54:00+02:00,2025-05-25,16:54,4,3,7
76,2025-05-25T08:50:00+02:00,2025-05-25,16:50,0,2,2
76,2025-05-25T08:52:00+02:00,2025-05-25,16:52,0,2,2
76,2025-05-25T08:54:00+02:00,2025-05-25,16:54,2,1,3
79,2025-05-25T08:41:00+02:00,2025-05-25,16:41,5,19,24
79,2025-05-25T08:42:00+02:00,2025-05-25,16:42,4,10,14
79,2025-05-25T08:44:00+02:00,2025-05-25,16:44,14,5,19
79,2025-05-25T08:48:00+02:00,2025-05-25,16:48,34,6,40
79,2025-05-25T08:52:00+02:00,2025-05-25,16:52,5,10,15
85,2025-05-25T08:40:00+02:00,2025-05-25,16:40,1,2,3
85,2025-05-25T08:41:00+02:00,2025-05-25,16:41,1,1,2
85,2025-05-25T08:42:00+02:00,2025-05-25,16:42,1,0,1
85,2025-05-25T08:43:00+02:00,2025-05-25,16:43,0,3,3
85,2025-05-25T08:45:00+02:00,2025-05-25,16:45,3,0,3
85,2025-05-25T08:52:00+02:00,2025-05-25,16:52,0,1,1
86,2025-05-25T08:40:00+02:00,2025-05-25,16:40,0,1,1
86,2025-05-25T08:41:00+02:00,2025-05-25,16:41,1,0,1
86,2025-05-25T08:44:00+02:00,2025-05-25,16:44,1,1,2
86,2025-05-25T08:47:00+02:00,2025-05-25,16:47,1,1,2
86,2025-05-25T08:54:00+02:00,2025-05-25,16:54,1,1,2
109,2025-05-25T08:40:00+02:00,2025-05-25,16:40,10,19,29
109,2025-05-25T08:45:00+02:00,2025-05-25,16:45,7,8,15
117,2025-05-25T08:40:00+02:00,2025-05-25,16:40,23,21,44
117,2025-05-25T08:50:00+02:00,2025-05-25,16:50,35,33,68
136,2025-05-25T08:40:00+02:00,2025-05-25,16:40,11,16,27
136,2025-05-25T08:45:00+02:00,2025-05-25,16:45,12,12,24
137,2025-05-25T08:45:00+02:00,2025-05-25,16:45,0,5,5
139,2025-05-25T08:50:00+02:00,2025-05-25,16:50,7,4,11
141,2025-05-25T08:45:00+02:00,2025-05-25,16:45,17,7,24
164,2025-05-25T08:45:00+02:00,2025-05-25,16:45,13,11,24
3,2025-05-25T08:56:00+02:00,2025-05-25,16:56,19,18,37
3,2025-05-25T08:57:00+02:00,2025-05-25,16:57,7,18,25
3,2025-05-25T09:01:00+02:00,2025-05-25,17:01,10,34,44
3,2025-05-25T09:05:00+02:00,2025-05-25,17:05,13,31,44
3,2025-05-25T09:06:00+02:00,2025-05-25,17:06,10,18,28
3,2025-05-25T09:08:00+02:00,2025-05-25,17:08,14,19,33
3,2025-05-25T09:09:00+02:00,2025-05-25,17:09,13,18,31
4,2025-05-25T08:56:00+02:00,2025-05-25,16:56,26,32,58
4,2025-05-25T08:58:00+02:00,2025-05-25,16:58,31,12,43
4,2025-05-25T09:03:00+02:00,2025-05-25,17:03,37,20,57
4,2025-05-25T09:05:00+02:00,2025-05-25,17:05,33,32,65
4,2025-05-25T09:07:00+02:00,2025-05-25,17:07,28,30,58
5,2025-05-25T09:00:00+02:00,2025-05-25,17:00,105,105,210
5,2025-05-25T09:05:00+02:00,2025-05-25,17:05,70,87,157
6,2025-05-25T08:55:00+02:00,2025-05-25,16:55,4,16,20
6,2025-05-25T08:56:00+02:00,2025-05-25,16:56,23,5,28
6,2025-05-25T08:58:00+02:00,2025-05-25,16:58,5,12,17
6,2025-05-25T09:03:00+02:00,2025-05-25,17:03,18,17,35
6,2025-05-25T09:06:00+02:00,2025-05-25,17:06,20,7,27
8,2025-05-25T08:55:00+02:00,2025-05-25,16:55,7,2,9
8,2025-05-25T08:59:00+02:00,2025-05-25,16:59,2,1,3
8,2025-05-25T09:00:00+02:00,2025-05-25,17:00,2,8,10
8,2025-05-25T09:02:00+02:00,2025-05-25,17:02,4,3,7
8,2025-05-25T09:04:00+02:00,2025-05-25,17:04,4,9,13
8,2025-05-25T09:05:00+02:00,2025-05-25,17:05,7,1,8
8,2025-05-25T09:06:00+02:00,2025-05-25,17:06,3,0,3
8,2025-05-25T09:08:00+02:00,2025-05-25,17:08,1,8,9
28,2025-05-25T08:58:00+02:00,2025-05-25,16:58,4,9,13
28,2025-05-25T09:04:00+02:00,2025-05-25,17:04,13,12,25
28,2025-05-25T09:07:00+02:00,2025-05-25,17:07,9,9,18
28,2025-05-25T09:08:00+02:00,2025-05-25,17:08,8,15,23
29,2025-05-25T08:55:00+02:00,2025-05-25,16:55,10,6,16
29,2025-05-25T08:56:00+02:00,2025-05-25,16:56,15,7,22
29,2025-05-25T08:59:00+02:00,2025-05-25,16:59,4,13,17
29,2025-05-25T09:01:00+02:00,2025-05-25,17:01,2,9,11
29,2025-05-25T09:04:00+02:00,2025-05-25,17:04,10,10,20
29,2025-05-25T09:05:00+02:00,2025-05-25,17:05,11,11,22
29,2025-05-25T09:06:00+02:00,2025-05-25,17:06,6,17,23
29,2025-05-25T09:08:00+02:00,2025-05-25,17:08,19,16,35
29,2025-05-25T09:09:00+02:00,2025-05-25,17:09,6,12,18
31,2025-05-25T08:55:00+02:00,2025-05-25,16:55,3,2,5
31,2025-05-25T08:58:00+02:00,2025-05-25,16:58,5,2,7
36,2025-05-25T09:00:00+02:00,2025-05-25,17:00,0,3,3
36,2025-05-25T09:05:00+02:00,2025-05-25,17:05,0,7,7
36,2025-05-25T09:06:00+02:00,2025-05-25,17:06,1,0,1
36,2025-05-25T09:07:00+02:00,2025-05-25,17:07,2,0,2
36,2025-05-25T09:08:00+02:00,2025-05-25,17:08,1,3,4
36,2025-05-25T09:09:00+02:00,2025-05-25,17:09,0,2,2
39,2025-05-25T08:56:00+02:00,2025-05-25,16:56,0,2,2
39,2025-05-25T08:57:00+02:00,2025-05-25,16:57,1,0,1
40,2025-05-25T08:58:00+02:00,2025-05-25,16:58,1,0,1
40,2025-05-25T09:06:00+02:00,2025-05-25,17:06,0,3,3
41,2025-05-25T08:55:00+02:00,2025-05-25,16:55,7,12,19
41,2025-05-25T09:00:00+02:00,2025-05-25,17:00,8,5,13
41,2025-05-25T09:01:00+02:00,2025-05-25,17:01,9,5,14
41,2025-05-25T09:08:00+02:00,2025-05-25,17:08,4,5,9
43,2025-05-25T08:55:00+02:00,2025-05-25,16:55,15,3,18
44,2025-05-25T09:00:00+02:00,2025-05-25,17:00,9,4,13
45,2025-05-25T08:56:00+02:00,2025-05-25,16:56,10,5,15
45,2025-05-25T08:58:00+02:00,2025-05-25,16:58,5,12,17
45,2025-05-25T08:59:00+02:00,2025-05-25,16:59,19,23,42
45,2025-05-25T09:03:00+02:00,2025-05-25,17:03,16,18,34
45,2025-05-25T09:06:00+02:00,2025-05-25,17:06,22,21,43
45,2025-05-25T09:07:00+02:00,2025-05-25,17:07,18,22,40
45,2025-05-25T09:09:00+02:00,2025-05-25,17:09,18,15,33
47,2025-05-25T08:56:00+02:00,2025-05-25,16:56,11,23,34
47,2025-05-25T08:59:00+02:00,2025-05-25,16:59,26,12,38
47,2025-05-25T09:07:00+02:00,2025-05-25,17:07,35,21,56
50,2025-05-25T08:55:00+02:00,2025-05-25,16:55,1,3,4
50,2025-05-25T08:56:00+02:00,2025-05-25,16:56,7,4,11
50,2025-05-25T08:59:00+02:00,2025-05-25,16:59,5,3,8
50,2025-05-25T09:00:00+02:00,2025-05-25,17:00,3,2,5
50,2025-05-25T09:06:00+02:00,2025-05-25,17:06,2,1,3
50,2025-05-25T09:07:00+02:00,2025-05-25,17:07,0,1,1
54,2025-05-25T08:55:00+02:00,2025-05-25,16:55,1,3,4
54,2025-05-25T09:00:00+02:00,2025-05-25,17:00,3,1,4
54,2025-05-25T09:03:00+02:00,2025-05-25,17:03,0,2,2
54,2025-05-25T09:06:00+02:00,2025-05-25,17:06,1,1,2
59,2025-05-25T08:55:00+02:00,2025-05-25,16:55,19,23,42
59,2025-05-25T09:05:00+02:00,2025-05-25,17:05,16,31,47
61,2025-05-25T08:56:00+02:00,2025-05-25,16:56,6,9,15
61,2025-05-25T08:57:00+02:00,2025-05-25,16:57,6,10,16
61,2025-05-25T08:59:00+02:00,2025-05-25,16:59,6,9,15
61,2025-05-25T09:00:00+02:00,2025-05-25,17:00,11,2,13
61,2025-05-25T09:01:00+02:00,2025-05-25,17:01,10,23,33
61,2025-05-25T09:02:00+02:00,2025-05-25,17:02,32,4,36
61,2025-05-25T09:04:00+02:00,2025-05-25,17:04,14,5,19
61,2025-05-25T09:05:00+02:00,2025-05-25,17:05,9,7,16
66,2025-05-25T08:57:00+02:00,2025-05-25,16:57,15,27,42
66,2025-05-25T09:03:00+02:00,2025-05-25,17:03,26,44,70
66,2025-05-25T09:08:00+02:00,2025-05-25,17:08,21,14,35
69,2025-05-25T08:56:00+02:00,2025-05-25,16:56,2,8,10
69,2025-05-25T08:58:00+02:00,2025-05-25,16:58,0,3,3
69,2025-05-25T08:59:00+02:00,2025-05-25,16:59,3,3,6
69,2025-05-25T09:01:00+02:00,2025-05-25,17:01,2,1,3
69,2025-05-25T09:07:00+02:00,2025-05-25,17:07,0,2,2
69,2025-05-25T09:08:00+02:00,2025-05-25,17:08,2,6,8
70,2025-05-25T08:55:00+02:00,2025-05-25,16:55,4,1,5
70,2025-05-25T09:02:00+02:00,2025-05-25,17:02,7,3,10
70,2025-05-25T09:05:00+02:00,2025-05-25,17:05,0,2,2
70,2025-05-25T09:08:00+02:00,2025-05-25,17:08,2,2,4
70,2025-05-25T09:09:00+02:00,2025-05-25,17:09,2,0,2
71,2025-05-25T09:09:00+02:00,2025-05-25,17:09,1,0,1
75,2025-05-25T08:55:00+02:00,2025-05-25,16:55,0,3,3
75,2025-05-25T09:02:00+02:00,2025-05-25,17:02,0,3,3
75,2025-05-25T09:09:00+02:00,2025-05-25,17:09,2,0,2
77,2025-05-25T08:55:00+02:00,2025-05-25,16:55,19,17,36
78,2025-05-25T08:56:00+02:00,2025-05-25,16:56,0,2,2
78,2025-05-25T09:08:00+02:00,2025-05-25,17:08,0,2,2
78,2025-05-25T09:09:00+02:00,2025-05-25,17:09,0,1,1
87,2025-05-25T08:57:00+02:00,2025-05-25,16:57,1,4,5
87,2025-05-25T09:00:00+02:00,2025-05-25,17:00,2,7,9
87,2025-05-25T09:01:00+02:00,2025-05-25,17:01,3,4,7
87,2025-05-25T09:04:00+02:00,2025-05-25,17:04,0,2,2
87,2025-05-25T09:05:00+02:00,2025-05-25,17:05,5,1,6
87,2025-05-25T09:07:00+02:00,2025-05-25,17:07,2,0,2
107,2025-05-25T09:00:00+02:00,2025-05-25,17:00,9,11,20
107,2025-05-25T09:05:00+02:00,2025-05-25,17:05,9,7,16
108,2025-05-25T08:55:00+02:00,2025-05-25,16:55,3,2,5
108,2025-05-25T08:56:00+02:00,2025-05-25,16:56,2,0,2
108,2025-05-25T08:58:00+02:00,2025-05-25,16:58,0,3,3
108,2025-05-25T09:00:00+02:00,2025-05-25,17:00,3,6,9
108,2025-05-25T09:01:00+02:00,2025-05-25,17:01,0,2,2
108,2025-05-25T09:06:00+02:00,2025-05-25,17:06,0,3,3
108,2025-05-25T09:09:00+02:00,2025-05-25,17:09,2,4,6
118,2025-05-25T08:55:00+02:00,2025-05-25,16:55,1,1,2
118,2025-05-25T09:05:00+02:00,2025-05-25,17:05,4,2,6
132,2025-05-25T09:05:00+02:00,2025-05-25,17:05,13,16,29
133,2025-05-25T09:05:00+02:00,2025-05-25,17:05,38,32,70
134,2025-05-25T09:05:00+02:00,2025-05-25,17:05,44,27,71
135,2025-05-25T09:00:00+02:00,2025-05-25,17:00,37,27,64
135,2025-05-25T09:05:00+02:00,2025-05-25,17:05,30,22,52
140,2025-05-25T09:00:00+02:00,2025-05-25,17:00,9,8,17
162,2025-05-25T08:55:00+02:00,2025-05-25,16:55,27,34,61
166,2025-05-25T08:55:00+02:00,2025-05-25,16:55,4,8,12
166,2025-05-25T09:00:00+02:00,2025-05-25,17:00,11,8,19
166,2025-05-25T09:05:00+02:00,2025-05-25,17:05,5,1,6
167,2025-05-25T09:00:00+02:00,2025-05-25,17:00,5,12,17
179,2025-05-25T09:05:00+02:00,2025-05-25,17:05,6,6,12
1,2025-05-25T08:55:00+02:00,2025-05-25,16:55,14,15,29
1,2025-05-25T08:57:00+02:00,2025-05-25,16:57,23,26,49
1,2025-05-25T08:58:00+02:00,2025-05-25,16:58,16,13,29
1,2025-05-25T09:04:00+02:00,2025-05-25,17:04,28,11,39
1,2025-05-25T09:05:00+02:00,2025-05-25,17:05,29,9,38
1,2025-05-25T09:06:00+02:00,2025-05-25,17:06,31,35,66
1,2025-05-25T09:08:00+02:00,2025-05-25,17:08,14,14,28
1,2025-05-25T09:09:00+02:00,2025-05-25,17:09,20,10,30
2,2025-05-25T08:55:00+02:00,2025-05-25,16:55,7,9,16
2,2025-05-25T08:58:00+02:00,2025-05-25,16:58,6,9,15
2,2025-05-25T08:59:00+02:00,2025-05-25,16:59,4,6,10
2,2025-05-25T09:00:00+02:00,2025-05-25,17:00,8,15,23
2,2025-05-25T09:01:00+02:00,2025-05-25,17:01,18,7,25
2,2025-05-25T09:07:00+02:00,2025-05-25,17:07,10,6,16
2,2025-05-25T09:09:00+02:00,2025-05-25,17:09,12,1,13
9,2025-05-25T08:56:00+02:00,2025-05-25,16:56,1,0,1
9,2025-05-25T09:06:00+02:00,2025-05-25,17:06,2,1,3
9,2025-05-25T09:08:00+02:00,2025-05-25,17:08,2,0,2
11,2025-05-25T08:55:00+02:00,2025-05-25,16:55,9,5,14
12,2025-05-25T08:55:00+02:00,2025-05-25,16:55,13,3,16
12,2025-05-25T09:01:00+02:00,2025-05-25,17:01,10,4,14
12,2025-05-25T09:03:00+02:00,2025-05-25,17:03,5,11,16
12,2025-05-25T09:06:00+02:00,2025-05-25,17:06,6,1,7
12,2025-05-25T09:09:00+02:00,2025-05-25,17:09,4,4,8
17,2025-05-25T08:55:00+02:00,2025-05-25,16:55,4,7,11
17,2025-05-25T08:57:00+02:00,2025-05-25,16:57,1,1,2
17,2025-05-25T08:59:00+02:00,2025-05-25,16:59,5,8,13
17,2025-05-25T09:03:00+02:00,2025-05-25,17:03,0,5,5
17,2025-05-25T09:06:00+02:00,2025-05-25,17:06,3,1,4
17,2025-05-25T09:08:00+02:00,2025-05-25,17:08,1,4,5
18,2025-05-25T08:56:00+02:00,2025-05-25,16:56,1,0,1
18,2025-05-25T08:58:00+02:00,2025-05-25,16:58,2,0,2
18,2025-05-25T09:00:00+02:00,2025-05-25,17:00,2,0,2
18,2025-05-25T09:02:00+02:00,2025-05-25,17:02,2,0,2
18,2025-05-25T09:04:00+02:00,2025-05-25,17:04,0,1,1
18,2025-05-25T09:08:00+02:00,2025-05-25,17:08,3,4,7
19,2025-05-25T09:03:00+02:00,2025-05-25,17:03,14,7,21
19,2025-05-25T09:04:00+02:00,2025-05-25,17:04,10,11,21
19,2025-05-25T09:07:00+02:00,2025-05-25,17:07,22,11,33
20,2025-05-25T09:01:00+02:00,2025-05-25,17:01,4,3,7
20,2025-05-25T09:02:00+02:00,2025-05-25,17:02,1,4,5
20,2025-05-25T09:04:00+02:00,2025-05-25,17:04,9,6,15
20,2025-05-25T09:07:00+02:00,2025-05-25,17:07,9,1,10
23,2025-05-25T08:56:00+02:00,2025-05-25,16:56,1,6,7
23,2025-05-25T08:58:00+02:00,2025-05-25,16:58,1,10,11
23,2025-05-25T09:00:00+02:00,2025-05-25,17:00,0,2,2
24,2025-05-25T08:55:00+02:00,2025-05-25,16:55,1,12,13
24,2025-05-25T08:57:00+02:00,2025-05-25,16:57,13,23,36
24,2025-05-25T08:59:00+02:00,2025-05-25,16:59,8,6,14
24,2025-05-25T09:00:00+02:00,2025-05-25,17:00,4,9,13
24,2025-05-25T09:03:00+02:00,2025-05-25,17:03,1,8,9
24,2025-05-25T09:05:00+02:00,2025-05-25,17:05,0,29,29
24,2025-05-25T09:09:00+02:00,2025-05-25,17:09,2,20,22
25,2025-05-25T09:05:00+02:00,2025-05-25,17:05,103,23,126
27,2025-05-25T08:58:00+02:00,2025-05-25,16:58,2,1,3
27,2025-05-25T09:01:00+02:00,2025-05-25,17:01,1,0,1
27,2025-05-25T09:05:00+02:00,2025-05-25,17:05,1,11,12
27,2025-05-25T09:09:00+02:00,2025-05-25,17:09,2,0,2
30,2025-05-25T08:55:00+02:00,2025-05-25,16:55,8,8,16
30,2025-05-25T08:57:00+02:00,2025-05-25,16:57,5,7,12
30,2025-05-25T08:59:00+02:00,2025-05-25,16:59,9,2,11
30,2025-05-25T09:00:00+02:00,2025-05-25,17:00,9,10,19
30,2025-05-25T09:06:00+02:00,2025-05-25,17:06,4,3,7
35,2025-05-25T09:00:00+02:00,2025-05-25,17:00,15,27,42
35,2025-05-25T09:04:00+02:00,2025-05-25,17:04,19,30,49
35,2025-05-25T09:05:00+02:00,2025-05-25,17:05,20,16,36
35,2025-05-25T09:09:00+02:00,2025-05-25,17:09,27,39,66
48,2025-05-25T08:55:00+02:00,2025-05-25,16:55,4,10,14
48,2025-05-25T09:07:00+02:00,2025-05-25,17:07,3,1,4
48,2025-05-25T09:09:00+02:00,2025-05-25,17:09,4,3,7
49,2025-05-25T08:57:00+02:00,2025-05-25,16:57,4,8,12
49,2025-05-25T09:00:00+02:00,2025-05-25,17:00,4,1,5
49,2025-05-25T09:04:00+02:00,2025-05-25,17:04,10,2,12
49,2025-05-25T09:07:00+02:00,2025-05-25,17:07,5,1,6
51,2025-05-25T09:07:00+02:00,2025-05-25,17:07,3,4,7
51,2025-05-25T09:08:00+02:00,2025-05-25,17:08,1,1,2
52,2025-05-25T08:56:00+02:00,2025-05-25,16:56,12,4,16
52,2025-05-25T08:59:00+02:00,2025-05-25,16:59,3,0,3
52,2025-05-25T09:02:00+02:00,2025-05-25,17:02,8,3,11
52,2025-05-25T09:05:00+02:00,2025-05-25,17:05,15,1,16
52,2025-05-25T09:06:00+02:00,2025-05-25,17:06,7,7,14
53,2025-05-25T08:57:00+02:00,2025-05-25,16:57,12,5,17
53,2025-05-25T08:58:00+02:00,2025-05-25,16:58,20,1,21
53,2025-05-25T09:01:00+02:00,2025-05-25,17:01,3,4,7
53,2025-05-25T09:07:00+02:00,2025-05-25,17:07,7,1,8
53,2025-05-25T09:08:00+02:00,2025-05-25,17:08,5,4,9
56,2025-05-25T08:56:00+02:00,2025-05-25,16:56,6,3,9
56,2025-05-25T08:57:00+02:00,2025-05-25,16:57,2,6,8
56,2025-05-25T08:58:00+02:00,2025-05-25,16:58,3,10,13
56,2025-05-25T08:59:00+02:00,2025-05-25,16:59,0,10,10
56,2025-05-25T09:07:00+02:00,2025-05-25,17:07,3,8,11
56,2025-05-25T09:09:00+02:00,2025-05-25,17:09,4,14,18
58,2025-05-25T08:59:00+02:00,2025-05-25,16:59,6,6,12
58,2025-05-25T09:04:00+02:00,2025-05-25,17:04,6,8,14
58,2025-05-25T09:05:00+02:00,2025-05-25,17:05,4,3,7
62,2025-05-25T08:56:00+02:00,2025-05-25,16:56,5,2,7
62,2025-05-25T08:59:00+02:00,2025-05-25,16:59,4,7,11
62,2025-05-25T09:01:00+02:00,2025-05-25,17:01,1,2,3
62,2025-05-25T09:05:00+02:00,2025-05-25,17:05,2,4,6
62,2025-05-25T09:06:00+02:00,2025-05-25,17:06,2,4,6
62,2025-05-25T09:07:00+02:00,2025-05-25,17:07,7,2,9
62,2025-05-25T09:09:00+02:00,2025-05-25,17:09,5,4,9
63,2025-05-25T08:56:00+02:00,2025-05-25,16:56,4,2,6
63,2025-05-25T08:57:00+02:00,2025-05-25,16:57,2,9,11
63,2025-05-25T09:02:00+02:00,2025-05-25,17:02,5,7,12
67,2025-05-25T08:56:00+02:00,2025-05-25,16:56,5,14,19
67,2025-05-25T08:58:00+02:00,2025-05-25,16:58,6,9,15
67,2025-05-25T08:59:00+02:00,2025-05-25,16:59,4,12,16
67,2025-05-25T09:05:00+02:00,2025-05-25,17:05,10,6,16
67,2025-05-25T09:06:00+02:00,2025-05-25,17:06,3,9,12
68,2025-05-25T08:58:00+02:00,2025-05-25,16:58,4,1,5
68,2025-05-25T08:59:00+02:00,2025-05-25,16:59,8,4,12
68,2025-05-25T09:01:00+02:00,2025-05-25,17:01,8,3,11
68,2025-05-25T09:04:00+02:00,2025-05-25,17:04,5,1,6
68,2025-05-25T09:08:00+02:00,2025-05-25,17:08,7,11,18
68,2025-05-25T09:09:00+02:00,2025-05-25,17:09,5,3,8
72,2025-05-25T08:55:00+02:00,2025-05-25,16:55,19,15,34
72,2025-05-25T08:59:00+02:00,2025-05-25,16:59,2,18,20
72,2025-05-25T09:00:00+02:00,2025-05-25,17:00,9,15,24
72,2025-05-25T09:01:00+02:00,2025-05-25,17:01,11,10,21
72,2025-05-25T09:03:00+02:00,2025-05-25,17:03,3,20,23
72,2025-05-25T09:08:00+02:00,2025-05-25,17:08,7,6,13
76,2025-05-25T08:57:00+02:00,2025-05-25,16:57,1,0,1
76,2025-05-25T08:59:00+02:00,2025-05-25,16:59,2,1,3
76,2025-05-25T09:00:00+02:00,2025-05-25,17:00,1,1,2
76,2025-05-25T09:02:00+02:00,2025-05-25,17:02,1,1,2
76,2025-05-25T09:03:00+02:00,2025-05-25,17:03,0,1,1
76,2025-05-25T09:05:00+02:00,2025-05-25,17:05,2,1,3
76,2025-05-25T09:08:00+02:00,2025-05-25,17:08,2,0,2
79,2025-05-25T08:56:00+02:00,2025-05-25,16:56,10,18,28
79,2025-05-25T09:04:00+02:00,2025-05-25,17:04,7,8,15
79,2025-05-25T09:08:00+02:00,2025-05-25,17:08,13,4,17
85,2025-05-25T08:56:00+02:00,2025-05-25,16:56,2,0,2
85,2025-05-25T09:05:00+02:00,2025-05-25,17:05,0,1,1
85,2025-05-25T09:07:00+02:00,2025-05-25,17:07,2,0,2
85,2025-05-25T09:09:00+02:00,2025-05-25,17:09,0,2,2
86,2025-05-25T08:56:00+02:00,2025-05-25,16:56,1,0,1
86,2025-05-25T08:57:00+02:00,2025-05-25,16:57,0,4,4
86,2025-05-25T08:59:00+02:00,2025-05-25,16:59,1,0,1
86,2025-05-25T09:02:00+02:00,2025-05-25,17:02,0,1,1
109,2025-05-25T09:00:00+02:00,2025-05-25,17:00,2,9,11
117,2025-05-25T08:55:00+02:00,2025-05-25,16:55,22,29,51
130,2025-05-25T09:05:00+02:00,2025-05-25,17:05,2,6,8
137,2025-05-25T09:05:00+02:00,2025-05-25,17:05,0,1,1
138,2025-05-25T08:55:00+02:00,2025-05-25,16:55,1,0,1
139,2025-05-25T08:55:00+02:00,2025-05-25,16:55,4,3,7
139,2025-05-25T09:05:00+02:00,2025-05-25,17:05,1,7,8
141,2025-05-25T09:00:00+02:00,2025-05-25,17:00,22,6,28
142,2025-05-25T08:55:00+02:00,2025-05-25,16:55,50,55,105
161,2025-05-25T09:05:00+02:00,2025-05-25,17:05,36,20,56
164,2025-05-25T09:00:00+02:00,2025-05-25,17:00,6,7,13
164,2025-05-25T09:05:00+02:00,2025-05-25,17:05,7,6,13
180,2025-05-25T08:40:00+02:00,2025-05-25,16:40,2,0,2
180,2025-05-25T08:41:00+02:00,2025-05-25,16:41,1,0,1
180,2025-05-25T08:42:00+02:00,2025-05-25,16:42,2,0,2
180,2025-05-25T08:43:00+02:00,2025-05-25,16:43,3,1,4
180,2025-05-25T08:46:00+02:00,2025-05-25,16:46,0,2,2
180,2025-05-25T08:47:00+02:00,2025-05-25,16:47,0,1,1
181,2025-05-25T08:55:00+02:00,2025-05-25,16:55,8,20,28
181,2025-05-25T08:56:00+02:00,2025-05-25,16:56,19,13,32
181,2025-05-25T08:57:00+02:00,2025-05-25,16:57,16,17,33
181,2025-05-25T08:58:00+02:00,2025-05-25,16:58,15,12,27
181,2025-05-25T09:02:00+02:00,2025-05-25,17:02,13,18,31
181,2025-05-25T09:06:00+02:00,2025-05-25,17:06,21,17,38
182,2025-05-25T09:05:00+02:00,2025-05-25,17:05,17,19,36
180,2025-05-25T08:56:00+02:00,2025-05-25,16:56,2,0,2
180,2025-05-25T09:05:00+02:00,2025-05-25,17:05,3,3,6
180,2025-05-25T09:06:00+02:00,2025-05-25,17:06,0,1,1
3,2025-05-25T09:20:00+02:00,2025-05-25,17:20,11,19,30
3,2025-05-25T09:21:00+02:00,2025-05-25,17:21,8,19,27
4,2025-05-25T09:13:00+02:00,2025-05-25,17:13,28,25,53
4,2025-05-25T09:21:00+02:00,2025-05-25,17:21,24,13,37
4,2025-05-25T09:23:00+02:00,2025-05-25,17:23,16,18,34
6,2025-05-25T09:13:00+02:00,2025-05-25,17:13,16,22,38
6,2025-05-25T09:15:00+02:00,2025-05-25,17:15,17,13,30
6,2025-05-25T09:17:00+02:00,2025-05-25,17:17,19,7,26
6,2025-05-25T09:23:00+02:00,2025-05-25,17:23,26,14,40
6,2025-05-25T09:24:00+02:00,2025-05-25,17:24,20,18,38
8,2025-05-25T09:10:00+02:00,2025-05-25,17:10,1,0,1
8,2025-05-25T09:11:00+02:00,2025-05-25,17:11,3,3,6
8,2025-05-25T09:14:00+02:00,2025-05-25,17:14,4,6,10
8,2025-05-25T09:17:00+02:00,2025-05-25,17:17,2,2,4
8,2025-05-25T09:20:00+02:00,2025-05-25,17:20,5,2,7
8,2025-05-25T09:24:00+02:00,2025-05-25,17:24,5,2,7
28,2025-05-25T09:15:00+02:00,2025-05-25,17:15,7,6,13
28,2025-05-25T09:16:00+02:00,2025-05-25,17:16,10,7,17
28,2025-05-25T09:18:00+02:00,2025-05-25,17:18,11,9,20
28,2025-05-25T09:20:00+02:00,2025-05-25,17:20,4,2,6
28,2025-05-25T09:21:00+02:00,2025-05-25,17:21,7,6,13
28,2025-05-25T09:24:00+02:00,2025-05-25,17:24,3,8,11
29,2025-05-25T09:11:00+02:00,2025-05-25,17:11,19,6,25
29,2025-05-25T09:14:00+02:00,2025-05-25,17:14,9,16,25
29,2025-05-25T09:15:00+02:00,2025-05-25,17:15,13,4,17
29,2025-05-25T09:17:00+02:00,2025-05-25,17:17,6,3,9
29,2025-05-25T09:18:00+02:00,2025-05-25,17:18,10,6,16
29,2025-05-25T09:21:00+02:00,2025-05-25,17:21,10,0,10
29,2025-05-25T09:22:00+02:00,2025-05-25,17:22,7,5,12
29,2025-05-25T09:23:00+02:00,2025-05-25,17:23,11,5,16
31,2025-05-25T09:10:00+02:00,2025-05-25,17:10,10,1,11
31,2025-05-25T09:12:00+02:00,2025-05-25,17:12,1,2,3
31,2025-05-25T09:16:00+02:00,2025-05-25,17:16,0,8,8
31,2025-05-25T09:19:00+02:00,2025-05-25,17:19,1,0,1
31,2025-05-25T09:20:00+02:00,2025-05-25,17:20,3,2,5
31,2025-05-25T09:21:00+02:00,2025-05-25,17:21,1,7,8
31,2025-05-25T09:23:00+02:00,2025-05-25,17:23,3,6,9
36,2025-05-25T09:13:00+02:00,2025-05-25,17:13,3,0,3
36,2025-05-25T09:17:00+02:00,2025-05-25,17:17,3,2,5
36,2025-05-25T09:19:00+02:00,2025-05-25,17:19,2,0,2
36,2025-05-25T09:23:00+02:00,2025-05-25,17:23,2,4,6
36,2025-05-25T09:24:00+02:00,2025-05-25,17:24,3,1,4
39,2025-05-25T09:22:00+02:00,2025-05-25,17:22,2,0,2
40,2025-05-25T09:10:00+02:00,2025-05-25,17:10,1,4,5
40,2025-05-25T09:11:00+02:00,2025-05-25,17:11,2,5,7
40,2025-05-25T09:21:00+02:00,2025-05-25,17:21,0,4,4
40,2025-05-25T09:23:00+02:00,2025-05-25,17:23,1,4,5
41,2025-05-25T09:14:00+02:00,2025-05-25,17:14,9,15,24
41,2025-05-25T09:15:00+02:00,2025-05-25,17:15,1,7,8
41,2025-05-25T09:19:00+02:00,2025-05-25,17:19,14,8,22
41,2025-05-25T09:22:00+02:00,2025-05-25,17:22,4,8,12
41,2025-05-25T09:23:00+02:00,2025-05-25,17:23,18,3,21
43,2025-05-25T09:15:00+02:00,2025-05-25,17:15,4,5,9
44,2025-05-25T09:10:00+02:00,2025-05-25,17:10,1,8,9
44,2025-05-25T09:15:00+02:00,2025-05-25,17:15,4,8,12
45,2025-05-25T09:10:00+02:00,2025-05-25,17:10,25,6,31
45,2025-05-25T09:11:00+02:00,2025-05-25,17:11,36,19,55
45,2025-05-25T09:12:00+02:00,2025-05-25,17:12,17,28,45
45,2025-05-25T09:16:00+02:00,2025-05-25,17:16,32,14,46
45,2025-05-25T09:23:00+02:00,2025-05-25,17:23,8,15,23
45,2025-05-25T09:24:00+02:00,2025-05-25,17:24,18,17,35
47,2025-05-25T09:10:00+02:00,2025-05-25,17:10,18,24,42
47,2025-05-25T09:12:00+02:00,2025-05-25,17:12,19,6,25
47,2025-05-25T09:14:00+02:00,2025-05-25,17:14,14,10,24
47,2025-05-25T09:17:00+02:00,2025-05-25,17:17,21,21,42
50,2025-05-25T09:23:00+02:00,2025-05-25,17:23,10,0,10
54,2025-05-25T09:16:00+02:00,2025-05-25,17:16,3,12,15
54,2025-05-25T09:17:00+02:00,2025-05-25,17:17,3,1,4
54,2025-05-25T09:19:00+02:00,2025-05-25,17:19,2,3,5
54,2025-05-25T09:22:00+02:00,2025-05-25,17:22,3,2,5
54,2025-05-25T09:23:00+02:00,2025-05-25,17:23,0,3,3
59,2025-05-25T09:20:00+02:00,2025-05-25,17:20,24,35,59
61,2025-05-25T09:12:00+02:00,2025-05-25,17:12,8,10,18
61,2025-05-25T09:14:00+02:00,2025-05-25,17:14,8,13,21
61,2025-05-25T09:16:00+02:00,2025-05-25,17:16,8,6,14
61,2025-05-25T09:19:00+02:00,2025-05-25,17:19,14,9,23
61,2025-05-25T09:20:00+02:00,2025-05-25,17:20,3,11,14
61,2025-05-25T09:24:00+02:00,2025-05-25,17:24,7,7,14
66,2025-05-25T09:11:00+02:00,2025-05-25,17:11,28,19,47
66,2025-05-25T09:15:00+02:00,2025-05-25,17:15,24,22,46
66,2025-05-25T09:16:00+02:00,2025-05-25,17:16,15,22,37
66,2025-05-25T09:23:00+02:00,2025-05-25,17:23,20,9,29
69,2025-05-25T09:10:00+02:00,2025-05-25,17:10,1,5,6
69,2025-05-25T09:12:00+02:00,2025-05-25,17:12,4,0,4
69,2025-05-25T09:13:00+02:00,2025-05-25,17:13,3,0,3
69,2025-05-25T09:19:00+02:00,2025-05-25,17:19,1,0,1
69,2025-05-25T09:22:00+02:00,2025-05-25,17:22,0,2,2
69,2025-05-25T09:24:00+02:00,2025-05-25,17:24,0,1,1
70,2025-05-25T09:12:00+02:00,2025-05-25,17:12,4,0,4
70,2025-05-25T09:14:00+02:00,2025-05-25,17:14,1,1,2
70,2025-05-25T09:15:00+02:00,2025-05-25,17:15,1,1,2
70,2025-05-25T09:18:00+02:00,2025-05-25,17:18,1,4,5
70,2025-05-25T09:19:00+02:00,2025-05-25,17:19,1,1,2
70,2025-05-25T09:20:00+02:00,2025-05-25,17:20,0,2,2
70,2025-05-25T09:21:00+02:00,2025-05-25,17:21,1,2,3
70,2025-05-25T09:22:00+02:00,2025-05-25,17:22,3,2,5
70,2025-05-25T09:23:00+02:00,2025-05-25,17:23,2,1,3
71,2025-05-25T09:15:00+02:00,2025-05-25,17:15,0,1,1
75,2025-05-25T09:12:00+02:00,2025-05-25,17:12,1,0,1
75,2025-05-25T09:14:00+02:00,2025-05-25,17:14,1,0,1
75,2025-05-25T09:18:00+02:00,2025-05-25,17:18,1,1,2
77,2025-05-25T09:10:00+02:00,2025-05-25,17:10,38,14,52
78,2025-05-25T09:14:00+02:00,2025-05-25,17:14,1,1,2
84,2025-05-25T09:15:00+02:00,2025-05-25,17:15,104,102,206
87,2025-05-25T09:18:00+02:00,2025-05-25,17:18,0,1,1
87,2025-05-25T09:22:00+02:00,2025-05-25,17:22,2,2,4
107,2025-05-25T09:10:00+02:00,2025-05-25,17:10,9,14,23
107,2025-05-25T09:20:00+02:00,2025-05-25,17:20,4,11,15
108,2025-05-25T09:13:00+02:00,2025-05-25,17:13,0,1,1
108,2025-05-25T09:15:00+02:00,2025-05-25,17:15,5,2,7
108,2025-05-25T09:17:00+02:00,2025-05-25,17:17,0,4,4
108,2025-05-25T09:21:00+02:00,2025-05-25,17:21,3,3,6
108,2025-05-25T09:22:00+02:00,2025-05-25,17:22,6,2,8
118,2025-05-25T09:15:00+02:00,2025-05-25,17:15,6,6,12
124,2025-05-25T09:15:00+02:00,2025-05-25,17:15,1,0,1
124,2025-05-25T09:20:00+02:00,2025-05-25,17:20,1,0,1
131,2025-05-25T09:20:00+02:00,2025-05-25,17:20,10,2,12
132,2025-05-25T09:15:00+02:00,2025-05-25,17:15,25,3,28
133,2025-05-25T09:10:00+02:00,2025-05-25,17:10,38,33,71
134,2025-05-25T09:15:00+02:00,2025-05-25,17:15,33,34,67
134,2025-05-25T09:20:00+02:00,2025-05-25,17:20,18,19,37
135,2025-05-25T09:20:00+02:00,2025-05-25,17:20,20,33,53
140,2025-05-25T09:10:00+02:00,2025-05-25,17:10,5,7,12
140,2025-05-25T09:15:00+02:00,2025-05-25,17:15,9,11,20
162,2025-05-25T09:15:00+02:00,2025-05-25,17:15,21,15,36
165,2025-05-25T09:15:00+02:00,2025-05-25,17:15,1,9,10
165,2025-05-25T09:20:00+02:00,2025-05-25,17:20,9,4,13
166,2025-05-25T09:10:00+02:00,2025-05-25,17:10,4,4,8
179,2025-05-25T09:10:00+02:00,2025-05-25,17:10,4,6,10
1,2025-05-25T09:10:00+02:00,2025-05-25,17:10,28,28,56
1,2025-05-25T09:14:00+02:00,2025-05-25,17:14,17,14,31
1,2025-05-25T09:15:00+02:00,2025-05-25,17:15,22,12,34
1,2025-05-25T09:16:00+02:00,2025-05-25,17:16,19,13,32
1,2025-05-25T09:21:00+02:00,2025-05-25,17:21,21,13,34
1,2025-05-25T09:24:00+02:00,2025-05-25,17:24,16,16,32
2,2025-05-25T09:10:00+02:00,2025-05-25,17:10,11,7,18
2,2025-05-25T09:12:00+02:00,2025-05-25,17:12,4,4,8
2,2025-05-25T09:14:00+02:00,2025-05-25,17:14,5,4,9
2,2025-05-25T09:16:00+02:00,2025-05-25,17:16,7,7,14
2,2025-05-25T09:18:00+02:00,2025-05-25,17:18,15,10,25
2,2025-05-25T09:19:00+02:00,2025-05-25,17:19,4,11,15
2,2025-05-25T09:21:00+02:00,2025-05-25,17:21,12,4,16
9,2025-05-25T09:11:00+02:00,2025-05-25,17:11,0,2,2
9,2025-05-25T09:13:00+02:00,2025-05-25,17:13,1,0,1
10,2025-05-25T09:14:00+02:00,2025-05-25,17:14,4,0,4
10,2025-05-25T09:18:00+02:00,2025-05-25,17:18,0,1,1
10,2025-05-25T09:24:00+02:00,2025-05-25,17:24,1,1,2
12,2025-05-25T09:10:00+02:00,2025-05-25,17:10,5,1,6
12,2025-05-25T09:12:00+02:00,2025-05-25,17:12,2,3,5
12,2025-05-25T09:16:00+02:00,2025-05-25,17:16,4,9,13
12,2025-05-25T09:18:00+02:00,2025-05-25,17:18,2,2,4
12,2025-05-25T09:19:00+02:00,2025-05-25,17:19,5,4,9
12,2025-05-25T09:23:00+02:00,2025-05-25,17:23,4,1,5
17,2025-05-25T09:11:00+02:00,2025-05-25,17:11,0,2,2
17,2025-05-25T09:18:00+02:00,2025-05-25,17:18,1,3,4
17,2025-05-25T09:19:00+02:00,2025-05-25,17:19,0,2,2
17,2025-05-25T09:22:00+02:00,2025-05-25,17:22,3,0,3
18,2025-05-25T09:11:00+02:00,2025-05-25,17:11,0,3,3
18,2025-05-25T09:13:00+02:00,2025-05-25,17:13,1,0,1
18,2025-05-25T09:15:00+02:00,2025-05-25,17:15,0,2,2
18,2025-05-25T09:19:00+02:00,2025-05-25,17:19,1,0,1
18,2025-05-25T09:21:00+02:00,2025-05-25,17:21,0,2,2
18,2025-05-25T09:24:00+02:00,2025-05-25,17:24,1,1,2
19,2025-05-25T09:10:00+02:00,2025-05-25,17:10,3,7,10
19,2025-05-25T09:16:00+02:00,2025-05-25,17:16,15,6,21
19,2025-05-25T09:21:00+02:00,2025-05-25,17:21,14,9,23
20,2025-05-25T09:10:00+02:00,2025-05-25,17:10,5,1,6
20,2025-05-25T09:15:00+02:00,2025-05-25,17:15,1,0,1
20,2025-05-25T09:17:00+02:00,2025-05-25,17:17,16,0,16
20,2025-05-25T09:20:00+02:00,2025-05-25,17:20,9,7,16
20,2025-05-25T09:21:00+02:00,2025-05-25,17:21,0,8,8
20,2025-05-25T09:23:00+02:00,2025-05-25,17:23,2,4,6
23,2025-05-25T09:11:00+02:00,2025-05-25,17:11,1,4,5
23,2025-05-25T09:13:00+02:00,2025-05-25,17:13,1,2,3
23,2025-05-25T09:17:00+02:00,2025-05-25,17:17,3,2,5
24,2025-05-25T09:12:00+02:00,2025-05-25,17:12,5,4,9
24,2025-05-25T09:14:00+02:00,2025-05-25,17:14,16,1,17
24,2025-05-25T09:17:00+02:00,2025-05-25,17:17,4,13,17
24,2025-05-25T09:18:00+02:00,2025-05-25,17:18,3,7,10
24,2025-05-25T09:19:00+02:00,2025-05-25,17:19,11,1,12
25,2025-05-25T09:10:00+02:00,2025-05-25,17:10,84,23,107
25,2025-05-25T09:20:00+02:00,2025-05-25,17:20,64,22,86
27,2025-05-25T09:14:00+02:00,2025-05-25,17:14,1,1,2
27,2025-05-25T09:15:00+02:00,2025-05-25,17:15,1,0,1
27,2025-05-25T09:17:00+02:00,2025-05-25,17:17,1,0,1
27,2025-05-25T09:18:00+02:00,2025-05-25,17:18,0,4,4
27,2025-05-25T09:21:00+02:00,2025-05-25,17:21,1,2,3
27,2025-05-25T09:22:00+02:00,2025-05-25,17:22,0,2,2
27,2025-05-25T09:23:00+02:00,2025-05-25,17:23,2,3,5
30,2025-05-25T09:14:00+02:00,2025-05-25,17:14,4,17,21
30,2025-05-25T09:15:00+02:00,2025-05-25,17:15,4,5,9
30,2025-05-25T09:18:00+02:00,2025-05-25,17:18,3,5,8
30,2025-05-25T09:19:00+02:00,2025-05-25,17:19,11,7,18
30,2025-05-25T09:21:00+02:00,2025-05-25,17:21,3,8,11
30,2025-05-25T09:24:00+02:00,2025-05-25,17:24,1,13,14
35,2025-05-25T09:11:00+02:00,2025-05-25,17:11,18,28,46
35,2025-05-25T09:13:00+02:00,2025-05-25,17:13,11,21,32
35,2025-05-25T09:16:00+02:00,2025-05-25,17:16,24,34,58
35,2025-05-25T09:22:00+02:00,2025-05-25,17:22,16,18,34
35,2025-05-25T09:24:00+02:00,2025-05-25,17:24,18,47,65
46,2025-05-25T09:10:00+02:00,2025-05-25,17:10,4,8,12
48,2025-05-25T09:11:00+02:00,2025-05-25,17:11,2,1,3
48,2025-05-25T09:14:00+02:00,2025-05-25,17:14,0,1,1
48,2025-05-25T09:15:00+02:00,2025-05-25,17:15,1,0,1
48,2025-05-25T09:17:00+02:00,2025-05-25,17:17,0,2,2
48,2025-05-25T09:18:00+02:00,2025-05-25,17:18,8,2,10
48,2025-05-25T09:24:00+02:00,2025-05-25,17:24,1,3,4
49,2025-05-25T09:13:00+02:00,2025-05-25,17:13,5,4,9
49,2025-05-25T09:15:00+02:00,2025-05-25,17:15,1,0,1
49,2025-05-25T09:20:00+02:00,2025-05-25,17:20,4,13,17
49,2025-05-25T09:22:00+02:00,2025-05-25,17:22,7,0,7
49,2025-05-25T09:24:00+02:00,2025-05-25,17:24,5,3,8
51,2025-05-25T09:13:00+02:00,2025-05-25,17:13,1,2,3
51,2025-05-25T09:17:00+02:00,2025-05-25,17:17,2,2,4
51,2025-05-25T09:21:00+02:00,2025-05-25,17:21,0,2,2
52,2025-05-25T09:11:00+02:00,2025-05-25,17:11,13,5,18
52,2025-05-25T09:16:00+02:00,2025-05-25,17:16,4,7,11
52,2025-05-25T09:18:00+02:00,2025-05-25,17:18,5,10,15
52,2025-05-25T09:21:00+02:00,2025-05-25,17:21,3,7,10
52,2025-05-25T09:22:00+02:00,2025-05-25,17:22,4,6,10
52,2025-05-25T09:24:00+02:00,2025-05-25,17:24,5,11,16
53,2025-05-25T09:10:00+02:00,2025-05-25,17:10,8,5,13
53,2025-05-25T09:13:00+02:00,2025-05-25,17:13,9,1,10
53,2025-05-25T09:14:00+02:00,2025-05-25,17:14,7,7,14
56,2025-05-25T09:10:00+02:00,2025-05-25,17:10,2,5,7
56,2025-05-25T09:16:00+02:00,2025-05-25,17:16,18,0,18
56,2025-05-25T09:17:00+02:00,2025-05-25,17:17,11,7,18
56,2025-05-25T09:18:00+02:00,2025-05-25,17:18,7,8,15
56,2025-05-25T09:19:00+02:00,2025-05-25,17:19,3,5,8
56,2025-05-25T09:20:00+02:00,2025-05-25,17:20,10,3,13
56,2025-05-25T09:23:00+02:00,2025-05-25,17:23,4,11,15
58,2025-05-25T09:10:00+02:00,2025-05-25,17:10,8,7,15
58,2025-05-25T09:13:00+02:00,2025-05-25,17:13,2,8,10
58,2025-05-25T09:18:00+02:00,2025-05-25,17:18,3,7,10
58,2025-05-25T09:21:00+02:00,2025-05-25,17:21,14,3,17
58,2025-05-25T09:22:00+02:00,2025-05-25,17:22,8,2,10
62,2025-05-25T09:17:00+02:00,2025-05-25,17:17,8,4,12
62,2025-05-25T09:20:00+02:00,2025-05-25,17:20,1,0,1
63,2025-05-25T09:11:00+02:00,2025-05-25,17:11,12,7,19
63,2025-05-25T09:12:00+02:00,2025-05-25,17:12,6,1,7
63,2025-05-25T09:13:00+02:00,2025-05-25,17:13,6,5,11
63,2025-05-25T09:16:00+02:00,2025-05-25,17:16,4,4,8
63,2025-05-25T09:22:00+02:00,2025-05-25,17:22,0,11,11
63,2025-05-25T09:23:00+02:00,2025-05-25,17:23,2,2,4
67,2025-05-25T09:10:00+02:00,2025-05-25,17:10,5,7,12
67,2025-05-25T09:11:00+02:00,2025-05-25,17:11,7,5,12
67,2025-05-25T09:13:00+02:00,2025-05-25,17:13,3,2,5
67,2025-05-25T09:14:00+02:00,2025-05-25,17:14,0,8,8
67,2025-05-25T09:16:00+02:00,2025-05-25,17:16,8,7,15
67,2025-05-25T09:17:00+02:00,2025-05-25,17:17,4,4,8
67,2025-05-25T09:21:00+02:00,2025-05-25,17:21,4,6,10
67,2025-05-25T09:22:00+02:00,2025-05-25,17:22,3,18,21
68,2025-05-25T09:10:00+02:00,2025-05-25,17:10,4,3,7
68,2025-05-25T09:11:00+02:00,2025-05-25,17:11,5,5,10
68,2025-05-25T09:17:00+02:00,2025-05-25,17:17,3,4,7
68,2025-05-25T09:18:00+02:00,2025-05-25,17:18,2,2,4
68,2025-05-25T09:19:00+02:00,2025-05-25,17:19,1,1,2
68,2025-05-25T09:20:00+02:00,2025-05-25,17:20,1,2,3
72,2025-05-25T09:11:00+02:00,2025-05-25,17:11,2,5,7
72,2025-05-25T09:13:00+02:00,2025-05-25,17:13,6,13,19
72,2025-05-25T09:16:00+02:00,2025-05-25,17:16,1,3,4
72,2025-05-25T09:17:00+02:00,2025-05-25,17:17,2,6,8
72,2025-05-25T09:23:00+02:00,2025-05-25,17:23,2,11,13
72,2025-05-25T09:24:00+02:00,2025-05-25,17:24,5,6,11
76,2025-05-25T09:11:00+02:00,2025-05-25,17:11,0,1,1
76,2025-05-25T09:16:00+02:00,2025-05-25,17:16,1,0,1
79,2025-05-25T09:10:00+02:00,2025-05-25,17:10,13,7,20
79,2025-05-25T09:11:00+02:00,2025-05-25,17:11,7,14,21
79,2025-05-25T09:12:00+02:00,2025-05-25,17:12,9,9,18
79,2025-05-25T09:16:00+02:00,2025-05-25,17:16,5,7,12
85,2025-05-25T09:12:00+02:00,2025-05-25,17:12,0,3,3
85,2025-05-25T09:17:00+02:00,2025-05-25,17:17,2,1,3
85,2025-05-25T09:18:00+02:00,2025-05-25,17:18,0,1,1
85,2025-05-25T09:20:00+02:00,2025-05-25,17:20,2,2,4
85,2025-05-25T09:22:00+02:00,2025-05-25,17:22,1,1,2
86,2025-05-25T09:13:00+02:00,2025-05-25,17:13,0,1,1
86,2025-05-25T09:17:00+02:00,2025-05-25,17:17,1,0,1
86,2025-05-25T09:18:00+02:00,2025-05-25,17:18,0,4,4
86,2025-05-25T09:23:00+02:00,2025-05-25,17:23,2,0,2
109,2025-05-25T09:20:00+02:00,2025-05-25,17:20,8,8,16
117,2025-05-25T09:10:00+02:00,2025-05-25,17:10,19,26,45
117,2025-05-25T09:20:00+02:00,2025-05-25,17:20,18,15,33
123,2025-05-25T09:15:00+02:00,2025-05-25,17:15,9,4,13
130,2025-05-25T09:10:00+02:00,2025-05-25,17:10,1,5,6
130,2025-05-25T09:15:00+02:00,2025-05-25,17:15,1,0,1
136,2025-05-25T09:15:00+02:00,2025-05-25,17:15,15,10,25
137,2025-05-25T09:10:00+02:00,2025-05-25,17:10,0,1,1
137,2025-05-25T09:15:00+02:00,2025-05-25,17:15,2,2,4
138,2025-05-25T09:15:00+02:00,2025-05-25,17:15,0,2,2
139,2025-05-25T09:10:00+02:00,2025-05-25,17:10,7,2,9
141,2025-05-25T09:10:00+02:00,2025-05-25,17:10,17,3,20
141,2025-05-25T09:15:00+02:00,2025-05-25,17:15,24,8,32
181,2025-05-25T09:13:00+02:00,2025-05-25,17:13,13,17,30
181,2025-05-25T09:14:00+02:00,2025-05-25,17:14,9,16,25
181,2025-05-25T09:20:00+02:00,2025-05-25,17:20,14,16,30
182,2025-05-25T09:15:00+02:00,2025-05-25,17:15,16,16,32
180,2025-05-25T09:12:00+02:00,2025-05-25,17:12,0,3,3
180,2025-05-25T09:15:00+02:00,2025-05-25,17:15,1,1,2
180,2025-05-25T09:22:00+02:00,2025-05-25,17:22,1,0,1
3,2025-05-25T09:25:00+02:00,2025-05-25,17:25,9,34,43
3,2025-05-25T09:30:00+02:00,2025-05-25,17:30,8,20,28
3,2025-05-25T09:39:00+02:00,2025-05-25,17:39,11,24,35
4,2025-05-25T09:25:00+02:00,2025-05-25,17:25,34,23,57
4,2025-05-25T09:30:00+02:00,2025-05-25,17:30,19,35,54
4,2025-05-25T09:31:00+02:00,2025-05-25,17:31,18,21,39
4,2025-05-25T09:34:00+02:00,2025-05-25,17:34,20,18,38
4,2025-05-25T09:37:00+02:00,2025-05-25,17:37,24,19,43
5,2025-05-25T09:35:00+02:00,2025-05-25,17:35,75,75,150
6,2025-05-25T09:26:00+02:00,2025-05-25,17:26,7,10,17
6,2025-05-25T09:29:00+02:00,2025-05-25,17:29,3,23,26
6,2025-05-25T09:33:00+02:00,2025-05-25,17:33,26,5,31
6,2025-05-25T09:38:00+02:00,2025-05-25,17:38,15,2,17
6,2025-05-25T09:39:00+02:00,2025-05-25,17:39,9,16,25
8,2025-05-25T09:26:00+02:00,2025-05-25,17:26,2,2,4
8,2025-05-25T09:27:00+02:00,2025-05-25,17:27,1,1,2
8,2025-05-25T09:28:00+02:00,2025-05-25,17:28,2,2,4
8,2025-05-25T09:29:00+02:00,2025-05-25,17:29,4,3,7
28,2025-05-25T09:25:00+02:00,2025-05-25,17:25,3,8,11
28,2025-05-25T09:29:00+02:00,2025-05-25,17:29,5,5,10
28,2025-05-25T09:34:00+02:00,2025-05-25,17:34,11,4,15
28,2025-05-25T09:36:00+02:00,2025-05-25,17:36,3,11,14
28,2025-05-25T09:39:00+02:00,2025-05-25,17:39,5,8,13
29,2025-05-25T09:29:00+02:00,2025-05-25,17:29,6,14,20
29,2025-05-25T09:30:00+02:00,2025-05-25,17:30,9,10,19
29,2025-05-25T09:33:00+02:00,2025-05-25,17:33,9,9,18
29,2025-05-25T09:37:00+02:00,2025-05-25,17:37,10,4,14
31,2025-05-25T09:25:00+02:00,2025-05-25,17:25,3,3,6
31,2025-05-25T09:29:00+02:00,2025-05-25,17:29,3,4,7
31,2025-05-25T09:30:00+02:00,2025-05-25,17:30,3,2,5
31,2025-05-25T09:31:00+02:00,2025-05-25,17:31,4,2,6
31,2025-05-25T09:32:00+02:00,2025-05-25,17:32,1,4,5
31,2025-05-25T09:37:00+02:00,2025-05-25,17:37,1,3,4
36,2025-05-25T09:27:00+02:00,2025-05-25,17:27,1,0,1
39,2025-05-25T09:35:00+02:00,2025-05-25,17:35,1,0,1
40,2025-05-25T09:27:00+02:00,2025-05-25,17:27,0,8,8
40,2025-05-25T09:28:00+02:00,2025-05-25,17:28,1,13,14
40,2025-05-25T09:29:00+02:00,2025-05-25,17:29,0,3,3
40,2025-05-25T09:32:00+02:00,2025-05-25,17:32,3,3,6
40,2025-05-25T09:35:00+02:00,2025-05-25,17:35,0,9,9
40,2025-05-25T09:36:00+02:00,2025-05-25,17:36,2,0,2
40,2025-05-25T09:39:00+02:00,2025-05-25,17:39,0,2,2
41,2025-05-25T09:26:00+02:00,2025-05-25,17:26,1,4,5
41,2025-05-25T09:29:00+02:00,2025-05-25,17:29,6,3,9
41,2025-05-25T09:30:00+02:00,2025-05-25,17:30,10,7,17
41,2025-05-25T09:37:00+02:00,2025-05-25,17:37,10,2,12
43,2025-05-25T09:35:00+02:00,2025-05-25,17:35,3,9,12
44,2025-05-25T09:25:00+02:00,2025-05-25,17:25,0,4,4
44,2025-05-25T09:30:00+02:00,2025-05-25,17:30,7,0,7
44,2025-05-25T09:35:00+02:00,2025-05-25,17:35,6,6,12
45,2025-05-25T09:28:00+02:00,2025-05-25,17:28,15,8,23
45,2025-05-25T09:29:00+02:00,2025-05-25,17:29,16,12,28
45,2025-05-25T09:30:00+02:00,2025-05-25,17:30,20,9,29
45,2025-05-25T09:31:00+02:00,2025-05-25,17:31,12,18,30
45,2025-05-25T09:32:00+02:00,2025-05-25,17:32,8,14,22
45,2025-05-25T09:33:00+02:00,2025-05-25,17:33,21,9,30
45,2025-05-25T09:35:00+02:00,2025-05-25,17:35,12,14,26
47,2025-05-25T09:25:00+02:00,2025-05-25,17:25,20,28,48
47,2025-05-25T09:26:00+02:00,2025-05-25,17:26,14,16,30
47,2025-05-25T09:28:00+02:00,2025-05-25,17:28,22,7,29
47,2025-05-25T09:29:00+02:00,2025-05-25,17:29,22,14,36
47,2025-05-25T09:38:00+02:00,2025-05-25,17:38,8,8,16
47,2025-05-25T09:39:00+02:00,2025-05-25,17:39,15,5,20
50,2025-05-25T09:25:00+02:00,2025-05-25,17:25,1,2,3
50,2025-05-25T09:27:00+02:00,2025-05-25,17:27,5,2,7
50,2025-05-25T09:29:00+02:00,2025-05-25,17:29,1,5,6
50,2025-05-25T09:30:00+02:00,2025-05-25,17:30,1,4,5
50,2025-05-25T09:34:00+02:00,2025-05-25,17:34,2,1,3
50,2025-05-25T09:38:00+02:00,2025-05-25,17:38,1,1,2
54,2025-05-25T09:26:00+02:00,2025-05-25,17:26,14,0,14
54,2025-05-25T09:32:00+02:00,2025-05-25,17:32,2,0,2
54,2025-05-25T09:33:00+02:00,2025-05-25,17:33,1,1,2
54,2025-05-25T09:34:00+02:00,2025-05-25,17:34,0,6,6
59,2025-05-25T09:25:00+02:00,2025-05-25,17:25,20,16,36
61,2025-05-25T09:34:00+02:00,2025-05-25,17:34,7,6,13
61,2025-05-25T09:36:00+02:00,2025-05-25,17:36,6,9,15
61,2025-05-25T09:38:00+02:00,2025-05-25,17:38,3,8,11
66,2025-05-25T09:31:00+02:00,2025-05-25,17:31,20,40,60
66,2025-05-25T09:35:00+02:00,2025-05-25,17:35,21,22,43
66,2025-05-25T09:36:00+02:00,2025-05-25,17:36,12,28,40
69,2025-05-25T09:25:00+02:00,2025-05-25,17:25,4,1,5
69,2025-05-25T09:27:00+02:00,2025-05-25,17:27,4,1,5
69,2025-05-25T09:28:00+02:00,2025-05-25,17:28,1,0,1
69,2025-05-25T09:33:00+02:00,2025-05-25,17:33,0,3,3
69,2025-05-25T09:35:00+02:00,2025-05-25,17:35,10,0,10
69,2025-05-25T09:38:00+02:00,2025-05-25,17:38,1,0,1
70,2025-05-25T09:27:00+02:00,2025-05-25,17:27,8,3,11
70,2025-05-25T09:28:00+02:00,2025-05-25,17:28,2,1,3
70,2025-05-25T09:29:00+02:00,2025-05-25,17:29,3,10,13
70,2025-05-25T09:33:00+02:00,2025-05-25,17:33,7,1,8
70,2025-05-25T09:34:00+02:00,2025-05-25,17:34,3,3,6
70,2025-05-25T09:36:00+02:00,2025-05-25,17:36,2,3,5
70,2025-05-25T09:38:00+02:00,2025-05-25,17:38,2,6,8
71,2025-05-25T09:25:00+02:00,2025-05-25,17:25,0,1,1
75,2025-05-25T09:30:00+02:00,2025-05-25,17:30,0,2,2
75,2025-05-25T09:36:00+02:00,2025-05-25,17:36,0,2,2
77,2025-05-25T09:25:00+02:00,2025-05-25,17:25,11,6,17
77,2025-05-25T09:30:00+02:00,2025-05-25,17:30,7,14,21
77,2025-05-25T09:35:00+02:00,2025-05-25,17:35,14,10,24
78,2025-05-25T09:29:00+02:00,2025-05-25,17:29,0,1,1
78,2025-05-25T09:32:00+02:00,2025-05-25,17:32,0,1,1
84,2025-05-25T09:35:00+02:00,2025-05-25,17:35,67,81,148
87,2025-05-25T09:26:00+02:00,2025-05-25,17:26,0,1,1
87,2025-05-25T09:28:00+02:00,2025-05-25,17:28,3,0,3
87,2025-05-25T09:29:00+02:00,2025-05-25,17:29,0,2,2
87,2025-05-25T09:31:00+02:00,2025-05-25,17:31,2,0,2
87,2025-05-25T09:33:00+02:00,2025-05-25,17:33,1,4,5
107,2025-05-25T09:25:00+02:00,2025-05-25,17:25,5,10,15
107,2025-05-25T09:30:00+02:00,2025-05-25,17:30,1,15,16
108,2025-05-25T09:28:00+02:00,2025-05-25,17:28,1,3,4
108,2025-05-25T09:34:00+02:00,2025-05-25,17:34,4,1,5
118,2025-05-25T09:35:00+02:00,2025-05-25,17:35,2,0,2
131,2025-05-25T09:30:00+02:00,2025-05-25,17:30,2,12,14
135,2025-05-25T09:25:00+02:00,2025-05-25,17:25,19,35,54
140,2025-05-25T09:25:00+02:00,2025-05-25,17:25,2,1,3
162,2025-05-25T09:30:00+02:00,2025-05-25,17:30,19,19,38
166,2025-05-25T09:25:00+02:00,2025-05-25,17:25,12,9,21
167,2025-05-25T09:25:00+02:00,2025-05-25,17:25,5,8,13
167,2025-05-25T09:30:00+02:00,2025-05-25,17:30,4,3,7
179,2025-05-25T09:30:00+02:00,2025-05-25,17:30,7,6,13
179,2025-05-25T09:35:00+02:00,2025-05-25,17:35,6,5,11
1,2025-05-25T09:25:00+02:00,2025-05-25,17:25,20,13,33
1,2025-05-25T09:29:00+02:00,2025-05-25,17:29,22,4,26
1,2025-05-25T09:32:00+02:00,2025-05-25,17:32,10,16,26
1,2025-05-25T09:36:00+02:00,2025-05-25,17:36,9,23,32
1,2025-05-25T09:38:00+02:00,2025-05-25,17:38,24,2,26
2,2025-05-25T09:29:00+02:00,2025-05-25,17:29,8,6,14
9,2025-05-25T09:26:00+02:00,2025-05-25,17:26,0,4,4
9,2025-05-25T09:29:00+02:00,2025-05-25,17:29,3,4,7
9,2025-05-25T09:35:00+02:00,2025-05-25,17:35,2,0,2
9,2025-05-25T09:36:00+02:00,2025-05-25,17:36,0,2,2
9,2025-05-25T09:38:00+02:00,2025-05-25,17:38,0,2,2
9,2025-05-25T09:39:00+02:00,2025-05-25,17:39,7,0,7
10,2025-05-25T09:27:00+02:00,2025-05-25,17:27,1,0,1
10,2025-05-25T09:29:00+02:00,2025-05-25,17:29,2,3,5
10,2025-05-25T09:34:00+02:00,2025-05-25,17:34,1,0,1
10,2025-05-25T09:37:00+02:00,2025-05-25,17:37,0,1,1
11,2025-05-25T09:30:00+02:00,2025-05-25,17:30,7,3,10
12,2025-05-25T09:28:00+02:00,2025-05-25,17:28,1,0,1
12,2025-05-25T09:33:00+02:00,2025-05-25,17:33,6,4,10
17,2025-05-25T09:25:00+02:00,2025-05-25,17:25,2,2,4
17,2025-05-25T09:26:00+02:00,2025-05-25,17:26,4,4,8
17,2025-05-25T09:31:00+02:00,2025-05-25,17:31,1,3,4
17,2025-05-25T09:34:00+02:00,2025-05-25,17:34,1,0,1
17,2025-05-25T09:36:00+02:00,2025-05-25,17:36,6,4,10
17,2025-05-25T09:39:00+02:00,2025-05-25,17:39,2,0,2
18,2025-05-25T09:30:00+02:00,2025-05-25,17:30,2,0,2
18,2025-05-25T09:32:00+02:00,2025-05-25,17:32,0,1,1
19,2025-05-25T09:28:00+02:00,2025-05-25,17:28,8,14,22
19,2025-05-25T09:30:00+02:00,2025-05-25,17:30,29,13,42
19,2025-05-25T09:34:00+02:00,2025-05-25,17:34,3,3,6
19,2025-05-25T09:39:00+02:00,2025-05-25,17:39,17,6,23
20,2025-05-25T09:28:00+02:00,2025-05-25,17:28,8,4,12
20,2025-05-25T09:35:00+02:00,2025-05-25,17:35,1,4,5
20,2025-05-25T09:39:00+02:00,2025-05-25,17:39,9,6,15
23,2025-05-25T09:27:00+02:00,2025-05-25,17:27,0,1,1
23,2025-05-25T09:31:00+02:00,2025-05-25,17:31,2,5,7
23,2025-05-25T09:34:00+02:00,2025-05-25,17:34,4,2,6
23,2025-05-25T09:36:00+02:00,2025-05-25,17:36,0,2,2
24,2025-05-25T09:26:00+02:00,2025-05-25,17:26,3,38,41
24,2025-05-25T09:33:00+02:00,2025-05-25,17:33,16,4,20
24,2025-05-25T09:36:00+02:00,2025-05-25,17:36,9,13,22
24,2025-05-25T09:37:00+02:00,2025-05-25,17:37,4,6,10
25,2025-05-25T09:35:00+02:00,2025-05-25,17:35,75,17,92
27,2025-05-25T09:25:00+02:00,2025-05-25,17:25,0,5,5
27,2025-05-25T09:26:00+02:00,2025-05-25,17:26,2,3,5
27,2025-05-25T09:28:00+02:00,2025-05-25,17:28,4,3,7
27,2025-05-25T09:30:00+02:00,2025-05-25,17:30,4,5,9
27,2025-05-25T09:35:00+02:00,2025-05-25,17:35,0,5,5
27,2025-05-25T09:38:00+02:00,2025-05-25,17:38,1,0,1
30,2025-05-25T09:30:00+02:00,2025-05-25,17:30,5,2,7
30,2025-05-25T09:39:00+02:00,2025-05-25,17:39,5,8,13
35,2025-05-25T09:25:00+02:00,2025-05-25,17:25,19,27,46
35,2025-05-25T09:29:00+02:00,2025-05-25,17:29,20,17,37
35,2025-05-25T09:39:00+02:00,2025-05-25,17:39,18,8,26
48,2025-05-25T09:30:00+02:00,2025-05-25,17:30,3,3,6
48,2025-05-25T09:32:00+02:00,2025-05-25,17:32,1,6,7
48,2025-05-25T09:35:00+02:00,2025-05-25,17:35,0,1,1
48,2025-05-25T09:36:00+02:00,2025-05-25,17:36,1,0,1
48,2025-05-25T09:39:00+02:00,2025-05-25,17:39,0,3,3
49,2025-05-25T09:26:00+02:00,2025-05-25,17:26,1,5,6
49,2025-05-25T09:34:00+02:00,2025-05-25,17:34,3,5,8
49,2025-05-25T09:38:00+02:00,2025-05-25,17:38,10,2,12
51,2025-05-25T09:25:00+02:00,2025-05-25,17:25,1,0,1
51,2025-05-25T09:29:00+02:00,2025-05-25,17:29,2,1,3
51,2025-05-25T09:32:00+02:00,2025-05-25,17:32,2,1,3
51,2025-05-25T09:35:00+02:00,2025-05-25,17:35,0,7,7
51,2025-05-25T09:38:00+02:00,2025-05-25,17:38,0,3,3
52,2025-05-25T09:26:00+02:00,2025-05-25,17:26,11,6,17
52,2025-05-25T09:27:00+02:00,2025-05-25,17:27,13,3,16
52,2025-05-25T09:29:00+02:00,2025-05-25,17:29,5,10,15
52,2025-05-25T09:30:00+02:00,2025-05-25,17:30,8,10,18
52,2025-05-25T09:31:00+02:00,2025-05-25,17:31,6,12,18
52,2025-05-25T09:34:00+02:00,2025-05-25,17:34,11,8,19
52,2025-05-25T09:37:00+02:00,2025-05-25,17:37,2,3,5
53,2025-05-25T09:25:00+02:00,2025-05-25,17:25,6,1,7
53,2025-05-25T09:28:00+02:00,2025-05-25,17:28,0,2,2
53,2025-05-25T09:30:00+02:00,2025-05-25,17:30,12,2,14
53,2025-05-25T09:31:00+02:00,2025-05-25,17:31,6,5,11
53,2025-05-25T09:32:00+02:00,2025-05-25,17:32,3,2,5
56,2025-05-25T09:27:00+02:00,2025-05-25,17:27,7,11,18
56,2025-05-25T09:31:00+02:00,2025-05-25,17:31,4,4,8
56,2025-05-25T09:32:00+02:00,2025-05-25,17:32,1,4,5
56,2025-05-25T09:34:00+02:00,2025-05-25,17:34,6,2,8
56,2025-05-25T09:39:00+02:00,2025-05-25,17:39,12,7,19
58,2025-05-25T09:25:00+02:00,2025-05-25,17:25,13,1,14
58,2025-05-25T09:31:00+02:00,2025-05-25,17:31,10,10,20
58,2025-05-25T09:32:00+02:00,2025-05-25,17:32,10,2,12
58,2025-05-25T09:33:00+02:00,2025-05-25,17:33,7,2,9
58,2025-05-25T09:36:00+02:00,2025-05-25,17:36,7,1,8
58,2025-05-25T09:38:00+02:00,2025-05-25,17:38,10,1,11
62,2025-05-25T09:27:00+02:00,2025-05-25,17:27,2,1,3
62,2025-05-25T09:28:00+02:00,2025-05-25,17:28,2,1,3
62,2025-05-25T09:30:00+02:00,2025-05-25,17:30,4,4,8
62,2025-05-25T09:36:00+02:00,2025-05-25,17:36,1,4,5
63,2025-05-25T09:25:00+02:00,2025-05-25,17:25,0,4,4
63,2025-05-25T09:27:00+02:00,2025-05-25,17:27,0,2,2
63,2025-05-25T09:28:00+02:00,2025-05-25,17:28,0,1,1
63,2025-05-25T09:30:00+02:00,2025-05-25,17:30,9,5,14
63,2025-05-25T09:31:00+02:00,2025-05-25,17:31,10,5,15
63,2025-05-25T09:32:00+02:00,2025-05-25,17:32,3,3,6
63,2025-05-25T09:35:00+02:00,2025-05-25,17:35,2,10,12
63,2025-05-25T09:36:00+02:00,2025-05-25,17:36,5,7,12
63,2025-05-25T09:38:00+02:00,2025-05-25,17:38,4,4,8
63,2025-05-25T09:39:00+02:00,2025-05-25,17:39,7,6,13
67,2025-05-25T09:26:00+02:00,2025-05-25,17:26,4,8,12
67,2025-05-25T09:27:00+02:00,2025-05-25,17:27,8,7,15
67,2025-05-25T09:29:00+02:00,2025-05-25,17:29,7,0,7
67,2025-05-25T09:30:00+02:00,2025-05-25,17:30,2,3,5
67,2025-05-25T09:31:00+02:00,2025-05-25,17:31,6,11,17
67,2025-05-25T09:35:00+02:00,2025-05-25,17:35,3,8,11
67,2025-05-25T09:37:00+02:00,2025-05-25,17:37,8,3,11
67,2025-05-25T09:38:00+02:00,2025-05-25,17:38,5,5,10
68,2025-05-25T09:25:00+02:00,2025-05-25,17:25,4,4,8
68,2025-05-25T09:27:00+02:00,2025-05-25,17:27,1,0,1
68,2025-05-25T09:32:00+02:00,2025-05-25,17:32,4,2,6
68,2025-05-25T09:34:00+02:00,2025-05-25,17:34,3,1,4
72,2025-05-25T09:28:00+02:00,2025-05-25,17:28,6,14,20
72,2025-05-25T09:32:00+02:00,2025-05-25,17:32,1,5,6
72,2025-05-25T09:35:00+02:00,2025-05-25,17:35,6,4,10
76,2025-05-25T09:36:00+02:00,2025-05-25,17:36,0,2,2
76,2025-05-25T09:39:00+02:00,2025-05-25,17:39,1,0,1
79,2025-05-25T09:25:00+02:00,2025-05-25,17:25,1,17,18
79,2025-05-25T09:29:00+02:00,2025-05-25,17:29,8,3,11
79,2025-05-25T09:30:00+02:00,2025-05-25,17:30,4,4,8
79,2025-05-25T09:36:00+02:00,2025-05-25,17:36,9,1,10
85,2025-05-25T09:30:00+02:00,2025-05-25,17:30,1,4,5
85,2025-05-25T09:31:00+02:00,2025-05-25,17:31,0,2,2
85,2025-05-25T09:32:00+02:00,2025-05-25,17:32,1,1,2
85,2025-05-25T09:35:00+02:00,2025-05-25,17:35,1,0,1
86,2025-05-25T09:37:00+02:00,2025-05-25,17:37,0,2,2
109,2025-05-25T09:30:00+02:00,2025-05-25,17:30,5,12,17
123,2025-05-25T09:30:00+02:00,2025-05-25,17:30,4,3,7
136,2025-05-25T09:25:00+02:00,2025-05-25,17:25,22,10,32
137,2025-05-25T09:25:00+02:00,2025-05-25,17:25,2,0,2
137,2025-05-25T09:35:00+02:00,2025-05-25,17:35,1,0,1
139,2025-05-25T09:35:00+02:00,2025-05-25,17:35,4,0,4
141,2025-05-25T09:30:00+02:00,2025-05-25,17:30,7,16,23
142,2025-05-25T09:30:00+02:00,2025-05-25,17:30,35,41,76
164,2025-05-25T09:30:00+02:00,2025-05-25,17:30,9,1,10
181,2025-05-25T09:29:00+02:00,2025-05-25,17:29,12,17,29
181,2025-05-25T09:30:00+02:00,2025-05-25,17:30,19,11,30
181,2025-05-25T09:31:00+02:00,2025-05-25,17:31,28,17,45
181,2025-05-25T09:32:00+02:00,2025-05-25,17:32,22,11,33
181,2025-05-25T09:33:00+02:00,2025-05-25,17:33,6,20,26
181,2025-05-25T09:34:00+02:00,2025-05-25,17:34,26,16,42
182,2025-05-25T09:30:00+02:00,2025-05-25,17:30,21,14,35
182,2025-05-25T09:35:00+02:00,2025-05-25,17:35,15,16,31
180,2025-05-25T09:26:00+02:00,2025-05-25,17:26,0,1,1
180,2025-05-25T09:36:00+02:00,2025-05-25,17:36,1,0,1
180,2025-05-25T09:37:00+02:00,2025-05-25,17:37,1,0,1
180,2025-05-25T09:38:00+02:00,2025-05-25,17:38,1,0,1
180,2025-05-25T09:39:00+02:00,2025-05-25,17:39,1,0,1
3,2025-05-25T09:43:00+02:00,2025-05-25,17:43,10,22,32
3,2025-05-25T09:50:00+02:00,2025-05-25,17:50,12,20,32
3,2025-05-25T09:51:00+02:00,2025-05-25,17:51,6,28,34
4,2025-05-25T09:44:00+02:00,2025-05-25,17:44,20,20,40
4,2025-05-25T09:45:00+02:00,2025-05-25,17:45,17,27,44
4,2025-05-25T09:49:00+02:00,2025-05-25,17:49,36,23,59
4,2025-05-25T09:51:00+02:00,2025-05-25,17:51,16,34,50
4,2025-05-25T09:54:00+02:00,2025-05-25,17:54,43,30,73
5,2025-05-25T09:45:00+02:00,2025-05-25,17:45,74,71,145
6,2025-05-25T09:44:00+02:00,2025-05-25,17:44,6,7,13
6,2025-05-25T09:46:00+02:00,2025-05-25,17:46,1,21,22
6,2025-05-25T09:48:00+02:00,2025-05-25,17:48,23,20,43
6,2025-05-25T09:49:00+02:00,2025-05-25,17:49,9,11,20
6,2025-05-25T09:50:00+02:00,2025-05-25,17:50,13,7,20
6,2025-05-25T09:51:00+02:00,2025-05-25,17:51,16,5,21
6,2025-05-25T09:52:00+02:00,2025-05-25,17:52,14,16,30
6,2025-05-25T09:53:00+02:00,2025-05-25,17:53,7,4,11
6,2025-05-25T09:54:00+02:00,2025-05-25,17:54,9,4,13
8,2025-05-25T09:40:00+02:00,2025-05-25,17:40,4,1,5
8,2025-05-25T09:43:00+02:00,2025-05-25,17:43,0,1,1
28,2025-05-25T09:40:00+02:00,2025-05-25,17:40,4,1,5
28,2025-05-25T09:41:00+02:00,2025-05-25,17:41,3,7,10
28,2025-05-25T09:46:00+02:00,2025-05-25,17:46,2,7,9
28,2025-05-25T09:51:00+02:00,2025-05-25,17:51,7,4,11
29,2025-05-25T09:42:00+02:00,2025-05-25,17:42,4,3,7
29,2025-05-25T09:46:00+02:00,2025-05-25,17:46,9,4,13
29,2025-05-25T09:47:00+02:00,2025-05-25,17:47,8,8,16
29,2025-05-25T09:53:00+02:00,2025-05-25,17:53,9,4,13
29,2025-05-25T09:54:00+02:00,2025-05-25,17:54,2,6,8
31,2025-05-25T09:42:00+02:00,2025-05-25,17:42,4,1,5
31,2025-05-25T09:47:00+02:00,2025-05-25,17:47,3,1,4
39,2025-05-25T09:40:00+02:00,2025-05-25,17:40,0,1,1
40,2025-05-25T09:45:00+02:00,2025-05-25,17:45,2,7,9
40,2025-05-25T09:46:00+02:00,2025-05-25,17:46,2,3,5
40,2025-05-25T09:54:00+02:00,2025-05-25,17:54,4,2,6
41,2025-05-25T09:40:00+02:00,2025-05-25,17:40,18,9,27
41,2025-05-25T09:49:00+02:00,2025-05-25,17:49,7,3,10
41,2025-05-25T09:51:00+02:00,2025-05-25,17:51,19,9,28
41,2025-05-25T09:54:00+02:00,2025-05-25,17:54,20,5,25
43,2025-05-25T09:50:00+02:00,2025-05-25,17:50,0,4,4
45,2025-05-25T09:40:00+02:00,2025-05-25,17:40,15,11,26
45,2025-05-25T09:41:00+02:00,2025-05-25,17:41,13,22,35
45,2025-05-25T09:43:00+02:00,2025-05-25,17:43,20,17,37
45,2025-05-25T09:46:00+02:00,2025-05-25,17:46,19,19,38
45,2025-05-25T09:47:00+02:00,2025-05-25,17:47,36,22,58
45,2025-05-25T09:49:00+02:00,2025-05-25,17:49,16,17,33
45,2025-05-25T09:50:00+02:00,2025-05-25,17:50,9,9,18
45,2025-05-25T09:51:00+02:00,2025-05-25,17:51,12,46,58
45,2025-05-25T09:52:00+02:00,2025-05-25,17:52,25,28,53
45,2025-05-25T09:54:00+02:00,2025-05-25,17:54,15,17,32
47,2025-05-25T09:42:00+02:00,2025-05-25,17:42,13,6,19
47,2025-05-25T09:45:00+02:00,2025-05-25,17:45,15,7,22
47,2025-05-25T09:48:00+02:00,2025-05-25,17:48,21,9,30
50,2025-05-25T09:41:00+02:00,2025-05-25,17:41,3,4,7
50,2025-05-25T09:42:00+02:00,2025-05-25,17:42,5,2,7
50,2025-05-25T09:43:00+02:00,2025-05-25,17:43,3,4,7
50,2025-05-25T09:44:00+02:00,2025-05-25,17:44,2,9,11
50,2025-05-25T09:47:00+02:00,2025-05-25,17:47,2,1,3
50,2025-05-25T09:49:00+02:00,2025-05-25,17:49,5,5,10
50,2025-05-25T09:52:00+02:00,2025-05-25,17:52,5,4,9
54,2025-05-25T09:44:00+02:00,2025-05-25,17:44,0,1,1
54,2025-05-25T09:52:00+02:00,2025-05-25,17:52,1,1,2
54,2025-05-25T09:53:00+02:00,2025-05-25,17:53,1,5,6
54,2025-05-25T09:54:00+02:00,2025-05-25,17:54,1,0,1
61,2025-05-25T09:40:00+02:00,2025-05-25,17:40,5,7,12
61,2025-05-25T09:45:00+02:00,2025-05-25,17:45,9,6,15
61,2025-05-25T09:51:00+02:00,2025-05-25,17:51,2,5,7
61,2025-05-25T09:54:00+02:00,2025-05-25,17:54,7,6,13
66,2025-05-25T09:40:00+02:00,2025-05-25,17:40,22,28,50
66,2025-05-25T09:41:00+02:00,2025-05-25,17:41,19,12,31
66,2025-05-25T09:45:00+02:00,2025-05-25,17:45,21,26,47
66,2025-05-25T09:48:00+02:00,2025-05-25,17:48,30,24,54
69,2025-05-25T09:40:00+02:00,2025-05-25,17:40,0,2,2
69,2025-05-25T09:41:00+02:00,2025-05-25,17:41,9,1,10
69,2025-05-25T09:45:00+02:00,2025-05-25,17:45,1,0,1
69,2025-05-25T09:49:00+02:00,2025-05-25,17:49,5,0,5
69,2025-05-25T09:54:00+02:00,2025-05-25,17:54,1,0,1
70,2025-05-25T09:40:00+02:00,2025-05-25,17:40,3,6,9
70,2025-05-25T09:43:00+02:00,2025-05-25,17:43,1,4,5
70,2025-05-25T09:45:00+02:00,2025-05-25,17:45,4,3,7
70,2025-05-25T09:47:00+02:00,2025-05-25,17:47,1,0,1
70,2025-05-25T09:48:00+02:00,2025-05-25,17:48,2,2,4
70,2025-05-25T09:50:00+02:00,2025-05-25,17:50,3,1,4
70,2025-05-25T09:52:00+02:00,2025-05-25,17:52,2,0,2
70,2025-05-25T09:53:00+02:00,2025-05-25,17:53,0,1,1
70,2025-05-25T09:54:00+02:00,2025-05-25,17:54,3,0,3
71,2025-05-25T09:49:00+02:00,2025-05-25,17:49,1,0,1
71,2025-05-25T09:50:00+02:00,2025-05-25,17:50,3,0,3
71,2025-05-25T09:51:00+02:00,2025-05-25,17:51,0,1,1
75,2025-05-25T09:42:00+02:00,2025-05-25,17:42,2,1,3
75,2025-05-25T09:43:00+02:00,2025-05-25,17:43,0,1,1
75,2025-05-25T09:45:00+02:00,2025-05-25,17:45,1,0,1
75,2025-05-25T09:46:00+02:00,2025-05-25,17:46,2,2,4
78,2025-05-25T09:50:00+02:00,2025-05-25,17:50,0,1,1
78,2025-05-25T09:53:00+02:00,2025-05-25,17:53,0,1,1
84,2025-05-25T09:45:00+02:00,2025-05-25,17:45,71,81,152
84,2025-05-25T09:50:00+02:00,2025-05-25,17:50,70,88,158
87,2025-05-25T09:46:00+02:00,2025-05-25,17:46,0,2,2
87,2025-05-25T09:49:00+02:00,2025-05-25,17:49,0,3,3
87,2025-05-25T09:51:00+02:00,2025-05-25,17:51,0,2,2
87,2025-05-25T09:52:00+02:00,2025-05-25,17:52,1,0,1
108,2025-05-25T09:44:00+02:00,2025-05-25,17:44,1,4,5
108,2025-05-25T09:45:00+02:00,2025-05-25,17:45,2,2,4
108,2025-05-25T09:51:00+02:00,2025-05-25,17:51,2,3,5
118,2025-05-25T09:40:00+02:00,2025-05-25,17:40,0,2,2
118,2025-05-25T09:45:00+02:00,2025-05-25,17:45,2,7,9
131,2025-05-25T09:40:00+02:00,2025-05-25,17:40,11,5,16
131,2025-05-25T09:45:00+02:00,2025-05-25,17:45,6,1,7
135,2025-05-25T09:45:00+02:00,2025-05-25,17:45,8,28,36
135,2025-05-25T09:50:00+02:00,2025-05-25,17:50,23,26,49
162,2025-05-25T09:50:00+02:00,2025-05-25,17:50,25,16,41
165,2025-05-25T09:50:00+02:00,2025-05-25,17:50,1,1,2
167,2025-05-25T09:40:00+02:00,2025-05-25,17:40,3,6,9
179,2025-05-25T09:40:00+02:00,2025-05-25,17:40,11,3,14
179,2025-05-25T09:45:00+02:00,2025-05-25,17:45,7,10,17
1,2025-05-25T09:44:00+02:00,2025-05-25,17:44,19,10,29
1,2025-05-25T09:47:00+02:00,2025-05-25,17:47,14,11,25
1,2025-05-25T09:49:00+02:00,2025-05-25,17:49,30,4,34
1,2025-05-25T09:52:00+02:00,2025-05-25,17:52,17,15,32
2,2025-05-25T09:45:00+02:00,2025-05-25,17:45,8,3,11
2,2025-05-25T09:46:00+02:00,2025-05-25,17:46,6,2,8
2,2025-05-25T09:51:00+02:00,2025-05-25,17:51,4,4,8
9,2025-05-25T09:43:00+02:00,2025-05-25,17:43,1,2,3
9,2025-05-25T09:46:00+02:00,2025-05-25,17:46,2,0,2
9,2025-05-25T09:52:00+02:00,2025-05-25,17:52,1,0,1
9,2025-05-25T09:53:00+02:00,2025-05-25,17:53,0,1,1
9,2025-05-25T09:54:00+02:00,2025-05-25,17:54,1,0,1
10,2025-05-25T09:40:00+02:00,2025-05-25,17:40,2,0,2
10,2025-05-25T09:42:00+02:00,2025-05-25,17:42,0,3,3
10,2025-05-25T09:50:00+02:00,2025-05-25,17:50,4,0,4
11,2025-05-25T09:40:00+02:00,2025-05-25,17:40,11,4,15
11,2025-05-25T09:45:00+02:00,2025-05-25,17:45,1,3,4
11,2025-05-25T09:50:00+02:00,2025-05-25,17:50,15,2,17
12,2025-05-25T09:40:00+02:00,2025-05-25,17:40,5,5,10
12,2025-05-25T09:43:00+02:00,2025-05-25,17:43,2,1,3
12,2025-05-25T09:44:00+02:00,2025-05-25,17:44,6,4,10
12,2025-05-25T09:51:00+02:00,2025-05-25,17:51,2,0,2
12,2025-05-25T09:52:00+02:00,2025-05-25,17:52,8,4,12
17,2025-05-25T09:40:00+02:00,2025-05-25,17:40,2,4,6
17,2025-05-25T09:47:00+02:00,2025-05-25,17:47,4,2,6
17,2025-05-25T09:50:00+02:00,2025-05-25,17:50,0,6,6
17,2025-05-25T09:52:00+02:00,2025-05-25,17:52,0,3,3
18,2025-05-25T09:42:00+02:00,2025-05-25,17:42,0,1,1
18,2025-05-25T09:49:00+02:00,2025-05-25,17:49,0,1,1
18,2025-05-25T09:50:00+02:00,2025-05-25,17:50,0,2,2
19,2025-05-25T09:40:00+02:00,2025-05-25,17:40,14,17,31
19,2025-05-25T09:47:00+02:00,2025-05-25,17:47,5,18,23
19,2025-05-25T09:51:00+02:00,2025-05-25,17:51,3,16,19
20,2025-05-25T09:41:00+02:00,2025-05-25,17:41,1,20,21
20,2025-05-25T09:46:00+02:00,2025-05-25,17:46,8,7,15
20,2025-05-25T09:48:00+02:00,2025-05-25,17:48,3,6,9
20,2025-05-25T09:49:00+02:00,2025-05-25,17:49,6,7,13
20,2025-05-25T09:53:00+02:00,2025-05-25,17:53,0,7,7
23,2025-05-25T09:41:00+02:00,2025-05-25,17:41,1,6,7
23,2025-05-25T09:44:00+02:00,2025-05-25,17:44,6,5,11
23,2025-05-25T09:49:00+02:00,2025-05-25,17:49,4,0,4
24,2025-05-25T09:46:00+02:00,2025-05-25,17:46,3,8,11
24,2025-05-25T09:49:00+02:00,2025-05-25,17:49,3,3,6
24,2025-05-25T09:50:00+02:00,2025-05-25,17:50,9,3,12
24,2025-05-25T09:51:00+02:00,2025-05-25,17:51,8,36,44
24,2025-05-25T09:53:00+02:00,2025-05-25,17:53,10,20,30
25,2025-05-25T09:50:00+02:00,2025-05-25,17:50,82,18,100
27,2025-05-25T09:43:00+02:00,2025-05-25,17:43,1,1,2
27,2025-05-25T09:47:00+02:00,2025-05-25,17:47,0,1,1
27,2025-05-25T09:49:00+02:00,2025-05-25,17:49,1,6,7
27,2025-05-25T09:50:00+02:00,2025-05-25,17:50,4,2,6
30,2025-05-25T09:45:00+02:00,2025-05-25,17:45,3,18,21
30,2025-05-25T09:47:00+02:00,2025-05-25,17:47,6,8,14
30,2025-05-25T09:50:00+02:00,2025-05-25,17:50,6,10,16
30,2025-05-25T09:53:00+02:00,2025-05-25,17:53,9,17,26
30,2025-05-25T09:54:00+02:00,2025-05-25,17:54,6,6,12
35,2025-05-25T09:42:00+02:00,2025-05-25,17:42,15,21,36
35,2025-05-25T09:43:00+02:00,2025-05-25,17:43,20,9,29
35,2025-05-25T09:51:00+02:00,2025-05-25,17:51,17,9,26
35,2025-05-25T09:53:00+02:00,2025-05-25,17:53,12,4,16
48,2025-05-25T09:40:00+02:00,2025-05-25,17:40,3,3,6
48,2025-05-25T09:44:00+02:00,2025-05-25,17:44,3,3,6
48,2025-05-25T09:47:00+02:00,2025-05-25,17:47,2,10,12
48,2025-05-25T09:48:00+02:00,2025-05-25,17:48,1,1,2
48,2025-05-25T09:51:00+02:00,2025-05-25,17:51,3,7,10
48,2025-05-25T09:52:00+02:00,2025-05-25,17:52,8,1,9
49,2025-05-25T09:40:00+02:00,2025-05-25,17:40,8,8,16
49,2025-05-25T09:41:00+02:00,2025-05-25,17:41,3,3,6
49,2025-05-25T09:42:00+02:00,2025-05-25,17:42,0,1,1
49,2025-05-25T09:47:00+02:00,2025-05-25,17:47,2,4,6
51,2025-05-25T09:40:00+02:00,2025-05-25,17:40,1,4,5
51,2025-05-25T09:42:00+02:00,2025-05-25,17:42,1,0,1
51,2025-05-25T09:43:00+02:00,2025-05-25,17:43,0,4,4
51,2025-05-25T09:48:00+02:00,2025-05-25,17:48,5,2,7
51,2025-05-25T09:52:00+02:00,2025-05-25,17:52,1,2,3
52,2025-05-25T09:40:00+02:00,2025-05-25,17:40,8,4,12
52,2025-05-25T09:45:00+02:00,2025-05-25,17:45,4,10,14
52,2025-05-25T09:46:00+02:00,2025-05-25,17:46,9,6,15
52,2025-05-25T09:51:00+02:00,2025-05-25,17:51,5,10,15
52,2025-05-25T09:52:00+02:00,2025-05-25,17:52,4,2,6
52,2025-05-25T09:53:00+02:00,2025-05-25,17:53,0,5,5
52,2025-05-25T09:54:00+02:00,2025-05-25,17:54,3,19,22
53,2025-05-25T09:40:00+02:00,2025-05-25,17:40,7,3,10
53,2025-05-25T09:44:00+02:00,2025-05-25,17:44,6,4,10
53,2025-05-25T09:51:00+02:00,2025-05-25,17:51,6,0,6
53,2025-05-25T09:54:00+02:00,2025-05-25,17:54,6,2,8
56,2025-05-25T09:43:00+02:00,2025-05-25,17:43,7,10,17
56,2025-05-25T09:44:00+02:00,2025-05-25,17:44,9,8,17
56,2025-05-25T09:47:00+02:00,2025-05-25,17:47,6,17,23
56,2025-05-25T09:49:00+02:00,2025-05-25,17:49,13,8,21
56,2025-05-25T09:50:00+02:00,2025-05-25,17:50,11,10,21
58,2025-05-25T09:40:00+02:00,2025-05-25,17:40,8,1,9
58,2025-05-25T09:42:00+02:00,2025-05-25,17:42,9,8,17
58,2025-05-25T09:43:00+02:00,2025-05-25,17:43,6,7,13
58,2025-05-25T09:53:00+02:00,2025-05-25,17:53,12,2,14
62,2025-05-25T09:44:00+02:00,2025-05-25,17:44,0,1,1
62,2025-05-25T09:46:00+02:00,2025-05-25,17:46,6,3,9
62,2025-05-25T09:48:00+02:00,2025-05-25,17:48,3,7,10
62,2025-05-25T09:51:00+02:00,2025-05-25,17:51,2,4,6
62,2025-05-25T09:53:00+02:00,2025-05-25,17:53,5,3,8
62,2025-05-25T09:54:00+02:00,2025-05-25,17:54,3,3,6
63,2025-05-25T09:40:00+02:00,2025-05-25,17:40,1,6,7
63,2025-05-25T09:41:00+02:00,2025-05-25,17:41,3,2,5
63,2025-05-25T09:42:00+02:00,2025-05-25,17:42,0,7,7
63,2025-05-25T09:43:00+02:00,2025-05-25,17:43,2,3,5
63,2025-05-25T09:44:00+02:00,2025-05-25,17:44,2,4,6
63,2025-05-25T09:49:00+02:00,2025-05-25,17:49,5,11,16
63,2025-05-25T09:50:00+02:00,2025-05-25,17:50,6,3,9
63,2025-05-25T09:52:00+02:00,2025-05-25,17:52,7,8,15
63,2025-05-25T09:53:00+02:00,2025-05-25,17:53,0,6,6
63,2025-05-25T09:54:00+02:00,2025-05-25,17:54,4,4,8
67,2025-05-25T09:40:00+02:00,2025-05-25,17:40,5,6,11
67,2025-05-25T09:47:00+02:00,2025-05-25,17:47,3,8,11
67,2025-05-25T09:48:00+02:00,2025-05-25,17:48,3,5,8
67,2025-05-25T09:49:00+02:00,2025-05-25,17:49,4,8,12
67,2025-05-25T09:53:00+02:00,2025-05-25,17:53,8,9,17
68,2025-05-25T09:40:00+02:00,2025-05-25,17:40,1,1,2
68,2025-05-25T09:44:00+02:00,2025-05-25,17:44,4,2,6
68,2025-05-25T09:50:00+02:00,2025-05-25,17:50,4,2,6
68,2025-05-25T09:54:00+02:00,2025-05-25,17:54,4,0,4
72,2025-05-25T09:43:00+02:00,2025-05-25,17:43,7,6,13
72,2025-05-25T09:44:00+02:00,2025-05-25,17:44,4,8,12
72,2025-05-25T09:50:00+02:00,2025-05-25,17:50,2,1,3
72,2025-05-25T09:52:00+02:00,2025-05-25,17:52,2,14,16
76,2025-05-25T09:49:00+02:00,2025-05-25,17:49,0,1,1
76,2025-05-25T09:53:00+02:00,2025-05-25,17:53,1,0,1
79,2025-05-25T09:41:00+02:00,2025-05-25,17:41,4,4,8
79,2025-05-25T09:43:00+02:00,2025-05-25,17:43,7,3,10
79,2025-05-25T09:44:00+02:00,2025-05-25,17:44,8,5,13
79,2025-05-25T09:46:00+02:00,2025-05-25,17:46,7,5,12
79,2025-05-25T09:47:00+02:00,2025-05-25,17:47,13,3,16
79,2025-05-25T09:49:00+02:00,2025-05-25,17:49,11,10,21
79,2025-05-25T09:50:00+02:00,2025-05-25,17:50,6,4,10
79,2025-05-25T09:51:00+02:00,2025-05-25,17:51,8,7,15
79,2025-05-25T09:54:00+02:00,2025-05-25,17:54,7,7,14
85,2025-05-25T09:45:00+02:00,2025-05-25,17:45,1,0,1
85,2025-05-25T09:46:00+02:00,2025-05-25,17:46,1,0,1
85,2025-05-25T09:48:00+02:00,2025-05-25,17:48,4,0,4
85,2025-05-25T09:50:00+02:00,2025-05-25,17:50,0,1,1
85,2025-05-25T09:53:00+02:00,2025-05-25,17:53,2,1,3
85,2025-05-25T09:54:00+02:00,2025-05-25,17:54,1,2,3
86,2025-05-25T09:41:00+02:00,2025-05-25,17:41,1,0,1
86,2025-05-25T09:45:00+02:00,2025-05-25,17:45,5,0,5
86,2025-05-25T09:48:00+02:00,2025-05-25,17:48,1,0,1
86,2025-05-25T09:50:00+02:00,2025-05-25,17:50,2,0,2
109,2025-05-25T09:45:00+02:00,2025-05-25,17:45,3,8,11
136,2025-05-25T09:40:00+02:00,2025-05-25,17:40,7,14,21
139,2025-05-25T09:45:00+02:00,2025-05-25,17:45,4,2,6
139,2025-05-25T09:50:00+02:00,2025-05-25,17:50,3,2,5
141,2025-05-25T09:50:00+02:00,2025-05-25,17:50,18,4,22
161,2025-05-25T09:40:00+02:00,2025-05-25,17:40,5,1,6
181,2025-05-25T09:44:00+02:00,2025-05-25,17:44,11,13,24
181,2025-05-25T09:45:00+02:00,2025-05-25,17:45,20,7,27
181,2025-05-25T09:47:00+02:00,2025-05-25,17:47,10,11,21
181,2025-05-25T09:50:00+02:00,2025-05-25,17:50,31,17,48
181,2025-05-25T09:53:00+02:00,2025-05-25,17:53,16,16,32
180,2025-05-25T09:42:00+02:00,2025-05-25,17:42,4,0,4
180,2025-05-25T09:43:00+02:00,2025-05-25,17:43,0,2,2
180,2025-05-25T09:46:00+02:00,2025-05-25,17:46,0,1,1
180,2025-05-25T09:53:00+02:00,2025-05-25,17:53,1,0,1
3,2025-05-25T09:59:00+02:00,2025-05-25,17:59,23,21,44
3,2025-05-25T10:01:00+02:00,2025-05-25,18:01,25,26,51
3,2025-05-25T10:03:00+02:00,2025-05-25,18:03,15,10,25
3,2025-05-25T10:06:00+02:00,2025-05-25,18:06,20,12,32
3,2025-05-25T10:08:00+02:00,2025-05-25,18:08,18,13,31
4,2025-05-25T09:57:00+02:00,2025-05-25,17:57,25,10,35
4,2025-05-25T09:58:00+02:00,2025-05-25,17:58,29,29,58
4,2025-05-25T09:59:00+02:00,2025-05-25,17:59,27,26,53
4,2025-05-25T10:01:00+02:00,2025-05-25,18:01,18,24,42
4,2025-05-25T10:02:00+02:00,2025-05-25,18:02,19,12,31
4,2025-05-25T10:03:00+02:00,2025-05-25,18:03,9,28,37
4,2025-05-25T10:04:00+02:00,2025-05-25,18:04,10,17,27
4,2025-05-25T10:07:00+02:00,2025-05-25,18:07,24,8,32
6,2025-05-25T10:01:00+02:00,2025-05-25,18:01,11,24,35
6,2025-05-25T10:02:00+02:00,2025-05-25,18:02,7,4,11
6,2025-05-25T10:03:00+02:00,2025-05-25,18:03,17,14,31
6,2025-05-25T10:05:00+02:00,2025-05-25,18:05,5,7,12
6,2025-05-25T10:07:00+02:00,2025-05-25,18:07,15,3,18
6,2025-05-25T10:08:00+02:00,2025-05-25,18:08,6,13,19
6,2025-05-25T10:09:00+02:00,2025-05-25,18:09,18,13,31
8,2025-05-25T09:56:00+02:00,2025-05-25,17:56,0,1,1
8,2025-05-25T09:57:00+02:00,2025-05-25,17:57,2,0,2
8,2025-05-25T10:00:00+02:00,2025-05-25,18:00,3,0,3
8,2025-05-25T10:07:00+02:00,2025-05-25,18:07,1,0,1
28,2025-05-25T09:57:00+02:00,2025-05-25,17:57,7,13,20
28,2025-05-25T10:01:00+02:00,2025-05-25,18:01,2,15,17
28,2025-05-25T10:02:00+02:00,2025-05-25,18:02,6,15,21
28,2025-05-25T10:06:00+02:00,2025-05-25,18:06,4,32,36
28,2025-05-25T10:08:00+02:00,2025-05-25,18:08,1,17,18
29,2025-05-25T09:57:00+02:00,2025-05-25,17:57,9,4,13
29,2025-05-25T10:00:00+02:00,2025-05-25,18:00,12,1,13
29,2025-05-25T10:04:00+02:00,2025-05-25,18:04,17,8,25
29,2025-05-25T10:06:00+02:00,2025-05-25,18:06,11,1,12
29,2025-05-25T10:09:00+02:00,2025-05-25,18:09,2,9,11
31,2025-05-25T09:55:00+02:00,2025-05-25,17:55,0,4,4
31,2025-05-25T09:57:00+02:00,2025-05-25,17:57,8,2,10
31,2025-05-25T09:58:00+02:00,2025-05-25,17:58,6,2,8
31,2025-05-25T10:01:00+02:00,2025-05-25,18:01,2,1,3
31,2025-05-25T10:02:00+02:00,2025-05-25,18:02,0,1,1
31,2025-05-25T10:04:00+02:00,2025-05-25,18:04,3,4,7
31,2025-05-25T10:05:00+02:00,2025-05-25,18:05,2,0,2
31,2025-05-25T10:07:00+02:00,2025-05-25,18:07,8,1,9
36,2025-05-25T09:55:00+02:00,2025-05-25,17:55,1,0,1
36,2025-05-25T10:02:00+02:00,2025-05-25,18:02,2,1,3
36,2025-05-25T10:09:00+02:00,2025-05-25,18:09,1,0,1
39,2025-05-25T10:04:00+02:00,2025-05-25,18:04,1,0,1
39,2025-05-25T10:05:00+02:00,2025-05-25,18:05,1,2,3
40,2025-05-25T10:06:00+02:00,2025-05-25,18:06,1,1,2
40,2025-05-25T10:07:00+02:00,2025-05-25,18:07,0,7,7
41,2025-05-25T09:56:00+02:00,2025-05-25,17:56,4,1,5
41,2025-05-25T09:57:00+02:00,2025-05-25,17:57,6,9,15
41,2025-05-25T09:58:00+02:00,2025-05-25,17:58,2,3,5
41,2025-05-25T09:59:00+02:00,2025-05-25,17:59,1,0,1
41,2025-05-25T10:03:00+02:00,2025-05-25,18:03,10,6,16
41,2025-05-25T10:07:00+02:00,2025-05-25,18:07,3,1,4
41,2025-05-25T10:09:00+02:00,2025-05-25,18:09,0,20,20
44,2025-05-25T09:55:00+02:00,2025-05-25,17:55,1,1,2
45,2025-05-25T09:58:00+02:00,2025-05-25,17:58,11,13,24
45,2025-05-25T10:06:00+02:00,2025-05-25,18:06,13,27,40
45,2025-05-25T10:07:00+02:00,2025-05-25,18:07,5,21,26
45,2025-05-25T10:09:00+02:00,2025-05-25,18:09,8,14,22
47,2025-05-25T09:55:00+02:00,2025-05-25,17:55,11,8,19
47,2025-05-25T09:56:00+02:00,2025-05-25,17:56,13,13,26
47,2025-05-25T10:01:00+02:00,2025-05-25,18:01,12,20,32
47,2025-05-25T10:03:00+02:00,2025-05-25,18:03,17,23,40
47,2025-05-25T10:06:00+02:00,2025-05-25,18:06,9,11,20
50,2025-05-25T09:55:00+02:00,2025-05-25,17:55,4,8,12
50,2025-05-25T10:01:00+02:00,2025-05-25,18:01,5,1,6
50,2025-05-25T10:05:00+02:00,2025-05-25,18:05,2,4,6
50,2025-05-25T10:06:00+02:00,2025-05-25,18:06,6,2,8
54,2025-05-25T09:56:00+02:00,2025-05-25,17:56,1,1,2
54,2025-05-25T10:01:00+02:00,2025-05-25,18:01,1,4,5
54,2025-05-25T10:03:00+02:00,2025-05-25,18:03,3,3,6
54,2025-05-25T10:05:00+02:00,2025-05-25,18:05,13,6,19
54,2025-05-25T10:06:00+02:00,2025-05-25,18:06,3,5,8
59,2025-05-25T10:00:00+02:00,2025-05-25,18:00,24,26,50
61,2025-05-25T09:57:00+02:00,2025-05-25,17:57,3,3,6
61,2025-05-25T09:59:00+02:00,2025-05-25,17:59,7,2,9
61,2025-05-25T10:01:00+02:00,2025-05-25,18:01,6,4,10
66,2025-05-25T09:55:00+02:00,2025-05-25,17:55,13,21,34
66,2025-05-25T09:58:00+02:00,2025-05-25,17:58,17,44,61
66,2025-05-25T09:59:00+02:00,2025-05-25,17:59,14,23,37
66,2025-05-25T10:02:00+02:00,2025-05-25,18:02,11,28,39
66,2025-05-25T10:06:00+02:00,2025-05-25,18:06,13,21,34
66,2025-05-25T10:08:00+02:00,2025-05-25,18:08,10,11,21
69,2025-05-25T09:55:00+02:00,2025-05-25,17:55,0,1,1
69,2025-05-25T09:58:00+02:00,2025-05-25,17:58,1,2,3
69,2025-05-25T09:59:00+02:00,2025-05-25,17:59,1,0,1
70,2025-05-25T09:55:00+02:00,2025-05-25,17:55,6,3,9
70,2025-05-25T09:58:00+02:00,2025-05-25,17:58,2,3,5
70,2025-05-25T10:07:00+02:00,2025-05-25,18:07,2,5,7
75,2025-05-25T09:55:00+02:00,2025-05-25,17:55,0,1,1
75,2025-05-25T09:56:00+02:00,2025-05-25,17:56,1,1,2
75,2025-05-25T10:05:00+02:00,2025-05-25,18:05,0,4,4
75,2025-05-25T10:07:00+02:00,2025-05-25,18:07,7,0,7
77,2025-05-25T10:05:00+02:00,2025-05-25,18:05,9,14,23
78,2025-05-25T09:59:00+02:00,2025-05-25,17:59,0,2,2
78,2025-05-25T10:09:00+02:00,2025-05-25,18:09,0,1,1
87,2025-05-25T09:55:00+02:00,2025-05-25,17:55,6,0,6
87,2025-05-25T10:03:00+02:00,2025-05-25,18:03,2,5,7
87,2025-05-25T10:04:00+02:00,2025-05-25,18:04,1,0,1
108,2025-05-25T09:55:00+02:00,2025-05-25,17:55,1,2,3
108,2025-05-25T09:57:00+02:00,2025-05-25,17:57,3,2,5
108,2025-05-25T10:03:00+02:00,2025-05-25,18:03,1,0,1
108,2025-05-25T10:04:00+02:00,2025-05-25,18:04,2,2,4
108,2025-05-25T10:09:00+02:00,2025-05-25,18:09,1,2,3
118,2025-05-25T09:55:00+02:00,2025-05-25,17:55,1,0,1
131,2025-05-25T10:05:00+02:00,2025-05-25,18:05,18,9,27
132,2025-05-25T10:00:00+02:00,2025-05-25,18:00,7,7,14
132,2025-05-25T10:05:00+02:00,2025-05-25,18:05,9,14,23
133,2025-05-25T09:55:00+02:00,2025-05-25,17:55,44,39,83
135,2025-05-25T10:00:00+02:00,2025-05-25,18:00,11,22,33
165,2025-05-25T10:00:00+02:00,2025-05-25,18:00,0,1,1
166,2025-05-25T09:55:00+02:00,2025-05-25,17:55,2,0,2
166,2025-05-25T10:00:00+02:00,2025-05-25,18:00,2,0,2
167,2025-05-25T09:55:00+02:00,2025-05-25,17:55,5,3,8
179,2025-05-25T09:55:00+02:00,2025-05-25,17:55,4,1,5
1,2025-05-25T10:01:00+02:00,2025-05-25,18:01,14,11,25
1,2025-05-25T10:04:00+02:00,2025-05-25,18:04,18,5,23
1,2025-05-25T10:06:00+02:00,2025-05-25,18:06,41,3,44
2,2025-05-25T10:01:00+02:00,2025-05-25,18:01,0,4,4
2,2025-05-25T10:02:00+02:00,2025-05-25,18:02,6,2,8
2,2025-05-25T10:04:00+02:00,2025-05-25,18:04,6,5,11
2,2025-05-25T10:08:00+02:00,2025-05-25,18:08,3,6,9
9,2025-05-25T09:56:00+02:00,2025-05-25,17:56,2,0,2
9,2025-05-25T09:58:00+02:00,2025-05-25,17:58,0,1,1
9,2025-05-25T09:59:00+02:00,2025-05-25,17:59,0,1,1
9,2025-05-25T10:03:00+02:00,2025-05-25,18:03,3,1,4
9,2025-05-25T10:04:00+02:00,2025-05-25,18:04,1,2,3
9,2025-05-25T10:05:00+02:00,2025-05-25,18:05,2,0,2
9,2025-05-25T10:06:00+02:00,2025-05-25,18:06,3,3,6
10,2025-05-25T09:55:00+02:00,2025-05-25,17:55,1,0,1
10,2025-05-25T09:58:00+02:00,2025-05-25,17:58,2,2,4
10,2025-05-25T10:01:00+02:00,2025-05-25,18:01,1,1,2
10,2025-05-25T10:04:00+02:00,2025-05-25,18:04,2,0,2
11,2025-05-25T10:00:00+02:00,2025-05-25,18:00,5,7,12
11,2025-05-25T10:05:00+02:00,2025-05-25,18:05,3,3,6
12,2025-05-25T10:01:00+02:00,2025-05-25,18:01,0,11,11
12,2025-05-25T10:02:00+02:00,2025-05-25,18:02,7,6,13
12,2025-05-25T10:09:00+02:00,2025-05-25,18:09,5,0,5
17,2025-05-25T09:57:00+02:00,2025-05-25,17:57,3,3,6
17,2025-05-25T10:02:00+02:00,2025-05-25,18:02,0,1,1
17,2025-05-25T10:03:00+02:00,2025-05-25,18:03,2,2,4
17,2025-05-25T10:04:00+02:00,2025-05-25,18:04,4,0,4
17,2025-05-25T10:07:00+02:00,2025-05-25,18:07,0,5,5
18,2025-05-25T10:03:00+02:00,2025-05-25,18:03,0,1,1
18,2025-05-25T10:08:00+02:00,2025-05-25,18:08,0,1,1
19,2025-05-25T09:56:00+02:00,2025-05-25,17:56,9,5,14
19,2025-05-25T10:03:00+02:00,2025-05-25,18:03,9,4,13
19,2025-05-25T10:05:00+02:00,2025-05-25,18:05,20,7,27
19,2025-05-25T10:07:00+02:00,2025-05-25,18:07,9,8,17
19,2025-05-25T10:09:00+02:00,2025-05-25,18:09,8,8,16
20,2025-05-25T10:01:00+02:00,2025-05-25,18:01,11,2,13
20,2025-05-25T10:03:00+02:00,2025-05-25,18:03,7,8,15
20,2025-05-25T10:04:00+02:00,2025-05-25,18:04,8,7,15
20,2025-05-25T10:06:00+02:00,2025-05-25,18:06,17,7,24
23,2025-05-25T10:00:00+02:00,2025-05-25,18:00,2,1,3
23,2025-05-25T10:02:00+02:00,2025-05-25,18:02,1,3,4
23,2025-05-25T10:03:00+02:00,2025-05-25,18:03,1,2,3
24,2025-05-25T09:56:00+02:00,2025-05-25,17:56,4,2,6
24,2025-05-25T10:00:00+02:00,2025-05-25,18:00,6,5,11
24,2025-05-25T10:01:00+02:00,2025-05-25,18:01,4,1,5
24,2025-05-25T10:04:00+02:00,2025-05-25,18:04,1,13,14
24,2025-05-25T10:06:00+02:00,2025-05-25,18:06,13,5,18
24,2025-05-25T10:07:00+02:00,2025-05-25,18:07,3,6,9
24,2025-05-25T10:08:00+02:00,2025-05-25,18:08,8,11,19
25,2025-05-25T10:00:00+02:00,2025-05-25,18:00,74,30,104
27,2025-05-25T09:56:00+02:00,2025-05-25,17:56,1,0,1
27,2025-05-25T09:58:00+02:00,2025-05-25,17:58,2,1,3
27,2025-05-25T10:00:00+02:00,2025-05-25,18:00,2,3,5
27,2025-05-25T10:03:00+02:00,2025-05-25,18:03,4,2,6
27,2025-05-25T10:07:00+02:00,2025-05-25,18:07,2,0,2
27,2025-05-25T10:09:00+02:00,2025-05-25,18:09,2,1,3
30,2025-05-25T09:55:00+02:00,2025-05-25,17:55,11,10,21
30,2025-05-25T09:56:00+02:00,2025-05-25,17:56,8,8,16
30,2025-05-25T10:02:00+02:00,2025-05-25,18:02,5,4,9
30,2025-05-25T10:03:00+02:00,2025-05-25,18:03,5,8,13
30,2025-05-25T10:05:00+02:00,2025-05-25,18:05,7,6,13
35,2025-05-25T09:55:00+02:00,2025-05-25,17:55,8,15,23
35,2025-05-25T09:57:00+02:00,2025-05-25,17:57,10,7,17
35,2025-05-25T10:01:00+02:00,2025-05-25,18:01,11,11,22
35,2025-05-25T10:02:00+02:00,2025-05-25,18:02,12,11,23
35,2025-05-25T10:05:00+02:00,2025-05-25,18:05,17,16,33
35,2025-05-25T10:07:00+02:00,2025-05-25,18:07,13,15,28
48,2025-05-25T09:55:00+02:00,2025-05-25,17:55,4,2,6
48,2025-05-25T09:58:00+02:00,2025-05-25,17:58,1,4,5
48,2025-05-25T10:02:00+02:00,2025-05-25,18:02,2,1,3
48,2025-05-25T10:04:00+02:00,2025-05-25,18:04,1,2,3
49,2025-05-25T09:56:00+02:00,2025-05-25,17:56,13,0,13
49,2025-05-25T10:00:00+02:00,2025-05-25,18:00,3,7,10
49,2025-05-25T10:07:00+02:00,2025-05-25,18:07,14,6,20
49,2025-05-25T10:09:00+02:00,2025-05-25,18:09,1,3,4
51,2025-05-25T09:57:00+02:00,2025-05-25,17:57,2,0,2
51,2025-05-25T09:58:00+02:00,2025-05-25,17:58,1,7,8
51,2025-05-25T10:04:00+02:00,2025-05-25,18:04,8,1,9
51,2025-05-25T10:07:00+02:00,2025-05-25,18:07,3,4,7
51,2025-05-25T10:08:00+02:00,2025-05-25,18:08,1,1,2
52,2025-05-25T09:55:00+02:00,2025-05-25,17:55,3,5,8
52,2025-05-25T10:00:00+02:00,2025-05-25,18:00,2,6,8
52,2025-05-25T10:05:00+02:00,2025-05-25,18:05,7,3,10
52,2025-05-25T10:06:00+02:00,2025-05-25,18:06,10,6,16
52,2025-05-25T10:09:00+02:00,2025-05-25,18:09,7,0,7
53,2025-05-25T09:58:00+02:00,2025-05-25,17:58,8,0,8
53,2025-05-25T10:02:00+02:00,2025-05-25,18:02,7,6,13
53,2025-05-25T10:03:00+02:00,2025-05-25,18:03,6,3,9
53,2025-05-25T10:09:00+02:00,2025-05-25,18:09,13,1,14
56,2025-05-25T09:57:00+02:00,2025-05-25,17:57,7,13,20
56,2025-05-25T09:58:00+02:00,2025-05-25,17:58,8,7,15
56,2025-05-25T10:05:00+02:00,2025-05-25,18:05,1,4,5
56,2025-05-25T10:06:00+02:00,2025-05-25,18:06,4,14,18
56,2025-05-25T10:08:00+02:00,2025-05-25,18:08,5,15,20
58,2025-05-25T09:56:00+02:00,2025-05-25,17:56,7,10,17
58,2025-05-25T09:59:00+02:00,2025-05-25,17:59,2,17,19
58,2025-05-25T10:02:00+02:00,2025-05-25,18:02,8,2,10
58,2025-05-25T10:03:00+02:00,2025-05-25,18:03,13,2,15
58,2025-05-25T10:04:00+02:00,2025-05-25,18:04,4,5,9
58,2025-05-25T10:07:00+02:00,2025-05-25,18:07,7,6,13
58,2025-05-25T10:09:00+02:00,2025-05-25,18:09,3,7,10
62,2025-05-25T09:59:00+02:00,2025-05-25,17:59,8,2,10
62,2025-05-25T10:03:00+02:00,2025-05-25,18:03,1,3,4
62,2025-05-25T10:06:00+02:00,2025-05-25,18:06,2,1,3
62,2025-05-25T10:08:00+02:00,2025-05-25,18:08,4,1,5
63,2025-05-25T09:55:00+02:00,2025-05-25,17:55,3,3,6
63,2025-05-25T09:59:00+02:00,2025-05-25,17:59,2,1,3
63,2025-05-25T10:00:00+02:00,2025-05-25,18:00,6,13,19
63,2025-05-25T10:02:00+02:00,2025-05-25,18:02,1,4,5
63,2025-05-25T10:04:00+02:00,2025-05-25,18:04,2,3,5
63,2025-05-25T10:05:00+02:00,2025-05-25,18:05,5,4,9
63,2025-05-25T10:08:00+02:00,2025-05-25,18:08,2,3,5
67,2025-05-25T10:02:00+02:00,2025-05-25,18:02,5,10,15
67,2025-05-25T10:07:00+02:00,2025-05-25,18:07,6,4,10
67,2025-05-25T10:08:00+02:00,2025-05-25,18:08,7,6,13
68,2025-05-25T10:08:00+02:00,2025-05-25,18:08,5,3,8
72,2025-05-25T09:55:00+02:00,2025-05-25,17:55,5,20,25
72,2025-05-25T09:56:00+02:00,2025-05-25,17:56,0,6,6
72,2025-05-25T09:59:00+02:00,2025-05-25,17:59,6,12,18
72,2025-05-25T10:00:00+02:00,2025-05-25,18:00,3,12,15
72,2025-05-25T10:04:00+02:00,2025-05-25,18:04,2,13,15
72,2025-05-25T10:06:00+02:00,2025-05-25,18:06,4,5,9
72,2025-05-25T10:07:00+02:00,2025-05-25,18:07,5,4,9
72,2025-05-25T10:08:00+02:00,2025-05-25,18:08,12,7,19
76,2025-05-25T09:56:00+02:00,2025-05-25,17:56,2,2,4
76,2025-05-25T09:59:00+02:00,2025-05-25,17:59,0,1,1
79,2025-05-25T09:59:00+02:00,2025-05-25,17:59,7,7,14
79,2025-05-25T10:05:00+02:00,2025-05-25,18:05,8,11,19
79,2025-05-25T10:06:00+02:00,2025-05-25,18:06,9,4,13
79,2025-05-25T10:07:00+02:00,2025-05-25,18:07,13,13,26
79,2025-05-25T10:08:00+02:00,2025-05-25,18:08,9,7,16
85,2025-05-25T10:00:00+02:00,2025-05-25,18:00,0,2,2
85,2025-05-25T10:04:00+02:00,2025-05-25,18:04,2,0,2
85,2025-05-25T10:06:00+02:00,2025-05-25,18:06,2,0,2
86,2025-05-25T10:01:00+02:00,2025-05-25,18:01,1,3,4
86,2025-05-25T10:05:00+02:00,2025-05-25,18:05,3,1,4
130,2025-05-25T10:05:00+02:00,2025-05-25,18:05,0,19,19
136,2025-05-25T10:05:00+02:00,2025-05-25,18:05,5,27,32
137,2025-05-25T10:00:00+02:00,2025-05-25,18:00,0,1,1
142,2025-05-25T10:00:00+02:00,2025-05-25,18:00,4,8,12
181,2025-05-25T09:56:00+02:00,2025-05-25,17:56,17,24,41
181,2025-05-25T10:01:00+02:00,2025-05-25,18:01,7,21,28
181,2025-05-25T10:06:00+02:00,2025-05-25,18:06,14,8,22
182,2025-05-25T09:55:00+02:00,2025-05-25,17:55,25,10,35
180,2025-05-25T09:55:00+02:00,2025-05-25,17:55,1,0,1
3,2025-05-25T10:10:00+02:00,2025-05-25,18:10,13,15,28
3,2025-05-25T10:11:00+02:00,2025-05-25,18:11,13,18,31
3,2025-05-25T10:12:00+02:00,2025-05-25,18:12,12,18,30
3,2025-05-25T10:21:00+02:00,2025-05-25,18:21,11,7,18
3,2025-05-25T10:22:00+02:00,2025-05-25,18:22,18,15,33
3,2025-05-25T10:23:00+02:00,2025-05-25,18:23,18,20,38
4,2025-05-25T10:14:00+02:00,2025-05-25,18:14,37,17,54
4,2025-05-25T10:15:00+02:00,2025-05-25,18:15,25,20,45
4,2025-05-25T10:17:00+02:00,2025-05-25,18:17,24,27,51
4,2025-05-25T10:18:00+02:00,2025-05-25,18:18,5,13,18
4,2025-05-25T10:21:00+02:00,2025-05-25,18:21,22,10,32
4,2025-05-25T10:22:00+02:00,2025-05-25,18:22,12,14,26
4,2025-05-25T10:23:00+02:00,2025-05-25,18:23,20,26,46
4,2025-05-25T10:24:00+02:00,2025-05-25,18:24,31,15,46
5,2025-05-25T10:10:00+02:00,2025-05-25,18:10,135,73,208
5,2025-05-25T10:15:00+02:00,2025-05-25,18:15,58,97,155
6,2025-05-25T10:11:00+02:00,2025-05-25,18:11,11,15,26
6,2025-05-25T10:13:00+02:00,2025-05-25,18:13,11,16,27
6,2025-05-25T10:16:00+02:00,2025-05-25,18:16,14,14,28
6,2025-05-25T10:20:00+02:00,2025-05-25,18:20,11,4,15
6,2025-05-25T10:23:00+02:00,2025-05-25,18:23,13,17,30
8,2025-05-25T10:10:00+02:00,2025-05-25,18:10,2,1,3
8,2025-05-25T10:12:00+02:00,2025-05-25,18:12,0,1,1
8,2025-05-25T10:13:00+02:00,2025-05-25,18:13,1,0,1
8,2025-05-25T10:22:00+02:00,2025-05-25,18:22,1,1,2
28,2025-05-25T10:12:00+02:00,2025-05-25,18:12,0,2,2
28,2025-05-25T10:14:00+02:00,2025-05-25,18:14,2,8,10
28,2025-05-25T10:17:00+02:00,2025-05-25,18:17,5,2,7
29,2025-05-25T10:12:00+02:00,2025-05-25,18:12,2,6,8
29,2025-05-25T10:13:00+02:00,2025-05-25,18:13,3,3,6
29,2025-05-25T10:17:00+02:00,2025-05-25,18:17,1,0,1
29,2025-05-25T10:22:00+02:00,2025-05-25,18:22,6,9,15
31,2025-05-25T10:11:00+02:00,2025-05-25,18:11,2,3,5
31,2025-05-25T10:12:00+02:00,2025-05-25,18:12,0,3,3
31,2025-05-25T10:16:00+02:00,2025-05-25,18:16,1,2,3
31,2025-05-25T10:21:00+02:00,2025-05-25,18:21,0,3,3
31,2025-05-25T10:22:00+02:00,2025-05-25,18:22,1,5,6
31,2025-05-25T10:23:00+02:00,2025-05-25,18:23,11,4,15
31,2025-05-25T10:24:00+02:00,2025-05-25,18:24,2,1,3
36,2025-05-25T10:10:00+02:00,2025-05-25,18:10,0,3,3
36,2025-05-25T10:20:00+02:00,2025-05-25,18:20,5,0,5
36,2025-05-25T10:22:00+02:00,2025-05-25,18:22,3,0,3
39,2025-05-25T10:24:00+02:00,2025-05-25,18:24,0,2,2
40,2025-05-25T10:24:00+02:00,2025-05-25,18:24,0,2,2
41,2025-05-25T10:15:00+02:00,2025-05-25,18:15,22,16,38
41,2025-05-25T10:16:00+02:00,2025-05-25,18:16,12,15,27
41,2025-05-25T10:17:00+02:00,2025-05-25,18:17,12,2,14
41,2025-05-25T10:18:00+02:00,2025-05-25,18:18,12,7,19
41,2025-05-25T10:20:00+02:00,2025-05-25,18:20,4,6,10
41,2025-05-25T10:21:00+02:00,2025-05-25,18:21,11,9,20
41,2025-05-25T10:24:00+02:00,2025-05-25,18:24,1,1,2
45,2025-05-25T10:10:00+02:00,2025-05-25,18:10,2,19,21
45,2025-05-25T10:11:00+02:00,2025-05-25,18:11,18,11,29
45,2025-05-25T10:13:00+02:00,2025-05-25,18:13,14,25,39
45,2025-05-25T10:15:00+02:00,2025-05-25,18:15,18,17,35
45,2025-05-25T10:21:00+02:00,2025-05-25,18:21,14,20,34
45,2025-05-25T10:24:00+02:00,2025-05-25,18:24,7,16,23
47,2025-05-25T10:12:00+02:00,2025-05-25,18:12,11,24,35
47,2025-05-25T10:14:00+02:00,2025-05-25,18:14,18,4,22
47,2025-05-25T10:15:00+02:00,2025-05-25,18:15,14,12,26
47,2025-05-25T10:18:00+02:00,2025-05-25,18:18,17,10,27
47,2025-05-25T10:19:00+02:00,2025-05-25,18:19,29,15,44
47,2025-05-25T10:22:00+02:00,2025-05-25,18:22,23,10,33
47,2025-05-25T10:23:00+02:00,2025-05-25,18:23,5,23,28
50,2025-05-25T10:11:00+02:00,2025-05-25,18:11,3,8,11
50,2025-05-25T10:12:00+02:00,2025-05-25,18:12,0,2,2
50,2025-05-25T10:14:00+02:00,2025-05-25,18:14,4,5,9
50,2025-05-25T10:15:00+02:00,2025-05-25,18:15,0,5,5
50,2025-05-25T10:16:00+02:00,2025-05-25,18:16,3,1,4
50,2025-05-25T10:17:00+02:00,2025-05-25,18:17,1,1,2
50,2025-05-25T10:19:00+02:00,2025-05-25,18:19,8,1,9
50,2025-05-25T10:23:00+02:00,2025-05-25,18:23,3,0,3
50,2025-05-25T10:24:00+02:00,2025-05-25,18:24,1,2,3
54,2025-05-25T10:12:00+02:00,2025-05-25,18:12,10,4,14
54,2025-05-25T10:13:00+02:00,2025-05-25,18:13,1,0,1
54,2025-05-25T10:14:00+02:00,2025-05-25,18:14,4,2,6
54,2025-05-25T10:17:00+02:00,2025-05-25,18:17,2,1,3
54,2025-05-25T10:18:00+02:00,2025-05-25,18:18,7,3,10
54,2025-05-25T10:19:00+02:00,2025-05-25,18:19,2,3,5
54,2025-05-25T10:21:00+02:00,2025-05-25,18:21,1,1,2
59,2025-05-25T10:15:00+02:00,2025-05-25,18:15,25,27,52
61,2025-05-25T10:18:00+02:00,2025-05-25,18:18,8,0,8
61,2025-05-25T10:21:00+02:00,2025-05-25,18:21,2,2,4
61,2025-05-25T10:24:00+02:00,2025-05-25,18:24,6,3,9
66,2025-05-25T10:11:00+02:00,2025-05-25,18:11,21,18,39
66,2025-05-25T10:12:00+02:00,2025-05-25,18:12,14,25,39
66,2025-05-25T10:14:00+02:00,2025-05-25,18:14,29,5,34
66,2025-05-25T10:18:00+02:00,2025-05-25,18:18,15,33,48
66,2025-05-25T10:19:00+02:00,2025-05-25,18:19,15,31,46
69,2025-05-25T10:10:00+02:00,2025-05-25,18:10,1,0,1
70,2025-05-25T10:11:00+02:00,2025-05-25,18:11,0,7,7
70,2025-05-25T10:12:00+02:00,2025-05-25,18:12,2,0,2
70,2025-05-25T10:14:00+02:00,2025-05-25,18:14,5,3,8
70,2025-05-25T10:16:00+02:00,2025-05-25,18:16,5,4,9
70,2025-05-25T10:19:00+02:00,2025-05-25,18:19,7,11,18
77,2025-05-25T10:10:00+02:00,2025-05-25,18:10,16,6,22
87,2025-05-25T10:11:00+02:00,2025-05-25,18:11,0,6,6
87,2025-05-25T10:12:00+02:00,2025-05-25,18:12,0,3,3
87,2025-05-25T10:13:00+02:00,2025-05-25,18:13,1,2,3
87,2025-05-25T10:16:00+02:00,2025-05-25,18:16,1,0,1
87,2025-05-25T10:17:00+02:00,2025-05-25,18:17,1,2,3
87,2025-05-25T10:23:00+02:00,2025-05-25,18:23,2,2,4
87,2025-05-25T10:24:00+02:00,2025-05-25,18:24,0,1,1
107,2025-05-25T10:10:00+02:00,2025-05-25,18:10,7,15,22
108,2025-05-25T10:10:00+02:00,2025-05-25,18:10,1,1,2
108,2025-05-25T10:12:00+02:00,2025-05-25,18:12,6,4,10
108,2025-05-25T10:13:00+02:00,2025-05-25,18:13,1,1,2
108,2025-05-25T10:16:00+02:00,2025-05-25,18:16,3,0,3
108,2025-05-25T10:20:00+02:00,2025-05-25,18:20,0,2,2
133,2025-05-25T10:10:00+02:00,2025-05-25,18:10,55,42,97
133,2025-05-25T10:15:00+02:00,2025-05-25,18:15,65,40,105
133,2025-05-25T10:20:00+02:00,2025-05-25,18:20,50,33,83
134,2025-05-25T10:10:00+02:00,2025-05-25,18:10,38,37,75
135,2025-05-25T10:10:00+02:00,2025-05-25,18:10,21,14,35
135,2025-05-25T10:20:00+02:00,2025-05-25,18:20,14,22,36
162,2025-05-25T10:10:00+02:00,2025-05-25,18:10,10,13,23
162,2025-05-25T10:15:00+02:00,2025-05-25,18:15,24,23,47
165,2025-05-25T10:20:00+02:00,2025-05-25,18:20,5,3,8
179,2025-05-25T10:15:00+02:00,2025-05-25,18:15,5,1,6
179,2025-05-25T10:20:00+02:00,2025-05-25,18:20,4,5,9
1,2025-05-25T10:11:00+02:00,2025-05-25,18:11,21,10,31
1,2025-05-25T10:12:00+02:00,2025-05-25,18:12,20,12,32
1,2025-05-25T10:22:00+02:00,2025-05-25,18:22,13,12,25
2,2025-05-25T10:10:00+02:00,2025-05-25,18:10,5,2,7
2,2025-05-25T10:12:00+02:00,2025-05-25,18:12,1,2,3
2,2025-05-25T10:13:00+02:00,2025-05-25,18:13,2,4,6
2,2025-05-25T10:15:00+02:00,2025-05-25,18:15,6,3,9
2,2025-05-25T10:17:00+02:00,2025-05-25,18:17,3,2,5
2,2025-05-25T10:18:00+02:00,2025-05-25,18:18,1,1,2
2,2025-05-25T10:20:00+02:00,2025-05-25,18:20,8,4,12
2,2025-05-25T10:21:00+02:00,2025-05-25,18:21,1,10,11
2,2025-05-25T10:24:00+02:00,2025-05-25,18:24,1,3,4
9,2025-05-25T10:10:00+02:00,2025-05-25,18:10,1,0,1
9,2025-05-25T10:19:00+02:00,2025-05-25,18:19,1,0,1
9,2025-05-25T10:20:00+02:00,2025-05-25,18:20,3,0,3
9,2025-05-25T10:22:00+02:00,2025-05-25,18:22,1,0,1
10,2025-05-25T10:17:00+02:00,2025-05-25,18:17,1,0,1
10,2025-05-25T10:19:00+02:00,2025-05-25,18:19,0,2,2
10,2025-05-25T10:20:00+02:00,2025-05-25,18:20,3,0,3
10,2025-05-25T10:24:00+02:00,2025-05-25,18:24,0,4,4
11,2025-05-25T10:10:00+02:00,2025-05-25,18:10,2,1,3
11,2025-05-25T10:20:00+02:00,2025-05-25,18:20,5,8,13
12,2025-05-25T10:10:00+02:00,2025-05-25,18:10,7,1,8
12,2025-05-25T10:11:00+02:00,2025-05-25,18:11,4,1,5
12,2025-05-25T10:13:00+02:00,2025-05-25,18:13,6,1,7
12,2025-05-25T10:14:00+02:00,2025-05-25,18:14,0,3,3
12,2025-05-25T10:17:00+02:00,2025-05-25,18:17,2,6,8
12,2025-05-25T10:18:00+02:00,2025-05-25,18:18,6,0,6
12,2025-05-25T10:19:00+02:00,2025-05-25,18:19,3,3,6
12,2025-05-25T10:24:00+02:00,2025-05-25,18:24,4,3,7
17,2025-05-25T10:14:00+02:00,2025-05-25,18:14,6,0,6
17,2025-05-25T10:19:00+02:00,2025-05-25,18:19,1,0,1
17,2025-05-25T10:21:00+02:00,2025-05-25,18:21,3,1,4
19,2025-05-25T10:12:00+02:00,2025-05-25,18:12,12,8,20
19,2025-05-25T10:15:00+02:00,2025-05-25,18:15,10,5,15
19,2025-05-25T10:17:00+02:00,2025-05-25,18:17,10,4,14
19,2025-05-25T10:20:00+02:00,2025-05-25,18:20,18,3,21
19,2025-05-25T10:24:00+02:00,2025-05-25,18:24,12,10,22
20,2025-05-25T10:10:00+02:00,2025-05-25,18:10,12,7,19
20,2025-05-25T10:12:00+02:00,2025-05-25,18:12,2,5,7
20,2025-05-25T10:16:00+02:00,2025-05-25,18:16,13,5,18
23,2025-05-25T10:13:00+02:00,2025-05-25,18:13,1,1,2
23,2025-05-25T10:24:00+02:00,2025-05-25,18:24,0,2,2
24,2025-05-25T10:13:00+02:00,2025-05-25,18:13,3,9,12
24,2025-05-25T10:15:00+02:00,2025-05-25,18:15,9,27,36
24,2025-05-25T10:16:00+02:00,2025-05-25,18:16,6,13,19
24,2025-05-25T10:21:00+02:00,2025-05-25,18:21,7,26,33
24,2025-05-25T10:22:00+02:00,2025-05-25,18:22,3,2,5
24,2025-05-25T10:24:00+02:00,2025-05-25,18:24,5,14,19
25,2025-05-25T10:15:00+02:00,2025-05-25,18:15,76,30,106
27,2025-05-25T10:10:00+02:00,2025-05-25,18:10,2,3,5
27,2025-05-25T10:18:00+02:00,2025-05-25,18:18,4,0,4
27,2025-05-25T10:19:00+02:00,2025-05-25,18:19,2,2,4
30,2025-05-25T10:10:00+02:00,2025-05-25,18:10,6,15,21
30,2025-05-25T10:13:00+02:00,2025-05-25,18:13,9,9,18
30,2025-05-25T10:15:00+02:00,2025-05-25,18:15,5,3,8
30,2025-05-25T10:17:00+02:00,2025-05-25,18:17,6,8,14
30,2025-05-25T10:18:00+02:00,2025-05-25,18:18,5,6,11
30,2025-05-25T10:19:00+02:00,2025-05-25,18:19,9,0,9
30,2025-05-25T10:20:00+02:00,2025-05-25,18:20,12,12,24
30,2025-05-25T10:21:00+02:00,2025-05-25,18:21,6,7,13
30,2025-05-25T10:22:00+02:00,2025-05-25,18:22,5,5,10
30,2025-05-25T10:24:00+02:00,2025-05-25,18:24,0,7,7
35,2025-05-25T10:13:00+02:00,2025-05-25,18:13,14,8,22
35,2025-05-25T10:14:00+02:00,2025-05-25,18:14,13,15,28
35,2025-05-25T10:16:00+02:00,2025-05-25,18:16,10,11,21
35,2025-05-25T10:19:00+02:00,2025-05-25,18:19,18,21,39
35,2025-05-25T10:21:00+02:00,2025-05-25,18:21,8,14,22
35,2025-05-25T10:23:00+02:00,2025-05-25,18:23,12,7,19
35,2025-05-25T10:24:00+02:00,2025-05-25,18:24,16,20,36
46,2025-05-25T10:10:00+02:00,2025-05-25,18:10,3,0,3
48,2025-05-25T10:13:00+02:00,2025-05-25,18:13,3,0,3
48,2025-05-25T10:14:00+02:00,2025-05-25,18:14,0,3,3
48,2025-05-25T10:23:00+02:00,2025-05-25,18:23,7,4,11
49,2025-05-25T10:17:00+02:00,2025-05-25,18:17,4,7,11
49,2025-05-25T10:19:00+02:00,2025-05-25,18:19,6,4,10
49,2025-05-25T10:22:00+02:00,2025-05-25,18:22,6,0,6
49,2025-05-25T10:24:00+02:00,2025-05-25,18:24,4,3,7
51,2025-05-25T10:12:00+02:00,2025-05-25,18:12,0,2,2
51,2025-05-25T10:20:00+02:00,2025-05-25,18:20,1,0,1
51,2025-05-25T10:22:00+02:00,2025-05-25,18:22,4,0,4
51,2025-05-25T10:24:00+02:00,2025-05-25,18:24,3,0,3
52,2025-05-25T10:12:00+02:00,2025-05-25,18:12,3,1,4
53,2025-05-25T10:12:00+02:00,2025-05-25,18:12,6,7,13
53,2025-05-25T10:13:00+02:00,2025-05-25,18:13,7,4,11
53,2025-05-25T10:16:00+02:00,2025-05-25,18:16,4,6,10
53,2025-05-25T10:22:00+02:00,2025-05-25,18:22,1,2,3
56,2025-05-25T10:12:00+02:00,2025-05-25,18:12,5,11,16
56,2025-05-25T10:16:00+02:00,2025-05-25,18:16,4,6,10
56,2025-05-25T10:18:00+02:00,2025-05-25,18:18,6,8,14
56,2025-05-25T10:19:00+02:00,2025-05-25,18:19,5,2,7
56,2025-05-25T10:23:00+02:00,2025-05-25,18:23,5,10,15
58,2025-05-25T10:12:00+02:00,2025-05-25,18:12,7,5,12
62,2025-05-25T10:12:00+02:00,2025-05-25,18:12,3,0,3
62,2025-05-25T10:16:00+02:00,2025-05-25,18:16,5,1,6
62,2025-05-25T10:20:00+02:00,2025-05-25,18:20,1,4,5
62,2025-05-25T10:24:00+02:00,2025-05-25,18:24,2,4,6
63,2025-05-25T10:11:00+02:00,2025-05-25,18:11,0,2,2
63,2025-05-25T10:16:00+02:00,2025-05-25,18:16,2,11,13
63,2025-05-25T10:19:00+02:00,2025-05-25,18:19,0,3,3
63,2025-05-25T10:20:00+02:00,2025-05-25,18:20,3,5,8
63,2025-05-25T10:22:00+02:00,2025-05-25,18:22,4,1,5
63,2025-05-25T10:23:00+02:00,2025-05-25,18:23,4,5,9
67,2025-05-25T10:10:00+02:00,2025-05-25,18:10,5,6,11
67,2025-05-25T10:12:00+02:00,2025-05-25,18:12,13,5,18
67,2025-05-25T10:16:00+02:00,2025-05-25,18:16,8,10,18
67,2025-05-25T10:21:00+02:00,2025-05-25,18:21,7,6,13
67,2025-05-25T10:23:00+02:00,2025-05-25,18:23,3,8,11
67,2025-05-25T10:24:00+02:00,2025-05-25,18:24,2,8,10
68,2025-05-25T10:10:00+02:00,2025-05-25,18:10,4,3,7
68,2025-05-25T10:13:00+02:00,2025-05-25,18:13,2,0,2
68,2025-05-25T10:15:00+02:00,2025-05-25,18:15,1,1,2
68,2025-05-25T10:16:00+02:00,2025-05-25,18:16,2,2,4
68,2025-05-25T10:18:00+02:00,2025-05-25,18:18,3,0,3
68,2025-05-25T10:23:00+02:00,2025-05-25,18:23,5,7,12
72,2025-05-25T10:12:00+02:00,2025-05-25,18:12,1,3,4
72,2025-05-25T10:13:00+02:00,2025-05-25,18:13,2,4,6
72,2025-05-25T10:15:00+02:00,2025-05-25,18:15,3,2,5
72,2025-05-25T10:18:00+02:00,2025-05-25,18:18,2,5,7
72,2025-05-25T10:19:00+02:00,2025-05-25,18:19,1,6,7
72,2025-05-25T10:21:00+02:00,2025-05-25,18:21,5,5,10
72,2025-05-25T10:22:00+02:00,2025-05-25,18:22,6,6,12
72,2025-05-25T10:23:00+02:00,2025-05-25,18:23,9,4,13
72,2025-05-25T10:24:00+02:00,2025-05-25,18:24,5,2,7
76,2025-05-25T10:15:00+02:00,2025-05-25,18:15,1,0,1
76,2025-05-25T10:24:00+02:00,2025-05-25,18:24,0,1,1
79,2025-05-25T10:14:00+02:00,2025-05-25,18:14,5,13,18
79,2025-05-25T10:15:00+02:00,2025-05-25,18:15,13,8,21
79,2025-05-25T10:21:00+02:00,2025-05-25,18:21,5,6,11
79,2025-05-25T10:24:00+02:00,2025-05-25,18:24,4,6,10
85,2025-05-25T10:11:00+02:00,2025-05-25,18:11,1,0,1
85,2025-05-25T10:12:00+02:00,2025-05-25,18:12,3,0,3
85,2025-05-25T10:13:00+02:00,2025-05-25,18:13,1,1,2
85,2025-05-25T10:19:00+02:00,2025-05-25,18:19,1,1,2
86,2025-05-25T10:10:00+02:00,2025-05-25,18:10,1,3,4
86,2025-05-25T10:14:00+02:00,2025-05-25,18:14,2,1,3
86,2025-05-25T10:19:00+02:00,2025-05-25,18:19,2,0,2
86,2025-05-25T10:20:00+02:00,2025-05-25,18:20,2,2,4
86,2025-05-25T10:23:00+02:00,2025-05-25,18:23,2,2,4
109,2025-05-25T10:20:00+02:00,2025-05-25,18:20,10,13,23
117,2025-05-25T10:10:00+02:00,2025-05-25,18:10,26,32,58
130,2025-05-25T10:10:00+02:00,2025-05-25,18:10,0,1,1
137,2025-05-25T10:15:00+02:00,2025-05-25,18:15,0,1,1
141,2025-05-25T10:15:00+02:00,2025-05-25,18:15,11,6,17
142,2025-05-25T10:10:00+02:00,2025-05-25,18:10,6,4,10
142,2025-05-25T10:15:00+02:00,2025-05-25,18:15,3,2,5
164,2025-05-25T10:10:00+02:00,2025-05-25,18:10,9,3,12
181,2025-05-25T10:10:00+02:00,2025-05-25,18:10,18,7,25
181,2025-05-25T10:11:00+02:00,2025-05-25,18:11,9,21,30
181,2025-05-25T10:12:00+02:00,2025-05-25,18:12,18,13,31
181,2025-05-25T10:14:00+02:00,2025-05-25,18:14,17,22,39
181,2025-05-25T10:15:00+02:00,2025-05-25,18:15,14,20,34
181,2025-05-25T10:18:00+02:00,2025-05-25,18:18,20,10,30
181,2025-05-25T10:19:00+02:00,2025-05-25,18:19,21,15,36
181,2025-05-25T10:20:00+02:00,2025-05-25,18:20,25,14,39
180,2025-05-25T10:12:00+02:00,2025-05-25,18:12,1,0,1
180,2025-05-25T10:24:00+02:00,2025-05-25,18:24,0,1,1
3,2025-05-25T10:29:00+02:00,2025-05-25,18:29,8,5,13
3,2025-05-25T10:30:00+02:00,2025-05-25,18:30,5,10,15
3,2025-05-25T10:32:00+02:00,2025-05-25,18:32,9,19,28
3,2025-05-25T10:35:00+02:00,2025-05-25,18:35,21,13,34
3,2025-05-25T10:37:00+02:00,2025-05-25,18:37,6,17,23
4,2025-05-25T10:33:00+02:00,2025-05-25,18:33,16,16,32
4,2025-05-25T10:39:00+02:00,2025-05-25,18:39,15,24,39
5,2025-05-25T10:35:00+02:00,2025-05-25,18:35,31,83,114
6,2025-05-25T10:25:00+02:00,2025-05-25,18:25,9,11,20
6,2025-05-25T10:26:00+02:00,2025-05-25,18:26,13,18,31
6,2025-05-25T10:30:00+02:00,2025-05-25,18:30,21,14,35
6,2025-05-25T10:31:00+02:00,2025-05-25,18:31,18,9,27
6,2025-05-25T10:32:00+02:00,2025-05-25,18:32,13,7,20
6,2025-05-25T10:37:00+02:00,2025-05-25,18:37,8,7,15
6,2025-05-25T10:38:00+02:00,2025-05-25,18:38,5,19,24
6,2025-05-25T10:39:00+02:00,2025-05-25,18:39,9,11,20
8,2025-05-25T10:28:00+02:00,2025-05-25,18:28,1,1,2
8,2025-05-25T10:30:00+02:00,2025-05-25,18:30,2,0,2
8,2025-05-25T10:36:00+02:00,2025-05-25,18:36,0,1,1
28,2025-05-25T10:31:00+02:00,2025-05-25,18:31,7,4,11
28,2025-05-25T10:34:00+02:00,2025-05-25,18:34,5,13,18
29,2025-05-25T10:28:00+02:00,2025-05-25,18:28,3,5,8
29,2025-05-25T10:31:00+02:00,2025-05-25,18:31,1,0,1
29,2025-05-25T10:36:00+02:00,2025-05-25,18:36,6,11,17
29,2025-05-25T10:38:00+02:00,2025-05-25,18:38,3,9,12
29,2025-05-25T10:39:00+02:00,2025-05-25,18:39,1,5,6
31,2025-05-25T10:32:00+02:00,2025-05-25,18:32,7,2,9
31,2025-05-25T10:37:00+02:00,2025-05-25,18:37,5,2,7
36,2025-05-25T10:39:00+02:00,2025-05-25,18:39,7,0,7
39,2025-05-25T10:26:00+02:00,2025-05-25,18:26,2,0,2
39,2025-05-25T10:30:00+02:00,2025-05-25,18:30,1,0,1
39,2025-05-25T10:36:00+02:00,2025-05-25,18:36,0,1,1
40,2025-05-25T10:26:00+02:00,2025-05-25,18:26,3,3,6
40,2025-05-25T10:27:00+02:00,2025-05-25,18:27,0,2,2
40,2025-05-25T10:31:00+02:00,2025-05-25,18:31,0,1,1
40,2025-05-25T10:32:00+02:00,2025-05-25,18:32,1,1,2
40,2025-05-25T10:39:00+02:00,2025-05-25,18:39,5,1,6
41,2025-05-25T10:28:00+02:00,2025-05-25,18:28,0,5,5
41,2025-05-25T10:29:00+02:00,2025-05-25,18:29,2,0,2
41,2025-05-25T10:31:00+02:00,2025-05-25,18:31,5,2,7
41,2025-05-25T10:32:00+02:00,2025-05-25,18:32,4,6,10
41,2025-05-25T10:33:00+02:00,2025-05-25,18:33,0,8,8
41,2025-05-25T10:37:00+02:00,2025-05-25,18:37,3,2,5
43,2025-05-25T10:30:00+02:00,2025-05-25,18:30,0,4,4
45,2025-05-25T10:26:00+02:00,2025-05-25,18:26,16,12,28
45,2025-05-25T10:27:00+02:00,2025-05-25,18:27,7,16,23
45,2025-05-25T10:30:00+02:00,2025-05-25,18:30,4,16,20
45,2025-05-25T10:31:00+02:00,2025-05-25,18:31,16,3,19
45,2025-05-25T10:32:00+02:00,2025-05-25,18:32,9,12,21
45,2025-05-25T10:34:00+02:00,2025-05-25,18:34,9,21,30
45,2025-05-25T10:37:00+02:00,2025-05-25,18:37,6,9,15
45,2025-05-25T10:39:00+02:00,2025-05-25,18:39,15,5,20
47,2025-05-25T10:25:00+02:00,2025-05-25,18:25,10,18,28
47,2025-05-25T10:27:00+02:00,2025-05-25,18:27,11,8,19
47,2025-05-25T10:28:00+02:00,2025-05-25,18:28,18,6,24
47,2025-05-25T10:35:00+02:00,2025-05-25,18:35,11,9,20
47,2025-05-25T10:37:00+02:00,2025-05-25,18:37,14,9,23
47,2025-05-25T10:39:00+02:00,2025-05-25,18:39,9,8,17
50,2025-05-25T10:29:00+02:00,2025-05-25,18:29,2,5,7
50,2025-05-25T10:33:00+02:00,2025-05-25,18:33,7,5,12
50,2025-05-25T10:36:00+02:00,2025-05-25,18:36,2,0,2
54,2025-05-25T10:27:00+02:00,2025-05-25,18:27,0,2,2
54,2025-05-25T10:28:00+02:00,2025-05-25,18:28,0,1,1
54,2025-05-25T10:31:00+02:00,2025-05-25,18:31,3,3,6
54,2025-05-25T10:33:00+02:00,2025-05-25,18:33,1,0,1
54,2025-05-25T10:34:00+02:00,2025-05-25,18:34,0,1,1
54,2025-05-25T10:36:00+02:00,2025-05-25,18:36,2,2,4
54,2025-05-25T10:37:00+02:00,2025-05-25,18:37,4,1,5
54,2025-05-25T10:38:00+02:00,2025-05-25,18:38,0,4,4
54,2025-05-25T10:39:00+02:00,2025-05-25,18:39,2,1,3
59,2025-05-25T10:25:00+02:00,2025-05-25,18:25,31,5,36
59,2025-05-25T10:30:00+02:00,2025-05-25,18:30,28,36,64
61,2025-05-25T10:27:00+02:00,2025-05-25,18:27,4,7,11
61,2025-05-25T10:28:00+02:00,2025-05-25,18:28,6,1,7
61,2025-05-25T10:29:00+02:00,2025-05-25,18:29,6,5,11
61,2025-05-25T10:31:00+02:00,2025-05-25,18:31,2,0,2
61,2025-05-25T10:32:00+02:00,2025-05-25,18:32,7,8,15
61,2025-05-25T10:35:00+02:00,2025-05-25,18:35,1,3,4
61,2025-05-25T10:37:00+02:00,2025-05-25,18:37,9,6,15
66,2025-05-25T10:26:00+02:00,2025-05-25,18:26,16,19,35
66,2025-05-25T10:28:00+02:00,2025-05-25,18:28,11,25,36
66,2025-05-25T10:29:00+02:00,2025-05-25,18:29,21,6,27
66,2025-05-25T10:32:00+02:00,2025-05-25,18:32,32,11,43
66,2025-05-25T10:34:00+02:00,2025-05-25,18:34,15,35,50
66,2025-05-25T10:35:00+02:00,2025-05-25,18:35,32,20,52
66,2025-05-25T10:38:00+02:00,2025-05-25,18:38,16,26,42
66,2025-05-25T10:39:00+02:00,2025-05-25,18:39,18,9,27
69,2025-05-25T10:37:00+02:00,2025-05-25,18:37,0,1,1
70,2025-05-25T10:30:00+02:00,2025-05-25,18:30,4,7,11
70,2025-05-25T10:32:00+02:00,2025-05-25,18:32,5,4,9
70,2025-05-25T10:34:00+02:00,2025-05-25,18:34,7,9,16
70,2025-05-25T10:37:00+02:00,2025-05-25,18:37,0,10,10
70,2025-05-25T10:39:00+02:00,2025-05-25,18:39,1,2,3
71,2025-05-25T10:31:00+02:00,2025-05-25,18:31,1,0,1
75,2025-05-25T10:27:00+02:00,2025-05-25,18:27,3,0,3
75,2025-05-25T10:32:00+02:00,2025-05-25,18:32,2,1,3
75,2025-05-25T10:36:00+02:00,2025-05-25,18:36,2,0,2
75,2025-05-25T10:38:00+02:00,2025-05-25,18:38,2,0,2
77,2025-05-25T10:35:00+02:00,2025-05-25,18:35,11,5,16
78,2025-05-25T10:31:00+02:00,2025-05-25,18:31,0,1,1
78,2025-05-25T10:34:00+02:00,2025-05-25,18:34,0,2,2
78,2025-05-25T10:38:00+02:00,2025-05-25,18:38,4,0,4
84,2025-05-25T10:25:00+02:00,2025-05-25,18:25,95,82,177
84,2025-05-25T10:35:00+02:00,2025-05-25,18:35,67,75,142
87,2025-05-25T10:27:00+02:00,2025-05-25,18:27,3,4,7
87,2025-05-25T10:30:00+02:00,2025-05-25,18:30,4,3,7
87,2025-05-25T10:33:00+02:00,2025-05-25,18:33,4,0,4
87,2025-05-25T10:36:00+02:00,2025-05-25,18:36,2,0,2
108,2025-05-25T10:26:00+02:00,2025-05-25,18:26,0,2,2
108,2025-05-25T10:32:00+02:00,2025-05-25,18:32,4,0,4
108,2025-05-25T10:33:00+02:00,2025-05-25,18:33,5,2,7
108,2025-05-25T10:34:00+02:00,2025-05-25,18:34,0,1,1
108,2025-05-25T10:37:00+02:00,2025-05-25,18:37,4,9,13
108,2025-05-25T10:38:00+02:00,2025-05-25,18:38,5,3,8
118,2025-05-25T10:35:00+02:00,2025-05-25,18:35,1,0,1
131,2025-05-25T10:25:00+02:00,2025-05-25,18:25,5,4,9
131,2025-05-25T10:30:00+02:00,2025-05-25,18:30,5,4,9
132,2025-05-25T10:30:00+02:00,2025-05-25,18:30,8,17,25
132,2025-05-25T10:35:00+02:00,2025-05-25,18:35,7,7,14
133,2025-05-25T10:25:00+02:00,2025-05-25,18:25,41,39,80
135,2025-05-25T10:30:00+02:00,2025-05-25,18:30,21,36,57
162,2025-05-25T10:25:00+02:00,2025-05-25,18:25,15,17,32
166,2025-05-25T10:25:00+02:00,2025-05-25,18:25,2,8,10
166,2025-05-25T10:30:00+02:00,2025-05-25,18:30,3,4,7
167,2025-05-25T10:25:00+02:00,2025-05-25,18:25,1,1,2
179,2025-05-25T10:35:00+02:00,2025-05-25,18:35,7,3,10
1,2025-05-25T10:25:00+02:00,2025-05-25,18:25,11,15,26
1,2025-05-25T10:27:00+02:00,2025-05-25,18:27,8,13,21
1,2025-05-25T10:29:00+02:00,2025-05-25,18:29,8,11,19
1,2025-05-25T10:30:00+02:00,2025-05-25,18:30,15,7,22
1,2025-05-25T10:33:00+02:00,2025-05-25,18:33,19,8,27
1,2025-05-25T10:34:00+02:00,2025-05-25,18:34,6,15,21
1,2025-05-25T10:35:00+02:00,2025-05-25,18:35,11,11,22
1,2025-05-25T10:36:00+02:00,2025-05-25,18:36,15,4,19
1,2025-05-25T10:39:00+02:00,2025-05-25,18:39,24,5,29
2,2025-05-25T10:25:00+02:00,2025-05-25,18:25,16,1,17
2,2025-05-25T10:27:00+02:00,2025-05-25,18:27,1,0,1
2,2025-05-25T10:28:00+02:00,2025-05-25,18:28,6,11,17
2,2025-05-25T10:31:00+02:00,2025-05-25,18:31,5,2,7
2,2025-05-25T10:35:00+02:00,2025-05-25,18:35,2,1,3
2,2025-05-25T10:36:00+02:00,2025-05-25,18:36,11,5,16
2,2025-05-25T10:38:00+02:00,2025-05-25,18:38,5,3,8
2,2025-05-25T10:39:00+02:00,2025-05-25,18:39,7,4,11
9,2025-05-25T10:25:00+02:00,2025-05-25,18:25,0,2,2
9,2025-05-25T10:26:00+02:00,2025-05-25,18:26,2,0,2
9,2025-05-25T10:28:00+02:00,2025-05-25,18:28,3,0,3
9,2025-05-25T10:29:00+02:00,2025-05-25,18:29,1,0,1
9,2025-05-25T10:33:00+02:00,2025-05-25,18:33,2,0,2
10,2025-05-25T10:30:00+02:00,2025-05-25,18:30,1,1,2
10,2025-05-25T10:31:00+02:00,2025-05-25,18:31,4,2,6
10,2025-05-25T10:32:00+02:00,2025-05-25,18:32,5,4,9
11,2025-05-25T10:35:00+02:00,2025-05-25,18:35,13,3,16
12,2025-05-25T10:26:00+02:00,2025-05-25,18:26,2,1,3
12,2025-05-25T10:29:00+02:00,2025-05-25,18:29,0,2,2
12,2025-05-25T10:32:00+02:00,2025-05-25,18:32,0,1,1
12,2025-05-25T10:33:00+02:00,2025-05-25,18:33,0,13,13
12,2025-05-25T10:35:00+02:00,2025-05-25,18:35,1,1,2
12,2025-05-25T10:36:00+02:00,2025-05-25,18:36,0,3,3
17,2025-05-25T10:34:00+02:00,2025-05-25,18:34,8,0,8
17,2025-05-25T10:38:00+02:00,2025-05-25,18:38,6,1,7
19,2025-05-25T10:26:00+02:00,2025-05-25,18:26,19,6,25
19,2025-05-25T10:37:00+02:00,2025-05-25,18:37,10,8,18
19,2025-05-25T10:39:00+02:00,2025-05-25,18:39,9,7,16
20,2025-05-25T10:25:00+02:00,2025-05-25,18:25,14,4,18
20,2025-05-25T10:27:00+02:00,2025-05-25,18:27,22,3,25
20,2025-05-25T10:29:00+02:00,2025-05-25,18:29,7,7,14
20,2025-05-25T10:33:00+02:00,2025-05-25,18:33,6,4,10
20,2025-05-25T10:34:00+02:00,2025-05-25,18:34,7,8,15
23,2025-05-25T10:30:00+02:00,2025-05-25,18:30,2,2,4
23,2025-05-25T10:31:00+02:00,2025-05-25,18:31,4,12,16
23,2025-05-25T10:32:00+02:00,2025-05-25,18:32,0,2,2
23,2025-05-25T10:37:00+02:00,2025-05-25,18:37,5,1,6
23,2025-05-25T10:38:00+02:00,2025-05-25,18:38,1,5,6
24,2025-05-25T10:27:00+02:00,2025-05-25,18:27,7,7,14
24,2025-05-25T10:36:00+02:00,2025-05-25,18:36,10,4,14
27,2025-05-25T10:25:00+02:00,2025-05-25,18:25,1,0,1
27,2025-05-25T10:26:00+02:00,2025-05-25,18:26,3,0,3
27,2025-05-25T10:30:00+02:00,2025-05-25,18:30,3,1,4
27,2025-05-25T10:38:00+02:00,2025-05-25,18:38,0,2,2
27,2025-05-25T10:39:00+02:00,2025-05-25,18:39,0,1,1
30,2025-05-25T10:27:00+02:00,2025-05-25,18:27,7,9,16
30,2025-05-25T10:34:00+02:00,2025-05-25,18:34,2,5,7
30,2025-05-25T10:36:00+02:00,2025-05-25,18:36,0,2,2
35,2025-05-25T10:25:00+02:00,2025-05-25,18:25,15,13,28
35,2025-05-25T10:26:00+02:00,2025-05-25,18:26,18,22,40
35,2025-05-25T10:27:00+02:00,2025-05-25,18:27,7,28,35
35,2025-05-25T10:30:00+02:00,2025-05-25,18:30,8,22,30
35,2025-05-25T10:31:00+02:00,2025-05-25,18:31,4,18,22
35,2025-05-25T10:34:00+02:00,2025-05-25,18:34,6,7,13
48,2025-05-25T10:25:00+02:00,2025-05-25,18:25,3,13,16
48,2025-05-25T10:26:00+02:00,2025-05-25,18:26,1,2,3
48,2025-05-25T10:27:00+02:00,2025-05-25,18:27,2,1,3
48,2025-05-25T10:29:00+02:00,2025-05-25,18:29,1,3,4
48,2025-05-25T10:35:00+02:00,2025-05-25,18:35,1,1,2
48,2025-05-25T10:36:00+02:00,2025-05-25,18:36,1,1,2
48,2025-05-25T10:37:00+02:00,2025-05-25,18:37,0,4,4
49,2025-05-25T10:25:00+02:00,2025-05-25,18:25,3,6,9
49,2025-05-25T10:26:00+02:00,2025-05-25,18:26,4,3,7
49,2025-05-25T10:30:00+02:00,2025-05-25,18:30,9,7,16
49,2025-05-25T10:32:00+02:00,2025-05-25,18:32,5,0,5
49,2025-05-25T10:35:00+02:00,2025-05-25,18:35,10,7,17
49,2025-05-25T10:36:00+02:00,2025-05-25,18:36,4,6,10
49,2025-05-25T10:37:00+02:00,2025-05-25,18:37,4,8,12
51,2025-05-25T10:25:00+02:00,2025-05-25,18:25,1,1,2
51,2025-05-25T10:29:00+02:00,2025-05-25,18:29,0,2,2
51,2025-05-25T10:31:00+02:00,2025-05-25,18:31,5,2,7
51,2025-05-25T10:32:00+02:00,2025-05-25,18:32,3,3,6
51,2025-05-25T10:34:00+02:00,2025-05-25,18:34,0,1,1
52,2025-05-25T10:29:00+02:00,2025-05-25,18:29,4,2,6
52,2025-05-25T10:31:00+02:00,2025-05-25,18:31,4,8,12
52,2025-05-25T10:36:00+02:00,2025-05-25,18:36,3,5,8
52,2025-05-25T10:37:00+02:00,2025-05-25,18:37,6,8,14
52,2025-05-25T10:39:00+02:00,2025-05-25,18:39,4,9,13
53,2025-05-25T10:26:00+02:00,2025-05-25,18:26,6,2,8
53,2025-05-25T10:28:00+02:00,2025-05-25,18:28,7,0,7
53,2025-05-25T10:29:00+02:00,2025-05-25,18:29,0,1,1
53,2025-05-25T10:33:00+02:00,2025-05-25,18:33,4,0,4
53,2025-05-25T10:37:00+02:00,2025-05-25,18:37,3,1,4
56,2025-05-25T10:25:00+02:00,2025-05-25,18:25,5,4,9
56,2025-05-25T10:29:00+02:00,2025-05-25,18:29,0,3,3
56,2025-05-25T10:30:00+02:00,2025-05-25,18:30,4,5,9
56,2025-05-25T10:32:00+02:00,2025-05-25,18:32,4,8,12
56,2025-05-25T10:33:00+02:00,2025-05-25,18:33,14,2,16
56,2025-05-25T10:35:00+02:00,2025-05-25,18:35,5,12,17
56,2025-05-25T10:37:00+02:00,2025-05-25,18:37,15,8,23
58,2025-05-25T10:31:00+02:00,2025-05-25,18:31,12,3,15
58,2025-05-25T10:35:00+02:00,2025-05-25,18:35,10,2,12
58,2025-05-25T10:39:00+02:00,2025-05-25,18:39,7,2,9
62,2025-05-25T10:38:00+02:00,2025-05-25,18:38,3,2,5
62,2025-05-25T10:39:00+02:00,2025-05-25,18:39,3,4,7
63,2025-05-25T10:27:00+02:00,2025-05-25,18:27,6,3,9
63,2025-05-25T10:28:00+02:00,2025-05-25,18:28,5,3,8
63,2025-05-25T10:30:00+02:00,2025-05-25,18:30,3,0,3
63,2025-05-25T10:33:00+02:00,2025-05-25,18:33,2,4,6
63,2025-05-25T10:35:00+02:00,2025-05-25,18:35,3,1,4
63,2025-05-25T10:37:00+02:00,2025-05-25,18:37,0,3,3
67,2025-05-25T10:26:00+02:00,2025-05-25,18:26,8,7,15
67,2025-05-25T10:29:00+02:00,2025-05-25,18:29,5,2,7
67,2025-05-25T10:31:00+02:00,2025-05-25,18:31,6,2,8
67,2025-05-25T10:33:00+02:00,2025-05-25,18:33,4,1,5
67,2025-05-25T10:34:00+02:00,2025-05-25,18:34,1,11,12
67,2025-05-25T10:35:00+02:00,2025-05-25,18:35,7,7,14
67,2025-05-25T10:38:00+02:00,2025-05-25,18:38,0,4,4
67,2025-05-25T10:39:00+02:00,2025-05-25,18:39,7,5,12
68,2025-05-25T10:26:00+02:00,2025-05-25,18:26,0,3,3
68,2025-05-25T10:28:00+02:00,2025-05-25,18:28,3,0,3
68,2025-05-25T10:31:00+02:00,2025-05-25,18:31,1,1,2
68,2025-05-25T10:36:00+02:00,2025-05-25,18:36,1,0,1
72,2025-05-25T10:32:00+02:00,2025-05-25,18:32,3,9,12
72,2025-05-25T10:35:00+02:00,2025-05-25,18:35,2,13,15
72,2025-05-25T10:36:00+02:00,2025-05-25,18:36,1,16,17
76,2025-05-25T10:32:00+02:00,2025-05-25,18:32,1,5,6
76,2025-05-25T10:35:00+02:00,2025-05-25,18:35,0,2,2
76,2025-05-25T10:36:00+02:00,2025-05-25,18:36,0,2,2
76,2025-05-25T10:37:00+02:00,2025-05-25,18:37,0,2,2
79,2025-05-25T10:25:00+02:00,2025-05-25,18:25,5,2,7
79,2025-05-25T10:28:00+02:00,2025-05-25,18:28,6,6,12
79,2025-05-25T10:29:00+02:00,2025-05-25,18:29,14,1,15
79,2025-05-25T10:37:00+02:00,2025-05-25,18:37,8,15,23
85,2025-05-25T10:25:00+02:00,2025-05-25,18:25,0,1,1
85,2025-05-25T10:28:00+02:00,2025-05-25,18:28,1,0,1
85,2025-05-25T10:30:00+02:00,2025-05-25,18:30,0,6,6
85,2025-05-25T10:36:00+02:00,2025-05-25,18:36,2,3,5
86,2025-05-25T10:26:00+02:00,2025-05-25,18:26,0,1,1
86,2025-05-25T10:28:00+02:00,2025-05-25,18:28,6,0,6
86,2025-05-25T10:29:00+02:00,2025-05-25,18:29,2,0,2
86,2025-05-25T10:35:00+02:00,2025-05-25,18:35,4,4,8
86,2025-05-25T10:37:00+02:00,2025-05-25,18:37,3,2,5
117,2025-05-25T10:25:00+02:00,2025-05-25,18:25,25,20,45
130,2025-05-25T10:25:00+02:00,2025-05-25,18:25,2,0,2
136,2025-05-25T10:25:00+02:00,2025-05-25,18:25,0,105,105
136,2025-05-25T10:35:00+02:00,2025-05-25,18:35,2,87,89
137,2025-05-25T10:25:00+02:00,2025-05-25,18:25,0,2,2
139,2025-05-25T10:35:00+02:00,2025-05-25,18:35,1,5,6
142,2025-05-25T10:30:00+02:00,2025-05-25,18:30,5,1,6
161,2025-05-25T10:30:00+02:00,2025-05-25,18:30,0,6,6
164,2025-05-25T10:30:00+02:00,2025-05-25,18:30,3,5,8
181,2025-05-25T10:27:00+02:00,2025-05-25,18:27,28,3,31
181,2025-05-25T10:30:00+02:00,2025-05-25,18:30,5,8,13
181,2025-05-25T10:31:00+02:00,2025-05-25,18:31,12,11,23
181,2025-05-25T10:33:00+02:00,2025-05-25,18:33,12,15,27
181,2025-05-25T10:34:00+02:00,2025-05-25,18:34,14,9,23
41,2025-05-25T10:44:00+02:00,2025-05-25,18:44,12,6,18
41,2025-05-25T10:45:00+02:00,2025-05-25,18:45,5,2,7
41,2025-05-25T10:47:00+02:00,2025-05-25,18:47,4,0,4
41,2025-05-25T10:54:00+02:00,2025-05-25,18:54,4,1,5
43,2025-05-25T10:50:00+02:00,2025-05-25,18:50,4,3,7
44,2025-05-25T10:40:00+02:00,2025-05-25,18:40,2,0,2
44,2025-05-25T10:45:00+02:00,2025-05-25,18:45,1,4,5
45,2025-05-25T10:41:00+02:00,2025-05-25,18:41,12,23,35
45,2025-05-25T10:42:00+02:00,2025-05-25,18:42,11,4,15
45,2025-05-25T10:43:00+02:00,2025-05-25,18:43,6,11,17
45,2025-05-25T10:46:00+02:00,2025-05-25,18:46,14,15,29
45,2025-05-25T10:47:00+02:00,2025-05-25,18:47,12,16,28
45,2025-05-25T10:50:00+02:00,2025-05-25,18:50,9,8,17
47,2025-05-25T10:40:00+02:00,2025-05-25,18:40,18,8,26
47,2025-05-25T10:41:00+02:00,2025-05-25,18:41,23,15,38
47,2025-05-25T10:42:00+02:00,2025-05-25,18:42,8,11,19
47,2025-05-25T10:43:00+02:00,2025-05-25,18:43,14,7,21
47,2025-05-25T10:48:00+02:00,2025-05-25,18:48,3,7,10
47,2025-05-25T10:51:00+02:00,2025-05-25,18:51,7,7,14
47,2025-05-25T10:52:00+02:00,2025-05-25,18:52,17,0,17
47,2025-05-25T10:53:00+02:00,2025-05-25,18:53,6,24,30
47,2025-05-25T10:54:00+02:00,2025-05-25,18:54,11,29,40
50,2025-05-25T10:41:00+02:00,2025-05-25,18:41,2,4,6
50,2025-05-25T10:47:00+02:00,2025-05-25,18:47,3,7,10
50,2025-05-25T10:50:00+02:00,2025-05-25,18:50,4,1,5
50,2025-05-25T10:54:00+02:00,2025-05-25,18:54,1,2,3
54,2025-05-25T10:42:00+02:00,2025-05-25,18:42,3,0,3
54,2025-05-25T10:43:00+02:00,2025-05-25,18:43,4,1,5
54,2025-05-25T10:48:00+02:00,2025-05-25,18:48,2,6,8
54,2025-05-25T10:49:00+02:00,2025-05-25,18:49,0,6,6
54,2025-05-25T10:52:00+02:00,2025-05-25,18:52,2,2,4
61,2025-05-25T10:41:00+02:00,2025-05-25,18:41,6,8,14
61,2025-05-25T10:49:00+02:00,2025-05-25,18:49,2,2,4
61,2025-05-25T10:52:00+02:00,2025-05-25,18:52,2,6,8
61,2025-05-25T10:53:00+02:00,2025-05-25,18:53,6,0,6
66,2025-05-25T10:41:00+02:00,2025-05-25,18:41,16,27,43
66,2025-05-25T10:46:00+02:00,2025-05-25,18:46,24,18,42
66,2025-05-25T10:50:00+02:00,2025-05-25,18:50,16,17,33
66,2025-05-25T10:53:00+02:00,2025-05-25,18:53,10,23,33
69,2025-05-25T10:40:00+02:00,2025-05-25,18:40,1,2,3
69,2025-05-25T10:52:00+02:00,2025-05-25,18:52,0,1,1
70,2025-05-25T10:41:00+02:00,2025-05-25,18:41,0,7,7
70,2025-05-25T10:43:00+02:00,2025-05-25,18:43,3,6,9
70,2025-05-25T10:51:00+02:00,2025-05-25,18:51,1,2,3
70,2025-05-25T10:52:00+02:00,2025-05-25,18:52,1,4,5
75,2025-05-25T10:40:00+02:00,2025-05-25,18:40,4,0,4
75,2025-05-25T10:42:00+02:00,2025-05-25,18:42,2,1,3
75,2025-05-25T10:43:00+02:00,2025-05-25,18:43,1,0,1
75,2025-05-25T10:45:00+02:00,2025-05-25,18:45,3,1,4
75,2025-05-25T10:52:00+02:00,2025-05-25,18:52,0,3,3
77,2025-05-25T10:40:00+02:00,2025-05-25,18:40,15,15,30
77,2025-05-25T10:45:00+02:00,2025-05-25,18:45,11,17,28
78,2025-05-25T10:49:00+02:00,2025-05-25,18:49,1,0,1
84,2025-05-25T10:45:00+02:00,2025-05-25,18:45,69,81,150
87,2025-05-25T10:43:00+02:00,2025-05-25,18:43,0,1,1
87,2025-05-25T10:45:00+02:00,2025-05-25,18:45,5,3,8
87,2025-05-25T10:46:00+02:00,2025-05-25,18:46,1,3,4
87,2025-05-25T10:48:00+02:00,2025-05-25,18:48,1,2,3
87,2025-05-25T10:50:00+02:00,2025-05-25,18:50,2,1,3
87,2025-05-25T10:51:00+02:00,2025-05-25,18:51,0,2,2
108,2025-05-25T10:40:00+02:00,2025-05-25,18:40,2,0,2
108,2025-05-25T10:42:00+02:00,2025-05-25,18:42,1,1,2
108,2025-05-25T10:43:00+02:00,2025-05-25,18:43,8,1,9
108,2025-05-25T10:44:00+02:00,2025-05-25,18:44,2,3,5
108,2025-05-25T10:47:00+02:00,2025-05-25,18:47,2,2,4
108,2025-05-25T10:50:00+02:00,2025-05-25,18:50,2,2,4
108,2025-05-25T10:51:00+02:00,2025-05-25,18:51,2,0,2
108,2025-05-25T10:52:00+02:00,2025-05-25,18:52,2,7,9
118,2025-05-25T10:50:00+02:00,2025-05-25,18:50,1,0,1
131,2025-05-25T10:40:00+02:00,2025-05-25,18:40,25,7,32
131,2025-05-25T10:45:00+02:00,2025-05-25,18:45,4,8,12
131,2025-05-25T10:50:00+02:00,2025-05-25,18:50,10,6,16
133,2025-05-25T10:40:00+02:00,2025-05-25,18:40,35,31,66
135,2025-05-25T10:40:00+02:00,2025-05-25,18:40,24,21,45
162,2025-05-25T10:45:00+02:00,2025-05-25,18:45,30,22,52
165,2025-05-25T10:45:00+02:00,2025-05-25,18:45,1,0,1
167,2025-05-25T10:40:00+02:00,2025-05-25,18:40,1,1,2
167,2025-05-25T10:50:00+02:00,2025-05-25,18:50,1,2,3
179,2025-05-25T10:40:00+02:00,2025-05-25,18:40,4,7,11
179,2025-05-25T10:50:00+02:00,2025-05-25,18:50,1,3,4
1,2025-05-25T10:42:00+02:00,2025-05-25,18:42,10,4,14
1,2025-05-25T10:46:00+02:00,2025-05-25,18:46,6,7,13
1,2025-05-25T10:47:00+02:00,2025-05-25,18:47,14,10,24
1,2025-05-25T10:50:00+02:00,2025-05-25,18:50,15,7,22
2,2025-05-25T10:41:00+02:00,2025-05-25,18:41,6,7,13
2,2025-05-25T10:42:00+02:00,2025-05-25,18:42,2,10,12
2,2025-05-25T10:43:00+02:00,2025-05-25,18:43,4,3,7
2,2025-05-25T10:44:00+02:00,2025-05-25,18:44,1,8,9
2,2025-05-25T10:45:00+02:00,2025-05-25,18:45,4,1,5
2,2025-05-25T10:48:00+02:00,2025-05-25,18:48,0,4,4
2,2025-05-25T10:51:00+02:00,2025-05-25,18:51,2,8,10
9,2025-05-25T10:40:00+02:00,2025-05-25,18:40,1,0,1
9,2025-05-25T10:48:00+02:00,2025-05-25,18:48,0,1,1
9,2025-05-25T10:50:00+02:00,2025-05-25,18:50,1,1,2
10,2025-05-25T10:42:00+02:00,2025-05-25,18:42,4,0,4
10,2025-05-25T10:47:00+02:00,2025-05-25,18:47,1,1,2
10,2025-05-25T10:48:00+02:00,2025-05-25,18:48,2,0,2
10,2025-05-25T10:49:00+02:00,2025-05-25,18:49,4,0,4
10,2025-05-25T10:51:00+02:00,2025-05-25,18:51,1,1,2
11,2025-05-25T10:40:00+02:00,2025-05-25,18:40,1,0,1
12,2025-05-25T10:43:00+02:00,2025-05-25,18:43,0,3,3
12,2025-05-25T10:47:00+02:00,2025-05-25,18:47,2,3,5
12,2025-05-25T10:50:00+02:00,2025-05-25,18:50,0,2,2
12,2025-05-25T10:54:00+02:00,2025-05-25,18:54,4,4,8
17,2025-05-25T10:41:00+02:00,2025-05-25,18:41,3,2,5
17,2025-05-25T10:45:00+02:00,2025-05-25,18:45,4,0,4
17,2025-05-25T10:47:00+02:00,2025-05-25,18:47,4,0,4
17,2025-05-25T10:50:00+02:00,2025-05-25,18:50,8,5,13
17,2025-05-25T10:52:00+02:00,2025-05-25,18:52,2,1,3
18,2025-05-25T10:51:00+02:00,2025-05-25,18:51,0,1,1
19,2025-05-25T10:40:00+02:00,2025-05-25,18:40,22,2,24
19,2025-05-25T10:44:00+02:00,2025-05-25,18:44,10,19,29
19,2025-05-25T10:45:00+02:00,2025-05-25,18:45,11,5,16
19,2025-05-25T10:47:00+02:00,2025-05-25,18:47,8,5,13
19,2025-05-25T10:48:00+02:00,2025-05-25,18:48,5,9,14
20,2025-05-25T10:42:00+02:00,2025-05-25,18:42,10,8,18
20,2025-05-25T10:44:00+02:00,2025-05-25,18:44,4,9,13
20,2025-05-25T10:46:00+02:00,2025-05-25,18:46,9,13,22
20,2025-05-25T10:49:00+02:00,2025-05-25,18:49,15,9,24
20,2025-05-25T10:52:00+02:00,2025-05-25,18:52,11,6,17
20,2025-05-25T10:53:00+02:00,2025-05-25,18:53,2,7,9
20,2025-05-25T10:54:00+02:00,2025-05-25,18:54,13,9,22
23,2025-05-25T10:48:00+02:00,2025-05-25,18:48,5,5,10
23,2025-05-25T10:50:00+02:00,2025-05-25,18:50,4,2,6
23,2025-05-25T10:53:00+02:00,2025-05-25,18:53,0,8,8
23,2025-05-25T10:54:00+02:00,2025-05-25,18:54,0,5,5
24,2025-05-25T10:45:00+02:00,2025-05-25,18:45,10,18,28
24,2025-05-25T10:47:00+02:00,2025-05-25,18:47,9,6,15
24,2025-05-25T10:51:00+02:00,2025-05-25,18:51,7,8,15
24,2025-05-25T10:52:00+02:00,2025-05-25,18:52,15,8,23
27,2025-05-25T10:43:00+02:00,2025-05-25,18:43,3,5,8
27,2025-05-25T10:45:00+02:00,2025-05-25,18:45,4,0,4
27,2025-05-25T10:46:00+02:00,2025-05-25,18:46,5,0,5
27,2025-05-25T10:51:00+02:00,2025-05-25,18:51,2,0,2
30,2025-05-25T10:40:00+02:00,2025-05-25,18:40,7,10,17
30,2025-05-25T10:42:00+02:00,2025-05-25,18:42,2,12,14
30,2025-05-25T10:44:00+02:00,2025-05-25,18:44,4,3,7
30,2025-05-25T10:46:00+02:00,2025-05-25,18:46,6,3,9
30,2025-05-25T10:47:00+02:00,2025-05-25,18:47,11,15,26
30,2025-05-25T10:52:00+02:00,2025-05-25,18:52,4,14,18
30,2025-05-25T10:54:00+02:00,2025-05-25,18:54,3,9,12
35,2025-05-25T10:41:00+02:00,2025-05-25,18:41,9,22,31
35,2025-05-25T10:42:00+02:00,2025-05-25,18:42,10,18,28
35,2025-05-25T10:43:00+02:00,2025-05-25,18:43,7,16,23
35,2025-05-25T10:45:00+02:00,2025-05-25,18:45,17,28,45
48,2025-05-25T10:44:00+02:00,2025-05-25,18:44,2,1,3
48,2025-05-25T10:46:00+02:00,2025-05-25,18:46,1,10,11
48,2025-05-25T10:47:00+02:00,2025-05-25,18:47,2,1,3
48,2025-05-25T10:50:00+02:00,2025-05-25,18:50,1,4,5
48,2025-05-25T10:52:00+02:00,2025-05-25,18:52,1,1,2
48,2025-05-25T10:54:00+02:00,2025-05-25,18:54,1,1,2
49,2025-05-25T10:41:00+02:00,2025-05-25,18:41,5,4,9
49,2025-05-25T10:45:00+02:00,2025-05-25,18:45,2,0,2
49,2025-05-25T10:51:00+02:00,2025-05-25,18:51,7,6,13
51,2025-05-25T10:42:00+02:00,2025-05-25,18:42,1,0,1
51,2025-05-25T10:44:00+02:00,2025-05-25,18:44,0,2,2
51,2025-05-25T10:46:00+02:00,2025-05-25,18:46,3,6,9
51,2025-05-25T10:47:00+02:00,2025-05-25,18:47,2,4,6
51,2025-05-25T10:48:00+02:00,2025-05-25,18:48,0,1,1
51,2025-05-25T10:49:00+02:00,2025-05-25,18:49,0,3,3
51,2025-05-25T10:53:00+02:00,2025-05-25,18:53,6,6,12
52,2025-05-25T10:42:00+02:00,2025-05-25,18:42,3,2,5
52,2025-05-25T10:43:00+02:00,2025-05-25,18:43,11,3,14
52,2025-05-25T10:44:00+02:00,2025-05-25,18:44,4,2,6
52,2025-05-25T10:46:00+02:00,2025-05-25,18:46,4,5,9
52,2025-05-25T10:48:00+02:00,2025-05-25,18:48,1,6,7
52,2025-05-25T10:50:00+02:00,2025-05-25,18:50,2,6,8
52,2025-05-25T10:51:00+02:00,2025-05-25,18:51,4,5,9
53,2025-05-25T10:45:00+02:00,2025-05-25,18:45,2,3,5
53,2025-05-25T10:49:00+02:00,2025-05-25,18:49,0,7,7
53,2025-05-25T10:51:00+02:00,2025-05-25,18:51,2,2,4
53,2025-05-25T10:52:00+02:00,2025-05-25,18:52,8,1,9
53,2025-05-25T10:54:00+02:00,2025-05-25,18:54,4,1,5
56,2025-05-25T10:42:00+02:00,2025-05-25,18:42,7,9,16
56,2025-05-25T10:44:00+02:00,2025-05-25,18:44,8,12,20
56,2025-05-25T10:46:00+02:00,2025-05-25,18:46,6,10,16
56,2025-05-25T10:49:00+02:00,2025-05-25,18:49,7,2,9
56,2025-05-25T10:50:00+02:00,2025-05-25,18:50,5,7,12
56,2025-05-25T10:52:00+02:00,2025-05-25,18:52,7,9,16
56,2025-05-25T10:53:00+02:00,2025-05-25,18:53,13,7,20
58,2025-05-25T10:42:00+02:00,2025-05-25,18:42,5,13,18
58,2025-05-25T10:44:00+02:00,2025-05-25,18:44,1,5,6
58,2025-05-25T10:51:00+02:00,2025-05-25,18:51,0,3,3
58,2025-05-25T10:54:00+02:00,2025-05-25,18:54,4,5,9
62,2025-05-25T10:40:00+02:00,2025-05-25,18:40,1,2,3
62,2025-05-25T10:41:00+02:00,2025-05-25,18:41,1,3,4
62,2025-05-25T10:44:00+02:00,2025-05-25,18:44,3,7,10
62,2025-05-25T10:45:00+02:00,2025-05-25,18:45,2,3,5
62,2025-05-25T10:47:00+02:00,2025-05-25,18:47,4,2,6
63,2025-05-25T10:40:00+02:00,2025-05-25,18:40,0,1,1
63,2025-05-25T10:42:00+02:00,2025-05-25,18:42,2,6,8
63,2025-05-25T10:44:00+02:00,2025-05-25,18:44,0,3,3
63,2025-05-25T10:45:00+02:00,2025-05-25,18:45,0,2,2
63,2025-05-25T10:47:00+02:00,2025-05-25,18:47,0,9,9
63,2025-05-25T10:51:00+02:00,2025-05-25,18:51,0,3,3
63,2025-05-25T10:54:00+02:00,2025-05-25,18:54,0,4,4
67,2025-05-25T10:40:00+02:00,2025-05-25,18:40,5,7,12
67,2025-05-25T10:46:00+02:00,2025-05-25,18:46,7,6,13
67,2025-05-25T10:49:00+02:00,2025-05-25,18:49,2,2,4
67,2025-05-25T10:51:00+02:00,2025-05-25,18:51,6,13,19
68,2025-05-25T10:40:00+02:00,2025-05-25,18:40,3,3,6
68,2025-05-25T10:41:00+02:00,2025-05-25,18:41,2,2,4
68,2025-05-25T10:46:00+02:00,2025-05-25,18:46,7,5,12
68,2025-05-25T10:54:00+02:00,2025-05-25,18:54,3,1,4
72,2025-05-25T10:44:00+02:00,2025-05-25,18:44,6,20,26
72,2025-05-25T10:46:00+02:00,2025-05-25,18:46,1,5,6
72,2025-05-25T10:49:00+02:00,2025-05-25,18:49,3,13,16
72,2025-05-25T10:50:00+02:00,2025-05-25,18:50,6,4,10
72,2025-05-25T10:51:00+02:00,2025-05-25,18:51,17,0,17
76,2025-05-25T10:40:00+02:00,2025-05-25,18:40,0,2,2
76,2025-05-25T10:48:00+02:00,2025-05-25,18:48,0,1,1
76,2025-05-25T10:53:00+02:00,2025-05-25,18:53,0,1,1
79,2025-05-25T10:40:00+02:00,2025-05-25,18:40,18,6,24
79,2025-05-25T10:44:00+02:00,2025-05-25,18:44,12,13,25
79,2025-05-25T10:47:00+02:00,2025-05-25,18:47,10,15,25
79,2025-05-25T10:50:00+02:00,2025-05-25,18:50,2,18,20
85,2025-05-25T10:40:00+02:00,2025-05-25,18:40,3,1,4
85,2025-05-25T10:41:00+02:00,2025-05-25,18:41,0,1,1
85,2025-05-25T10:47:00+02:00,2025-05-25,18:47,1,0,1
85,2025-05-25T10:49:00+02:00,2025-05-25,18:49,0,3,3
85,2025-05-25T10:51:00+02:00,2025-05-25,18:51,0,1,1
85,2025-05-25T10:54:00+02:00,2025-05-25,18:54,0,2,2
86,2025-05-25T10:41:00+02:00,2025-05-25,18:41,3,0,3
86,2025-05-25T10:42:00+02:00,2025-05-25,18:42,0,2,2
86,2025-05-25T10:53:00+02:00,2025-05-25,18:53,0,3,3
109,2025-05-25T10:45:00+02:00,2025-05-25,18:45,5,14,19
117,2025-05-25T10:40:00+02:00,2025-05-25,18:40,23,34,57
117,2025-05-25T10:50:00+02:00,2025-05-25,18:50,13,10,23
123,2025-05-25T10:40:00+02:00,2025-05-25,18:40,1,0,1
136,2025-05-25T10:50:00+02:00,2025-05-25,18:50,1,5,6
137,2025-05-25T10:45:00+02:00,2025-05-25,18:45,0,1,1
137,2025-05-25T10:50:00+02:00,2025-05-25,18:50,1,1,2
141,2025-05-25T10:45:00+02:00,2025-05-25,18:45,16,11,27
141,2025-05-25T10:50:00+02:00,2025-05-25,18:50,5,13,18
142,2025-05-25T10:40:00+02:00,2025-05-25,18:40,7,3,10
142,2025-05-25T10:45:00+02:00,2025-05-25,18:45,13,3,16
161,2025-05-25T10:50:00+02:00,2025-05-25,18:50,0,1,1
164,2025-05-25T10:40:00+02:00,2025-05-25,18:40,16,13,29
164,2025-05-25T10:50:00+02:00,2025-05-25,18:50,3,5,8
3,2025-05-25T10:44:00+02:00,2025-05-25,18:44,13,12,25
3,2025-05-25T10:46:00+02:00,2025-05-25,18:46,14,29,43
3,2025-05-25T10:47:00+02:00,2025-05-25,18:47,27,16,43
3,2025-05-25T10:49:00+02:00,2025-05-25,18:49,5,23,28
4,2025-05-25T10:44:00+02:00,2025-05-25,18:44,11,19,30
4,2025-05-25T10:46:00+02:00,2025-05-25,18:46,17,22,39
4,2025-05-25T10:47:00+02:00,2025-05-25,18:47,31,21,52
4,2025-05-25T10:54:00+02:00,2025-05-25,18:54,19,13,32
5,2025-05-25T10:40:00+02:00,2025-05-25,18:40,31,112,143
6,2025-05-25T10:46:00+02:00,2025-05-25,18:46,11,18,29
6,2025-05-25T10:47:00+02:00,2025-05-25,18:47,16,9,25
8,2025-05-25T10:43:00+02:00,2025-05-25,18:43,1,0,1
8,2025-05-25T10:47:00+02:00,2025-05-25,18:47,0,1,1
21,2025-05-25T10:50:00+02:00,2025-05-25,18:50,24,45,69
28,2025-05-25T10:40:00+02:00,2025-05-25,18:40,15,10,25
28,2025-05-25T10:42:00+02:00,2025-05-25,18:42,7,17,24
28,2025-05-25T10:44:00+02:00,2025-05-25,18:44,5,12,17
28,2025-05-25T10:45:00+02:00,2025-05-25,18:45,4,8,12
28,2025-05-25T10:46:00+02:00,2025-05-25,18:46,8,18,26
28,2025-05-25T10:47:00+02:00,2025-05-25,18:47,6,11,17
28,2025-05-25T10:50:00+02:00,2025-05-25,18:50,1,14,15
28,2025-05-25T10:51:00+02:00,2025-05-25,18:51,4,16,20
29,2025-05-25T10:41:00+02:00,2025-05-25,18:41,2,16,18
29,2025-05-25T10:42:00+02:00,2025-05-25,18:42,3,6,9
29,2025-05-25T10:49:00+02:00,2025-05-25,18:49,4,4,8
29,2025-05-25T10:51:00+02:00,2025-05-25,18:51,8,4,12
31,2025-05-25T10:41:00+02:00,2025-05-25,18:41,3,2,5
31,2025-05-25T10:43:00+02:00,2025-05-25,18:43,7,2,9
31,2025-05-25T10:47:00+02:00,2025-05-25,18:47,3,0,3
36,2025-05-25T10:41:00+02:00,2025-05-25,18:41,4,0,4
36,2025-05-25T10:48:00+02:00,2025-05-25,18:48,2,3,5
36,2025-05-25T10:50:00+02:00,2025-05-25,18:50,2,1,3
39,2025-05-25T10:54:00+02:00,2025-05-25,18:54,3,1,4
40,2025-05-25T10:40:00+02:00,2025-05-25,18:40,2,1,3
40,2025-05-25T10:46:00+02:00,2025-05-25,18:46,0,1,1
40,2025-05-25T10:47:00+02:00,2025-05-25,18:47,3,1,4
40,2025-05-25T10:51:00+02:00,2025-05-25,18:51,1,1,2
40,2025-05-25T10:53:00+02:00,2025-05-25,18:53,5,0,5
181,2025-05-25T10:44:00+02:00,2025-05-25,18:44,12,6,18
181,2025-05-25T10:46:00+02:00,2025-05-25,18:46,17,16,33
181,2025-05-25T10:47:00+02:00,2025-05-25,18:47,16,14,30
181,2025-05-25T10:54:00+02:00,2025-05-25,18:54,12,21,33
182,2025-05-25T10:40:00+02:00,2025-05-25,18:40,26,21,47
182,2025-05-25T10:45:00+02:00,2025-05-25,18:45,25,15,40
3,2025-05-25T10:56:00+02:00,2025-05-25,18:56,12,32,44
3,2025-05-25T10:57:00+02:00,2025-05-25,18:57,24,7,31
3,2025-05-25T10:58:00+02:00,2025-05-25,18:58,12,9,21
3,2025-05-25T10:59:00+02:00,2025-05-25,18:59,19,22,41
3,2025-05-25T11:01:00+02:00,2025-05-25,19:01,19,26,45
3,2025-05-25T11:02:00+02:00,2025-05-25,19:02,24,21,45
3,2025-05-25T11:03:00+02:00,2025-05-25,19:03,20,9,29
3,2025-05-25T11:05:00+02:00,2025-05-25,19:05,16,12,28
3,2025-05-25T11:06:00+02:00,2025-05-25,19:06,12,13,25
3,2025-05-25T11:09:00+02:00,2025-05-25,19:09,19,18,37
4,2025-05-25T11:01:00+02:00,2025-05-25,19:01,11,16,27
4,2025-05-25T11:02:00+02:00,2025-05-25,19:02,23,21,44
4,2025-05-25T11:08:00+02:00,2025-05-25,19:08,23,21,44
6,2025-05-25T10:56:00+02:00,2025-05-25,18:56,6,31,37
6,2025-05-25T10:57:00+02:00,2025-05-25,18:57,10,5,15
28,2025-05-25T10:55:00+02:00,2025-05-25,18:55,3,10,13
28,2025-05-25T11:01:00+02:00,2025-05-25,19:01,1,2,3
28,2025-05-25T11:05:00+02:00,2025-05-25,19:05,3,10,13
28,2025-05-25T11:09:00+02:00,2025-05-25,19:09,3,13,16
29,2025-05-25T10:55:00+02:00,2025-05-25,18:55,0,7,7
29,2025-05-25T11:03:00+02:00,2025-05-25,19:03,4,8,12
29,2025-05-25T11:04:00+02:00,2025-05-25,19:04,8,15,23
31,2025-05-25T10:55:00+02:00,2025-05-25,18:55,1,2,3
31,2025-05-25T10:57:00+02:00,2025-05-25,18:57,6,7,13
31,2025-05-25T10:59:00+02:00,2025-05-25,18:59,6,4,10
31,2025-05-25T11:02:00+02:00,2025-05-25,19:02,3,3,6
31,2025-05-25T11:04:00+02:00,2025-05-25,19:04,4,4,8
31,2025-05-25T11:05:00+02:00,2025-05-25,19:05,7,1,8
31,2025-05-25T11:08:00+02:00,2025-05-25,19:08,3,6,9
36,2025-05-25T10:58:00+02:00,2025-05-25,18:58,3,1,4
36,2025-05-25T11:06:00+02:00,2025-05-25,19:06,0,4,4
36,2025-05-25T11:08:00+02:00,2025-05-25,19:08,0,3,3
39,2025-05-25T10:57:00+02:00,2025-05-25,18:57,1,0,1
39,2025-05-25T10:59:00+02:00,2025-05-25,18:59,3,0,3
39,2025-05-25T11:06:00+02:00,2025-05-25,19:06,1,1,2
39,2025-05-25T11:07:00+02:00,2025-05-25,19:07,3,0,3
40,2025-05-25T10:57:00+02:00,2025-05-25,18:57,2,0,2
40,2025-05-25T10:58:00+02:00,2025-05-25,18:58,1,4,5
40,2025-05-25T11:01:00+02:00,2025-05-25,19:01,1,0,1
40,2025-05-25T11:05:00+02:00,2025-05-25,19:05,3,0,3
40,2025-05-25T11:08:00+02:00,2025-05-25,19:08,0,2,2
41,2025-05-25T10:56:00+02:00,2025-05-25,18:56,2,9,11
41,2025-05-25T10:57:00+02:00,2025-05-25,18:57,0,1,1
41,2025-05-25T10:58:00+02:00,2025-05-25,18:58,19,3,22
41,2025-05-25T11:01:00+02:00,2025-05-25,19:01,1,1,2
41,2025-05-25T11:05:00+02:00,2025-05-25,19:05,3,15,18
41,2025-05-25T11:06:00+02:00,2025-05-25,19:06,3,7,10
41,2025-05-25T11:09:00+02:00,2025-05-25,19:09,3,13,16
43,2025-05-25T10:55:00+02:00,2025-05-25,18:55,9,5,14
43,2025-05-25T11:00:00+02:00,2025-05-25,19:00,1,4,5
43,2025-05-25T11:05:00+02:00,2025-05-25,19:05,2,1,3
44,2025-05-25T10:55:00+02:00,2025-05-25,18:55,2,5,7
44,2025-05-25T11:00:00+02:00,2025-05-25,19:00,3,1,4
44,2025-05-25T11:05:00+02:00,2025-05-25,19:05,3,2,5
45,2025-05-25T10:57:00+02:00,2025-05-25,18:57,9,8,17
45,2025-05-25T11:01:00+02:00,2025-05-25,19:01,14,12,26
45,2025-05-25T11:02:00+02:00,2025-05-25,19:02,15,9,24
45,2025-05-25T11:04:00+02:00,2025-05-25,19:04,20,14,34
45,2025-05-25T11:05:00+02:00,2025-05-25,19:05,6,22,28
45,2025-05-25T11:09:00+02:00,2025-05-25,19:09,9,22,31
47,2025-05-25T10:57:00+02:00,2025-05-25,18:57,7,29,36
47,2025-05-25T11:01:00+02:00,2025-05-25,19:01,12,0,12
47,2025-05-25T11:03:00+02:00,2025-05-25,19:03,22,9,31
47,2025-05-25T11:05:00+02:00,2025-05-25,19:05,15,13,28
47,2025-05-25T11:08:00+02:00,2025-05-25,19:08,18,16,34
50,2025-05-25T10:56:00+02:00,2025-05-25,18:56,5,3,8
50,2025-05-25T10:58:00+02:00,2025-05-25,18:58,5,1,6
50,2025-05-25T10:59:00+02:00,2025-05-25,18:59,2,0,2
50,2025-05-25T11:03:00+02:00,2025-05-25,19:03,5,3,8
50,2025-05-25T11:07:00+02:00,2025-05-25,19:07,2,0,2
54,2025-05-25T10:57:00+02:00,2025-05-25,18:57,3,0,3
54,2025-05-25T10:58:00+02:00,2025-05-25,18:58,3,1,4
54,2025-05-25T11:04:00+02:00,2025-05-25,19:04,1,2,3
54,2025-05-25T11:05:00+02:00,2025-05-25,19:05,1,4,5
54,2025-05-25T11:07:00+02:00,2025-05-25,19:07,7,1,8
59,2025-05-25T11:00:00+02:00,2025-05-25,19:00,14,31,45
59,2025-05-25T11:05:00+02:00,2025-05-25,19:05,24,10,34
61,2025-05-25T10:55:00+02:00,2025-05-25,18:55,3,2,5
61,2025-05-25T11:02:00+02:00,2025-05-25,19:02,3,3,6
61,2025-05-25T11:03:00+02:00,2025-05-25,19:03,1,1,2
61,2025-05-25T11:06:00+02:00,2025-05-25,19:06,5,5,10
61,2025-05-25T11:07:00+02:00,2025-05-25,19:07,6,4,10
66,2025-05-25T10:57:00+02:00,2025-05-25,18:57,23,9,32
66,2025-05-25T10:58:00+02:00,2025-05-25,18:58,21,9,30
66,2025-05-25T10:59:00+02:00,2025-05-25,18:59,22,7,29
66,2025-05-25T11:00:00+02:00,2025-05-25,19:00,34,9,43
66,2025-05-25T11:02:00+02:00,2025-05-25,19:02,23,24,47
66,2025-05-25T11:05:00+02:00,2025-05-25,19:05,12,22,34
66,2025-05-25T11:06:00+02:00,2025-05-25,19:06,25,27,52
66,2025-05-25T11:07:00+02:00,2025-05-25,19:07,31,26,57
66,2025-05-25T11:08:00+02:00,2025-05-25,19:08,11,26,37
69,2025-05-25T10:56:00+02:00,2025-05-25,18:56,1,0,1
70,2025-05-25T10:55:00+02:00,2025-05-25,18:55,3,8,11
70,2025-05-25T10:59:00+02:00,2025-05-25,18:59,0,13,13
70,2025-05-25T11:01:00+02:00,2025-05-25,19:01,4,0,4
70,2025-05-25T11:08:00+02:00,2025-05-25,19:08,3,4,7
71,2025-05-25T10:56:00+02:00,2025-05-25,18:56,0,1,1
77,2025-05-25T10:55:00+02:00,2025-05-25,18:55,13,9,22
78,2025-05-25T11:08:00+02:00,2025-05-25,19:08,3,0,3
84,2025-05-25T11:00:00+02:00,2025-05-25,19:00,71,76,147
87,2025-05-25T10:57:00+02:00,2025-05-25,18:57,1,2,3
87,2025-05-25T11:04:00+02:00,2025-05-25,19:04,0,1,1
87,2025-05-25T11:06:00+02:00,2025-05-25,19:06,0,2,2
107,2025-05-25T11:05:00+02:00,2025-05-25,19:05,7,2,9
108,2025-05-25T11:01:00+02:00,2025-05-25,19:01,4,2,6
108,2025-05-25T11:02:00+02:00,2025-05-25,19:02,0,1,1
108,2025-05-25T11:06:00+02:00,2025-05-25,19:06,5,4,9
108,2025-05-25T11:08:00+02:00,2025-05-25,19:08,8,1,9
118,2025-05-25T11:05:00+02:00,2025-05-25,19:05,1,0,1
131,2025-05-25T11:05:00+02:00,2025-05-25,19:05,3,11,14
132,2025-05-25T10:55:00+02:00,2025-05-25,18:55,6,8,14
132,2025-05-25T11:00:00+02:00,2025-05-25,19:00,13,9,22
132,2025-05-25T11:05:00+02:00,2025-05-25,19:05,10,3,13
133,2025-05-25T11:00:00+02:00,2025-05-25,19:00,43,29,72
167,2025-05-25T10:55:00+02:00,2025-05-25,18:55,1,2,3
1,2025-05-25T10:59:00+02:00,2025-05-25,18:59,11,13,24
1,2025-05-25T11:04:00+02:00,2025-05-25,19:04,9,13,22
2,2025-05-25T11:00:00+02:00,2025-05-25,19:00,2,4,6
2,2025-05-25T11:07:00+02:00,2025-05-25,19:07,2,1,3
2,2025-05-25T11:08:00+02:00,2025-05-25,19:08,3,6,9
9,2025-05-25T10:56:00+02:00,2025-05-25,18:56,2,0,2
9,2025-05-25T11:07:00+02:00,2025-05-25,19:07,2,2,4
10,2025-05-25T10:55:00+02:00,2025-05-25,18:55,3,0,3
10,2025-05-25T10:56:00+02:00,2025-05-25,18:56,1,0,1
10,2025-05-25T10:57:00+02:00,2025-05-25,18:57,2,0,2
10,2025-05-25T10:58:00+02:00,2025-05-25,18:58,2,0,2
10,2025-05-25T11:03:00+02:00,2025-05-25,19:03,0,4,4
10,2025-05-25T11:07:00+02:00,2025-05-25,19:07,1,0,1
11,2025-05-25T11:05:00+02:00,2025-05-25,19:05,6,4,10
12,2025-05-25T10:56:00+02:00,2025-05-25,18:56,0,4,4
12,2025-05-25T10:58:00+02:00,2025-05-25,18:58,0,2,2
12,2025-05-25T11:03:00+02:00,2025-05-25,19:03,2,4,6
12,2025-05-25T11:04:00+02:00,2025-05-25,19:04,3,5,8
12,2025-05-25T11:06:00+02:00,2025-05-25,19:06,3,2,5
12,2025-05-25T11:08:00+02:00,2025-05-25,19:08,5,0,5
12,2025-05-25T11:09:00+02:00,2025-05-25,19:09,1,4,5
17,2025-05-25T10:57:00+02:00,2025-05-25,18:57,1,0,1
17,2025-05-25T11:01:00+02:00,2025-05-25,19:01,5,0,5
17,2025-05-25T11:03:00+02:00,2025-05-25,19:03,2,0,2
17,2025-05-25T11:04:00+02:00,2025-05-25,19:04,1,0,1
17,2025-05-25T11:09:00+02:00,2025-05-25,19:09,2,2,4
19,2025-05-25T11:00:00+02:00,2025-05-25,19:00,7,9,16
19,2025-05-25T11:02:00+02:00,2025-05-25,19:02,10,14,24
19,2025-05-25T11:03:00+02:00,2025-05-25,19:03,22,8,30
19,2025-05-25T11:04:00+02:00,2025-05-25,19:04,8,15,23
19,2025-05-25T11:05:00+02:00,2025-05-25,19:05,11,19,30
19,2025-05-25T11:09:00+02:00,2025-05-25,19:09,16,5,21
20,2025-05-25T11:00:00+02:00,2025-05-25,19:00,12,13,25
20,2025-05-25T11:01:00+02:00,2025-05-25,19:01,14,2,16
20,2025-05-25T11:03:00+02:00,2025-05-25,19:03,12,5,17
20,2025-05-25T11:04:00+02:00,2025-05-25,19:04,8,4,12
20,2025-05-25T11:06:00+02:00,2025-05-25,19:06,6,11,17
23,2025-05-25T10:57:00+02:00,2025-05-25,18:57,0,1,1
23,2025-05-25T10:58:00+02:00,2025-05-25,18:58,0,1,1
23,2025-05-25T10:59:00+02:00,2025-05-25,18:59,1,1,2
23,2025-05-25T11:00:00+02:00,2025-05-25,19:00,3,5,8
23,2025-05-25T11:02:00+02:00,2025-05-25,19:02,4,2,6
23,2025-05-25T11:05:00+02:00,2025-05-25,19:05,0,7,7
24,2025-05-25T10:57:00+02:00,2025-05-25,18:57,8,0,8
24,2025-05-25T10:58:00+02:00,2025-05-25,18:58,18,8,26
24,2025-05-25T11:01:00+02:00,2025-05-25,19:01,6,4,10
24,2025-05-25T11:05:00+02:00,2025-05-25,19:05,3,7,10
25,2025-05-25T10:55:00+02:00,2025-05-25,18:55,26,27,53
27,2025-05-25T10:59:00+02:00,2025-05-25,18:59,0,1,1
30,2025-05-25T11:01:00+02:00,2025-05-25,19:01,11,11,22
30,2025-05-25T11:03:00+02:00,2025-05-25,19:03,2,9,11
30,2025-05-25T11:05:00+02:00,2025-05-25,19:05,8,2,10
35,2025-05-25T10:59:00+02:00,2025-05-25,18:59,12,21,33
35,2025-05-25T11:03:00+02:00,2025-05-25,19:03,5,11,16
35,2025-05-25T11:04:00+02:00,2025-05-25,19:04,9,17,26
35,2025-05-25T11:05:00+02:00,2025-05-25,19:05,9,13,22
35,2025-05-25T11:06:00+02:00,2025-05-25,19:06,13,6,19
35,2025-05-25T11:07:00+02:00,2025-05-25,19:07,7,14,21
35,2025-05-25T11:08:00+02:00,2025-05-25,19:08,12,3,15
35,2025-05-25T11:09:00+02:00,2025-05-25,19:09,7,12,19
48,2025-05-25T11:01:00+02:00,2025-05-25,19:01,7,2,9
48,2025-05-25T11:08:00+02:00,2025-05-25,19:08,2,4,6
49,2025-05-25T10:57:00+02:00,2025-05-25,18:57,6,2,8
49,2025-05-25T10:58:00+02:00,2025-05-25,18:58,6,2,8
49,2025-05-25T11:01:00+02:00,2025-05-25,19:01,4,4,8
49,2025-05-25T11:02:00+02:00,2025-05-25,19:02,9,4,13
49,2025-05-25T11:05:00+02:00,2025-05-25,19:05,2,1,3
49,2025-05-25T11:06:00+02:00,2025-05-25,19:06,5,1,6
49,2025-05-25T11:09:00+02:00,2025-05-25,19:09,0,3,3
51,2025-05-25T10:56:00+02:00,2025-05-25,18:56,4,1,5
51,2025-05-25T11:00:00+02:00,2025-05-25,19:00,6,2,8
51,2025-05-25T11:04:00+02:00,2025-05-25,19:04,4,3,7
52,2025-05-25T10:56:00+02:00,2025-05-25,18:56,4,7,11
52,2025-05-25T10:57:00+02:00,2025-05-25,18:57,3,2,5
52,2025-05-25T11:00:00+02:00,2025-05-25,19:00,3,9,12
52,2025-05-25T11:01:00+02:00,2025-05-25,19:01,12,10,22
52,2025-05-25T11:04:00+02:00,2025-05-25,19:04,3,7,10
52,2025-05-25T11:05:00+02:00,2025-05-25,19:05,6,5,11
52,2025-05-25T11:08:00+02:00,2025-05-25,19:08,10,7,17
53,2025-05-25T10:55:00+02:00,2025-05-25,18:55,4,4,8
53,2025-05-25T10:57:00+02:00,2025-05-25,18:57,3,6,9
53,2025-05-25T10:58:00+02:00,2025-05-25,18:58,1,2,3
53,2025-05-25T11:00:00+02:00,2025-05-25,19:00,3,0,3
53,2025-05-25T11:02:00+02:00,2025-05-25,19:02,2,5,7
53,2025-05-25T11:05:00+02:00,2025-05-25,19:05,7,0,7
53,2025-05-25T11:06:00+02:00,2025-05-25,19:06,1,10,11
53,2025-05-25T11:09:00+02:00,2025-05-25,19:09,5,2,7
56,2025-05-25T10:56:00+02:00,2025-05-25,18:56,3,5,8
56,2025-05-25T10:57:00+02:00,2025-05-25,18:57,5,12,17
56,2025-05-25T10:59:00+02:00,2025-05-25,18:59,4,9,13
58,2025-05-25T10:57:00+02:00,2025-05-25,18:57,13,4,17
58,2025-05-25T10:59:00+02:00,2025-05-25,18:59,3,5,8
58,2025-05-25T11:01:00+02:00,2025-05-25,19:01,6,6,12
58,2025-05-25T11:02:00+02:00,2025-05-25,19:02,8,4,12
58,2025-05-25T11:07:00+02:00,2025-05-25,19:07,17,4,21
58,2025-05-25T11:09:00+02:00,2025-05-25,19:09,4,2,6
62,2025-05-25T10:57:00+02:00,2025-05-25,18:57,3,3,6
62,2025-05-25T10:58:00+02:00,2025-05-25,18:58,1,1,2
62,2025-05-25T11:01:00+02:00,2025-05-25,19:01,1,2,3
62,2025-05-25T11:02:00+02:00,2025-05-25,19:02,5,3,8
62,2025-05-25T11:04:00+02:00,2025-05-25,19:04,1,8,9
62,2025-05-25T11:05:00+02:00,2025-05-25,19:05,2,6,8
62,2025-05-25T11:06:00+02:00,2025-05-25,19:06,4,5,9
62,2025-05-25T11:09:00+02:00,2025-05-25,19:09,2,11,13
63,2025-05-25T10:56:00+02:00,2025-05-25,18:56,0,2,2
63,2025-05-25T10:57:00+02:00,2025-05-25,18:57,0,1,1
63,2025-05-25T11:00:00+02:00,2025-05-25,19:00,0,1,1
67,2025-05-25T10:57:00+02:00,2025-05-25,18:57,1,3,4
67,2025-05-25T11:02:00+02:00,2025-05-25,19:02,4,0,4
67,2025-05-25T11:04:00+02:00,2025-05-25,19:04,1,3,4
67,2025-05-25T11:05:00+02:00,2025-05-25,19:05,1,3,4
67,2025-05-25T11:09:00+02:00,2025-05-25,19:09,0,7,7
68,2025-05-25T10:58:00+02:00,2025-05-25,18:58,2,1,3
68,2025-05-25T11:00:00+02:00,2025-05-25,19:00,4,1,5
68,2025-05-25T11:03:00+02:00,2025-05-25,19:03,4,1,5
72,2025-05-25T10:55:00+02:00,2025-05-25,18:55,4,4,8
72,2025-05-25T10:58:00+02:00,2025-05-25,18:58,3,8,11
72,2025-05-25T11:02:00+02:00,2025-05-25,19:02,2,2,4
72,2025-05-25T11:03:00+02:00,2025-05-25,19:03,6,3,9
76,2025-05-25T10:59:00+02:00,2025-05-25,18:59,3,1,4
79,2025-05-25T10:57:00+02:00,2025-05-25,18:57,11,1,12
79,2025-05-25T11:00:00+02:00,2025-05-25,19:00,5,1,6
79,2025-05-25T11:02:00+02:00,2025-05-25,19:02,4,9,13
79,2025-05-25T11:06:00+02:00,2025-05-25,19:06,6,2,8
79,2025-05-25T11:07:00+02:00,2025-05-25,19:07,10,4,14
79,2025-05-25T11:08:00+02:00,2025-05-25,19:08,5,3,8
79,2025-05-25T11:09:00+02:00,2025-05-25,19:09,3,10,13
85,2025-05-25T11:04:00+02:00,2025-05-25,19:04,1,0,1
85,2025-05-25T11:09:00+02:00,2025-05-25,19:09,0,1,1
86,2025-05-25T11:01:00+02:00,2025-05-25,19:01,2,0,2
86,2025-05-25T11:02:00+02:00,2025-05-25,19:02,0,5,5
86,2025-05-25T11:03:00+02:00,2025-05-25,19:03,0,1,1
86,2025-05-25T11:04:00+02:00,2025-05-25,19:04,2,0,2
86,2025-05-25T11:05:00+02:00,2025-05-25,19:05,3,2,5
86,2025-05-25T11:08:00+02:00,2025-05-25,19:08,3,0,3
109,2025-05-25T11:00:00+02:00,2025-05-25,19:00,10,13,23
117,2025-05-25T11:00:00+02:00,2025-05-25,19:00,10,20,30
117,2025-05-25T11:05:00+02:00,2025-05-25,19:05,22,3,25
130,2025-05-25T11:00:00+02:00,2025-05-25,19:00,2,4,6
136,2025-05-25T10:55:00+02:00,2025-05-25,18:55,0,2,2
136,2025-05-25T11:05:00+02:00,2025-05-25,19:05,3,2,5
142,2025-05-25T10:55:00+02:00,2025-05-25,18:55,19,0,19
164,2025-05-25T11:05:00+02:00,2025-05-25,19:05,4,2,6
181,2025-05-25T10:56:00+02:00,2025-05-25,18:56,17,18,35
181,2025-05-25T10:58:00+02:00,2025-05-25,18:58,21,8,29
181,2025-05-25T11:01:00+02:00,2025-05-25,19:01,13,18,31
181,2025-05-25T11:05:00+02:00,2025-05-25,19:05,13,14,27
181,2025-05-25T11:06:00+02:00,2025-05-25,19:06,28,8,36
181,2025-05-25T11:07:00+02:00,2025-05-25,19:07,20,22,42
181,2025-05-25T11:09:00+02:00,2025-05-25,19:09,9,8,17
180,2025-05-25T11:06:00+02:00,2025-05-25,19:06,0,1,1
3,2025-05-25T11:14:00+02:00,2025-05-25,19:14,8,17,25
3,2025-05-25T11:20:00+02:00,2025-05-25,19:20,10,18,28
3,2025-05-25T11:23:00+02:00,2025-05-25,19:23,13,24,37
3,2025-05-25T11:24:00+02:00,2025-05-25,19:24,7,9,16
4,2025-05-25T11:12:00+02:00,2025-05-25,19:12,12,18,30
4,2025-05-25T11:14:00+02:00,2025-05-25,19:14,39,20,59
4,2025-05-25T11:16:00+02:00,2025-05-25,19:16,19,31,50
4,2025-05-25T11:17:00+02:00,2025-05-25,19:17,23,23,46
4,2025-05-25T11:21:00+02:00,2025-05-25,19:21,16,16,32
4,2025-05-25T11:22:00+02:00,2025-05-25,19:22,17,26,43
6,2025-05-25T11:10:00+02:00,2025-05-25,19:10,13,7,20
6,2025-05-25T11:13:00+02:00,2025-05-25,19:13,8,6,14
6,2025-05-25T11:16:00+02:00,2025-05-25,19:16,11,7,18
6,2025-05-25T11:20:00+02:00,2025-05-25,19:20,8,7,15
8,2025-05-25T11:13:00+02:00,2025-05-25,19:13,0,1,1
8,2025-05-25T11:21:00+02:00,2025-05-25,19:21,1,0,1
8,2025-05-25T11:23:00+02:00,2025-05-25,19:23,0,2,2
21,2025-05-25T11:10:00+02:00,2025-05-25,19:10,55,28,83
28,2025-05-25T11:10:00+02:00,2025-05-25,19:10,3,19,22
28,2025-05-25T11:11:00+02:00,2025-05-25,19:11,0,11,11
28,2025-05-25T11:16:00+02:00,2025-05-25,19:16,6,12,18
28,2025-05-25T11:19:00+02:00,2025-05-25,19:19,0,6,6
28,2025-05-25T11:24:00+02:00,2025-05-25,19:24,8,15,23
29,2025-05-25T11:10:00+02:00,2025-05-25,19:10,10,3,13
29,2025-05-25T11:14:00+02:00,2025-05-25,19:14,3,6,9
29,2025-05-25T11:19:00+02:00,2025-05-25,19:19,3,7,10
29,2025-05-25T11:21:00+02:00,2025-05-25,19:21,4,3,7
29,2025-05-25T11:24:00+02:00,2025-05-25,19:24,3,2,5
31,2025-05-25T11:20:00+02:00,2025-05-25,19:20,3,0,3
36,2025-05-25T11:10:00+02:00,2025-05-25,19:10,2,1,3
36,2025-05-25T11:12:00+02:00,2025-05-25,19:12,0,1,1
36,2025-05-25T11:22:00+02:00,2025-05-25,19:22,2,0,2
36,2025-05-25T11:24:00+02:00,2025-05-25,19:24,0,1,1
40,2025-05-25T11:11:00+02:00,2025-05-25,19:11,1,5,6
41,2025-05-25T11:12:00+02:00,2025-05-25,19:12,3,7,10
41,2025-05-25T11:18:00+02:00,2025-05-25,19:18,12,0,12
41,2025-05-25T11:20:00+02:00,2025-05-25,19:20,3,2,5
41,2025-05-25T11:23:00+02:00,2025-05-25,19:23,9,21,30
43,2025-05-25T11:20:00+02:00,2025-05-25,19:20,5,1,6
44,2025-05-25T11:20:00+02:00,2025-05-25,19:20,2,1,3
45,2025-05-25T11:13:00+02:00,2025-05-25,19:13,10,20,30
45,2025-05-25T11:17:00+02:00,2025-05-25,19:17,13,14,27
45,2025-05-25T11:24:00+02:00,2025-05-25,19:24,8,20,28
47,2025-05-25T11:15:00+02:00,2025-05-25,19:15,19,10,29
47,2025-05-25T11:19:00+02:00,2025-05-25,19:19,13,6,19
47,2025-05-25T11:20:00+02:00,2025-05-25,19:20,3,8,11
50,2025-05-25T11:12:00+02:00,2025-05-25,19:12,2,0,2
50,2025-05-25T11:13:00+02:00,2025-05-25,19:13,1,1,2
50,2025-05-25T11:14:00+02:00,2025-05-25,19:14,4,1,5
50,2025-05-25T11:20:00+02:00,2025-05-25,19:20,4,8,12
50,2025-05-25T11:22:00+02:00,2025-05-25,19:22,1,1,2
50,2025-05-25T11:23:00+02:00,2025-05-25,19:23,4,3,7
50,2025-05-25T11:24:00+02:00,2025-05-25,19:24,2,2,4
54,2025-05-25T11:13:00+02:00,2025-05-25,19:13,1,1,2
59,2025-05-25T11:15:00+02:00,2025-05-25,19:15,17,30,47
59,2025-05-25T11:20:00+02:00,2025-05-25,19:20,17,37,54
61,2025-05-25T11:10:00+02:00,2025-05-25,19:10,1,4,5
61,2025-05-25T11:12:00+02:00,2025-05-25,19:12,5,5,10
61,2025-05-25T11:13:00+02:00,2025-05-25,19:13,6,5,11
61,2025-05-25T11:16:00+02:00,2025-05-25,19:16,1,1,2
66,2025-05-25T11:14:00+02:00,2025-05-25,19:14,15,27,42
66,2025-05-25T11:15:00+02:00,2025-05-25,19:15,31,1,32
66,2025-05-25T11:21:00+02:00,2025-05-25,19:21,12,13,25
69,2025-05-25T11:12:00+02:00,2025-05-25,19:12,0,1,1
69,2025-05-25T11:18:00+02:00,2025-05-25,19:18,0,2,2
70,2025-05-25T11:13:00+02:00,2025-05-25,19:13,4,4,8
70,2025-05-25T11:15:00+02:00,2025-05-25,19:15,2,5,7
70,2025-05-25T11:24:00+02:00,2025-05-25,19:24,0,1,1
71,2025-05-25T11:15:00+02:00,2025-05-25,19:15,0,1,1
71,2025-05-25T11:23:00+02:00,2025-05-25,19:23,1,0,1
77,2025-05-25T11:10:00+02:00,2025-05-25,19:10,12,3,15
78,2025-05-25T11:14:00+02:00,2025-05-25,19:14,0,1,1
78,2025-05-25T11:18:00+02:00,2025-05-25,19:18,0,1,1
78,2025-05-25T11:22:00+02:00,2025-05-25,19:22,0,3,3
78,2025-05-25T11:24:00+02:00,2025-05-25,19:24,0,1,1
87,2025-05-25T11:14:00+02:00,2025-05-25,19:14,0,1,1
87,2025-05-25T11:15:00+02:00,2025-05-25,19:15,2,2,4
87,2025-05-25T11:23:00+02:00,2025-05-25,19:23,2,0,2
107,2025-05-25T11:15:00+02:00,2025-05-25,19:15,4,4,8
107,2025-05-25T11:20:00+02:00,2025-05-25,19:20,4,10,14
108,2025-05-25T11:13:00+02:00,2025-05-25,19:13,3,10,13
108,2025-05-25T11:18:00+02:00,2025-05-25,19:18,2,0,2
108,2025-05-25T11:24:00+02:00,2025-05-25,19:24,0,1,1
131,2025-05-25T11:10:00+02:00,2025-05-25,19:10,7,5,12
131,2025-05-25T11:20:00+02:00,2025-05-25,19:20,2,1,3
132,2025-05-25T11:10:00+02:00,2025-05-25,19:10,2,17,19
132,2025-05-25T11:15:00+02:00,2025-05-25,19:15,15,11,26
133,2025-05-25T11:10:00+02:00,2025-05-25,19:10,44,26,70
134,2025-05-25T11:15:00+02:00,2025-05-25,19:15,25,14,39
135,2025-05-25T11:20:00+02:00,2025-05-25,19:20,27,88,115
162,2025-05-25T11:10:00+02:00,2025-05-25,19:10,19,13,32
165,2025-05-25T11:10:00+02:00,2025-05-25,19:10,1,0,1
165,2025-05-25T11:20:00+02:00,2025-05-25,19:20,6,0,6
166,2025-05-25T11:20:00+02:00,2025-05-25,19:20,3,4,7
167,2025-05-25T11:20:00+02:00,2025-05-25,19:20,3,4,7
179,2025-05-25T11:15:00+02:00,2025-05-25,19:15,4,5,9
1,2025-05-25T11:15:00+02:00,2025-05-25,19:15,11,4,15
1,2025-05-25T11:17:00+02:00,2025-05-25,19:17,3,3,6
1,2025-05-25T11:20:00+02:00,2025-05-25,19:20,9,8,17
1,2025-05-25T11:23:00+02:00,2025-05-25,19:23,5,17,22
2,2025-05-25T11:14:00+02:00,2025-05-25,19:14,1,4,5
2,2025-05-25T11:17:00+02:00,2025-05-25,19:17,3,3,6
2,2025-05-25T11:18:00+02:00,2025-05-25,19:18,0,4,4
2,2025-05-25T11:22:00+02:00,2025-05-25,19:22,3,2,5
2,2025-05-25T11:24:00+02:00,2025-05-25,19:24,1,4,5
9,2025-05-25T11:11:00+02:00,2025-05-25,19:11,6,0,6
9,2025-05-25T11:14:00+02:00,2025-05-25,19:14,1,0,1
9,2025-05-25T11:21:00+02:00,2025-05-25,19:21,2,0,2
10,2025-05-25T11:10:00+02:00,2025-05-25,19:10,0,2,2
10,2025-05-25T11:14:00+02:00,2025-05-25,19:14,2,0,2
11,2025-05-25T11:15:00+02:00,2025-05-25,19:15,1,3,4
12,2025-05-25T11:12:00+02:00,2025-05-25,19:12,1,2,3
12,2025-05-25T11:13:00+02:00,2025-05-25,19:13,5,8,13
12,2025-05-25T11:15:00+02:00,2025-05-25,19:15,4,7,11
12,2025-05-25T11:16:00+02:00,2025-05-25,19:16,2,6,8
12,2025-05-25T11:17:00+02:00,2025-05-25,19:17,4,4,8
12,2025-05-25T11:20:00+02:00,2025-05-25,19:20,4,1,5
17,2025-05-25T11:20:00+02:00,2025-05-25,19:20,2,0,2
17,2025-05-25T11:22:00+02:00,2025-05-25,19:22,2,2,4
18,2025-05-25T11:24:00+02:00,2025-05-25,19:24,0,2,2
19,2025-05-25T11:10:00+02:00,2025-05-25,19:10,7,11,18
19,2025-05-25T11:14:00+02:00,2025-05-25,19:14,8,16,24
19,2025-05-25T11:15:00+02:00,2025-05-25,19:15,5,9,14
19,2025-05-25T11:16:00+02:00,2025-05-25,19:16,11,7,18
19,2025-05-25T11:17:00+02:00,2025-05-25,19:17,10,7,17
19,2025-05-25T11:18:00+02:00,2025-05-25,19:18,5,9,14
19,2025-05-25T11:19:00+02:00,2025-05-25,19:19,13,2,15
19,2025-05-25T11:22:00+02:00,2025-05-25,19:22,7,17,24
19,2025-05-25T11:23:00+02:00,2025-05-25,19:23,13,17,30
20,2025-05-25T11:17:00+02:00,2025-05-25,19:17,11,10,21
20,2025-05-25T11:20:00+02:00,2025-05-25,19:20,3,11,14
23,2025-05-25T11:16:00+02:00,2025-05-25,19:16,0,1,1
23,2025-05-25T11:18:00+02:00,2025-05-25,19:18,0,10,10
23,2025-05-25T11:19:00+02:00,2025-05-25,19:19,0,1,1
23,2025-05-25T11:21:00+02:00,2025-05-25,19:21,2,0,2
23,2025-05-25T11:22:00+02:00,2025-05-25,19:22,3,2,5
23,2025-05-25T11:23:00+02:00,2025-05-25,19:23,2,0,2
24,2025-05-25T11:10:00+02:00,2025-05-25,19:10,7,1,8
24,2025-05-25T11:11:00+02:00,2025-05-25,19:11,1,3,4
24,2025-05-25T11:16:00+02:00,2025-05-25,19:16,8,4,12
24,2025-05-25T11:23:00+02:00,2025-05-25,19:23,8,0,8
24,2025-05-25T11:24:00+02:00,2025-05-25,19:24,10,4,14
27,2025-05-25T11:12:00+02:00,2025-05-25,19:12,4,0,4
27,2025-05-25T11:16:00+02:00,2025-05-25,19:16,0,1,1
27,2025-05-25T11:18:00+02:00,2025-05-25,19:18,2,0,2
27,2025-05-25T11:23:00+02:00,2025-05-25,19:23,2,0,2
30,2025-05-25T11:11:00+02:00,2025-05-25,19:11,7,3,10
30,2025-05-25T11:13:00+02:00,2025-05-25,19:13,2,8,10
30,2025-05-25T11:16:00+02:00,2025-05-25,19:16,3,13,16
30,2025-05-25T11:18:00+02:00,2025-05-25,19:18,10,22,32
30,2025-05-25T11:19:00+02:00,2025-05-25,19:19,18,1,19
30,2025-05-25T11:21:00+02:00,2025-05-25,19:21,7,5,12
30,2025-05-25T11:23:00+02:00,2025-05-25,19:23,10,2,12
30,2025-05-25T11:24:00+02:00,2025-05-25,19:24,6,4,10
35,2025-05-25T11:11:00+02:00,2025-05-25,19:11,13,22,35
35,2025-05-25T11:18:00+02:00,2025-05-25,19:18,5,11,16
35,2025-05-25T11:20:00+02:00,2025-05-25,19:20,5,15,20
35,2025-05-25T11:21:00+02:00,2025-05-25,19:21,4,7,11
35,2025-05-25T11:22:00+02:00,2025-05-25,19:22,11,10,21
48,2025-05-25T11:10:00+02:00,2025-05-25,19:10,1,3,4
48,2025-05-25T11:19:00+02:00,2025-05-25,19:19,2,0,2
48,2025-05-25T11:21:00+02:00,2025-05-25,19:21,1,4,5
49,2025-05-25T11:10:00+02:00,2025-05-25,19:10,7,0,7
49,2025-05-25T11:11:00+02:00,2025-05-25,19:11,5,4,9
49,2025-05-25T11:23:00+02:00,2025-05-25,19:23,1,4,5
51,2025-05-25T11:13:00+02:00,2025-05-25,19:13,3,1,4
51,2025-05-25T11:15:00+02:00,2025-05-25,19:15,0,1,1
51,2025-05-25T11:24:00+02:00,2025-05-25,19:24,1,0,1
52,2025-05-25T11:12:00+02:00,2025-05-25,19:12,7,5,12
52,2025-05-25T11:24:00+02:00,2025-05-25,19:24,2,3,5
53,2025-05-25T11:16:00+02:00,2025-05-25,19:16,7,4,11
53,2025-05-25T11:17:00+02:00,2025-05-25,19:17,4,6,10
53,2025-05-25T11:24:00+02:00,2025-05-25,19:24,2,2,4
56,2025-05-25T11:14:00+02:00,2025-05-25,19:14,8,5,13
56,2025-05-25T11:15:00+02:00,2025-05-25,19:15,0,8,8
56,2025-05-25T11:17:00+02:00,2025-05-25,19:17,8,5,13
56,2025-05-25T11:24:00+02:00,2025-05-25,19:24,2,6,8
58,2025-05-25T11:11:00+02:00,2025-05-25,19:11,7,6,13
58,2025-05-25T11:14:00+02:00,2025-05-25,19:14,7,1,8
58,2025-05-25T11:21:00+02:00,2025-05-25,19:21,11,4,15
58,2025-05-25T11:23:00+02:00,2025-05-25,19:23,32,8,40
62,2025-05-25T11:10:00+02:00,2025-05-25,19:10,3,3,6
62,2025-05-25T11:15:00+02:00,2025-05-25,19:15,6,2,8
62,2025-05-25T11:22:00+02:00,2025-05-25,19:22,1,0,1
62,2025-05-25T11:23:00+02:00,2025-05-25,19:23,7,7,14
63,2025-05-25T11:12:00+02:00,2025-05-25,19:12,0,1,1
63,2025-05-25T11:13:00+02:00,2025-05-25,19:13,1,2,3
63,2025-05-25T11:19:00+02:00,2025-05-25,19:19,5,4,9
67,2025-05-25T11:10:00+02:00,2025-05-25,19:10,0,13,13
67,2025-05-25T11:12:00+02:00,2025-05-25,19:12,6,8,14
67,2025-05-25T11:14:00+02:00,2025-05-25,19:14,0,8,8
67,2025-05-25T11:16:00+02:00,2025-05-25,19:16,4,5,9
67,2025-05-25T11:17:00+02:00,2025-05-25,19:17,2,2,4
67,2025-05-25T11:20:00+02:00,2025-05-25,19:20,8,3,11
67,2025-05-25T11:22:00+02:00,2025-05-25,19:22,4,2,6
68,2025-05-25T11:14:00+02:00,2025-05-25,19:14,0,3,3
68,2025-05-25T11:21:00+02:00,2025-05-25,19:21,2,0,2
72,2025-05-25T11:11:00+02:00,2025-05-25,19:11,2,2,4
72,2025-05-25T11:13:00+02:00,2025-05-25,19:13,6,4,10
72,2025-05-25T11:16:00+02:00,2025-05-25,19:16,3,4,7
72,2025-05-25T11:19:00+02:00,2025-05-25,19:19,6,14,20
76,2025-05-25T11:12:00+02:00,2025-05-25,19:12,1,0,1
76,2025-05-25T11:15:00+02:00,2025-05-25,19:15,2,0,2
76,2025-05-25T11:19:00+02:00,2025-05-25,19:19,1,1,2
79,2025-05-25T11:11:00+02:00,2025-05-25,19:11,14,13,27
79,2025-05-25T11:12:00+02:00,2025-05-25,19:12,11,9,20
79,2025-05-25T11:17:00+02:00,2025-05-25,19:17,1,11,12
79,2025-05-25T11:19:00+02:00,2025-05-25,19:19,19,10,29
79,2025-05-25T11:20:00+02:00,2025-05-25,19:20,1,11,12
85,2025-05-25T11:10:00+02:00,2025-05-25,19:10,1,0,1
85,2025-05-25T11:11:00+02:00,2025-05-25,19:11,0,2,2
86,2025-05-25T11:10:00+02:00,2025-05-25,19:10,0,1,1
86,2025-05-25T11:16:00+02:00,2025-05-25,19:16,2,1,3
86,2025-05-25T11:17:00+02:00,2025-05-25,19:17,0,4,4
86,2025-05-25T11:20:00+02:00,2025-05-25,19:20,1,0,1
109,2025-05-25T11:10:00+02:00,2025-05-25,19:10,9,3,12
109,2025-05-25T11:15:00+02:00,2025-05-25,19:15,6,7,13
109,2025-05-25T11:20:00+02:00,2025-05-25,19:20,6,14,20
117,2025-05-25T11:10:00+02:00,2025-05-25,19:10,17,12,29
136,2025-05-25T11:15:00+02:00,2025-05-25,19:15,1,2,3
137,2025-05-25T11:20:00+02:00,2025-05-25,19:20,3,0,3
141,2025-05-25T11:15:00+02:00,2025-05-25,19:15,9,9,18
142,2025-05-25T11:10:00+02:00,2025-05-25,19:10,15,2,17
164,2025-05-25T11:15:00+02:00,2025-05-25,19:15,9,5,14
181,2025-05-25T11:11:00+02:00,2025-05-25,19:11,30,12,42
181,2025-05-25T11:12:00+02:00,2025-05-25,19:12,9,9,18
181,2025-05-25T11:13:00+02:00,2025-05-25,19:13,11,13,24
181,2025-05-25T11:16:00+02:00,2025-05-25,19:16,18,7,25
181,2025-05-25T11:18:00+02:00,2025-05-25,19:18,8,19,27
181,2025-05-25T11:19:00+02:00,2025-05-25,19:19,13,19,32
181,2025-05-25T11:20:00+02:00,2025-05-25,19:20,16,12,28
181,2025-05-25T11:22:00+02:00,2025-05-25,19:22,17,13,30
182,2025-05-25T11:10:00+02:00,2025-05-25,19:10,22,16,38
182,2025-05-25T11:15:00+02:00,2025-05-25,19:15,20,10,30
182,2025-05-25T11:20:00+02:00,2025-05-25,19:20,19,15,34
180,2025-05-25T11:22:00+02:00,2025-05-25,19:22,1,1,2
3,2025-05-25T11:25:00+02:00,2025-05-25,19:25,7,17,24
3,2025-05-25T11:28:00+02:00,2025-05-25,19:28,9,10,19
3,2025-05-25T11:30:00+02:00,2025-05-25,19:30,9,14,23
3,2025-05-25T11:31:00+02:00,2025-05-25,19:31,13,13,26
3,2025-05-25T11:33:00+02:00,2025-05-25,19:33,10,13,23
3,2025-05-25T11:35:00+02:00,2025-05-25,19:35,25,13,38
3,2025-05-25T11:36:00+02:00,2025-05-25,19:36,18,12,30
3,2025-05-25T11:37:00+02:00,2025-05-25,19:37,7,10,17
4,2025-05-25T11:27:00+02:00,2025-05-25,19:27,16,11,27
4,2025-05-25T11:33:00+02:00,2025-05-25,19:33,14,31,45
4,2025-05-25T11:34:00+02:00,2025-05-25,19:34,4,13,17
4,2025-05-25T11:35:00+02:00,2025-05-25,19:35,16,19,35
5,2025-05-25T11:25:00+02:00,2025-05-25,19:25,19,61,80
5,2025-05-25T11:30:00+02:00,2025-05-25,19:30,28,38,66
5,2025-05-25T11:35:00+02:00,2025-05-25,19:35,42,37,79
6,2025-05-25T11:26:00+02:00,2025-05-25,19:26,19,10,29
6,2025-05-25T11:28:00+02:00,2025-05-25,19:28,12,7,19
6,2025-05-25T11:32:00+02:00,2025-05-25,19:32,10,7,17
6,2025-05-25T11:33:00+02:00,2025-05-25,19:33,11,8,19
6,2025-05-25T11:35:00+02:00,2025-05-25,19:35,8,3,11
6,2025-05-25T11:37:00+02:00,2025-05-25,19:37,6,8,14
8,2025-05-25T11:26:00+02:00,2025-05-25,19:26,0,1,1
8,2025-05-25T11:29:00+02:00,2025-05-25,19:29,0,2,2
28,2025-05-25T11:28:00+02:00,2025-05-25,19:28,4,0,4
28,2025-05-25T11:32:00+02:00,2025-05-25,19:32,1,2,3
28,2025-05-25T11:33:00+02:00,2025-05-25,19:33,2,5,7
28,2025-05-25T11:34:00+02:00,2025-05-25,19:34,4,2,6
29,2025-05-25T11:27:00+02:00,2025-05-25,19:27,5,6,11
29,2025-05-25T11:33:00+02:00,2025-05-25,19:33,4,3,7
29,2025-05-25T11:34:00+02:00,2025-05-25,19:34,3,6,9
29,2025-05-25T11:35:00+02:00,2025-05-25,19:35,0,3,3
29,2025-05-25T11:38:00+02:00,2025-05-25,19:38,4,7,11
31,2025-05-25T11:25:00+02:00,2025-05-25,19:25,6,3,9
31,2025-05-25T11:32:00+02:00,2025-05-25,19:32,1,2,3
31,2025-05-25T11:33:00+02:00,2025-05-25,19:33,5,5,10
31,2025-05-25T11:35:00+02:00,2025-05-25,19:35,1,5,6
31,2025-05-25T11:36:00+02:00,2025-05-25,19:36,16,6,22
36,2025-05-25T11:25:00+02:00,2025-05-25,19:25,1,0,1
36,2025-05-25T11:27:00+02:00,2025-05-25,19:27,3,1,4
36,2025-05-25T11:31:00+02:00,2025-05-25,19:31,0,2,2
36,2025-05-25T11:34:00+02:00,2025-05-25,19:34,4,0,4
36,2025-05-25T11:37:00+02:00,2025-05-25,19:37,0,1,1
36,2025-05-25T11:39:00+02:00,2025-05-25,19:39,0,5,5
40,2025-05-25T11:28:00+02:00,2025-05-25,19:28,1,0,1
40,2025-05-25T11:31:00+02:00,2025-05-25,19:31,2,1,3
40,2025-05-25T11:33:00+02:00,2025-05-25,19:33,1,0,1
40,2025-05-25T11:34:00+02:00,2025-05-25,19:34,0,3,3
41,2025-05-25T11:25:00+02:00,2025-05-25,19:25,5,3,8
41,2025-05-25T11:29:00+02:00,2025-05-25,19:29,3,1,4
43,2025-05-25T11:30:00+02:00,2025-05-25,19:30,3,7,10
43,2025-05-25T11:35:00+02:00,2025-05-25,19:35,5,4,9
45,2025-05-25T11:31:00+02:00,2025-05-25,19:31,12,12,24
45,2025-05-25T11:32:00+02:00,2025-05-25,19:32,15,8,23
45,2025-05-25T11:34:00+02:00,2025-05-25,19:34,5,17,22
45,2025-05-25T11:35:00+02:00,2025-05-25,19:35,7,15,22
45,2025-05-25T11:39:00+02:00,2025-05-25,19:39,18,2,20
47,2025-05-25T11:27:00+02:00,2025-05-25,19:27,9,7,16
47,2025-05-25T11:28:00+02:00,2025-05-25,19:28,3,5,8
47,2025-05-25T11:29:00+02:00,2025-05-25,19:29,6,7,13
47,2025-05-25T11:30:00+02:00,2025-05-25,19:30,5,8,13
47,2025-05-25T11:31:00+02:00,2025-05-25,19:31,10,4,14
47,2025-05-25T11:34:00+02:00,2025-05-25,19:34,12,6,18
47,2025-05-25T11:39:00+02:00,2025-05-25,19:39,1,7,8
50,2025-05-25T11:27:00+02:00,2025-05-25,19:27,2,1,3
50,2025-05-25T11:28:00+02:00,2025-05-25,19:28,6,1,7
50,2025-05-25T11:30:00+02:00,2025-05-25,19:30,2,4,6
50,2025-05-25T11:31:00+02:00,2025-05-25,19:31,1,2,3
50,2025-05-25T11:32:00+02:00,2025-05-25,19:32,2,0,2
50,2025-05-25T11:38:00+02:00,2025-05-25,19:38,6,1,7
54,2025-05-25T11:38:00+02:00,2025-05-25,19:38,2,2,4
59,2025-05-25T11:30:00+02:00,2025-05-25,19:30,17,18,35
61,2025-05-25T11:28:00+02:00,2025-05-25,19:28,2,2,4
61,2025-05-25T11:30:00+02:00,2025-05-25,19:30,3,0,3
61,2025-05-25T11:31:00+02:00,2025-05-25,19:31,7,1,8
61,2025-05-25T11:36:00+02:00,2025-05-25,19:36,5,4,9
61,2025-05-25T11:37:00+02:00,2025-05-25,19:37,6,3,9
66,2025-05-25T11:31:00+02:00,2025-05-25,19:31,24,21,45
66,2025-05-25T11:34:00+02:00,2025-05-25,19:34,16,16,32
66,2025-05-25T11:36:00+02:00,2025-05-25,19:36,23,6,29
66,2025-05-25T11:39:00+02:00,2025-05-25,19:39,6,5,11
69,2025-05-25T11:25:00+02:00,2025-05-25,19:25,1,0,1
69,2025-05-25T11:28:00+02:00,2025-05-25,19:28,0,2,2
69,2025-05-25T11:34:00+02:00,2025-05-25,19:34,0,2,2
69,2025-05-25T11:38:00+02:00,2025-05-25,19:38,1,0,1
70,2025-05-25T11:25:00+02:00,2025-05-25,19:25,5,8,13
70,2025-05-25T11:30:00+02:00,2025-05-25,19:30,11,9,20
70,2025-05-25T11:33:00+02:00,2025-05-25,19:33,0,4,4
70,2025-05-25T11:34:00+02:00,2025-05-25,19:34,0,2,2
70,2025-05-25T11:36:00+02:00,2025-05-25,19:36,0,1,1
70,2025-05-25T11:37:00+02:00,2025-05-25,19:37,1,0,1
70,2025-05-25T11:38:00+02:00,2025-05-25,19:38,3,1,4
77,2025-05-25T11:25:00+02:00,2025-05-25,19:25,51,5,56
78,2025-05-25T11:34:00+02:00,2025-05-25,19:34,0,2,2
78,2025-05-25T11:36:00+02:00,2025-05-25,19:36,1,0,1
84,2025-05-25T11:25:00+02:00,2025-05-25,19:25,52,81,133
87,2025-05-25T11:25:00+02:00,2025-05-25,19:25,0,2,2
87,2025-05-25T11:26:00+02:00,2025-05-25,19:26,1,0,1
87,2025-05-25T11:27:00+02:00,2025-05-25,19:27,1,1,2
87,2025-05-25T11:31:00+02:00,2025-05-25,19:31,1,0,1
87,2025-05-25T11:33:00+02:00,2025-05-25,19:33,1,3,4
87,2025-05-25T11:34:00+02:00,2025-05-25,19:34,0,1,1
87,2025-05-25T11:35:00+02:00,2025-05-25,19:35,1,1,2
87,2025-05-25T11:36:00+02:00,2025-05-25,19:36,1,4,5
87,2025-05-25T11:39:00+02:00,2025-05-25,19:39,5,0,5
107,2025-05-25T11:35:00+02:00,2025-05-25,19:35,7,4,11
108,2025-05-25T11:28:00+02:00,2025-05-25,19:28,0,2,2
108,2025-05-25T11:31:00+02:00,2025-05-25,19:31,6,0,6
108,2025-05-25T11:38:00+02:00,2025-05-25,19:38,0,2,2
131,2025-05-25T11:35:00+02:00,2025-05-25,19:35,0,8,8
132,2025-05-25T11:35:00+02:00,2025-05-25,19:35,16,7,23
133,2025-05-25T11:35:00+02:00,2025-05-25,19:35,48,22,70
134,2025-05-25T11:30:00+02:00,2025-05-25,19:30,51,28,79
165,2025-05-25T11:25:00+02:00,2025-05-25,19:25,5,1,6
165,2025-05-25T11:30:00+02:00,2025-05-25,19:30,6,1,7
165,2025-05-25T11:35:00+02:00,2025-05-25,19:35,0,1,1
166,2025-05-25T11:25:00+02:00,2025-05-25,19:25,2,1,3
166,2025-05-25T11:30:00+02:00,2025-05-25,19:30,2,2,4
167,2025-05-25T11:30:00+02:00,2025-05-25,19:30,2,1,3
179,2025-05-25T11:25:00+02:00,2025-05-25,19:25,7,7,14
1,2025-05-25T11:25:00+02:00,2025-05-25,19:25,9,4,13
1,2025-05-25T11:30:00+02:00,2025-05-25,19:30,12,7,19
1,2025-05-25T11:37:00+02:00,2025-05-25,19:37,1,8,9
2,2025-05-25T11:28:00+02:00,2025-05-25,19:28,0,2,2
2,2025-05-25T11:30:00+02:00,2025-05-25,19:30,5,3,8
2,2025-05-25T11:31:00+02:00,2025-05-25,19:31,4,11,15
2,2025-05-25T11:32:00+02:00,2025-05-25,19:32,4,7,11
2,2025-05-25T11:34:00+02:00,2025-05-25,19:34,1,3,4
2,2025-05-25T11:36:00+02:00,2025-05-25,19:36,1,4,5
2,2025-05-25T11:39:00+02:00,2025-05-25,19:39,0,10,10
9,2025-05-25T11:25:00+02:00,2025-05-25,19:25,2,0,2
9,2025-05-25T11:26:00+02:00,2025-05-25,19:26,4,0,4
9,2025-05-25T11:31:00+02:00,2025-05-25,19:31,0,5,5
9,2025-05-25T11:38:00+02:00,2025-05-25,19:38,0,3,3
10,2025-05-25T11:29:00+02:00,2025-05-25,19:29,0,2,2
10,2025-05-25T11:31:00+02:00,2025-05-25,19:31,2,8,10
10,2025-05-25T11:33:00+02:00,2025-05-25,19:33,2,3,5
10,2025-05-25T11:36:00+02:00,2025-05-25,19:36,0,2,2
12,2025-05-25T11:27:00+02:00,2025-05-25,19:27,1,10,11
12,2025-05-25T11:28:00+02:00,2025-05-25,19:28,4,5,9
12,2025-05-25T11:29:00+02:00,2025-05-25,19:29,6,8,14
12,2025-05-25T11:31:00+02:00,2025-05-25,19:31,7,20,27
12,2025-05-25T11:33:00+02:00,2025-05-25,19:33,3,6,9
12,2025-05-25T11:34:00+02:00,2025-05-25,19:34,2,13,15
12,2025-05-25T11:35:00+02:00,2025-05-25,19:35,3,2,5
12,2025-05-25T11:36:00+02:00,2025-05-25,19:36,0,8,8
12,2025-05-25T11:39:00+02:00,2025-05-25,19:39,4,4,8
17,2025-05-25T11:31:00+02:00,2025-05-25,19:31,2,4,6
17,2025-05-25T11:35:00+02:00,2025-05-25,19:35,1,2,3
17,2025-05-25T11:36:00+02:00,2025-05-25,19:36,1,2,3
18,2025-05-25T11:30:00+02:00,2025-05-25,19:30,1,0,1
19,2025-05-25T11:28:00+02:00,2025-05-25,19:28,2,17,19
19,2025-05-25T11:29:00+02:00,2025-05-25,19:29,7,20,27
19,2025-05-25T11:30:00+02:00,2025-05-25,19:30,12,6,18
19,2025-05-25T11:33:00+02:00,2025-05-25,19:33,4,7,11
19,2025-05-25T11:34:00+02:00,2025-05-25,19:34,5,5,10
19,2025-05-25T11:38:00+02:00,2025-05-25,19:38,15,7,22
20,2025-05-25T11:27:00+02:00,2025-05-25,19:27,1,7,8
20,2025-05-25T11:28:00+02:00,2025-05-25,19:28,7,5,12
20,2025-05-25T11:29:00+02:00,2025-05-25,19:29,7,2,9
20,2025-05-25T11:34:00+02:00,2025-05-25,19:34,5,3,8
20,2025-05-25T11:37:00+02:00,2025-05-25,19:37,2,2,4
20,2025-05-25T11:38:00+02:00,2025-05-25,19:38,4,0,4
23,2025-05-25T11:30:00+02:00,2025-05-25,19:30,1,1,2
23,2025-05-25T11:31:00+02:00,2025-05-25,19:31,6,2,8
23,2025-05-25T11:34:00+02:00,2025-05-25,19:34,1,2,3
23,2025-05-25T11:37:00+02:00,2025-05-25,19:37,0,2,2
23,2025-05-25T11:39:00+02:00,2025-05-25,19:39,0,4,4
24,2025-05-25T11:25:00+02:00,2025-05-25,19:25,9,14,23
24,2025-05-25T11:29:00+02:00,2025-05-25,19:29,11,8,19
24,2025-05-25T11:30:00+02:00,2025-05-25,19:30,24,3,27
24,2025-05-25T11:35:00+02:00,2025-05-25,19:35,12,14,26
24,2025-05-25T11:37:00+02:00,2025-05-25,19:37,7,7,14
27,2025-05-25T11:26:00+02:00,2025-05-25,19:26,2,2,4
27,2025-05-25T11:27:00+02:00,2025-05-25,19:27,2,5,7
27,2025-05-25T11:28:00+02:00,2025-05-25,19:28,4,0,4
27,2025-05-25T11:35:00+02:00,2025-05-25,19:35,1,4,5
27,2025-05-25T11:36:00+02:00,2025-05-25,19:36,4,0,4
30,2025-05-25T11:29:00+02:00,2025-05-25,19:29,9,4,13
30,2025-05-25T11:34:00+02:00,2025-05-25,19:34,1,12,13
30,2025-05-25T11:35:00+02:00,2025-05-25,19:35,2,4,6
30,2025-05-25T11:36:00+02:00,2025-05-25,19:36,7,1,8
30,2025-05-25T11:39:00+02:00,2025-05-25,19:39,5,6,11
35,2025-05-25T11:30:00+02:00,2025-05-25,19:30,13,9,22
35,2025-05-25T11:31:00+02:00,2025-05-25,19:31,2,8,10
35,2025-05-25T11:34:00+02:00,2025-05-25,19:34,9,9,18
35,2025-05-25T11:37:00+02:00,2025-05-25,19:37,4,6,10
35,2025-05-25T11:38:00+02:00,2025-05-25,19:38,8,16,24
48,2025-05-25T11:26:00+02:00,2025-05-25,19:26,2,5,7
48,2025-05-25T11:27:00+02:00,2025-05-25,19:27,1,5,6
48,2025-05-25T11:28:00+02:00,2025-05-25,19:28,2,0,2
48,2025-05-25T11:33:00+02:00,2025-05-25,19:33,0,8,8
48,2025-05-25T11:35:00+02:00,2025-05-25,19:35,2,0,2
48,2025-05-25T11:37:00+02:00,2025-05-25,19:37,4,4,8
49,2025-05-25T11:26:00+02:00,2025-05-25,19:26,4,2,6
49,2025-05-25T11:39:00+02:00,2025-05-25,19:39,3,16,19
51,2025-05-25T11:25:00+02:00,2025-05-25,19:25,1,0,1
51,2025-05-25T11:27:00+02:00,2025-05-25,19:27,2,0,2
51,2025-05-25T11:28:00+02:00,2025-05-25,19:28,0,1,1
51,2025-05-25T11:36:00+02:00,2025-05-25,19:36,1,1,2
52,2025-05-25T11:27:00+02:00,2025-05-25,19:27,0,11,11
52,2025-05-25T11:28:00+02:00,2025-05-25,19:28,5,11,16
52,2025-05-25T11:31:00+02:00,2025-05-25,19:31,5,8,13
52,2025-05-25T11:33:00+02:00,2025-05-25,19:33,5,8,13
52,2025-05-25T11:34:00+02:00,2025-05-25,19:34,5,5,10
52,2025-05-25T11:37:00+02:00,2025-05-25,19:37,3,4,7
53,2025-05-25T11:25:00+02:00,2025-05-25,19:25,6,1,7
53,2025-05-25T11:31:00+02:00,2025-05-25,19:31,0,2,2
53,2025-05-25T11:33:00+02:00,2025-05-25,19:33,0,2,2
53,2025-05-25T11:34:00+02:00,2025-05-25,19:34,6,6,12
53,2025-05-25T11:35:00+02:00,2025-05-25,19:35,0,8,8
53,2025-05-25T11:38:00+02:00,2025-05-25,19:38,1,4,5
56,2025-05-25T11:27:00+02:00,2025-05-25,19:27,2,7,9
56,2025-05-25T11:29:00+02:00,2025-05-25,19:29,8,9,17
56,2025-05-25T11:32:00+02:00,2025-05-25,19:32,3,3,6
58,2025-05-25T11:25:00+02:00,2025-05-25,19:25,45,17,62
58,2025-05-25T11:26:00+02:00,2025-05-25,19:26,16,5,21
58,2025-05-25T11:32:00+02:00,2025-05-25,19:32,21,12,33
62,2025-05-25T11:29:00+02:00,2025-05-25,19:29,0,11,11
62,2025-05-25T11:30:00+02:00,2025-05-25,19:30,1,0,1
62,2025-05-25T11:31:00+02:00,2025-05-25,19:31,6,2,8
62,2025-05-25T11:35:00+02:00,2025-05-25,19:35,3,0,3
63,2025-05-25T11:25:00+02:00,2025-05-25,19:25,2,7,9
63,2025-05-25T11:28:00+02:00,2025-05-25,19:28,0,5,5
63,2025-05-25T11:29:00+02:00,2025-05-25,19:29,2,5,7
63,2025-05-25T11:32:00+02:00,2025-05-25,19:32,0,1,1
63,2025-05-25T11:38:00+02:00,2025-05-25,19:38,0,1,1
63,2025-05-25T11:39:00+02:00,2025-05-25,19:39,0,1,1
67,2025-05-25T11:26:00+02:00,2025-05-25,19:26,0,3,3
67,2025-05-25T11:27:00+02:00,2025-05-25,19:27,1,4,5
67,2025-05-25T11:29:00+02:00,2025-05-25,19:29,6,6,12
67,2025-05-25T11:30:00+02:00,2025-05-25,19:30,0,5,5
67,2025-05-25T11:38:00+02:00,2025-05-25,19:38,1,4,5
68,2025-05-25T11:26:00+02:00,2025-05-25,19:26,3,1,4
68,2025-05-25T11:30:00+02:00,2025-05-25,19:30,5,0,5
68,2025-05-25T11:32:00+02:00,2025-05-25,19:32,1,1,2
68,2025-05-25T11:35:00+02:00,2025-05-25,19:35,3,0,3
72,2025-05-25T11:25:00+02:00,2025-05-25,19:25,5,13,18
72,2025-05-25T11:26:00+02:00,2025-05-25,19:26,3,10,13
72,2025-05-25T11:30:00+02:00,2025-05-25,19:30,0,5,5
72,2025-05-25T11:31:00+02:00,2025-05-25,19:31,1,3,4
72,2025-05-25T11:32:00+02:00,2025-05-25,19:32,8,1,9
72,2025-05-25T11:33:00+02:00,2025-05-25,19:33,15,2,17
76,2025-05-25T11:34:00+02:00,2025-05-25,19:34,2,1,3
79,2025-05-25T11:32:00+02:00,2025-05-25,19:32,11,6,17
79,2025-05-25T11:35:00+02:00,2025-05-25,19:35,1,5,6
79,2025-05-25T11:37:00+02:00,2025-05-25,19:37,5,4,9
85,2025-05-25T11:39:00+02:00,2025-05-25,19:39,1,0,1
86,2025-05-25T11:31:00+02:00,2025-05-25,19:31,0,3,3
117,2025-05-25T11:30:00+02:00,2025-05-25,19:30,15,19,34
123,2025-05-25T11:30:00+02:00,2025-05-25,19:30,2,0,2
137,2025-05-25T11:25:00+02:00,2025-05-25,19:25,1,0,1
139,2025-05-25T11:30:00+02:00,2025-05-25,19:30,0,3,3
141,2025-05-25T11:25:00+02:00,2025-05-25,19:25,7,10,17
142,2025-05-25T11:35:00+02:00,2025-05-25,19:35,1,2,3
164,2025-05-25T11:25:00+02:00,2025-05-25,19:25,27,9,36
164,2025-05-25T11:30:00+02:00,2025-05-25,19:30,10,2,12
164,2025-05-25T11:35:00+02:00,2025-05-25,19:35,6,0,6
181,2025-05-25T11:28:00+02:00,2025-05-25,19:28,5,7,12
181,2025-05-25T11:30:00+02:00,2025-05-25,19:30,10,15,25
181,2025-05-25T11:31:00+02:00,2025-05-25,19:31,2,18,20
181,2025-05-25T11:34:00+02:00,2025-05-25,19:34,9,19,28
181,2025-05-25T11:37:00+02:00,2025-05-25,19:37,4,13,17
180,2025-05-25T11:34:00+02:00,2025-05-25,19:34,1,0,1
3,2025-05-25T12:10:00+02:00,2025-05-25,20:10,10,15,25
3,2025-05-25T12:13:00+02:00,2025-05-25,20:13,12,13,25
3,2025-05-25T12:16:00+02:00,2025-05-25,20:16,14,10,24
3,2025-05-25T12:19:00+02:00,2025-05-25,20:19,11,15,26
3,2025-05-25T12:24:00+02:00,2025-05-25,20:24,7,7,14
4,2025-05-25T12:12:00+02:00,2025-05-25,20:12,14,11,25
4,2025-05-25T12:14:00+02:00,2025-05-25,20:14,22,6,28
4,2025-05-25T12:15:00+02:00,2025-05-25,20:15,10,8,18
4,2025-05-25T12:17:00+02:00,2025-05-25,20:17,1,15,16
4,2025-05-25T12:23:00+02:00,2025-05-25,20:23,8,10,18
4,2025-05-25T12:24:00+02:00,2025-05-25,20:24,9,15,24
6,2025-05-25T12:14:00+02:00,2025-05-25,20:14,10,7,17
6,2025-05-25T12:18:00+02:00,2025-05-25,20:18,7,2,9
6,2025-05-25T12:21:00+02:00,2025-05-25,20:21,3,7,10
6,2025-05-25T12:23:00+02:00,2025-05-25,20:23,6,13,19
6,2025-05-25T12:24:00+02:00,2025-05-25,20:24,7,15,22
8,2025-05-25T12:14:00+02:00,2025-05-25,20:14,0,1,1
21,2025-05-25T12:15:00+02:00,2025-05-25,20:15,21,25,46
21,2025-05-25T12:20:00+02:00,2025-05-25,20:20,17,22,39
28,2025-05-25T12:10:00+02:00,2025-05-25,20:10,4,2,6
28,2025-05-25T12:14:00+02:00,2025-05-25,20:14,0,1,1
28,2025-05-25T12:16:00+02:00,2025-05-25,20:16,2,1,3
28,2025-05-25T12:19:00+02:00,2025-05-25,20:19,7,0,7
28,2025-05-25T12:22:00+02:00,2025-05-25,20:22,2,3,5
29,2025-05-25T12:13:00+02:00,2025-05-25,20:13,0,2,2
29,2025-05-25T12:17:00+02:00,2025-05-25,20:17,0,5,5
29,2025-05-25T12:18:00+02:00,2025-05-25,20:18,0,2,2
29,2025-05-25T12:22:00+02:00,2025-05-25,20:22,1,2,3
29,2025-05-25T12:24:00+02:00,2025-05-25,20:24,0,3,3
31,2025-05-25T12:10:00+02:00,2025-05-25,20:10,10,2,12
31,2025-05-25T12:13:00+02:00,2025-05-25,20:13,4,4,8
31,2025-05-25T12:14:00+02:00,2025-05-25,20:14,4,6,10
31,2025-05-25T12:15:00+02:00,2025-05-25,20:15,5,1,6
31,2025-05-25T12:17:00+02:00,2025-05-25,20:17,4,5,9
31,2025-05-25T12:18:00+02:00,2025-05-25,20:18,0,7,7
31,2025-05-25T12:19:00+02:00,2025-05-25,20:19,7,2,9
31,2025-05-25T12:22:00+02:00,2025-05-25,20:22,3,3,6
36,2025-05-25T12:13:00+02:00,2025-05-25,20:13,1,0,1
36,2025-05-25T12:18:00+02:00,2025-05-25,20:18,1,4,5
36,2025-05-25T12:21:00+02:00,2025-05-25,20:21,2,0,2
40,2025-05-25T12:11:00+02:00,2025-05-25,20:11,4,0,4
40,2025-05-25T12:13:00+02:00,2025-05-25,20:13,0,1,1
40,2025-05-25T12:20:00+02:00,2025-05-25,20:20,6,0,6
41,2025-05-25T12:10:00+02:00,2025-05-25,20:10,1,0,1
41,2025-05-25T12:11:00+02:00,2025-05-25,20:11,10,1,11
41,2025-05-25T12:16:00+02:00,2025-05-25,20:16,0,3,3
41,2025-05-25T12:20:00+02:00,2025-05-25,20:20,4,1,5
41,2025-05-25T12:21:00+02:00,2025-05-25,20:21,2,2,4
44,2025-05-25T12:10:00+02:00,2025-05-25,20:10,2,3,5
44,2025-05-25T12:15:00+02:00,2025-05-25,20:15,0,3,3
45,2025-05-25T12:11:00+02:00,2025-05-25,20:11,3,20,23
45,2025-05-25T12:16:00+02:00,2025-05-25,20:16,10,24,34
45,2025-05-25T12:17:00+02:00,2025-05-25,20:17,9,8,17
45,2025-05-25T12:20:00+02:00,2025-05-25,20:20,6,12,18
45,2025-05-25T12:22:00+02:00,2025-05-25,20:22,9,10,19
47,2025-05-25T12:11:00+02:00,2025-05-25,20:11,7,6,13
47,2025-05-25T12:12:00+02:00,2025-05-25,20:12,5,11,16
47,2025-05-25T12:13:00+02:00,2025-05-25,20:13,2,6,8
47,2025-05-25T12:16:00+02:00,2025-05-25,20:16,10,5,15
47,2025-05-25T12:18:00+02:00,2025-05-25,20:18,5,9,14
47,2025-05-25T12:20:00+02:00,2025-05-25,20:20,3,6,9
47,2025-05-25T12:24:00+02:00,2025-05-25,20:24,14,7,21
50,2025-05-25T12:13:00+02:00,2025-05-25,20:13,4,3,7
50,2025-05-25T12:15:00+02:00,2025-05-25,20:15,7,3,10
50,2025-05-25T12:16:00+02:00,2025-05-25,20:16,5,1,6
50,2025-05-25T12:17:00+02:00,2025-05-25,20:17,4,11,15
50,2025-05-25T12:20:00+02:00,2025-05-25,20:20,0,3,3
50,2025-05-25T12:24:00+02:00,2025-05-25,20:24,5,1,6
54,2025-05-25T12:10:00+02:00,2025-05-25,20:10,3,1,4
54,2025-05-25T12:12:00+02:00,2025-05-25,20:12,1,0,1
54,2025-05-25T12:17:00+02:00,2025-05-25,20:17,1,1,2
54,2025-05-25T12:22:00+02:00,2025-05-25,20:22,0,1,1
59,2025-05-25T12:10:00+02:00,2025-05-25,20:10,17,8,25
59,2025-05-25T12:20:00+02:00,2025-05-25,20:20,19,14,33
61,2025-05-25T12:11:00+02:00,2025-05-25,20:11,4,1,5
61,2025-05-25T12:19:00+02:00,2025-05-25,20:19,7,8,15
61,2025-05-25T12:20:00+02:00,2025-05-25,20:20,0,4,4
66,2025-05-25T12:13:00+02:00,2025-05-25,20:13,30,13,43
66,2025-05-25T12:16:00+02:00,2025-05-25,20:16,12,11,23
66,2025-05-25T12:22:00+02:00,2025-05-25,20:22,11,15,26
66,2025-05-25T12:24:00+02:00,2025-05-25,20:24,28,5,33
69,2025-05-25T12:10:00+02:00,2025-05-25,20:10,1,0,1
69,2025-05-25T12:24:00+02:00,2025-05-25,20:24,1,1,2
70,2025-05-25T12:10:00+02:00,2025-05-25,20:10,1,1,2
70,2025-05-25T12:17:00+02:00,2025-05-25,20:17,4,0,4
75,2025-05-25T12:12:00+02:00,2025-05-25,20:12,0,3,3
75,2025-05-25T12:15:00+02:00,2025-05-25,20:15,0,1,1
77,2025-05-25T12:10:00+02:00,2025-05-25,20:10,7,11,18
77,2025-05-25T12:15:00+02:00,2025-05-25,20:15,17,4,21
77,2025-05-25T12:20:00+02:00,2025-05-25,20:20,19,3,22
78,2025-05-25T12:12:00+02:00,2025-05-25,20:12,0,2,2
84,2025-05-25T12:15:00+02:00,2025-05-25,20:15,41,55,96
87,2025-05-25T12:16:00+02:00,2025-05-25,20:16,1,0,1
87,2025-05-25T12:17:00+02:00,2025-05-25,20:17,0,2,2
87,2025-05-25T12:22:00+02:00,2025-05-25,20:22,1,0,1
107,2025-05-25T12:10:00+02:00,2025-05-25,20:10,8,5,13
108,2025-05-25T12:12:00+02:00,2025-05-25,20:12,2,3,5
108,2025-05-25T12:17:00+02:00,2025-05-25,20:17,0,2,2
108,2025-05-25T12:18:00+02:00,2025-05-25,20:18,3,0,3
108,2025-05-25T12:21:00+02:00,2025-05-25,20:21,1,2,3
131,2025-05-25T12:15:00+02:00,2025-05-25,20:15,7,8,15
132,2025-05-25T12:20:00+02:00,2025-05-25,20:20,2,12,14
133,2025-05-25T12:15:00+02:00,2025-05-25,20:15,37,28,65
134,2025-05-25T12:10:00+02:00,2025-05-25,20:10,10,16,26
165,2025-05-25T12:20:00+02:00,2025-05-25,20:20,2,0,2
167,2025-05-25T12:20:00+02:00,2025-05-25,20:20,0,2,2
1,2025-05-25T12:10:00+02:00,2025-05-25,20:10,8,7,15
1,2025-05-25T12:11:00+02:00,2025-05-25,20:11,7,5,12
1,2025-05-25T12:13:00+02:00,2025-05-25,20:13,10,2,12
1,2025-05-25T12:22:00+02:00,2025-05-25,20:22,8,6,14
1,2025-05-25T12:24:00+02:00,2025-05-25,20:24,4,1,5
2,2025-05-25T12:11:00+02:00,2025-05-25,20:11,0,5,5
2,2025-05-25T12:13:00+02:00,2025-05-25,20:13,3,0,3
2,2025-05-25T12:14:00+02:00,2025-05-25,20:14,3,2,5
2,2025-05-25T12:19:00+02:00,2025-05-25,20:19,2,0,2
2,2025-05-25T12:21:00+02:00,2025-05-25,20:21,2,5,7
9,2025-05-25T12:10:00+02:00,2025-05-25,20:10,2,0,2
9,2025-05-25T12:11:00+02:00,2025-05-25,20:11,0,5,5
9,2025-05-25T12:12:00+02:00,2025-05-25,20:12,0,1,1
9,2025-05-25T12:13:00+02:00,2025-05-25,20:13,1,0,1
9,2025-05-25T12:18:00+02:00,2025-05-25,20:18,5,0,5
9,2025-05-25T12:19:00+02:00,2025-05-25,20:19,5,0,5
9,2025-05-25T12:24:00+02:00,2025-05-25,20:24,0,1,1
10,2025-05-25T12:10:00+02:00,2025-05-25,20:10,2,0,2
10,2025-05-25T12:24:00+02:00,2025-05-25,20:24,0,2,2
11,2025-05-25T12:15:00+02:00,2025-05-25,20:15,1,0,1
11,2025-05-25T12:20:00+02:00,2025-05-25,20:20,3,0,3
12,2025-05-25T12:11:00+02:00,2025-05-25,20:11,5,0,5
12,2025-05-25T12:16:00+02:00,2025-05-25,20:16,2,2,4
12,2025-05-25T12:17:00+02:00,2025-05-25,20:17,1,3,4
12,2025-05-25T12:18:00+02:00,2025-05-25,20:18,0,5,5
12,2025-05-25T12:20:00+02:00,2025-05-25,20:20,4,1,5
12,2025-05-25T12:21:00+02:00,2025-05-25,20:21,4,0,4
12,2025-05-25T12:22:00+02:00,2025-05-25,20:22,11,4,15
17,2025-05-25T12:10:00+02:00,2025-05-25,20:10,5,1,6
17,2025-05-25T12:15:00+02:00,2025-05-25,20:15,0,3,3
17,2025-05-25T12:16:00+02:00,2025-05-25,20:16,1,0,1
17,2025-05-25T12:21:00+02:00,2025-05-25,20:21,0,3,3
17,2025-05-25T12:23:00+02:00,2025-05-25,20:23,0,4,4
18,2025-05-25T12:16:00+02:00,2025-05-25,20:16,2,2,4
19,2025-05-25T12:11:00+02:00,2025-05-25,20:11,9,10,19
19,2025-05-25T12:12:00+02:00,2025-05-25,20:12,6,12,18
19,2025-05-25T12:19:00+02:00,2025-05-25,20:19,10,8,18
19,2025-05-25T12:21:00+02:00,2025-05-25,20:21,2,6,8
19,2025-05-25T12:23:00+02:00,2025-05-25,20:23,5,6,11
20,2025-05-25T12:12:00+02:00,2025-05-25,20:12,3,12,15
20,2025-05-25T12:13:00+02:00,2025-05-25,20:13,4,9,13
20,2025-05-25T12:14:00+02:00,2025-05-25,20:14,7,4,11
20,2025-05-25T12:15:00+02:00,2025-05-25,20:15,5,10,15
20,2025-05-25T12:16:00+02:00,2025-05-25,20:16,5,12,17
20,2025-05-25T12:24:00+02:00,2025-05-25,20:24,2,5,7
23,2025-05-25T12:10:00+02:00,2025-05-25,20:10,3,0,3
23,2025-05-25T12:14:00+02:00,2025-05-25,20:14,4,3,7
23,2025-05-25T12:15:00+02:00,2025-05-25,20:15,2,4,6
23,2025-05-25T12:16:00+02:00,2025-05-25,20:16,2,0,2
23,2025-05-25T12:18:00+02:00,2025-05-25,20:18,0,2,2
24,2025-05-25T12:11:00+02:00,2025-05-25,20:11,8,2,10
24,2025-05-25T12:14:00+02:00,2025-05-25,20:14,10,5,15
24,2025-05-25T12:16:00+02:00,2025-05-25,20:16,2,13,15
24,2025-05-25T12:20:00+02:00,2025-05-25,20:20,6,3,9
24,2025-05-25T12:21:00+02:00,2025-05-25,20:21,15,1,16
24,2025-05-25T12:22:00+02:00,2025-05-25,20:22,1,0,1
24,2025-05-25T12:24:00+02:00,2025-05-25,20:24,4,1,5
25,2025-05-25T12:20:00+02:00,2025-05-25,20:20,19,12,31
27,2025-05-25T12:14:00+02:00,2025-05-25,20:14,1,0,1
27,2025-05-25T12:17:00+02:00,2025-05-25,20:17,0,1,1
27,2025-05-25T12:18:00+02:00,2025-05-25,20:18,1,0,1
30,2025-05-25T12:10:00+02:00,2025-05-25,20:10,9,6,15
30,2025-05-25T12:12:00+02:00,2025-05-25,20:12,0,12,12
30,2025-05-25T12:14:00+02:00,2025-05-25,20:14,5,6,11
30,2025-05-25T12:20:00+02:00,2025-05-25,20:20,2,7,9
30,2025-05-25T12:21:00+02:00,2025-05-25,20:21,2,15,17
30,2025-05-25T12:22:00+02:00,2025-05-25,20:22,12,10,22
35,2025-05-25T12:12:00+02:00,2025-05-25,20:12,11,7,18
35,2025-05-25T12:13:00+02:00,2025-05-25,20:13,8,4,12
35,2025-05-25T12:17:00+02:00,2025-05-25,20:17,4,19,23
35,2025-05-25T12:18:00+02:00,2025-05-25,20:18,6,7,13
46,2025-05-25T12:20:00+02:00,2025-05-25,20:20,1,0,1
48,2025-05-25T12:10:00+02:00,2025-05-25,20:10,0,9,9
48,2025-05-25T12:13:00+02:00,2025-05-25,20:13,0,4,4
49,2025-05-25T12:10:00+02:00,2025-05-25,20:10,0,2,2
49,2025-05-25T12:11:00+02:00,2025-05-25,20:11,2,3,5
49,2025-05-25T12:13:00+02:00,2025-05-25,20:13,3,8,11
49,2025-05-25T12:14:00+02:00,2025-05-25,20:14,3,1,4
49,2025-05-25T12:15:00+02:00,2025-05-25,20:15,5,1,6
49,2025-05-25T12:16:00+02:00,2025-05-25,20:16,5,4,9
49,2025-05-25T12:17:00+02:00,2025-05-25,20:17,0,4,4
51,2025-05-25T12:13:00+02:00,2025-05-25,20:13,0,1,1
51,2025-05-25T12:14:00+02:00,2025-05-25,20:14,0,1,1
51,2025-05-25T12:15:00+02:00,2025-05-25,20:15,1,0,1
51,2025-05-25T12:16:00+02:00,2025-05-25,20:16,2,1,3
51,2025-05-25T12:17:00+02:00,2025-05-25,20:17,0,1,1
51,2025-05-25T12:20:00+02:00,2025-05-25,20:20,1,3,4
51,2025-05-25T12:21:00+02:00,2025-05-25,20:21,8,0,8
52,2025-05-25T12:14:00+02:00,2025-05-25,20:14,4,6,10
52,2025-05-25T12:18:00+02:00,2025-05-25,20:18,7,3,10
52,2025-05-25T12:21:00+02:00,2025-05-25,20:21,7,0,7
52,2025-05-25T12:23:00+02:00,2025-05-25,20:23,2,1,3
52,2025-05-25T12:24:00+02:00,2025-05-25,20:24,8,9,17
53,2025-05-25T12:12:00+02:00,2025-05-25,20:12,0,4,4
53,2025-05-25T12:13:00+02:00,2025-05-25,20:13,3,2,5
53,2025-05-25T12:17:00+02:00,2025-05-25,20:17,0,3,3
53,2025-05-25T12:18:00+02:00,2025-05-25,20:18,4,0,4
53,2025-05-25T12:19:00+02:00,2025-05-25,20:19,1,0,1
53,2025-05-25T12:23:00+02:00,2025-05-25,20:23,0,1,1
53,2025-05-25T12:24:00+02:00,2025-05-25,20:24,5,2,7
56,2025-05-25T12:15:00+02:00,2025-05-25,20:15,4,8,12
56,2025-05-25T12:17:00+02:00,2025-05-25,20:17,7,6,13
58,2025-05-25T12:10:00+02:00,2025-05-25,20:10,5,0,5
58,2025-05-25T12:12:00+02:00,2025-05-25,20:12,8,6,14
58,2025-05-25T12:14:00+02:00,2025-05-25,20:14,1,1,2
58,2025-05-25T12:16:00+02:00,2025-05-25,20:16,2,4,6
58,2025-05-25T12:18:00+02:00,2025-05-25,20:18,12,7,19
58,2025-05-25T12:19:00+02:00,2025-05-25,20:19,1,2,3
58,2025-05-25T12:20:00+02:00,2025-05-25,20:20,8,0,8
58,2025-05-25T12:21:00+02:00,2025-05-25,20:21,8,3,11
62,2025-05-25T12:10:00+02:00,2025-05-25,20:10,4,2,6
62,2025-05-25T12:19:00+02:00,2025-05-25,20:19,1,3,4
62,2025-05-25T12:22:00+02:00,2025-05-25,20:22,4,0,4
62,2025-05-25T12:23:00+02:00,2025-05-25,20:23,2,5,7
63,2025-05-25T12:10:00+02:00,2025-05-25,20:10,0,2,2
63,2025-05-25T12:12:00+02:00,2025-05-25,20:12,0,3,3
63,2025-05-25T12:16:00+02:00,2025-05-25,20:16,0,6,6
63,2025-05-25T12:19:00+02:00,2025-05-25,20:19,0,3,3
63,2025-05-25T12:20:00+02:00,2025-05-25,20:20,0,2,2
63,2025-05-25T12:23:00+02:00,2025-05-25,20:23,2,2,4
63,2025-05-25T12:24:00+02:00,2025-05-25,20:24,1,3,4
67,2025-05-25T12:11:00+02:00,2025-05-25,20:11,0,4,4
67,2025-05-25T12:14:00+02:00,2025-05-25,20:14,1,1,2
67,2025-05-25T12:17:00+02:00,2025-05-25,20:17,2,6,8
67,2025-05-25T12:22:00+02:00,2025-05-25,20:22,5,8,13
67,2025-05-25T12:23:00+02:00,2025-05-25,20:23,2,1,3
67,2025-05-25T12:24:00+02:00,2025-05-25,20:24,7,4,11
68,2025-05-25T12:10:00+02:00,2025-05-25,20:10,5,0,5
68,2025-05-25T12:14:00+02:00,2025-05-25,20:14,1,0,1
68,2025-05-25T12:15:00+02:00,2025-05-25,20:15,4,4,8
68,2025-05-25T12:16:00+02:00,2025-05-25,20:16,4,1,5
68,2025-05-25T12:19:00+02:00,2025-05-25,20:19,4,4,8
76,2025-05-25T12:10:00+02:00,2025-05-25,20:10,0,1,1
79,2025-05-25T12:11:00+02:00,2025-05-25,20:11,3,3,6
79,2025-05-25T12:12:00+02:00,2025-05-25,20:12,1,3,4
79,2025-05-25T12:14:00+02:00,2025-05-25,20:14,2,10,12
79,2025-05-25T12:21:00+02:00,2025-05-25,20:21,8,3,11
85,2025-05-25T12:18:00+02:00,2025-05-25,20:18,1,0,1
86,2025-05-25T12:12:00+02:00,2025-05-25,20:12,5,1,6
109,2025-05-25T12:10:00+02:00,2025-05-25,20:10,12,4,16
130,2025-05-25T12:15:00+02:00,2025-05-25,20:15,1,0,1
136,2025-05-25T12:10:00+02:00,2025-05-25,20:10,1,0,1
136,2025-05-25T12:15:00+02:00,2025-05-25,20:15,1,0,1
136,2025-05-25T12:20:00+02:00,2025-05-25,20:20,1,0,1
137,2025-05-25T12:20:00+02:00,2025-05-25,20:20,0,1,1
139,2025-05-25T12:10:00+02:00,2025-05-25,20:10,1,0,1
139,2025-05-25T12:15:00+02:00,2025-05-25,20:15,0,2,2
139,2025-05-25T12:20:00+02:00,2025-05-25,20:20,1,0,1
141,2025-05-25T12:20:00+02:00,2025-05-25,20:20,12,5,17
142,2025-05-25T12:20:00+02:00,2025-05-25,20:20,1,2,3
164,2025-05-25T12:10:00+02:00,2025-05-25,20:10,0,12,12
164,2025-05-25T12:15:00+02:00,2025-05-25,20:15,10,6,16
3,2025-05-25T11:56:00+02:00,2025-05-25,19:56,16,12,28
3,2025-05-25T12:01:00+02:00,2025-05-25,20:01,8,15,23
3,2025-05-25T12:02:00+02:00,2025-05-25,20:02,19,17,36
3,2025-05-25T12:04:00+02:00,2025-05-25,20:04,12,3,15
3,2025-05-25T12:06:00+02:00,2025-05-25,20:06,22,17,39
3,2025-05-25T12:08:00+02:00,2025-05-25,20:08,24,3,27
4,2025-05-25T11:58:00+02:00,2025-05-25,19:58,5,13,18
4,2025-05-25T12:00:00+02:00,2025-05-25,20:00,3,7,10
4,2025-05-25T12:02:00+02:00,2025-05-25,20:02,13,12,25
4,2025-05-25T12:03:00+02:00,2025-05-25,20:03,10,15,25
4,2025-05-25T12:04:00+02:00,2025-05-25,20:04,4,7,11
4,2025-05-25T12:06:00+02:00,2025-05-25,20:06,10,16,26
4,2025-05-25T12:08:00+02:00,2025-05-25,20:08,6,11,17
6,2025-05-25T12:01:00+02:00,2025-05-25,20:01,2,10,12
6,2025-05-25T12:03:00+02:00,2025-05-25,20:03,8,3,11
6,2025-05-25T12:05:00+02:00,2025-05-25,20:05,2,9,11
6,2025-05-25T12:08:00+02:00,2025-05-25,20:08,8,6,14
6,2025-05-25T12:09:00+02:00,2025-05-25,20:09,8,3,11
8,2025-05-25T11:58:00+02:00,2025-05-25,19:58,1,0,1
8,2025-05-25T12:06:00+02:00,2025-05-25,20:06,0,1,1
28,2025-05-25T12:05:00+02:00,2025-05-25,20:05,0,5,5
28,2025-05-25T12:06:00+02:00,2025-05-25,20:06,2,2,4
28,2025-05-25T12:08:00+02:00,2025-05-25,20:08,3,3,6
28,2025-05-25T12:09:00+02:00,2025-05-25,20:09,3,0,3
29,2025-05-25T11:55:00+02:00,2025-05-25,19:55,2,2,4
29,2025-05-25T11:56:00+02:00,2025-05-25,19:56,2,11,13
29,2025-05-25T12:00:00+02:00,2025-05-25,20:00,0,5,5
29,2025-05-25T12:01:00+02:00,2025-05-25,20:01,3,5,8
29,2025-05-25T12:02:00+02:00,2025-05-25,20:02,6,2,8
29,2025-05-25T12:04:00+02:00,2025-05-25,20:04,0,3,3
29,2025-05-25T12:05:00+02:00,2025-05-25,20:05,2,5,7
29,2025-05-25T12:06:00+02:00,2025-05-25,20:06,0,3,3
29,2025-05-25T12:09:00+02:00,2025-05-25,20:09,1,5,6
31,2025-05-25T11:55:00+02:00,2025-05-25,19:55,4,8,12
31,2025-05-25T12:02:00+02:00,2025-05-25,20:02,9,10,19
31,2025-05-25T12:03:00+02:00,2025-05-25,20:03,5,3,8
31,2025-05-25T12:09:00+02:00,2025-05-25,20:09,6,5,11
36,2025-05-25T11:55:00+02:00,2025-05-25,19:55,0,7,7
36,2025-05-25T11:56:00+02:00,2025-05-25,19:56,6,1,7
36,2025-05-25T12:00:00+02:00,2025-05-25,20:00,1,0,1
36,2025-05-25T12:05:00+02:00,2025-05-25,20:05,2,0,2
36,2025-05-25T12:06:00+02:00,2025-05-25,20:06,3,5,8
36,2025-05-25T12:08:00+02:00,2025-05-25,20:08,0,2,2
39,2025-05-25T11:57:00+02:00,2025-05-25,19:57,1,0,1
39,2025-05-25T12:02:00+02:00,2025-05-25,20:02,0,1,1
39,2025-05-25T12:06:00+02:00,2025-05-25,20:06,0,2,2
40,2025-05-25T11:57:00+02:00,2025-05-25,19:57,2,0,2
40,2025-05-25T11:58:00+02:00,2025-05-25,19:58,0,1,1
40,2025-05-25T12:03:00+02:00,2025-05-25,20:03,13,3,16
40,2025-05-25T12:05:00+02:00,2025-05-25,20:05,5,1,6
40,2025-05-25T12:06:00+02:00,2025-05-25,20:06,5,0,5
40,2025-05-25T12:08:00+02:00,2025-05-25,20:08,2,1,3
40,2025-05-25T12:09:00+02:00,2025-05-25,20:09,3,0,3
41,2025-05-25T11:59:00+02:00,2025-05-25,19:59,2,0,2
41,2025-05-25T12:06:00+02:00,2025-05-25,20:06,1,1,2
41,2025-05-25T12:09:00+02:00,2025-05-25,20:09,0,1,1
44,2025-05-25T11:55:00+02:00,2025-05-25,19:55,3,1,4
44,2025-05-25T12:05:00+02:00,2025-05-25,20:05,2,0,2
45,2025-05-25T12:02:00+02:00,2025-05-25,20:02,5,12,17
47,2025-05-25T11:55:00+02:00,2025-05-25,19:55,4,11,15
50,2025-05-25T12:00:00+02:00,2025-05-25,20:00,2,1,3
50,2025-05-25T12:06:00+02:00,2025-05-25,20:06,1,0,1
50,2025-05-25T12:09:00+02:00,2025-05-25,20:09,1,0,1
54,2025-05-25T11:59:00+02:00,2025-05-25,19:59,1,4,5
54,2025-05-25T12:06:00+02:00,2025-05-25,20:06,4,2,6
54,2025-05-25T12:08:00+02:00,2025-05-25,20:08,2,0,2
61,2025-05-25T11:55:00+02:00,2025-05-25,19:55,10,1,11
61,2025-05-25T12:00:00+02:00,2025-05-25,20:00,1,2,3
61,2025-05-25T12:01:00+02:00,2025-05-25,20:01,1,1,2
61,2025-05-25T12:02:00+02:00,2025-05-25,20:02,4,1,5
61,2025-05-25T12:05:00+02:00,2025-05-25,20:05,1,1,2
66,2025-05-25T11:55:00+02:00,2025-05-25,19:55,16,23,39
66,2025-05-25T11:57:00+02:00,2025-05-25,19:57,7,7,14
66,2025-05-25T12:01:00+02:00,2025-05-25,20:01,26,13,39
66,2025-05-25T12:06:00+02:00,2025-05-25,20:06,16,22,38
69,2025-05-25T11:56:00+02:00,2025-05-25,19:56,1,0,1
69,2025-05-25T11:57:00+02:00,2025-05-25,19:57,0,3,3
69,2025-05-25T12:00:00+02:00,2025-05-25,20:00,1,0,1
69,2025-05-25T12:03:00+02:00,2025-05-25,20:03,0,1,1
69,2025-05-25T12:04:00+02:00,2025-05-25,20:04,1,0,1
69,2025-05-25T12:08:00+02:00,2025-05-25,20:08,1,1,2
70,2025-05-25T12:00:00+02:00,2025-05-25,20:00,1,2,3
70,2025-05-25T12:01:00+02:00,2025-05-25,20:01,2,1,3
70,2025-05-25T12:05:00+02:00,2025-05-25,20:05,1,7,8
70,2025-05-25T12:07:00+02:00,2025-05-25,20:07,5,2,7
71,2025-05-25T12:06:00+02:00,2025-05-25,20:06,1,0,1
75,2025-05-25T12:00:00+02:00,2025-05-25,20:00,0,4,4
77,2025-05-25T12:00:00+02:00,2025-05-25,20:00,8,7,15
77,2025-05-25T12:05:00+02:00,2025-05-25,20:05,11,6,17
78,2025-05-25T12:05:00+02:00,2025-05-25,20:05,1,0,1
84,2025-05-25T11:55:00+02:00,2025-05-25,19:55,47,42,89
87,2025-05-25T12:06:00+02:00,2025-05-25,20:06,1,0,1
87,2025-05-25T12:08:00+02:00,2025-05-25,20:08,0,1,1
108,2025-05-25T11:55:00+02:00,2025-05-25,19:55,2,1,3
108,2025-05-25T11:57:00+02:00,2025-05-25,19:57,10,0,10
108,2025-05-25T12:03:00+02:00,2025-05-25,20:03,1,3,4
131,2025-05-25T12:00:00+02:00,2025-05-25,20:00,2,5,7
132,2025-05-25T12:05:00+02:00,2025-05-25,20:05,4,1,5
133,2025-05-25T11:55:00+02:00,2025-05-25,19:55,38,19,57
134,2025-05-25T11:55:00+02:00,2025-05-25,19:55,29,18,47
134,2025-05-25T12:00:00+02:00,2025-05-25,20:00,36,22,58
135,2025-05-25T11:55:00+02:00,2025-05-25,19:55,5,15,20
135,2025-05-25T12:00:00+02:00,2025-05-25,20:00,16,28,44
162,2025-05-25T11:55:00+02:00,2025-05-25,19:55,3,15,18
162,2025-05-25T12:05:00+02:00,2025-05-25,20:05,7,15,22
165,2025-05-25T11:55:00+02:00,2025-05-25,19:55,1,0,1
167,2025-05-25T12:05:00+02:00,2025-05-25,20:05,0,6,6
1,2025-05-25T11:55:00+02:00,2025-05-25,19:55,6,12,18
1,2025-05-25T11:58:00+02:00,2025-05-25,19:58,7,10,17
1,2025-05-25T12:04:00+02:00,2025-05-25,20:04,6,8,14
1,2025-05-25T12:06:00+02:00,2025-05-25,20:06,7,4,11
1,2025-05-25T12:07:00+02:00,2025-05-25,20:07,1,6,7
2,2025-05-25T11:56:00+02:00,2025-05-25,19:56,2,2,4
2,2025-05-25T12:01:00+02:00,2025-05-25,20:01,4,7,11
2,2025-05-25T12:02:00+02:00,2025-05-25,20:02,2,1,3
2,2025-05-25T12:04:00+02:00,2025-05-25,20:04,0,5,5
2,2025-05-25T12:06:00+02:00,2025-05-25,20:06,0,2,2
2,2025-05-25T12:07:00+02:00,2025-05-25,20:07,0,5,5
9,2025-05-25T12:01:00+02:00,2025-05-25,20:01,6,2,8
10,2025-05-25T12:00:00+02:00,2025-05-25,20:00,3,3,6
10,2025-05-25T12:01:00+02:00,2025-05-25,20:01,2,0,2
10,2025-05-25T12:03:00+02:00,2025-05-25,20:03,1,3,4
10,2025-05-25T12:04:00+02:00,2025-05-25,20:04,0,3,3
12,2025-05-25T11:56:00+02:00,2025-05-25,19:56,3,5,8
12,2025-05-25T11:58:00+02:00,2025-05-25,19:58,3,3,6
12,2025-05-25T12:00:00+02:00,2025-05-25,20:00,1,10,11
12,2025-05-25T12:02:00+02:00,2025-05-25,20:02,2,4,6
12,2025-05-25T12:03:00+02:00,2025-05-25,20:03,3,2,5
12,2025-05-25T12:04:00+02:00,2025-05-25,20:04,7,1,8
12,2025-05-25T12:07:00+02:00,2025-05-25,20:07,3,3,6
17,2025-05-25T11:59:00+02:00,2025-05-25,19:59,1,0,1
17,2025-05-25T12:05:00+02:00,2025-05-25,20:05,3,4,7
17,2025-05-25T12:07:00+02:00,2025-05-25,20:07,4,0,4
19,2025-05-25T11:59:00+02:00,2025-05-25,19:59,7,9,16
19,2025-05-25T12:05:00+02:00,2025-05-25,20:05,3,14,17
19,2025-05-25T12:06:00+02:00,2025-05-25,20:06,7,9,16
19,2025-05-25T12:07:00+02:00,2025-05-25,20:07,2,3,5
20,2025-05-25T11:55:00+02:00,2025-05-25,19:55,3,2,5
20,2025-05-25T11:58:00+02:00,2025-05-25,19:58,12,1,13
20,2025-05-25T12:01:00+02:00,2025-05-25,20:01,5,6,11
20,2025-05-25T12:05:00+02:00,2025-05-25,20:05,5,10,15
20,2025-05-25T12:06:00+02:00,2025-05-25,20:06,6,5,11
20,2025-05-25T12:07:00+02:00,2025-05-25,20:07,7,15,22
23,2025-05-25T12:03:00+02:00,2025-05-25,20:03,3,1,4
23,2025-05-25T12:05:00+02:00,2025-05-25,20:05,0,7,7
23,2025-05-25T12:07:00+02:00,2025-05-25,20:07,0,2,2
23,2025-05-25T12:08:00+02:00,2025-05-25,20:08,0,4,4
24,2025-05-25T11:57:00+02:00,2025-05-25,19:57,3,8,11
24,2025-05-25T12:02:00+02:00,2025-05-25,20:02,2,2,4
24,2025-05-25T12:03:00+02:00,2025-05-25,20:03,12,0,12
24,2025-05-25T12:04:00+02:00,2025-05-25,20:04,3,6,9
24,2025-05-25T12:07:00+02:00,2025-05-25,20:07,7,5,12
24,2025-05-25T12:09:00+02:00,2025-05-25,20:09,8,1,9
25,2025-05-25T12:00:00+02:00,2025-05-25,20:00,9,6,15
25,2025-05-25T12:05:00+02:00,2025-05-25,20:05,10,19,29
27,2025-05-25T12:05:00+02:00,2025-05-25,20:05,3,0,3
27,2025-05-25T12:08:00+02:00,2025-05-25,20:08,0,4,4
30,2025-05-25T11:55:00+02:00,2025-05-25,19:55,1,6,7
35,2025-05-25T11:56:00+02:00,2025-05-25,19:56,3,10,13
35,2025-05-25T11:57:00+02:00,2025-05-25,19:57,6,2,8
35,2025-05-25T11:58:00+02:00,2025-05-25,19:58,4,3,7
35,2025-05-25T12:03:00+02:00,2025-05-25,20:03,2,10,12
48,2025-05-25T11:57:00+02:00,2025-05-25,19:57,2,0,2
48,2025-05-25T11:59:00+02:00,2025-05-25,19:59,1,1,2
48,2025-05-25T12:04:00+02:00,2025-05-25,20:04,2,0,2
48,2025-05-25T12:07:00+02:00,2025-05-25,20:07,0,1,1
48,2025-05-25T12:08:00+02:00,2025-05-25,20:08,0,2,2
49,2025-05-25T11:55:00+02:00,2025-05-25,19:55,14,3,17
49,2025-05-25T12:02:00+02:00,2025-05-25,20:02,7,3,10
49,2025-05-25T12:05:00+02:00,2025-05-25,20:05,0,2,2
49,2025-05-25T12:06:00+02:00,2025-05-25,20:06,4,3,7
49,2025-05-25T12:09:00+02:00,2025-05-25,20:09,3,4,7
51,2025-05-25T12:02:00+02:00,2025-05-25,20:02,1,0,1
51,2025-05-25T12:04:00+02:00,2025-05-25,20:04,1,4,5
51,2025-05-25T12:05:00+02:00,2025-05-25,20:05,1,0,1
51,2025-05-25T12:08:00+02:00,2025-05-25,20:08,0,2,2
52,2025-05-25T11:57:00+02:00,2025-05-25,19:57,1,0,1
52,2025-05-25T11:59:00+02:00,2025-05-25,19:59,6,4,10
52,2025-05-25T12:07:00+02:00,2025-05-25,20:07,2,4,6
53,2025-05-25T11:55:00+02:00,2025-05-25,19:55,5,0,5
53,2025-05-25T11:57:00+02:00,2025-05-25,19:57,4,0,4
53,2025-05-25T12:00:00+02:00,2025-05-25,20:00,2,2,4
53,2025-05-25T12:02:00+02:00,2025-05-25,20:02,0,1,1
53,2025-05-25T12:07:00+02:00,2025-05-25,20:07,0,2,2
53,2025-05-25T12:08:00+02:00,2025-05-25,20:08,0,3,3
56,2025-05-25T11:56:00+02:00,2025-05-25,19:56,1,6,7
56,2025-05-25T11:58:00+02:00,2025-05-25,19:58,3,5,8
56,2025-05-25T12:05:00+02:00,2025-05-25,20:05,4,4,8
56,2025-05-25T12:08:00+02:00,2025-05-25,20:08,1,7,8
58,2025-05-25T11:55:00+02:00,2025-05-25,19:55,8,3,11
58,2025-05-25T11:57:00+02:00,2025-05-25,19:57,5,6,11
58,2025-05-25T11:59:00+02:00,2025-05-25,19:59,2,1,3
58,2025-05-25T12:01:00+02:00,2025-05-25,20:01,2,5,7
58,2025-05-25T12:07:00+02:00,2025-05-25,20:07,17,5,22
58,2025-05-25T12:08:00+02:00,2025-05-25,20:08,3,7,10
62,2025-05-25T11:56:00+02:00,2025-05-25,19:56,1,0,1
62,2025-05-25T12:07:00+02:00,2025-05-25,20:07,4,3,7
62,2025-05-25T12:08:00+02:00,2025-05-25,20:08,2,4,6
63,2025-05-25T12:04:00+02:00,2025-05-25,20:04,0,1,1
63,2025-05-25T12:05:00+02:00,2025-05-25,20:05,0,4,4
63,2025-05-25T12:09:00+02:00,2025-05-25,20:09,1,1,2
67,2025-05-25T12:04:00+02:00,2025-05-25,20:04,4,5,9
67,2025-05-25T12:05:00+02:00,2025-05-25,20:05,2,7,9
67,2025-05-25T12:06:00+02:00,2025-05-25,20:06,6,5,11
68,2025-05-25T11:59:00+02:00,2025-05-25,19:59,3,1,4
68,2025-05-25T12:01:00+02:00,2025-05-25,20:01,8,1,9
68,2025-05-25T12:02:00+02:00,2025-05-25,20:02,1,1,2
68,2025-05-25T12:05:00+02:00,2025-05-25,20:05,1,2,3
68,2025-05-25T12:09:00+02:00,2025-05-25,20:09,2,2,4
72,2025-05-25T11:55:00+02:00,2025-05-25,19:55,1,5,6
72,2025-05-25T11:59:00+02:00,2025-05-25,19:59,0,2,2
72,2025-05-25T12:02:00+02:00,2025-05-25,20:02,0,2,2
72,2025-05-25T12:03:00+02:00,2025-05-25,20:03,4,1,5
72,2025-05-25T12:07:00+02:00,2025-05-25,20:07,0,4,4
79,2025-05-25T11:56:00+02:00,2025-05-25,19:56,3,1,4
79,2025-05-25T11:57:00+02:00,2025-05-25,19:57,8,5,13
79,2025-05-25T11:58:00+02:00,2025-05-25,19:58,2,7,9
79,2025-05-25T12:00:00+02:00,2025-05-25,20:00,0,3,3
79,2025-05-25T12:03:00+02:00,2025-05-25,20:03,2,2,4
79,2025-05-25T12:05:00+02:00,2025-05-25,20:05,2,0,2
79,2025-05-25T12:06:00+02:00,2025-05-25,20:06,2,5,7
79,2025-05-25T12:07:00+02:00,2025-05-25,20:07,7,4,11
79,2025-05-25T12:09:00+02:00,2025-05-25,20:09,1,1,2
85,2025-05-25T11:58:00+02:00,2025-05-25,19:58,0,2,2
85,2025-05-25T12:03:00+02:00,2025-05-25,20:03,1,0,1
86,2025-05-25T12:00:00+02:00,2025-05-25,20:00,0,1,1
109,2025-05-25T12:00:00+02:00,2025-05-25,20:00,8,6,14
117,2025-05-25T12:00:00+02:00,2025-05-25,20:00,8,2,10
130,2025-05-25T12:00:00+02:00,2025-05-25,20:00,1,0,1
136,2025-05-25T12:05:00+02:00,2025-05-25,20:05,0,1,1
141,2025-05-25T11:55:00+02:00,2025-05-25,19:55,7,9,16
142,2025-05-25T11:55:00+02:00,2025-05-25,19:55,0,2,2
142,2025-05-25T12:00:00+02:00,2025-05-25,20:00,5,2,7
3,2025-05-25T11:41:00+02:00,2025-05-25,19:41,15,14,29
3,2025-05-25T11:49:00+02:00,2025-05-25,19:49,5,21,26
3,2025-05-25T11:52:00+02:00,2025-05-25,19:52,2,29,31
3,2025-05-25T11:53:00+02:00,2025-05-25,19:53,10,10,20
3,2025-05-25T11:54:00+02:00,2025-05-25,19:54,10,9,19
4,2025-05-25T11:41:00+02:00,2025-05-25,19:41,13,3,16
4,2025-05-25T11:49:00+02:00,2025-05-25,19:49,23,15,38
4,2025-05-25T11:51:00+02:00,2025-05-25,19:51,12,14,26
6,2025-05-25T11:40:00+02:00,2025-05-25,19:40,11,6,17
6,2025-05-25T11:43:00+02:00,2025-05-25,19:43,15,7,22
6,2025-05-25T11:44:00+02:00,2025-05-25,19:44,4,12,16
6,2025-05-25T11:45:00+02:00,2025-05-25,19:45,5,5,10
6,2025-05-25T11:46:00+02:00,2025-05-25,19:46,4,7,11
6,2025-05-25T11:52:00+02:00,2025-05-25,19:52,7,10,17
21,2025-05-25T11:40:00+02:00,2025-05-25,19:40,10,18,28
21,2025-05-25T11:45:00+02:00,2025-05-25,19:45,33,21,54
21,2025-05-25T11:50:00+02:00,2025-05-25,19:50,30,18,48
28,2025-05-25T11:43:00+02:00,2025-05-25,19:43,1,1,2
28,2025-05-25T11:44:00+02:00,2025-05-25,19:44,0,3,3
28,2025-05-25T11:46:00+02:00,2025-05-25,19:46,1,2,3
28,2025-05-25T11:47:00+02:00,2025-05-25,19:47,2,3,5
28,2025-05-25T11:48:00+02:00,2025-05-25,19:48,1,1,2
28,2025-05-25T11:51:00+02:00,2025-05-25,19:51,1,4,5
28,2025-05-25T11:52:00+02:00,2025-05-25,19:52,1,5,6
29,2025-05-25T11:42:00+02:00,2025-05-25,19:42,3,0,3
29,2025-05-25T11:48:00+02:00,2025-05-25,19:48,1,0,1
29,2025-05-25T11:52:00+02:00,2025-05-25,19:52,10,4,14
31,2025-05-25T11:43:00+02:00,2025-05-25,19:43,8,0,8
31,2025-05-25T11:47:00+02:00,2025-05-25,19:47,12,5,17
31,2025-05-25T11:48:00+02:00,2025-05-25,19:48,7,3,10
36,2025-05-25T11:45:00+02:00,2025-05-25,19:45,0,2,2
36,2025-05-25T11:46:00+02:00,2025-05-25,19:46,0,4,4
36,2025-05-25T11:49:00+02:00,2025-05-25,19:49,0,4,4
39,2025-05-25T11:46:00+02:00,2025-05-25,19:46,2,0,2
40,2025-05-25T11:43:00+02:00,2025-05-25,19:43,1,2,3
40,2025-05-25T11:45:00+02:00,2025-05-25,19:45,1,2,3
40,2025-05-25T11:46:00+02:00,2025-05-25,19:46,0,5,5
40,2025-05-25T11:50:00+02:00,2025-05-25,19:50,2,0,2
40,2025-05-25T11:51:00+02:00,2025-05-25,19:51,2,0,2
40,2025-05-25T11:52:00+02:00,2025-05-25,19:52,3,0,3
40,2025-05-25T11:53:00+02:00,2025-05-25,19:53,3,1,4
41,2025-05-25T11:40:00+02:00,2025-05-25,19:40,2,0,2
41,2025-05-25T11:42:00+02:00,2025-05-25,19:42,6,5,11
41,2025-05-25T11:43:00+02:00,2025-05-25,19:43,3,1,4
41,2025-05-25T11:46:00+02:00,2025-05-25,19:46,2,0,2
43,2025-05-25T11:45:00+02:00,2025-05-25,19:45,4,14,18
43,2025-05-25T11:50:00+02:00,2025-05-25,19:50,1,2,3
44,2025-05-25T11:45:00+02:00,2025-05-25,19:45,2,5,7
45,2025-05-25T11:40:00+02:00,2025-05-25,19:40,8,10,18
45,2025-05-25T11:45:00+02:00,2025-05-25,19:45,10,24,34
47,2025-05-25T11:40:00+02:00,2025-05-25,19:40,6,10,16
47,2025-05-25T11:41:00+02:00,2025-05-25,19:41,8,11,19
47,2025-05-25T11:47:00+02:00,2025-05-25,19:47,18,17,35
47,2025-05-25T11:48:00+02:00,2025-05-25,19:48,11,11,22
47,2025-05-25T11:50:00+02:00,2025-05-25,19:50,8,2,10
47,2025-05-25T11:52:00+02:00,2025-05-25,19:52,7,2,9
50,2025-05-25T11:40:00+02:00,2025-05-25,19:40,0,4,4
50,2025-05-25T11:44:00+02:00,2025-05-25,19:44,2,7,9
50,2025-05-25T11:46:00+02:00,2025-05-25,19:46,6,0,6
50,2025-05-25T11:48:00+02:00,2025-05-25,19:48,2,1,3
50,2025-05-25T11:50:00+02:00,2025-05-25,19:50,9,3,12
50,2025-05-25T11:51:00+02:00,2025-05-25,19:51,1,2,3
54,2025-05-25T11:43:00+02:00,2025-05-25,19:43,2,3,5
54,2025-05-25T11:44:00+02:00,2025-05-25,19:44,5,1,6
54,2025-05-25T11:45:00+02:00,2025-05-25,19:45,2,3,5
54,2025-05-25T11:50:00+02:00,2025-05-25,19:50,3,7,10
54,2025-05-25T11:51:00+02:00,2025-05-25,19:51,4,1,5
59,2025-05-25T11:45:00+02:00,2025-05-25,19:45,12,18,30
61,2025-05-25T11:41:00+02:00,2025-05-25,19:41,5,1,6
61,2025-05-25T11:45:00+02:00,2025-05-25,19:45,20,3,23
61,2025-05-25T11:51:00+02:00,2025-05-25,19:51,15,0,15
61,2025-05-25T11:52:00+02:00,2025-05-25,19:52,1,5,6
61,2025-05-25T11:53:00+02:00,2025-05-25,19:53,2,0,2
66,2025-05-25T11:48:00+02:00,2025-05-25,19:48,22,8,30
66,2025-05-25T11:52:00+02:00,2025-05-25,19:52,23,29,52
66,2025-05-25T11:54:00+02:00,2025-05-25,19:54,24,5,29
69,2025-05-25T11:48:00+02:00,2025-05-25,19:48,1,1,2
69,2025-05-25T11:54:00+02:00,2025-05-25,19:54,2,1,3
70,2025-05-25T11:44:00+02:00,2025-05-25,19:44,3,0,3
70,2025-05-25T11:45:00+02:00,2025-05-25,19:45,0,1,1
70,2025-05-25T11:48:00+02:00,2025-05-25,19:48,0,1,1
70,2025-05-25T11:50:00+02:00,2025-05-25,19:50,3,0,3
70,2025-05-25T11:51:00+02:00,2025-05-25,19:51,4,0,4
70,2025-05-25T11:52:00+02:00,2025-05-25,19:52,5,1,6
70,2025-05-25T11:53:00+02:00,2025-05-25,19:53,2,0,2
78,2025-05-25T11:45:00+02:00,2025-05-25,19:45,0,1,1
78,2025-05-25T11:46:00+02:00,2025-05-25,19:46,0,1,1
78,2025-05-25T11:52:00+02:00,2025-05-25,19:52,0,1,1
78,2025-05-25T11:53:00+02:00,2025-05-25,19:53,0,1,1
84,2025-05-25T11:50:00+02:00,2025-05-25,19:50,24,51,75
87,2025-05-25T11:40:00+02:00,2025-05-25,19:40,0,2,2
87,2025-05-25T11:46:00+02:00,2025-05-25,19:46,3,0,3
87,2025-05-25T11:50:00+02:00,2025-05-25,19:50,2,2,4
107,2025-05-25T11:45:00+02:00,2025-05-25,19:45,5,2,7
108,2025-05-25T11:43:00+02:00,2025-05-25,19:43,0,3,3
108,2025-05-25T11:47:00+02:00,2025-05-25,19:47,4,1,5
108,2025-05-25T11:48:00+02:00,2025-05-25,19:48,4,4,8
108,2025-05-25T11:50:00+02:00,2025-05-25,19:50,8,0,8
118,2025-05-25T11:45:00+02:00,2025-05-25,19:45,2,0,2
118,2025-05-25T11:50:00+02:00,2025-05-25,19:50,3,0,3
132,2025-05-25T11:40:00+02:00,2025-05-25,19:40,9,6,15
132,2025-05-25T11:50:00+02:00,2025-05-25,19:50,8,14,22
133,2025-05-25T11:50:00+02:00,2025-05-25,19:50,28,11,39
134,2025-05-25T11:50:00+02:00,2025-05-25,19:50,15,23,38
135,2025-05-25T11:45:00+02:00,2025-05-25,19:45,10,32,42
135,2025-05-25T11:50:00+02:00,2025-05-25,19:50,11,19,30
162,2025-05-25T11:45:00+02:00,2025-05-25,19:45,6,8,14
166,2025-05-25T11:45:00+02:00,2025-05-25,19:45,1,1,2
166,2025-05-25T11:50:00+02:00,2025-05-25,19:50,4,0,4
1,2025-05-25T11:47:00+02:00,2025-05-25,19:47,4,11,15
1,2025-05-25T11:52:00+02:00,2025-05-25,19:52,0,1,1
1,2025-05-25T11:53:00+02:00,2025-05-25,19:53,0,6,6
1,2025-05-25T11:54:00+02:00,2025-05-25,19:54,4,4,8
2,2025-05-25T11:42:00+02:00,2025-05-25,19:42,5,3,8
2,2025-05-25T11:44:00+02:00,2025-05-25,19:44,1,0,1
2,2025-05-25T11:46:00+02:00,2025-05-25,19:46,1,5,6
2,2025-05-25T11:48:00+02:00,2025-05-25,19:48,0,1,1
2,2025-05-25T11:52:00+02:00,2025-05-25,19:52,2,10,12
2,2025-05-25T11:53:00+02:00,2025-05-25,19:53,6,2,8
2,2025-05-25T11:54:00+02:00,2025-05-25,19:54,2,0,2
9,2025-05-25T11:42:00+02:00,2025-05-25,19:42,0,4,4
9,2025-05-25T11:48:00+02:00,2025-05-25,19:48,1,0,1
9,2025-05-25T11:49:00+02:00,2025-05-25,19:49,1,1,2
9,2025-05-25T11:51:00+02:00,2025-05-25,19:51,4,2,6
10,2025-05-25T11:43:00+02:00,2025-05-25,19:43,1,1,2
10,2025-05-25T11:46:00+02:00,2025-05-25,19:46,1,1,2
11,2025-05-25T11:40:00+02:00,2025-05-25,19:40,2,1,3
11,2025-05-25T11:50:00+02:00,2025-05-25,19:50,6,2,8
12,2025-05-25T11:42:00+02:00,2025-05-25,19:42,3,7,10
12,2025-05-25T11:43:00+02:00,2025-05-25,19:43,1,8,9
12,2025-05-25T11:51:00+02:00,2025-05-25,19:51,2,7,9
12,2025-05-25T11:54:00+02:00,2025-05-25,19:54,0,1,1
17,2025-05-25T11:40:00+02:00,2025-05-25,19:40,3,1,4
17,2025-05-25T11:41:00+02:00,2025-05-25,19:41,1,2,3
17,2025-05-25T11:46:00+02:00,2025-05-25,19:46,3,1,4
17,2025-05-25T11:47:00+02:00,2025-05-25,19:47,0,1,1
19,2025-05-25T11:42:00+02:00,2025-05-25,19:42,9,6,15
19,2025-05-25T11:44:00+02:00,2025-05-25,19:44,9,7,16
19,2025-05-25T11:45:00+02:00,2025-05-25,19:45,22,6,28
19,2025-05-25T11:54:00+02:00,2025-05-25,19:54,6,9,15
20,2025-05-25T11:50:00+02:00,2025-05-25,19:50,8,3,11
23,2025-05-25T11:40:00+02:00,2025-05-25,19:40,0,2,2
23,2025-05-25T11:43:00+02:00,2025-05-25,19:43,0,2,2
23,2025-05-25T11:45:00+02:00,2025-05-25,19:45,3,2,5
23,2025-05-25T11:47:00+02:00,2025-05-25,19:47,0,3,3
23,2025-05-25T11:48:00+02:00,2025-05-25,19:48,1,1,2
23,2025-05-25T11:49:00+02:00,2025-05-25,19:49,2,3,5
23,2025-05-25T11:50:00+02:00,2025-05-25,19:50,1,10,11
24,2025-05-25T11:40:00+02:00,2025-05-25,19:40,9,1,10
24,2025-05-25T11:42:00+02:00,2025-05-25,19:42,5,11,16
24,2025-05-25T11:44:00+02:00,2025-05-25,19:44,9,6,15
24,2025-05-25T11:45:00+02:00,2025-05-25,19:45,6,6,12
24,2025-05-25T11:49:00+02:00,2025-05-25,19:49,14,2,16
24,2025-05-25T11:50:00+02:00,2025-05-25,19:50,6,17,23
27,2025-05-25T11:44:00+02:00,2025-05-25,19:44,1,1,2
27,2025-05-25T11:50:00+02:00,2025-05-25,19:50,2,0,2
27,2025-05-25T11:51:00+02:00,2025-05-25,19:51,3,2,5
30,2025-05-25T11:40:00+02:00,2025-05-25,19:40,3,5,8
30,2025-05-25T11:41:00+02:00,2025-05-25,19:41,7,3,10
30,2025-05-25T11:47:00+02:00,2025-05-25,19:47,1,14,15
30,2025-05-25T11:49:00+02:00,2025-05-25,19:49,4,8,12
30,2025-05-25T11:54:00+02:00,2025-05-25,19:54,2,1,3
35,2025-05-25T11:41:00+02:00,2025-05-25,19:41,4,11,15
35,2025-05-25T11:42:00+02:00,2025-05-25,19:42,10,8,18
35,2025-05-25T11:51:00+02:00,2025-05-25,19:51,10,9,19
35,2025-05-25T11:52:00+02:00,2025-05-25,19:52,7,14,21
35,2025-05-25T11:53:00+02:00,2025-05-25,19:53,11,2,13
35,2025-05-25T11:54:00+02:00,2025-05-25,19:54,6,19,25
46,2025-05-25T11:45:00+02:00,2025-05-25,19:45,1,0,1
48,2025-05-25T11:42:00+02:00,2025-05-25,19:42,1,6,7
48,2025-05-25T11:46:00+02:00,2025-05-25,19:46,2,4,6
48,2025-05-25T11:47:00+02:00,2025-05-25,19:47,1,1,2
48,2025-05-25T11:48:00+02:00,2025-05-25,19:48,0,1,1
49,2025-05-25T11:47:00+02:00,2025-05-25,19:47,2,3,5
49,2025-05-25T11:50:00+02:00,2025-05-25,19:50,3,1,4
51,2025-05-25T11:40:00+02:00,2025-05-25,19:40,2,2,4
51,2025-05-25T11:41:00+02:00,2025-05-25,19:41,0,2,2
51,2025-05-25T11:42:00+02:00,2025-05-25,19:42,0,2,2
51,2025-05-25T11:44:00+02:00,2025-05-25,19:44,2,3,5
51,2025-05-25T11:46:00+02:00,2025-05-25,19:46,2,2,4
51,2025-05-25T11:47:00+02:00,2025-05-25,19:47,0,3,3
51,2025-05-25T11:49:00+02:00,2025-05-25,19:49,1,2,3
51,2025-05-25T11:52:00+02:00,2025-05-25,19:52,2,5,7
51,2025-05-25T11:54:00+02:00,2025-05-25,19:54,1,2,3
52,2025-05-25T11:41:00+02:00,2025-05-25,19:41,3,1,4
52,2025-05-25T11:47:00+02:00,2025-05-25,19:47,11,2,13
52,2025-05-25T11:48:00+02:00,2025-05-25,19:48,2,3,5
52,2025-05-25T11:50:00+02:00,2025-05-25,19:50,2,0,2
52,2025-05-25T11:52:00+02:00,2025-05-25,19:52,10,1,11
53,2025-05-25T11:41:00+02:00,2025-05-25,19:41,11,3,14
53,2025-05-25T11:44:00+02:00,2025-05-25,19:44,4,1,5
53,2025-05-25T11:45:00+02:00,2025-05-25,19:45,0,3,3
53,2025-05-25T11:52:00+02:00,2025-05-25,19:52,5,1,6
53,2025-05-25T11:53:00+02:00,2025-05-25,19:53,1,1,2
53,2025-05-25T11:54:00+02:00,2025-05-25,19:54,0,4,4
56,2025-05-25T11:40:00+02:00,2025-05-25,19:40,8,4,12
56,2025-05-25T11:41:00+02:00,2025-05-25,19:41,5,0,5
56,2025-05-25T11:42:00+02:00,2025-05-25,19:42,1,5,6
56,2025-05-25T11:43:00+02:00,2025-05-25,19:43,0,8,8
56,2025-05-25T11:44:00+02:00,2025-05-25,19:44,8,3,11
56,2025-05-25T11:49:00+02:00,2025-05-25,19:49,10,10,20
56,2025-05-25T11:54:00+02:00,2025-05-25,19:54,2,5,7
58,2025-05-25T11:40:00+02:00,2025-05-25,19:40,4,3,7
58,2025-05-25T11:42:00+02:00,2025-05-25,19:42,15,8,23
58,2025-05-25T11:43:00+02:00,2025-05-25,19:43,10,4,14
58,2025-05-25T11:45:00+02:00,2025-05-25,19:45,8,0,8
58,2025-05-25T11:46:00+02:00,2025-05-25,19:46,1,1,2
58,2025-05-25T11:47:00+02:00,2025-05-25,19:47,13,2,15
58,2025-05-25T11:52:00+02:00,2025-05-25,19:52,8,1,9
58,2025-05-25T11:53:00+02:00,2025-05-25,19:53,7,4,11
58,2025-05-25T11:54:00+02:00,2025-05-25,19:54,3,5,8
62,2025-05-25T11:48:00+02:00,2025-05-25,19:48,1,2,3
62,2025-05-25T11:54:00+02:00,2025-05-25,19:54,2,2,4
63,2025-05-25T11:42:00+02:00,2025-05-25,19:42,0,1,1
63,2025-05-25T11:54:00+02:00,2025-05-25,19:54,0,1,1
67,2025-05-25T11:40:00+02:00,2025-05-25,19:40,4,6,10
67,2025-05-25T11:41:00+02:00,2025-05-25,19:41,7,9,16
67,2025-05-25T11:42:00+02:00,2025-05-25,19:42,4,3,7
67,2025-05-25T11:44:00+02:00,2025-05-25,19:44,4,2,6
67,2025-05-25T11:49:00+02:00,2025-05-25,19:49,1,7,8
67,2025-05-25T11:53:00+02:00,2025-05-25,19:53,0,5,5
68,2025-05-25T11:40:00+02:00,2025-05-25,19:40,1,0,1
68,2025-05-25T11:41:00+02:00,2025-05-25,19:41,6,1,7
68,2025-05-25T11:42:00+02:00,2025-05-25,19:42,0,1,1
68,2025-05-25T11:45:00+02:00,2025-05-25,19:45,2,2,4
68,2025-05-25T11:48:00+02:00,2025-05-25,19:48,0,1,1
68,2025-05-25T11:51:00+02:00,2025-05-25,19:51,1,0,1
68,2025-05-25T11:52:00+02:00,2025-05-25,19:52,1,0,1
72,2025-05-25T11:40:00+02:00,2025-05-25,19:40,10,0,10
72,2025-05-25T11:42:00+02:00,2025-05-25,19:42,5,0,5
72,2025-05-25T11:45:00+02:00,2025-05-25,19:45,6,5,11
72,2025-05-25T11:47:00+02:00,2025-05-25,19:47,3,7,10
72,2025-05-25T11:48:00+02:00,2025-05-25,19:48,6,1,7
72,2025-05-25T11:52:00+02:00,2025-05-25,19:52,3,11,14
76,2025-05-25T11:43:00+02:00,2025-05-25,19:43,2,0,2
76,2025-05-25T11:48:00+02:00,2025-05-25,19:48,2,0,2
76,2025-05-25T11:51:00+02:00,2025-05-25,19:51,0,2,2
79,2025-05-25T11:40:00+02:00,2025-05-25,19:40,0,6,6
79,2025-05-25T11:41:00+02:00,2025-05-25,19:41,5,4,9
79,2025-05-25T11:43:00+02:00,2025-05-25,19:43,1,4,5
79,2025-05-25T11:44:00+02:00,2025-05-25,19:44,5,2,7
79,2025-05-25T11:50:00+02:00,2025-05-25,19:50,5,4,9
79,2025-05-25T11:51:00+02:00,2025-05-25,19:51,2,4,6
79,2025-05-25T11:53:00+02:00,2025-05-25,19:53,5,1,6
85,2025-05-25T11:40:00+02:00,2025-05-25,19:40,4,0,4
85,2025-05-25T11:42:00+02:00,2025-05-25,19:42,0,1,1
85,2025-05-25T11:43:00+02:00,2025-05-25,19:43,1,3,4
85,2025-05-25T11:44:00+02:00,2025-05-25,19:44,0,1,1
85,2025-05-25T11:45:00+02:00,2025-05-25,19:45,2,0,2
85,2025-05-25T11:48:00+02:00,2025-05-25,19:48,1,0,1
86,2025-05-25T11:42:00+02:00,2025-05-25,19:42,2,1,3
86,2025-05-25T11:50:00+02:00,2025-05-25,19:50,3,0,3
86,2025-05-25T11:52:00+02:00,2025-05-25,19:52,5,0,5
86,2025-05-25T11:54:00+02:00,2025-05-25,19:54,0,1,1
117,2025-05-25T11:45:00+02:00,2025-05-25,19:45,27,3,30
130,2025-05-25T11:40:00+02:00,2025-05-25,19:40,0,1,1
137,2025-05-25T11:40:00+02:00,2025-05-25,19:40,1,1,2
139,2025-05-25T11:50:00+02:00,2025-05-25,19:50,0,1,1
141,2025-05-25T11:40:00+02:00,2025-05-25,19:40,4,2,6
164,2025-05-25T11:40:00+02:00,2025-05-25,19:40,4,0,4
164,2025-05-25T11:45:00+02:00,2025-05-25,19:45,4,21,25
181,2025-05-25T11:41:00+02:00,2025-05-25,19:41,11,16,27
181,2025-05-25T11:48:00+02:00,2025-05-25,19:48,22,12,34
181,2025-05-25T11:51:00+02:00,2025-05-25,19:51,15,9,24
181,2025-05-25T11:54:00+02:00,2025-05-25,19:54,18,13,31
182,2025-05-25T11:40:00+02:00,2025-05-25,19:40,17,24,41
180,2025-05-25T11:54:00+02:00,2025-05-25,19:54,0,1,1
181,2025-05-25T11:56:00+02:00,2025-05-25,19:56,8,9,17
181,2025-05-25T12:00:00+02:00,2025-05-25,20:00,21,6,27
181,2025-05-25T12:03:00+02:00,2025-05-25,20:03,20,10,30
181,2025-05-25T12:06:00+02:00,2025-05-25,20:06,2,6,8
181,2025-05-25T12:08:00+02:00,2025-05-25,20:08,10,10,20
181,2025-05-25T12:09:00+02:00,2025-05-25,20:09,16,10,26
182,2025-05-25T12:00:00+02:00,2025-05-25,20:00,20,16,36
181,2025-05-25T12:11:00+02:00,2025-05-25,20:11,32,11,43
181,2025-05-25T12:12:00+02:00,2025-05-25,20:12,12,6,18
181,2025-05-25T12:14:00+02:00,2025-05-25,20:14,12,15,27
181,2025-05-25T12:16:00+02:00,2025-05-25,20:16,13,6,19
181,2025-05-25T12:19:00+02:00,2025-05-25,20:19,8,14,22
181,2025-05-25T12:21:00+02:00,2025-05-25,20:21,6,15,21
181,2025-05-25T12:23:00+02:00,2025-05-25,20:23,11,5,16
182,2025-05-25T12:20:00+02:00,2025-05-25,20:20,11,11,22
3,2025-05-25T12:25:00+02:00,2025-05-25,20:25,12,11,23
3,2025-05-25T12:28:00+02:00,2025-05-25,20:28,6,17,23
3,2025-05-25T12:32:00+02:00,2025-05-25,20:32,1,8,9
3,2025-05-25T12:36:00+02:00,2025-05-25,20:36,17,22,39
4,2025-05-25T12:25:00+02:00,2025-05-25,20:25,4,17,21
4,2025-05-25T12:30:00+02:00,2025-05-25,20:30,7,7,14
4,2025-05-25T12:31:00+02:00,2025-05-25,20:31,11,3,14
4,2025-05-25T12:37:00+02:00,2025-05-25,20:37,12,11,23
4,2025-05-25T12:39:00+02:00,2025-05-25,20:39,4,7,11
6,2025-05-25T12:25:00+02:00,2025-05-25,20:25,10,10,20
6,2025-05-25T12:31:00+02:00,2025-05-25,20:31,14,10,24
6,2025-05-25T12:32:00+02:00,2025-05-25,20:32,10,11,21
6,2025-05-25T12:36:00+02:00,2025-05-25,20:36,2,8,10
6,2025-05-25T12:37:00+02:00,2025-05-25,20:37,5,3,8
6,2025-05-25T12:38:00+02:00,2025-05-25,20:38,4,14,18
6,2025-05-25T12:39:00+02:00,2025-05-25,20:39,5,8,13
21,2025-05-25T12:25:00+02:00,2025-05-25,20:25,33,25,58
28,2025-05-25T12:25:00+02:00,2025-05-25,20:25,2,0,2
28,2025-05-25T12:27:00+02:00,2025-05-25,20:27,3,0,3
28,2025-05-25T12:29:00+02:00,2025-05-25,20:29,8,3,11
28,2025-05-25T12:33:00+02:00,2025-05-25,20:33,2,2,4
28,2025-05-25T12:37:00+02:00,2025-05-25,20:37,5,1,6
29,2025-05-25T12:25:00+02:00,2025-05-25,20:25,0,4,4
29,2025-05-25T12:34:00+02:00,2025-05-25,20:34,3,4,7
29,2025-05-25T12:38:00+02:00,2025-05-25,20:38,1,2,3
29,2025-05-25T12:39:00+02:00,2025-05-25,20:39,2,8,10
31,2025-05-25T12:26:00+02:00,2025-05-25,20:26,0,7,7
31,2025-05-25T12:29:00+02:00,2025-05-25,20:29,4,8,12
31,2025-05-25T12:31:00+02:00,2025-05-25,20:31,0,2,2
31,2025-05-25T12:32:00+02:00,2025-05-25,20:32,3,0,3
36,2025-05-25T12:28:00+02:00,2025-05-25,20:28,1,3,4
36,2025-05-25T12:29:00+02:00,2025-05-25,20:29,0,1,1
36,2025-05-25T12:30:00+02:00,2025-05-25,20:30,4,1,5
36,2025-05-25T12:31:00+02:00,2025-05-25,20:31,4,0,4
36,2025-05-25T12:34:00+02:00,2025-05-25,20:34,3,0,3
36,2025-05-25T12:35:00+02:00,2025-05-25,20:35,2,0,2
36,2025-05-25T12:38:00+02:00,2025-05-25,20:38,1,0,1
40,2025-05-25T12:28:00+02:00,2025-05-25,20:28,2,0,2
40,2025-05-25T12:31:00+02:00,2025-05-25,20:31,0,4,4
40,2025-05-25T12:32:00+02:00,2025-05-25,20:32,3,0,3
40,2025-05-25T12:34:00+02:00,2025-05-25,20:34,3,0,3
40,2025-05-25T12:38:00+02:00,2025-05-25,20:38,0,2,2
41,2025-05-25T12:25:00+02:00,2025-05-25,20:25,2,5,7
41,2025-05-25T12:30:00+02:00,2025-05-25,20:30,0,4,4
41,2025-05-25T12:33:00+02:00,2025-05-25,20:33,0,1,1
41,2025-05-25T12:38:00+02:00,2025-05-25,20:38,1,0,1
43,2025-05-25T12:30:00+02:00,2025-05-25,20:30,5,1,6
43,2025-05-25T12:35:00+02:00,2025-05-25,20:35,2,5,7
45,2025-05-25T12:32:00+02:00,2025-05-25,20:32,7,11,18
45,2025-05-25T12:36:00+02:00,2025-05-25,20:36,4,10,14
47,2025-05-25T12:30:00+02:00,2025-05-25,20:30,6,6,12
47,2025-05-25T12:33:00+02:00,2025-05-25,20:33,0,3,3
47,2025-05-25T12:36:00+02:00,2025-05-25,20:36,6,12,18
47,2025-05-25T12:37:00+02:00,2025-05-25,20:37,14,11,25
50,2025-05-25T12:26:00+02:00,2025-05-25,20:26,7,0,7
50,2025-05-25T12:27:00+02:00,2025-05-25,20:27,1,5,6
50,2025-05-25T12:28:00+02:00,2025-05-25,20:28,6,0,6
50,2025-05-25T12:33:00+02:00,2025-05-25,20:33,5,1,6
50,2025-05-25T12:36:00+02:00,2025-05-25,20:36,4,3,7
50,2025-05-25T12:37:00+02:00,2025-05-25,20:37,3,2,5
54,2025-05-25T12:25:00+02:00,2025-05-25,20:25,6,0,6
54,2025-05-25T12:26:00+02:00,2025-05-25,20:26,2,4,6
54,2025-05-25T12:29:00+02:00,2025-05-25,20:29,1,0,1
54,2025-05-25T12:30:00+02:00,2025-05-25,20:30,0,3,3
54,2025-05-25T12:31:00+02:00,2025-05-25,20:31,2,0,2
54,2025-05-25T12:34:00+02:00,2025-05-25,20:34,1,0,1
54,2025-05-25T12:39:00+02:00,2025-05-25,20:39,3,5,8
59,2025-05-25T12:30:00+02:00,2025-05-25,20:30,14,12,26
59,2025-05-25T12:35:00+02:00,2025-05-25,20:35,18,9,27
61,2025-05-25T12:25:00+02:00,2025-05-25,20:25,5,2,7
61,2025-05-25T12:26:00+02:00,2025-05-25,20:26,2,4,6
61,2025-05-25T12:28:00+02:00,2025-05-25,20:28,6,1,7
61,2025-05-25T12:33:00+02:00,2025-05-25,20:33,5,0,5
61,2025-05-25T12:36:00+02:00,2025-05-25,20:36,2,1,3
61,2025-05-25T12:38:00+02:00,2025-05-25,20:38,9,3,12
61,2025-05-25T12:39:00+02:00,2025-05-25,20:39,3,0,3
66,2025-05-25T12:28:00+02:00,2025-05-25,20:28,16,14,30
66,2025-05-25T12:29:00+02:00,2025-05-25,20:29,10,16,26
66,2025-05-25T12:31:00+02:00,2025-05-25,20:31,13,8,21
66,2025-05-25T12:32:00+02:00,2025-05-25,20:32,11,4,15
66,2025-05-25T12:35:00+02:00,2025-05-25,20:35,17,14,31
66,2025-05-25T12:38:00+02:00,2025-05-25,20:38,8,4,12
69,2025-05-25T12:32:00+02:00,2025-05-25,20:32,3,0,3
69,2025-05-25T12:33:00+02:00,2025-05-25,20:33,2,1,3
69,2025-05-25T12:37:00+02:00,2025-05-25,20:37,1,0,1
70,2025-05-25T12:26:00+02:00,2025-05-25,20:26,3,0,3
70,2025-05-25T12:32:00+02:00,2025-05-25,20:32,0,2,2
70,2025-05-25T12:33:00+02:00,2025-05-25,20:33,1,1,2
70,2025-05-25T12:35:00+02:00,2025-05-25,20:35,1,1,2
70,2025-05-25T12:36:00+02:00,2025-05-25,20:36,0,1,1
75,2025-05-25T12:37:00+02:00,2025-05-25,20:37,1,0,1
77,2025-05-25T12:30:00+02:00,2025-05-25,20:30,4,7,11
78,2025-05-25T12:26:00+02:00,2025-05-25,20:26,0,1,1
78,2025-05-25T12:28:00+02:00,2025-05-25,20:28,0,1,1
78,2025-05-25T12:30:00+02:00,2025-05-25,20:30,0,1,1
87,2025-05-25T12:28:00+02:00,2025-05-25,20:28,1,0,1
87,2025-05-25T12:30:00+02:00,2025-05-25,20:30,1,0,1
87,2025-05-25T12:34:00+02:00,2025-05-25,20:34,0,1,1
108,2025-05-25T12:29:00+02:00,2025-05-25,20:29,2,4,6
108,2025-05-25T12:34:00+02:00,2025-05-25,20:34,3,0,3
108,2025-05-25T12:39:00+02:00,2025-05-25,20:39,2,2,4
118,2025-05-25T12:35:00+02:00,2025-05-25,20:35,1,0,1
131,2025-05-25T12:25:00+02:00,2025-05-25,20:25,4,5,9
131,2025-05-25T12:30:00+02:00,2025-05-25,20:30,7,1,8
132,2025-05-25T12:25:00+02:00,2025-05-25,20:25,4,1,5
133,2025-05-25T12:35:00+02:00,2025-05-25,20:35,31,27,58
134,2025-05-25T12:30:00+02:00,2025-05-25,20:30,22,17,39
135,2025-05-25T12:25:00+02:00,2025-05-25,20:25,4,4,8
165,2025-05-25T12:25:00+02:00,2025-05-25,20:25,1,0,1
165,2025-05-25T12:30:00+02:00,2025-05-25,20:30,2,1,3
165,2025-05-25T12:35:00+02:00,2025-05-25,20:35,1,1,2
1,2025-05-25T12:26:00+02:00,2025-05-25,20:26,5,2,7
1,2025-05-25T12:28:00+02:00,2025-05-25,20:28,2,8,10
1,2025-05-25T12:31:00+02:00,2025-05-25,20:31,7,0,7
1,2025-05-25T12:35:00+02:00,2025-05-25,20:35,1,3,4
1,2025-05-25T12:38:00+02:00,2025-05-25,20:38,4,7,11
2,2025-05-25T12:26:00+02:00,2025-05-25,20:26,4,9,13
2,2025-05-25T12:28:00+02:00,2025-05-25,20:28,0,6,6
2,2025-05-25T12:31:00+02:00,2025-05-25,20:31,2,0,2
2,2025-05-25T12:34:00+02:00,2025-05-25,20:34,1,4,5
2,2025-05-25T12:36:00+02:00,2025-05-25,20:36,3,0,3
2,2025-05-25T12:38:00+02:00,2025-05-25,20:38,3,0,3
2,2025-05-25T12:39:00+02:00,2025-05-25,20:39,2,2,4
9,2025-05-25T12:30:00+02:00,2025-05-25,20:30,0,2,2
10,2025-05-25T12:29:00+02:00,2025-05-25,20:29,3,0,3
10,2025-05-25T12:31:00+02:00,2025-05-25,20:31,2,7,9
11,2025-05-25T12:30:00+02:00,2025-05-25,20:30,2,3,5
12,2025-05-25T12:31:00+02:00,2025-05-25,20:31,0,4,4
12,2025-05-25T12:36:00+02:00,2025-05-25,20:36,1,0,1
17,2025-05-25T12:29:00+02:00,2025-05-25,20:29,2,4,6
17,2025-05-25T12:32:00+02:00,2025-05-25,20:32,8,0,8
17,2025-05-25T12:36:00+02:00,2025-05-25,20:36,1,1,2
18,2025-05-25T12:31:00+02:00,2025-05-25,20:31,0,1,1
19,2025-05-25T12:26:00+02:00,2025-05-25,20:26,6,1,7
19,2025-05-25T12:30:00+02:00,2025-05-25,20:30,7,6,13
19,2025-05-25T12:31:00+02:00,2025-05-25,20:31,6,8,14
19,2025-05-25T12:33:00+02:00,2025-05-25,20:33,3,4,7
19,2025-05-25T12:35:00+02:00,2025-05-25,20:35,2,10,12
19,2025-05-25T12:36:00+02:00,2025-05-25,20:36,3,17,20
19,2025-05-25T12:37:00+02:00,2025-05-25,20:37,8,15,23
19,2025-05-25T12:38:00+02:00,2025-05-25,20:38,8,24,32
20,2025-05-25T12:26:00+02:00,2025-05-25,20:26,4,2,6
20,2025-05-25T12:27:00+02:00,2025-05-25,20:27,0,14,14
20,2025-05-25T12:29:00+02:00,2025-05-25,20:29,1,15,16
20,2025-05-25T12:33:00+02:00,2025-05-25,20:33,1,4,5
20,2025-05-25T12:35:00+02:00,2025-05-25,20:35,3,12,15
20,2025-05-25T12:38:00+02:00,2025-05-25,20:38,2,8,10
23,2025-05-25T12:29:00+02:00,2025-05-25,20:29,0,5,5
23,2025-05-25T12:30:00+02:00,2025-05-25,20:30,2,3,5
23,2025-05-25T12:31:00+02:00,2025-05-25,20:31,0,2,2
23,2025-05-25T12:34:00+02:00,2025-05-25,20:34,1,0,1
24,2025-05-25T12:26:00+02:00,2025-05-25,20:26,4,11,15
24,2025-05-25T12:30:00+02:00,2025-05-25,20:30,5,3,8
24,2025-05-25T12:31:00+02:00,2025-05-25,20:31,1,1,2
24,2025-05-25T12:36:00+02:00,2025-05-25,20:36,2,2,4
25,2025-05-25T12:30:00+02:00,2025-05-25,20:30,10,11,21
27,2025-05-25T12:32:00+02:00,2025-05-25,20:32,1,0,1
30,2025-05-25T12:25:00+02:00,2025-05-25,20:25,4,15,19
30,2025-05-25T12:27:00+02:00,2025-05-25,20:27,2,5,7
30,2025-05-25T12:31:00+02:00,2025-05-25,20:31,3,13,16
30,2025-05-25T12:32:00+02:00,2025-05-25,20:32,4,6,10
30,2025-05-25T12:33:00+02:00,2025-05-25,20:33,3,7,10
30,2025-05-25T12:39:00+02:00,2025-05-25,20:39,4,1,5
35,2025-05-25T12:28:00+02:00,2025-05-25,20:28,8,4,12
35,2025-05-25T12:38:00+02:00,2025-05-25,20:38,3,8,11
48,2025-05-25T12:28:00+02:00,2025-05-25,20:28,1,0,1
48,2025-05-25T12:32:00+02:00,2025-05-25,20:32,3,0,3
48,2025-05-25T12:34:00+02:00,2025-05-25,20:34,0,2,2
48,2025-05-25T12:37:00+02:00,2025-05-25,20:37,0,5,5
49,2025-05-25T12:25:00+02:00,2025-05-25,20:25,7,6,13
49,2025-05-25T12:27:00+02:00,2025-05-25,20:27,4,0,4
49,2025-05-25T12:28:00+02:00,2025-05-25,20:28,6,3,9
49,2025-05-25T12:35:00+02:00,2025-05-25,20:35,8,3,11
49,2025-05-25T12:36:00+02:00,2025-05-25,20:36,4,3,7
49,2025-05-25T12:37:00+02:00,2025-05-25,20:37,1,0,1
49,2025-05-25T12:38:00+02:00,2025-05-25,20:38,4,1,5
49,2025-05-25T12:39:00+02:00,2025-05-25,20:39,1,2,3
51,2025-05-25T12:25:00+02:00,2025-05-25,20:25,1,0,1
51,2025-05-25T12:34:00+02:00,2025-05-25,20:34,4,0,4
52,2025-05-25T12:27:00+02:00,2025-05-25,20:27,2,4,6
52,2025-05-25T12:37:00+02:00,2025-05-25,20:37,1,8,9
52,2025-05-25T12:38:00+02:00,2025-05-25,20:38,5,0,5
53,2025-05-25T12:26:00+02:00,2025-05-25,20:26,2,3,5
53,2025-05-25T12:29:00+02:00,2025-05-25,20:29,0,2,2
53,2025-05-25T12:33:00+02:00,2025-05-25,20:33,2,0,2
53,2025-05-25T12:35:00+02:00,2025-05-25,20:35,4,3,7
53,2025-05-25T12:38:00+02:00,2025-05-25,20:38,0,5,5
56,2025-05-25T12:30:00+02:00,2025-05-25,20:30,12,0,12
56,2025-05-25T12:36:00+02:00,2025-05-25,20:36,3,4,7
56,2025-05-25T12:37:00+02:00,2025-05-25,20:37,3,5,8
58,2025-05-25T12:25:00+02:00,2025-05-25,20:25,1,8,9
58,2025-05-25T12:27:00+02:00,2025-05-25,20:27,3,0,3
58,2025-05-25T12:28:00+02:00,2025-05-25,20:28,1,2,3
58,2025-05-25T12:30:00+02:00,2025-05-25,20:30,2,5,7
58,2025-05-25T12:32:00+02:00,2025-05-25,20:32,8,3,11
58,2025-05-25T12:34:00+02:00,2025-05-25,20:34,4,5,9
58,2025-05-25T12:35:00+02:00,2025-05-25,20:35,2,3,5
62,2025-05-25T12:27:00+02:00,2025-05-25,20:27,8,5,13
62,2025-05-25T12:29:00+02:00,2025-05-25,20:29,3,1,4
62,2025-05-25T12:33:00+02:00,2025-05-25,20:33,2,0,2
62,2025-05-25T12:34:00+02:00,2025-05-25,20:34,1,2,3
62,2025-05-25T12:35:00+02:00,2025-05-25,20:35,1,3,4
63,2025-05-25T12:26:00+02:00,2025-05-25,20:26,0,2,2
63,2025-05-25T12:31:00+02:00,2025-05-25,20:31,0,1,1
63,2025-05-25T12:36:00+02:00,2025-05-25,20:36,1,3,4
67,2025-05-25T12:25:00+02:00,2025-05-25,20:25,1,5,6
67,2025-05-25T12:26:00+02:00,2025-05-25,20:26,1,6,7
67,2025-05-25T12:27:00+02:00,2025-05-25,20:27,4,3,7
67,2025-05-25T12:31:00+02:00,2025-05-25,20:31,1,4,5
67,2025-05-25T12:32:00+02:00,2025-05-25,20:32,2,3,5
68,2025-05-25T12:25:00+02:00,2025-05-25,20:25,6,2,8
68,2025-05-25T12:27:00+02:00,2025-05-25,20:27,3,0,3
68,2025-05-25T12:33:00+02:00,2025-05-25,20:33,2,0,2
68,2025-05-25T12:34:00+02:00,2025-05-25,20:34,2,2,4
68,2025-05-25T12:36:00+02:00,2025-05-25,20:36,6,0,6
68,2025-05-25T12:38:00+02:00,2025-05-25,20:38,1,2,3
68,2025-05-25T12:39:00+02:00,2025-05-25,20:39,1,3,4
72,2025-05-25T12:31:00+02:00,2025-05-25,20:31,1,0,1
72,2025-05-25T12:34:00+02:00,2025-05-25,20:34,0,3,3
76,2025-05-25T12:34:00+02:00,2025-05-25,20:34,0,1,1
79,2025-05-25T12:26:00+02:00,2025-05-25,20:26,5,4,9
79,2025-05-25T12:29:00+02:00,2025-05-25,20:29,1,2,3
79,2025-05-25T12:31:00+02:00,2025-05-25,20:31,4,2,6
79,2025-05-25T12:38:00+02:00,2025-05-25,20:38,4,2,6
79,2025-05-25T12:39:00+02:00,2025-05-25,20:39,2,8,10
85,2025-05-25T12:25:00+02:00,2025-05-25,20:25,1,0,1
86,2025-05-25T12:27:00+02:00,2025-05-25,20:27,1,2,3
86,2025-05-25T12:32:00+02:00,2025-05-25,20:32,1,2,3
109,2025-05-25T12:25:00+02:00,2025-05-25,20:25,2,4,6
109,2025-05-25T12:35:00+02:00,2025-05-25,20:35,2,5,7
117,2025-05-25T12:30:00+02:00,2025-05-25,20:30,20,2,22
117,2025-05-25T12:35:00+02:00,2025-05-25,20:35,11,5,16
142,2025-05-25T12:30:00+02:00,2025-05-25,20:30,4,1,5
181,2025-05-25T12:25:00+02:00,2025-05-25,20:25,9,20,29
181,2025-05-25T12:26:00+02:00,2025-05-25,20:26,9,14,23
181,2025-05-25T12:38:00+02:00,2025-05-25,20:38,17,12,29
3,2025-05-25T12:49:00+02:00,2025-05-25,20:49,17,6,23
3,2025-05-25T12:51:00+02:00,2025-05-25,20:51,9,7,16
3,2025-05-25T12:52:00+02:00,2025-05-25,20:52,15,13,28
3,2025-05-25T12:53:00+02:00,2025-05-25,20:53,15,7,22
4,2025-05-25T12:42:00+02:00,2025-05-25,20:42,21,3,24
4,2025-05-25T12:48:00+02:00,2025-05-25,20:48,9,11,20
4,2025-05-25T12:50:00+02:00,2025-05-25,20:50,7,5,12
4,2025-05-25T12:53:00+02:00,2025-05-25,20:53,4,9,13
4,2025-05-25T12:54:00+02:00,2025-05-25,20:54,29,6,35
6,2025-05-25T12:40:00+02:00,2025-05-25,20:40,1,9,10
6,2025-05-25T12:41:00+02:00,2025-05-25,20:41,2,9,11
6,2025-05-25T12:43:00+02:00,2025-05-25,20:43,7,2,9
6,2025-05-25T12:44:00+02:00,2025-05-25,20:44,6,7,13
6,2025-05-25T12:45:00+02:00,2025-05-25,20:45,6,1,7
6,2025-05-25T12:46:00+02:00,2025-05-25,20:46,2,9,11
6,2025-05-25T12:51:00+02:00,2025-05-25,20:51,16,15,31
21,2025-05-25T12:50:00+02:00,2025-05-25,20:50,21,17,38
28,2025-05-25T12:46:00+02:00,2025-05-25,20:46,3,0,3
28,2025-05-25T12:51:00+02:00,2025-05-25,20:51,1,2,3
28,2025-05-25T12:54:00+02:00,2025-05-25,20:54,9,1,10
29,2025-05-25T12:45:00+02:00,2025-05-25,20:45,0,2,2
29,2025-05-25T12:50:00+02:00,2025-05-25,20:50,0,3,3
29,2025-05-25T12:51:00+02:00,2025-05-25,20:51,1,8,9
29,2025-05-25T12:53:00+02:00,2025-05-25,20:53,1,1,2
29,2025-05-25T12:54:00+02:00,2025-05-25,20:54,0,2,2
31,2025-05-25T12:49:00+02:00,2025-05-25,20:49,4,6,10
31,2025-05-25T12:50:00+02:00,2025-05-25,20:50,2,0,2
31,2025-05-25T12:54:00+02:00,2025-05-25,20:54,5,8,13
36,2025-05-25T12:42:00+02:00,2025-05-25,20:42,0,2,2
36,2025-05-25T12:45:00+02:00,2025-05-25,20:45,1,0,1
39,2025-05-25T12:43:00+02:00,2025-05-25,20:43,0,1,1
39,2025-05-25T12:50:00+02:00,2025-05-25,20:50,1,0,1
40,2025-05-25T12:53:00+02:00,2025-05-25,20:53,1,0,1
44,2025-05-25T12:45:00+02:00,2025-05-25,20:45,2,0,2
45,2025-05-25T12:46:00+02:00,2025-05-25,20:46,15,6,21
45,2025-05-25T12:47:00+02:00,2025-05-25,20:47,1,3,4
45,2025-05-25T12:50:00+02:00,2025-05-25,20:50,1,7,8
45,2025-05-25T12:51:00+02:00,2025-05-25,20:51,8,4,12
47,2025-05-25T12:49:00+02:00,2025-05-25,20:49,9,7,16
47,2025-05-25T12:51:00+02:00,2025-05-25,20:51,10,2,12
47,2025-05-25T12:52:00+02:00,2025-05-25,20:52,9,7,16
50,2025-05-25T12:45:00+02:00,2025-05-25,20:45,9,0,9
54,2025-05-25T12:40:00+02:00,2025-05-25,20:40,5,2,7
54,2025-05-25T12:43:00+02:00,2025-05-25,20:43,3,3,6
54,2025-05-25T12:47:00+02:00,2025-05-25,20:47,1,3,4
54,2025-05-25T12:48:00+02:00,2025-05-25,20:48,6,2,8
54,2025-05-25T12:54:00+02:00,2025-05-25,20:54,2,4,6
59,2025-05-25T12:50:00+02:00,2025-05-25,20:50,15,15,30
61,2025-05-25T12:46:00+02:00,2025-05-25,20:46,1,1,2
61,2025-05-25T12:47:00+02:00,2025-05-25,20:47,2,2,4
61,2025-05-25T12:52:00+02:00,2025-05-25,20:52,9,2,11
66,2025-05-25T12:47:00+02:00,2025-05-25,20:47,16,7,23
66,2025-05-25T12:51:00+02:00,2025-05-25,20:51,17,19,36
66,2025-05-25T12:52:00+02:00,2025-05-25,20:52,32,10,42
66,2025-05-25T12:53:00+02:00,2025-05-25,20:53,19,8,27
69,2025-05-25T12:43:00+02:00,2025-05-25,20:43,1,0,1
70,2025-05-25T12:47:00+02:00,2025-05-25,20:47,0,3,3
70,2025-05-25T12:48:00+02:00,2025-05-25,20:48,6,0,6
70,2025-05-25T12:49:00+02:00,2025-05-25,20:49,1,1,2
70,2025-05-25T12:51:00+02:00,2025-05-25,20:51,0,2,2
70,2025-05-25T12:54:00+02:00,2025-05-25,20:54,3,1,4
77,2025-05-25T12:50:00+02:00,2025-05-25,20:50,4,6,10
84,2025-05-25T12:50:00+02:00,2025-05-25,20:50,36,62,98
87,2025-05-25T12:50:00+02:00,2025-05-25,20:50,0,3,3
87,2025-05-25T12:51:00+02:00,2025-05-25,20:51,0,1,1
87,2025-05-25T12:52:00+02:00,2025-05-25,20:52,0,1,1
87,2025-05-25T12:53:00+02:00,2025-05-25,20:53,1,0,1
107,2025-05-25T12:50:00+02:00,2025-05-25,20:50,5,1,6
108,2025-05-25T12:40:00+02:00,2025-05-25,20:40,3,0,3
108,2025-05-25T12:41:00+02:00,2025-05-25,20:41,5,3,8
108,2025-05-25T12:48:00+02:00,2025-05-25,20:48,1,0,1
108,2025-05-25T12:52:00+02:00,2025-05-25,20:52,0,1,1
108,2025-05-25T12:54:00+02:00,2025-05-25,20:54,2,0,2
118,2025-05-25T12:45:00+02:00,2025-05-25,20:45,2,0,2
131,2025-05-25T12:40:00+02:00,2025-05-25,20:40,2,2,4
132,2025-05-25T12:40:00+02:00,2025-05-25,20:40,4,1,5
132,2025-05-25T12:45:00+02:00,2025-05-25,20:45,8,4,12
133,2025-05-25T12:50:00+02:00,2025-05-25,20:50,23,17,40
135,2025-05-25T12:40:00+02:00,2025-05-25,20:40,12,7,19
135,2025-05-25T12:50:00+02:00,2025-05-25,20:50,14,4,18
165,2025-05-25T12:40:00+02:00,2025-05-25,20:40,1,1,2
167,2025-05-25T12:50:00+02:00,2025-05-25,20:50,1,2,3
179,2025-05-25T12:50:00+02:00,2025-05-25,20:50,1,4,5
1,2025-05-25T12:42:00+02:00,2025-05-25,20:42,4,6,10
1,2025-05-25T12:44:00+02:00,2025-05-25,20:44,0,1,1
1,2025-05-25T12:52:00+02:00,2025-05-25,20:52,2,6,8
1,2025-05-25T12:54:00+02:00,2025-05-25,20:54,1,9,10
2,2025-05-25T12:41:00+02:00,2025-05-25,20:41,0,7,7
2,2025-05-25T12:50:00+02:00,2025-05-25,20:50,0,4,4
2,2025-05-25T12:51:00+02:00,2025-05-25,20:51,0,2,2
2,2025-05-25T12:52:00+02:00,2025-05-25,20:52,1,2,3
2,2025-05-25T12:54:00+02:00,2025-05-25,20:54,1,0,1
9,2025-05-25T12:42:00+02:00,2025-05-25,20:42,1,0,1
9,2025-05-25T12:49:00+02:00,2025-05-25,20:49,0,2,2
9,2025-05-25T12:52:00+02:00,2025-05-25,20:52,0,2,2
9,2025-05-25T12:53:00+02:00,2025-05-25,20:53,0,5,5
9,2025-05-25T12:54:00+02:00,2025-05-25,20:54,0,1,1
10,2025-05-25T12:52:00+02:00,2025-05-25,20:52,0,7,7
12,2025-05-25T12:42:00+02:00,2025-05-25,20:42,1,4,5
12,2025-05-25T12:43:00+02:00,2025-05-25,20:43,0,2,2
12,2025-05-25T12:49:00+02:00,2025-05-25,20:49,0,2,2
12,2025-05-25T12:51:00+02:00,2025-05-25,20:51,2,0,2
12,2025-05-25T12:52:00+02:00,2025-05-25,20:52,2,2,4
17,2025-05-25T12:52:00+02:00,2025-05-25,20:52,2,1,3
19,2025-05-25T12:40:00+02:00,2025-05-25,20:40,7,5,12
19,2025-05-25T12:41:00+02:00,2025-05-25,20:41,5,9,14
19,2025-05-25T12:44:00+02:00,2025-05-25,20:44,3,13,16
19,2025-05-25T12:45:00+02:00,2025-05-25,20:45,9,1,10
19,2025-05-25T12:46:00+02:00,2025-05-25,20:46,3,17,20
19,2025-05-25T12:52:00+02:00,2025-05-25,20:52,5,5,10
19,2025-05-25T12:53:00+02:00,2025-05-25,20:53,11,9,20
20,2025-05-25T12:40:00+02:00,2025-05-25,20:40,1,7,8
20,2025-05-25T12:44:00+02:00,2025-05-25,20:44,0,1,1
20,2025-05-25T12:45:00+02:00,2025-05-25,20:45,2,7,9
20,2025-05-25T12:47:00+02:00,2025-05-25,20:47,3,3,6
20,2025-05-25T12:49:00+02:00,2025-05-25,20:49,2,4,6
20,2025-05-25T12:53:00+02:00,2025-05-25,20:53,11,4,15
23,2025-05-25T12:42:00+02:00,2025-05-25,20:42,1,1,2
23,2025-05-25T12:44:00+02:00,2025-05-25,20:44,0,2,2
23,2025-05-25T12:48:00+02:00,2025-05-25,20:48,5,0,5
23,2025-05-25T12:50:00+02:00,2025-05-25,20:50,2,4,6
23,2025-05-25T12:53:00+02:00,2025-05-25,20:53,1,2,3
23,2025-05-25T12:54:00+02:00,2025-05-25,20:54,0,3,3
24,2025-05-25T12:42:00+02:00,2025-05-25,20:42,0,2,2
24,2025-05-25T12:47:00+02:00,2025-05-25,20:47,9,0,9
24,2025-05-25T12:48:00+02:00,2025-05-25,20:48,4,3,7
24,2025-05-25T12:50:00+02:00,2025-05-25,20:50,4,10,14
24,2025-05-25T12:54:00+02:00,2025-05-25,20:54,2,1,3
25,2025-05-25T12:50:00+02:00,2025-05-25,20:50,5,15,20
27,2025-05-25T12:43:00+02:00,2025-05-25,20:43,2,0,2
27,2025-05-25T12:45:00+02:00,2025-05-25,20:45,2,0,2
27,2025-05-25T12:52:00+02:00,2025-05-25,20:52,0,2,2
27,2025-05-25T12:54:00+02:00,2025-05-25,20:54,2,0,2
30,2025-05-25T12:42:00+02:00,2025-05-25,20:42,11,7,18
30,2025-05-25T12:43:00+02:00,2025-05-25,20:43,3,14,17
30,2025-05-25T12:44:00+02:00,2025-05-25,20:44,2,5,7
30,2025-05-25T12:46:00+02:00,2025-05-25,20:46,6,3,9
30,2025-05-25T12:47:00+02:00,2025-05-25,20:47,0,5,5
30,2025-05-25T12:48:00+02:00,2025-05-25,20:48,2,20,22
30,2025-05-25T12:49:00+02:00,2025-05-25,20:49,0,5,5
30,2025-05-25T12:50:00+02:00,2025-05-25,20:50,3,10,13
30,2025-05-25T12:51:00+02:00,2025-05-25,20:51,5,13,18
30,2025-05-25T12:53:00+02:00,2025-05-25,20:53,11,2,13
30,2025-05-25T12:54:00+02:00,2025-05-25,20:54,2,1,3
35,2025-05-25T12:40:00+02:00,2025-05-25,20:40,4,18,22
35,2025-05-25T12:46:00+02:00,2025-05-25,20:46,6,8,14
35,2025-05-25T12:49:00+02:00,2025-05-25,20:49,3,6,9
35,2025-05-25T12:50:00+02:00,2025-05-25,20:50,3,11,14
35,2025-05-25T12:51:00+02:00,2025-05-25,20:51,6,6,12
35,2025-05-25T12:52:00+02:00,2025-05-25,20:52,7,17,24
35,2025-05-25T12:53:00+02:00,2025-05-25,20:53,4,11,15
48,2025-05-25T12:40:00+02:00,2025-05-25,20:40,1,2,3
48,2025-05-25T12:41:00+02:00,2025-05-25,20:41,0,2,2
48,2025-05-25T12:45:00+02:00,2025-05-25,20:45,1,3,4
48,2025-05-25T12:46:00+02:00,2025-05-25,20:46,1,0,1
48,2025-05-25T12:52:00+02:00,2025-05-25,20:52,1,0,1
49,2025-05-25T12:41:00+02:00,2025-05-25,20:41,7,2,9
49,2025-05-25T12:44:00+02:00,2025-05-25,20:44,0,4,4
49,2025-05-25T12:46:00+02:00,2025-05-25,20:46,3,1,4
49,2025-05-25T12:47:00+02:00,2025-05-25,20:47,2,3,5
49,2025-05-25T12:50:00+02:00,2025-05-25,20:50,2,0,2
49,2025-05-25T12:54:00+02:00,2025-05-25,20:54,5,2,7
51,2025-05-25T12:46:00+02:00,2025-05-25,20:46,0,2,2
51,2025-05-25T12:50:00+02:00,2025-05-25,20:50,2,1,3
51,2025-05-25T12:53:00+02:00,2025-05-25,20:53,0,3,3
52,2025-05-25T12:40:00+02:00,2025-05-25,20:40,2,0,2
52,2025-05-25T12:50:00+02:00,2025-05-25,20:50,0,5,5
52,2025-05-25T12:52:00+02:00,2025-05-25,20:52,1,4,5
53,2025-05-25T12:42:00+02:00,2025-05-25,20:42,3,3,6
53,2025-05-25T12:43:00+02:00,2025-05-25,20:43,3,3,6
53,2025-05-25T12:45:00+02:00,2025-05-25,20:45,2,4,6
53,2025-05-25T12:48:00+02:00,2025-05-25,20:48,3,0,3
56,2025-05-25T12:43:00+02:00,2025-05-25,20:43,2,3,5
56,2025-05-25T12:45:00+02:00,2025-05-25,20:45,0,2,2
56,2025-05-25T12:52:00+02:00,2025-05-25,20:52,6,2,8
58,2025-05-25T12:40:00+02:00,2025-05-25,20:40,0,4,4
58,2025-05-25T12:42:00+02:00,2025-05-25,20:42,5,2,7
58,2025-05-25T12:44:00+02:00,2025-05-25,20:44,11,5,16
58,2025-05-25T12:47:00+02:00,2025-05-25,20:47,4,0,4
58,2025-05-25T12:48:00+02:00,2025-05-25,20:48,6,1,7
58,2025-05-25T12:49:00+02:00,2025-05-25,20:49,2,3,5
58,2025-05-25T12:54:00+02:00,2025-05-25,20:54,1,6,7
62,2025-05-25T12:44:00+02:00,2025-05-25,20:44,6,1,7
62,2025-05-25T12:45:00+02:00,2025-05-25,20:45,2,3,5
62,2025-05-25T12:47:00+02:00,2025-05-25,20:47,5,3,8
62,2025-05-25T12:49:00+02:00,2025-05-25,20:49,1,0,1
62,2025-05-25T12:52:00+02:00,2025-05-25,20:52,4,0,4
62,2025-05-25T12:53:00+02:00,2025-05-25,20:53,2,0,2
63,2025-05-25T12:41:00+02:00,2025-05-25,20:41,1,1,2
63,2025-05-25T12:42:00+02:00,2025-05-25,20:42,1,6,7
63,2025-05-25T12:43:00+02:00,2025-05-25,20:43,0,3,3
63,2025-05-25T12:45:00+02:00,2025-05-25,20:45,0,1,1
63,2025-05-25T12:49:00+02:00,2025-05-25,20:49,0,1,1
67,2025-05-25T12:44:00+02:00,2025-05-25,20:44,2,6,8
67,2025-05-25T12:49:00+02:00,2025-05-25,20:49,2,2,4
67,2025-05-25T12:51:00+02:00,2025-05-25,20:51,1,7,8
67,2025-05-25T12:52:00+02:00,2025-05-25,20:52,1,3,4
67,2025-05-25T12:53:00+02:00,2025-05-25,20:53,2,3,5
68,2025-05-25T12:42:00+02:00,2025-05-25,20:42,0,1,1
68,2025-05-25T12:49:00+02:00,2025-05-25,20:49,2,1,3
68,2025-05-25T12:50:00+02:00,2025-05-25,20:50,0,4,4
68,2025-05-25T12:54:00+02:00,2025-05-25,20:54,0,2,2
72,2025-05-25T12:41:00+02:00,2025-05-25,20:41,4,1,5
72,2025-05-25T12:44:00+02:00,2025-05-25,20:44,4,7,11
72,2025-05-25T12:45:00+02:00,2025-05-25,20:45,6,3,9
72,2025-05-25T12:46:00+02:00,2025-05-25,20:46,4,5,9
79,2025-05-25T12:42:00+02:00,2025-05-25,20:42,2,2,4
79,2025-05-25T12:45:00+02:00,2025-05-25,20:45,2,5,7
79,2025-05-25T12:46:00+02:00,2025-05-25,20:46,1,11,12
79,2025-05-25T12:51:00+02:00,2025-05-25,20:51,2,6,8
79,2025-05-25T12:52:00+02:00,2025-05-25,20:52,1,0,1
79,2025-05-25T12:53:00+02:00,2025-05-25,20:53,0,1,1
85,2025-05-25T12:44:00+02:00,2025-05-25,20:44,1,0,1
85,2025-05-25T12:49:00+02:00,2025-05-25,20:49,0,1,1
86,2025-05-25T12:42:00+02:00,2025-05-25,20:42,2,0,2
86,2025-05-25T12:48:00+02:00,2025-05-25,20:48,1,1,2
109,2025-05-25T12:50:00+02:00,2025-05-25,20:50,5,6,11
130,2025-05-25T12:45:00+02:00,2025-05-25,20:45,1,0,1
136,2025-05-25T12:40:00+02:00,2025-05-25,20:40,1,0,1
164,2025-05-25T12:40:00+02:00,2025-05-25,20:40,3,0,3
181,2025-05-25T12:41:00+02:00,2025-05-25,20:41,12,4,16
181,2025-05-25T12:42:00+02:00,2025-05-25,20:42,11,10,21
181,2025-05-25T12:50:00+02:00,2025-05-25,20:50,4,13,17
181,2025-05-25T12:51:00+02:00,2025-05-25,20:51,11,6,17
181,2025-05-25T12:53:00+02:00,2025-05-25,20:53,8,14,22
180,2025-05-25T12:54:00+02:00,2025-05-25,20:54,0,1,1
181,2025-05-25T13:25:00+02:00,2025-05-25,21:25,10,10,20
181,2025-05-25T13:29:00+02:00,2025-05-25,21:29,13,13,26
181,2025-05-25T13:30:00+02:00,2025-05-25,21:30,7,3,10
181,2025-05-25T13:32:00+02:00,2025-05-25,21:32,11,7,18
181,2025-05-25T13:33:00+02:00,2025-05-25,21:33,13,14,27
181,2025-05-25T13:36:00+02:00,2025-05-25,21:36,12,6,18
181,2025-05-25T13:37:00+02:00,2025-05-25,21:37,8,5,13
181,2025-05-25T13:39:00+02:00,2025-05-25,21:39,6,12,18
3,2025-05-25T12:57:00+02:00,2025-05-25,20:57,3,12,15
3,2025-05-25T13:08:00+02:00,2025-05-25,21:08,16,2,18
4,2025-05-25T13:02:00+02:00,2025-05-25,21:02,25,5,30
4,2025-05-25T13:05:00+02:00,2025-05-25,21:05,21,6,27
4,2025-05-25T13:07:00+02:00,2025-05-25,21:07,12,9,21
6,2025-05-25T12:56:00+02:00,2025-05-25,20:56,9,7,16
6,2025-05-25T12:57:00+02:00,2025-05-25,20:57,12,3,15
6,2025-05-25T13:04:00+02:00,2025-05-25,21:04,11,7,18
6,2025-05-25T13:06:00+02:00,2025-05-25,21:06,4,1,5
6,2025-05-25T13:07:00+02:00,2025-05-25,21:07,13,7,20
21,2025-05-25T12:55:00+02:00,2025-05-25,20:55,12,24,36
21,2025-05-25T13:00:00+02:00,2025-05-25,21:00,16,23,39
21,2025-05-25T13:05:00+02:00,2025-05-25,21:05,18,11,29
28,2025-05-25T12:55:00+02:00,2025-05-25,20:55,2,0,2
28,2025-05-25T12:58:00+02:00,2025-05-25,20:58,2,0,2
28,2025-05-25T13:03:00+02:00,2025-05-25,21:03,3,0,3
28,2025-05-25T13:04:00+02:00,2025-05-25,21:04,1,3,4
29,2025-05-25T12:59:00+02:00,2025-05-25,20:59,2,7,9
29,2025-05-25T13:00:00+02:00,2025-05-25,21:00,7,5,12
29,2025-05-25T13:07:00+02:00,2025-05-25,21:07,1,5,6
31,2025-05-25T12:59:00+02:00,2025-05-25,20:59,5,4,9
31,2025-05-25T13:01:00+02:00,2025-05-25,21:01,5,6,11
31,2025-05-25T13:02:00+02:00,2025-05-25,21:02,1,2,3
31,2025-05-25T13:04:00+02:00,2025-05-25,21:04,0,6,6
31,2025-05-25T13:05:00+02:00,2025-05-25,21:05,2,1,3
31,2025-05-25T13:08:00+02:00,2025-05-25,21:08,2,0,2
36,2025-05-25T12:55:00+02:00,2025-05-25,20:55,0,2,2
36,2025-05-25T13:04:00+02:00,2025-05-25,21:04,0,2,2
36,2025-05-25T13:09:00+02:00,2025-05-25,21:09,2,2,4
39,2025-05-25T12:56:00+02:00,2025-05-25,20:56,2,0,2
39,2025-05-25T13:03:00+02:00,2025-05-25,21:03,1,0,1
40,2025-05-25T13:02:00+02:00,2025-05-25,21:02,2,0,2
41,2025-05-25T12:56:00+02:00,2025-05-25,20:56,0,7,7
41,2025-05-25T13:04:00+02:00,2025-05-25,21:04,1,0,1
43,2025-05-25T13:05:00+02:00,2025-05-25,21:05,5,7,12
45,2025-05-25T12:58:00+02:00,2025-05-25,20:58,2,7,9
45,2025-05-25T13:05:00+02:00,2025-05-25,21:05,5,8,13
45,2025-05-25T13:08:00+02:00,2025-05-25,21:08,1,12,13
47,2025-05-25T12:55:00+02:00,2025-05-25,20:55,13,0,13
47,2025-05-25T12:57:00+02:00,2025-05-25,20:57,5,0,5
47,2025-05-25T13:00:00+02:00,2025-05-25,21:00,8,4,12
47,2025-05-25T13:02:00+02:00,2025-05-25,21:02,0,2,2
47,2025-05-25T13:04:00+02:00,2025-05-25,21:04,1,4,5
47,2025-05-25T13:06:00+02:00,2025-05-25,21:06,13,4,17
47,2025-05-25T13:07:00+02:00,2025-05-25,21:07,8,3,11
47,2025-05-25T13:09:00+02:00,2025-05-25,21:09,9,1,10
50,2025-05-25T12:56:00+02:00,2025-05-25,20:56,8,1,9
50,2025-05-25T13:01:00+02:00,2025-05-25,21:01,2,5,7
50,2025-05-25T13:04:00+02:00,2025-05-25,21:04,0,2,2
50,2025-05-25T13:05:00+02:00,2025-05-25,21:05,0,1,1
50,2025-05-25T13:08:00+02:00,2025-05-25,21:08,5,0,5
54,2025-05-25T12:55:00+02:00,2025-05-25,20:55,0,6,6
54,2025-05-25T13:01:00+02:00,2025-05-25,21:01,1,1,2
54,2025-05-25T13:03:00+02:00,2025-05-25,21:03,6,4,10
54,2025-05-25T13:09:00+02:00,2025-05-25,21:09,0,1,1
59,2025-05-25T12:55:00+02:00,2025-05-25,20:55,13,35,48
61,2025-05-25T12:55:00+02:00,2025-05-25,20:55,8,3,11
61,2025-05-25T12:57:00+02:00,2025-05-25,20:57,5,0,5
61,2025-05-25T13:07:00+02:00,2025-05-25,21:07,7,3,10
61,2025-05-25T13:08:00+02:00,2025-05-25,21:08,3,1,4
66,2025-05-25T12:56:00+02:00,2025-05-25,20:56,10,5,15
66,2025-05-25T13:04:00+02:00,2025-05-25,21:04,0,9,9
66,2025-05-25T13:07:00+02:00,2025-05-25,21:07,8,21,29
70,2025-05-25T12:58:00+02:00,2025-05-25,20:58,0,2,2
70,2025-05-25T13:02:00+02:00,2025-05-25,21:02,0,1,1
70,2025-05-25T13:03:00+02:00,2025-05-25,21:03,1,2,3
70,2025-05-25T13:08:00+02:00,2025-05-25,21:08,2,0,2
75,2025-05-25T13:09:00+02:00,2025-05-25,21:09,0,2,2
78,2025-05-25T12:55:00+02:00,2025-05-25,20:55,0,2,2
87,2025-05-25T13:07:00+02:00,2025-05-25,21:07,1,0,1
107,2025-05-25T13:05:00+02:00,2025-05-25,21:05,5,1,6
108,2025-05-25T12:57:00+02:00,2025-05-25,20:57,0,1,1
108,2025-05-25T13:07:00+02:00,2025-05-25,21:07,4,1,5
108,2025-05-25T13:08:00+02:00,2025-05-25,21:08,6,0,6
108,2025-05-25T13:09:00+02:00,2025-05-25,21:09,1,3,4
132,2025-05-25T12:55:00+02:00,2025-05-25,20:55,2,2,4
132,2025-05-25T13:00:00+02:00,2025-05-25,21:00,6,15,21
132,2025-05-25T13:05:00+02:00,2025-05-25,21:05,10,13,23
133,2025-05-25T13:00:00+02:00,2025-05-25,21:00,35,18,53
134,2025-05-25T13:00:00+02:00,2025-05-25,21:00,11,25,36
135,2025-05-25T13:05:00+02:00,2025-05-25,21:05,5,2,7
162,2025-05-25T12:55:00+02:00,2025-05-25,20:55,5,11,16
162,2025-05-25T13:00:00+02:00,2025-05-25,21:00,9,8,17
162,2025-05-25T13:05:00+02:00,2025-05-25,21:05,14,4,18
165,2025-05-25T13:05:00+02:00,2025-05-25,21:05,1,0,1
167,2025-05-25T13:00:00+02:00,2025-05-25,21:00,1,1,2
167,2025-05-25T13:05:00+02:00,2025-05-25,21:05,2,0,2
179,2025-05-25T12:55:00+02:00,2025-05-25,20:55,3,5,8
179,2025-05-25T13:05:00+02:00,2025-05-25,21:05,5,0,5
1,2025-05-25T12:57:00+02:00,2025-05-25,20:57,1,2,3
1,2025-05-25T12:59:00+02:00,2025-05-25,20:59,3,1,4
1,2025-05-25T13:01:00+02:00,2025-05-25,21:01,0,2,2
1,2025-05-25T13:03:00+02:00,2025-05-25,21:03,1,2,3
1,2025-05-25T13:04:00+02:00,2025-05-25,21:04,0,4,4
1,2025-05-25T13:07:00+02:00,2025-05-25,21:07,10,1,11
2,2025-05-25T12:58:00+02:00,2025-05-25,20:58,2,7,9
2,2025-05-25T12:59:00+02:00,2025-05-25,20:59,0,3,3
2,2025-05-25T13:00:00+02:00,2025-05-25,21:00,1,2,3
2,2025-05-25T13:03:00+02:00,2025-05-25,21:03,0,5,5
2,2025-05-25T13:04:00+02:00,2025-05-25,21:04,0,2,2
2,2025-05-25T13:05:00+02:00,2025-05-25,21:05,0,4,4
9,2025-05-25T12:59:00+02:00,2025-05-25,20:59,2,2,4
9,2025-05-25T13:01:00+02:00,2025-05-25,21:01,0,1,1
9,2025-05-25T13:09:00+02:00,2025-05-25,21:09,0,2,2
10,2025-05-25T13:01:00+02:00,2025-05-25,21:01,0,1,1
10,2025-05-25T13:06:00+02:00,2025-05-25,21:06,2,0,2
10,2025-05-25T13:07:00+02:00,2025-05-25,21:07,0,1,1
10,2025-05-25T13:08:00+02:00,2025-05-25,21:08,3,1,4
10,2025-05-25T13:09:00+02:00,2025-05-25,21:09,2,4,6
11,2025-05-25T13:05:00+02:00,2025-05-25,21:05,5,1,6
12,2025-05-25T12:55:00+02:00,2025-05-25,20:55,0,1,1
12,2025-05-25T12:56:00+02:00,2025-05-25,20:56,2,0,2
12,2025-05-25T12:57:00+02:00,2025-05-25,20:57,0,2,2
12,2025-05-25T12:58:00+02:00,2025-05-25,20:58,5,0,5
12,2025-05-25T13:03:00+02:00,2025-05-25,21:03,4,1,5
12,2025-05-25T13:04:00+02:00,2025-05-25,21:04,8,3,11
12,2025-05-25T13:07:00+02:00,2025-05-25,21:07,1,0,1
17,2025-05-25T12:55:00+02:00,2025-05-25,20:55,0,1,1
17,2025-05-25T12:57:00+02:00,2025-05-25,20:57,1,1,2
17,2025-05-25T12:58:00+02:00,2025-05-25,20:58,13,0,13
17,2025-05-25T13:05:00+02:00,2025-05-25,21:05,1,2,3
18,2025-05-25T13:06:00+02:00,2025-05-25,21:06,1,1,2
19,2025-05-25T12:56:00+02:00,2025-05-25,20:56,1,4,5
19,2025-05-25T13:00:00+02:00,2025-05-25,21:00,11,14,25
19,2025-05-25T13:04:00+02:00,2025-05-25,21:04,10,8,18
19,2025-05-25T13:05:00+02:00,2025-05-25,21:05,2,2,4
19,2025-05-25T13:06:00+02:00,2025-05-25,21:06,8,16,24
20,2025-05-25T12:55:00+02:00,2025-05-25,20:55,1,5,6
20,2025-05-25T12:57:00+02:00,2025-05-25,20:57,1,1,2
20,2025-05-25T13:00:00+02:00,2025-05-25,21:00,0,7,7
20,2025-05-25T13:04:00+02:00,2025-05-25,21:04,5,5,10
20,2025-05-25T13:05:00+02:00,2025-05-25,21:05,3,18,21
20,2025-05-25T13:06:00+02:00,2025-05-25,21:06,1,3,4
23,2025-05-25T12:55:00+02:00,2025-05-25,20:55,3,0,3
23,2025-05-25T12:59:00+02:00,2025-05-25,20:59,3,0,3
23,2025-05-25T13:00:00+02:00,2025-05-25,21:00,0,3,3
23,2025-05-25T13:04:00+02:00,2025-05-25,21:04,0,5,5
23,2025-05-25T13:07:00+02:00,2025-05-25,21:07,6,4,10
24,2025-05-25T12:59:00+02:00,2025-05-25,20:59,3,4,7
24,2025-05-25T13:03:00+02:00,2025-05-25,21:03,11,13,24
24,2025-05-25T13:05:00+02:00,2025-05-25,21:05,4,27,31
24,2025-05-25T13:08:00+02:00,2025-05-25,21:08,2,0,2
25,2025-05-25T13:05:00+02:00,2025-05-25,21:05,9,14,23
27,2025-05-25T13:03:00+02:00,2025-05-25,21:03,2,0,2
27,2025-05-25T13:04:00+02:00,2025-05-25,21:04,5,0,5
27,2025-05-25T13:08:00+02:00,2025-05-25,21:08,1,1,2
30,2025-05-25T12:55:00+02:00,2025-05-25,20:55,2,3,5
30,2025-05-25T13:00:00+02:00,2025-05-25,21:00,11,5,16
30,2025-05-25T13:05:00+02:00,2025-05-25,21:05,5,10,15
30,2025-05-25T13:06:00+02:00,2025-05-25,21:06,6,7,13
30,2025-05-25T13:08:00+02:00,2025-05-25,21:08,0,4,4
35,2025-05-25T12:55:00+02:00,2025-05-25,20:55,1,8,9
35,2025-05-25T12:58:00+02:00,2025-05-25,20:58,9,6,15
35,2025-05-25T13:00:00+02:00,2025-05-25,21:00,8,7,15
35,2025-05-25T13:02:00+02:00,2025-05-25,21:02,14,2,16
35,2025-05-25T13:03:00+02:00,2025-05-25,21:03,10,5,15
35,2025-05-25T13:05:00+02:00,2025-05-25,21:05,9,3,12
35,2025-05-25T13:06:00+02:00,2025-05-25,21:06,6,8,14
46,2025-05-25T12:55:00+02:00,2025-05-25,20:55,0,1,1
48,2025-05-25T13:01:00+02:00,2025-05-25,21:01,0,2,2
48,2025-05-25T13:03:00+02:00,2025-05-25,21:03,0,1,1
48,2025-05-25T13:06:00+02:00,2025-05-25,21:06,0,2,2
49,2025-05-25T12:55:00+02:00,2025-05-25,20:55,5,7,12
49,2025-05-25T12:59:00+02:00,2025-05-25,20:59,5,3,8
49,2025-05-25T13:04:00+02:00,2025-05-25,21:04,4,3,7
49,2025-05-25T13:06:00+02:00,2025-05-25,21:06,1,0,1
49,2025-05-25T13:07:00+02:00,2025-05-25,21:07,1,10,11
51,2025-05-25T12:55:00+02:00,2025-05-25,20:55,1,1,2
51,2025-05-25T13:04:00+02:00,2025-05-25,21:04,1,1,2
51,2025-05-25T13:05:00+02:00,2025-05-25,21:05,2,2,4
52,2025-05-25T12:56:00+02:00,2025-05-25,20:56,6,3,9
52,2025-05-25T13:00:00+02:00,2025-05-25,21:00,5,6,11
52,2025-05-25T13:07:00+02:00,2025-05-25,21:07,0,4,4
53,2025-05-25T13:00:00+02:00,2025-05-25,21:00,2,6,8
53,2025-05-25T13:02:00+02:00,2025-05-25,21:02,0,16,16
53,2025-05-25T13:04:00+02:00,2025-05-25,21:04,1,7,8
56,2025-05-25T12:55:00+02:00,2025-05-25,20:55,2,8,10
56,2025-05-25T13:07:00+02:00,2025-05-25,21:07,0,5,5
56,2025-05-25T13:09:00+02:00,2025-05-25,21:09,10,1,11
58,2025-05-25T12:56:00+02:00,2025-05-25,20:56,2,2,4
58,2025-05-25T12:57:00+02:00,2025-05-25,20:57,8,3,11
58,2025-05-25T12:59:00+02:00,2025-05-25,20:59,1,6,7
58,2025-05-25T13:01:00+02:00,2025-05-25,21:01,6,4,10
58,2025-05-25T13:06:00+02:00,2025-05-25,21:06,1,4,5
58,2025-05-25T13:08:00+02:00,2025-05-25,21:08,8,1,9
62,2025-05-25T12:55:00+02:00,2025-05-25,20:55,0,4,4
62,2025-05-25T12:56:00+02:00,2025-05-25,20:56,2,2,4
62,2025-05-25T12:57:00+02:00,2025-05-25,20:57,0,2,2
62,2025-05-25T13:01:00+02:00,2025-05-25,21:01,6,2,8
62,2025-05-25T13:07:00+02:00,2025-05-25,21:07,3,2,5
62,2025-05-25T13:08:00+02:00,2025-05-25,21:08,3,2,5
62,2025-05-25T13:09:00+02:00,2025-05-25,21:09,1,2,3
63,2025-05-25T12:57:00+02:00,2025-05-25,20:57,0,1,1
63,2025-05-25T12:58:00+02:00,2025-05-25,20:58,0,1,1
63,2025-05-25T13:01:00+02:00,2025-05-25,21:01,0,5,5
63,2025-05-25T13:09:00+02:00,2025-05-25,21:09,0,6,6
67,2025-05-25T12:56:00+02:00,2025-05-25,20:56,0,2,2
67,2025-05-25T12:58:00+02:00,2025-05-25,20:58,2,1,3
67,2025-05-25T12:59:00+02:00,2025-05-25,20:59,0,4,4
67,2025-05-25T13:03:00+02:00,2025-05-25,21:03,0,1,1
67,2025-05-25T13:04:00+02:00,2025-05-25,21:04,0,9,9
67,2025-05-25T13:06:00+02:00,2025-05-25,21:06,2,3,5
67,2025-05-25T13:09:00+02:00,2025-05-25,21:09,1,7,8
68,2025-05-25T12:56:00+02:00,2025-05-25,20:56,4,4,8
68,2025-05-25T12:57:00+02:00,2025-05-25,20:57,4,1,5
68,2025-05-25T13:00:00+02:00,2025-05-25,21:00,3,0,3
68,2025-05-25T13:03:00+02:00,2025-05-25,21:03,0,1,1
68,2025-05-25T13:04:00+02:00,2025-05-25,21:04,2,2,4
68,2025-05-25T13:09:00+02:00,2025-05-25,21:09,1,1,2
72,2025-05-25T12:57:00+02:00,2025-05-25,20:57,5,2,7
72,2025-05-25T13:02:00+02:00,2025-05-25,21:02,0,4,4
72,2025-05-25T13:07:00+02:00,2025-05-25,21:07,6,0,6
79,2025-05-25T12:55:00+02:00,2025-05-25,20:55,2,3,5
79,2025-05-25T13:00:00+02:00,2025-05-25,21:00,3,2,5
79,2025-05-25T13:01:00+02:00,2025-05-25,21:01,1,5,6
79,2025-05-25T13:04:00+02:00,2025-05-25,21:04,4,2,6
85,2025-05-25T12:57:00+02:00,2025-05-25,20:57,0,1,1
117,2025-05-25T13:00:00+02:00,2025-05-25,21:00,9,4,13
137,2025-05-25T13:05:00+02:00,2025-05-25,21:05,0,1,1
141,2025-05-25T12:55:00+02:00,2025-05-25,20:55,3,4,7
164,2025-05-25T13:05:00+02:00,2025-05-25,21:05,6,1,7
181,2025-05-25T12:55:00+02:00,2025-05-25,20:55,10,8,18
181,2025-05-25T12:58:00+02:00,2025-05-25,20:58,7,4,11
181,2025-05-25T12:59:00+02:00,2025-05-25,20:59,9,11,20
181,2025-05-25T13:00:00+02:00,2025-05-25,21:00,18,7,25
181,2025-05-25T13:01:00+02:00,2025-05-25,21:01,21,12,33
181,2025-05-25T13:04:00+02:00,2025-05-25,21:04,16,5,21
182,2025-05-25T13:00:00+02:00,2025-05-25,21:00,14,23,37
182,2025-05-25T13:05:00+02:00,2025-05-25,21:05,8,5,13
181,2025-05-25T13:10:00+02:00,2025-05-25,21:10,9,9,18
181,2025-05-25T13:13:00+02:00,2025-05-25,21:13,7,6,13
181,2025-05-25T13:16:00+02:00,2025-05-25,21:16,5,8,13
181,2025-05-25T13:19:00+02:00,2025-05-25,21:19,6,11,17
181,2025-05-25T13:22:00+02:00,2025-05-25,21:22,6,8,14
181,2025-05-25T13:24:00+02:00,2025-05-25,21:24,19,5,24
182,2025-05-25T13:15:00+02:00,2025-05-25,21:15,20,20,40
180,2025-05-25T13:25:00+02:00,2025-05-25,21:25,0,2,2
3,2025-05-25T13:17:00+02:00,2025-05-25,21:17,14,7,21
3,2025-05-25T13:19:00+02:00,2025-05-25,21:19,6,7,13
3,2025-05-25T13:20:00+02:00,2025-05-25,21:20,7,21,28
3,2025-05-25T13:23:00+02:00,2025-05-25,21:23,18,15,33
4,2025-05-25T13:17:00+02:00,2025-05-25,21:17,13,4,17
4,2025-05-25T13:18:00+02:00,2025-05-25,21:18,13,10,23
4,2025-05-25T13:19:00+02:00,2025-05-25,21:19,12,5,17
5,2025-05-25T13:20:00+02:00,2025-05-25,21:20,25,48,73
6,2025-05-25T13:11:00+02:00,2025-05-25,21:11,4,4,8
6,2025-05-25T13:12:00+02:00,2025-05-25,21:12,9,4,13
6,2025-05-25T13:13:00+02:00,2025-05-25,21:13,4,12,16
6,2025-05-25T13:14:00+02:00,2025-05-25,21:14,4,9,13
6,2025-05-25T13:17:00+02:00,2025-05-25,21:17,8,4,12
6,2025-05-25T13:19:00+02:00,2025-05-25,21:19,5,6,11
6,2025-05-25T13:22:00+02:00,2025-05-25,21:22,14,10,24
6,2025-05-25T13:23:00+02:00,2025-05-25,21:23,11,5,16
8,2025-05-25T13:16:00+02:00,2025-05-25,21:16,0,1,1
21,2025-05-25T13:20:00+02:00,2025-05-25,21:20,35,60,95
28,2025-05-25T13:10:00+02:00,2025-05-25,21:10,4,0,4
28,2025-05-25T13:11:00+02:00,2025-05-25,21:11,9,1,10
28,2025-05-25T13:15:00+02:00,2025-05-25,21:15,1,1,2
28,2025-05-25T13:19:00+02:00,2025-05-25,21:19,0,3,3
29,2025-05-25T13:11:00+02:00,2025-05-25,21:11,0,7,7
29,2025-05-25T13:14:00+02:00,2025-05-25,21:14,0,4,4
29,2025-05-25T13:20:00+02:00,2025-05-25,21:20,0,8,8
29,2025-05-25T13:21:00+02:00,2025-05-25,21:21,0,4,4
29,2025-05-25T13:22:00+02:00,2025-05-25,21:22,0,2,2
31,2025-05-25T13:10:00+02:00,2025-05-25,21:10,4,14,18
31,2025-05-25T13:11:00+02:00,2025-05-25,21:11,2,6,8
31,2025-05-25T13:13:00+02:00,2025-05-25,21:13,4,4,8
31,2025-05-25T13:17:00+02:00,2025-05-25,21:17,3,6,9
31,2025-05-25T13:19:00+02:00,2025-05-25,21:19,2,4,6
36,2025-05-25T13:13:00+02:00,2025-05-25,21:13,1,0,1
36,2025-05-25T13:14:00+02:00,2025-05-25,21:14,0,2,2
36,2025-05-25T13:18:00+02:00,2025-05-25,21:18,1,1,2
40,2025-05-25T13:10:00+02:00,2025-05-25,21:10,1,0,1
40,2025-05-25T13:11:00+02:00,2025-05-25,21:11,2,0,2
40,2025-05-25T13:17:00+02:00,2025-05-25,21:17,1,0,1
40,2025-05-25T13:24:00+02:00,2025-05-25,21:24,0,2,2
41,2025-05-25T13:14:00+02:00,2025-05-25,21:14,0,1,1
41,2025-05-25T13:16:00+02:00,2025-05-25,21:16,0,4,4
41,2025-05-25T13:18:00+02:00,2025-05-25,21:18,0,15,15
41,2025-05-25T13:22:00+02:00,2025-05-25,21:22,0,3,3
41,2025-05-25T13:23:00+02:00,2025-05-25,21:23,2,1,3
41,2025-05-25T13:24:00+02:00,2025-05-25,21:24,0,4,4
43,2025-05-25T13:10:00+02:00,2025-05-25,21:10,4,9,13
44,2025-05-25T13:15:00+02:00,2025-05-25,21:15,0,1,1
44,2025-05-25T13:20:00+02:00,2025-05-25,21:20,0,5,5
45,2025-05-25T13:10:00+02:00,2025-05-25,21:10,4,5,9
45,2025-05-25T13:13:00+02:00,2025-05-25,21:13,17,8,25
45,2025-05-25T13:15:00+02:00,2025-05-25,21:15,27,7,34
45,2025-05-25T13:18:00+02:00,2025-05-25,21:18,8,13,21
45,2025-05-25T13:22:00+02:00,2025-05-25,21:22,4,10,14
45,2025-05-25T13:24:00+02:00,2025-05-25,21:24,3,6,9
47,2025-05-25T13:11:00+02:00,2025-05-25,21:11,6,10,16
47,2025-05-25T13:16:00+02:00,2025-05-25,21:16,8,4,12
47,2025-05-25T13:18:00+02:00,2025-05-25,21:18,7,3,10
47,2025-05-25T13:20:00+02:00,2025-05-25,21:20,8,5,13
50,2025-05-25T13:10:00+02:00,2025-05-25,21:10,2,12,14
50,2025-05-25T13:11:00+02:00,2025-05-25,21:11,3,3,6
50,2025-05-25T13:14:00+02:00,2025-05-25,21:14,1,1,2
54,2025-05-25T13:10:00+02:00,2025-05-25,21:10,0,1,1
54,2025-05-25T13:12:00+02:00,2025-05-25,21:12,3,8,11
54,2025-05-25T13:13:00+02:00,2025-05-25,21:13,1,2,3
54,2025-05-25T13:17:00+02:00,2025-05-25,21:17,5,0,5
54,2025-05-25T13:22:00+02:00,2025-05-25,21:22,1,4,5
61,2025-05-25T13:10:00+02:00,2025-05-25,21:10,2,1,3
61,2025-05-25T13:11:00+02:00,2025-05-25,21:11,4,3,7
61,2025-05-25T13:18:00+02:00,2025-05-25,21:18,2,0,2
61,2025-05-25T13:20:00+02:00,2025-05-25,21:20,1,5,6
61,2025-05-25T13:24:00+02:00,2025-05-25,21:24,4,4,8
66,2025-05-25T13:10:00+02:00,2025-05-25,21:10,9,4,13
66,2025-05-25T13:13:00+02:00,2025-05-25,21:13,19,15,34
66,2025-05-25T13:14:00+02:00,2025-05-25,21:14,10,5,15
66,2025-05-25T13:15:00+02:00,2025-05-25,21:15,6,0,6
66,2025-05-25T13:17:00+02:00,2025-05-25,21:17,10,5,15
66,2025-05-25T13:24:00+02:00,2025-05-25,21:24,22,7,29
69,2025-05-25T13:18:00+02:00,2025-05-25,21:18,0,2,2
69,2025-05-25T13:20:00+02:00,2025-05-25,21:20,3,1,4
69,2025-05-25T13:21:00+02:00,2025-05-25,21:21,0,1,1
70,2025-05-25T13:13:00+02:00,2025-05-25,21:13,1,2,3
70,2025-05-25T13:14:00+02:00,2025-05-25,21:14,0,2,2
70,2025-05-25T13:16:00+02:00,2025-05-25,21:16,1,0,1
70,2025-05-25T13:17:00+02:00,2025-05-25,21:17,3,0,3
70,2025-05-25T13:24:00+02:00,2025-05-25,21:24,2,3,5
71,2025-05-25T13:24:00+02:00,2025-05-25,21:24,0,1,1
75,2025-05-25T13:22:00+02:00,2025-05-25,21:22,1,0,1
77,2025-05-25T13:10:00+02:00,2025-05-25,21:10,3,2,5
78,2025-05-25T13:16:00+02:00,2025-05-25,21:16,2,0,2
84,2025-05-25T13:10:00+02:00,2025-05-25,21:10,30,45,75
84,2025-05-25T13:15:00+02:00,2025-05-25,21:15,45,66,111
87,2025-05-25T13:13:00+02:00,2025-05-25,21:13,0,1,1
87,2025-05-25T13:18:00+02:00,2025-05-25,21:18,1,1,2
107,2025-05-25T13:15:00+02:00,2025-05-25,21:15,5,2,7
108,2025-05-25T13:10:00+02:00,2025-05-25,21:10,4,0,4
108,2025-05-25T13:12:00+02:00,2025-05-25,21:12,0,3,3
108,2025-05-25T13:20:00+02:00,2025-05-25,21:20,0,1,1
118,2025-05-25T13:15:00+02:00,2025-05-25,21:15,1,1,2
133,2025-05-25T13:10:00+02:00,2025-05-25,21:10,17,20,37
134,2025-05-25T13:10:00+02:00,2025-05-25,21:10,19,15,34
134,2025-05-25T13:15:00+02:00,2025-05-25,21:15,20,22,42
135,2025-05-25T13:15:00+02:00,2025-05-25,21:15,5,13,18
162,2025-05-25T13:15:00+02:00,2025-05-25,21:15,6,6,12
162,2025-05-25T13:20:00+02:00,2025-05-25,21:20,5,1,6
165,2025-05-25T13:15:00+02:00,2025-05-25,21:15,1,0,1
179,2025-05-25T13:20:00+02:00,2025-05-25,21:20,2,1,3
1,2025-05-25T13:10:00+02:00,2025-05-25,21:10,1,0,1
1,2025-05-25T13:14:00+02:00,2025-05-25,21:14,1,5,6
1,2025-05-25T13:15:00+02:00,2025-05-25,21:15,1,5,6
1,2025-05-25T13:19:00+02:00,2025-05-25,21:19,6,1,7
1,2025-05-25T13:22:00+02:00,2025-05-25,21:22,4,2,6
1,2025-05-25T13:23:00+02:00,2025-05-25,21:23,1,3,4
2,2025-05-25T13:23:00+02:00,2025-05-25,21:23,6,1,7
9,2025-05-25T13:12:00+02:00,2025-05-25,21:12,2,0,2
9,2025-05-25T13:15:00+02:00,2025-05-25,21:15,0,3,3
10,2025-05-25T13:12:00+02:00,2025-05-25,21:12,0,1,1
10,2025-05-25T13:13:00+02:00,2025-05-25,21:13,1,0,1
11,2025-05-25T13:15:00+02:00,2025-05-25,21:15,4,2,6
11,2025-05-25T13:20:00+02:00,2025-05-25,21:20,6,0,6
12,2025-05-25T13:16:00+02:00,2025-05-25,21:16,2,2,4
12,2025-05-25T13:18:00+02:00,2025-05-25,21:18,3,8,11
12,2025-05-25T13:20:00+02:00,2025-05-25,21:20,0,5,5
12,2025-05-25T13:23:00+02:00,2025-05-25,21:23,2,4,6
17,2025-05-25T13:11:00+02:00,2025-05-25,21:11,2,0,2
17,2025-05-25T13:13:00+02:00,2025-05-25,21:13,0,1,1
17,2025-05-25T13:18:00+02:00,2025-05-25,21:18,2,1,3
17,2025-05-25T13:19:00+02:00,2025-05-25,21:19,0,1,1
17,2025-05-25T13:22:00+02:00,2025-05-25,21:22,4,0,4
17,2025-05-25T13:23:00+02:00,2025-05-25,21:23,0,1,1
18,2025-05-25T13:18:00+02:00,2025-05-25,21:18,1,0,1
19,2025-05-25T13:16:00+02:00,2025-05-25,21:16,0,13,13
19,2025-05-25T13:18:00+02:00,2025-05-25,21:18,7,10,17
19,2025-05-25T13:23:00+02:00,2025-05-25,21:23,8,2,10
20,2025-05-25T13:12:00+02:00,2025-05-25,21:12,0,6,6
20,2025-05-25T13:14:00+02:00,2025-05-25,21:14,6,20,26
20,2025-05-25T13:15:00+02:00,2025-05-25,21:15,3,2,5
20,2025-05-25T13:16:00+02:00,2025-05-25,21:16,5,9,14
20,2025-05-25T13:17:00+02:00,2025-05-25,21:17,5,5,10
23,2025-05-25T13:10:00+02:00,2025-05-25,21:10,0,2,2
23,2025-05-25T13:12:00+02:00,2025-05-25,21:12,3,0,3
23,2025-05-25T13:14:00+02:00,2025-05-25,21:14,2,0,2
23,2025-05-25T13:17:00+02:00,2025-05-25,21:17,1,2,3
23,2025-05-25T13:18:00+02:00,2025-05-25,21:18,0,5,5
24,2025-05-25T13:12:00+02:00,2025-05-25,21:12,2,3,5
24,2025-05-25T13:19:00+02:00,2025-05-25,21:19,4,7,11
24,2025-05-25T13:20:00+02:00,2025-05-25,21:20,3,4,7
24,2025-05-25T13:22:00+02:00,2025-05-25,21:22,5,8,13
24,2025-05-25T13:24:00+02:00,2025-05-25,21:24,4,29,33
25,2025-05-25T13:15:00+02:00,2025-05-25,21:15,16,14,30
27,2025-05-25T13:12:00+02:00,2025-05-25,21:12,6,0,6
27,2025-05-25T13:13:00+02:00,2025-05-25,21:13,2,0,2
27,2025-05-25T13:16:00+02:00,2025-05-25,21:16,0,2,2
27,2025-05-25T13:20:00+02:00,2025-05-25,21:20,2,5,7
27,2025-05-25T13:23:00+02:00,2025-05-25,21:23,1,0,1
30,2025-05-25T13:10:00+02:00,2025-05-25,21:10,1,0,1
30,2025-05-25T13:12:00+02:00,2025-05-25,21:12,1,19,20
30,2025-05-25T13:14:00+02:00,2025-05-25,21:14,7,0,7
30,2025-05-25T13:16:00+02:00,2025-05-25,21:16,6,2,8
30,2025-05-25T13:21:00+02:00,2025-05-25,21:21,3,6,9
30,2025-05-25T13:23:00+02:00,2025-05-25,21:23,0,9,9
35,2025-05-25T13:10:00+02:00,2025-05-25,21:10,6,10,16
35,2025-05-25T13:11:00+02:00,2025-05-25,21:11,8,6,14
35,2025-05-25T13:13:00+02:00,2025-05-25,21:13,4,10,14
35,2025-05-25T13:15:00+02:00,2025-05-25,21:15,4,4,8
35,2025-05-25T13:16:00+02:00,2025-05-25,21:16,1,7,8
35,2025-05-25T13:20:00+02:00,2025-05-25,21:20,6,2,8
35,2025-05-25T13:23:00+02:00,2025-05-25,21:23,2,5,7
35,2025-05-25T13:24:00+02:00,2025-05-25,21:24,0,7,7
48,2025-05-25T13:10:00+02:00,2025-05-25,21:10,0,6,6
48,2025-05-25T13:11:00+02:00,2025-05-25,21:11,0,1,1
48,2025-05-25T13:12:00+02:00,2025-05-25,21:12,8,0,8
48,2025-05-25T13:14:00+02:00,2025-05-25,21:14,4,3,7
48,2025-05-25T13:18:00+02:00,2025-05-25,21:18,1,2,3
48,2025-05-25T13:23:00+02:00,2025-05-25,21:23,3,0,3
49,2025-05-25T13:10:00+02:00,2025-05-25,21:10,2,0,2
49,2025-05-25T13:12:00+02:00,2025-05-25,21:12,3,0,3
49,2025-05-25T13:16:00+02:00,2025-05-25,21:16,1,3,4
49,2025-05-25T13:17:00+02:00,2025-05-25,21:17,0,4,4
49,2025-05-25T13:18:00+02:00,2025-05-25,21:18,6,1,7
49,2025-05-25T13:22:00+02:00,2025-05-25,21:22,2,3,5
49,2025-05-25T13:23:00+02:00,2025-05-25,21:23,2,1,3
51,2025-05-25T13:11:00+02:00,2025-05-25,21:11,2,2,4
51,2025-05-25T13:13:00+02:00,2025-05-25,21:13,1,0,1
51,2025-05-25T13:14:00+02:00,2025-05-25,21:14,0,1,1
51,2025-05-25T13:18:00+02:00,2025-05-25,21:18,2,0,2
51,2025-05-25T13:21:00+02:00,2025-05-25,21:21,1,0,1
52,2025-05-25T13:16:00+02:00,2025-05-25,21:16,4,4,8
53,2025-05-25T13:15:00+02:00,2025-05-25,21:15,0,3,3
53,2025-05-25T13:17:00+02:00,2025-05-25,21:17,2,5,7
56,2025-05-25T13:12:00+02:00,2025-05-25,21:12,1,8,9
56,2025-05-25T13:18:00+02:00,2025-05-25,21:18,0,4,4
56,2025-05-25T13:20:00+02:00,2025-05-25,21:20,9,1,10
56,2025-05-25T13:21:00+02:00,2025-05-25,21:21,1,3,4
56,2025-05-25T13:23:00+02:00,2025-05-25,21:23,1,10,11
58,2025-05-25T13:11:00+02:00,2025-05-25,21:11,9,6,15
58,2025-05-25T13:12:00+02:00,2025-05-25,21:12,2,6,8
58,2025-05-25T13:17:00+02:00,2025-05-25,21:17,9,5,14
58,2025-05-25T13:20:00+02:00,2025-05-25,21:20,3,2,5
58,2025-05-25T13:21:00+02:00,2025-05-25,21:21,1,4,5
62,2025-05-25T13:13:00+02:00,2025-05-25,21:13,1,0,1
62,2025-05-25T13:16:00+02:00,2025-05-25,21:16,5,1,6
62,2025-05-25T13:18:00+02:00,2025-05-25,21:18,1,11,12
63,2025-05-25T13:11:00+02:00,2025-05-25,21:11,1,2,3
63,2025-05-25T13:21:00+02:00,2025-05-25,21:21,0,3,3
63,2025-05-25T13:24:00+02:00,2025-05-25,21:24,0,1,1
67,2025-05-25T13:13:00+02:00,2025-05-25,21:13,0,3,3
67,2025-05-25T13:20:00+02:00,2025-05-25,21:20,0,3,3
67,2025-05-25T13:21:00+02:00,2025-05-25,21:21,5,3,8
67,2025-05-25T13:22:00+02:00,2025-05-25,21:22,3,4,7
68,2025-05-25T13:15:00+02:00,2025-05-25,21:15,1,1,2
68,2025-05-25T13:16:00+02:00,2025-05-25,21:16,1,0,1
68,2025-05-25T13:22:00+02:00,2025-05-25,21:22,3,0,3
72,2025-05-25T13:10:00+02:00,2025-05-25,21:10,3,2,5
72,2025-05-25T13:11:00+02:00,2025-05-25,21:11,0,2,2
72,2025-05-25T13:13:00+02:00,2025-05-25,21:13,0,1,1
72,2025-05-25T13:16:00+02:00,2025-05-25,21:16,2,3,5
72,2025-05-25T13:21:00+02:00,2025-05-25,21:21,3,0,3
79,2025-05-25T13:11:00+02:00,2025-05-25,21:11,5,0,5
79,2025-05-25T13:13:00+02:00,2025-05-25,21:13,1,10,11
79,2025-05-25T13:15:00+02:00,2025-05-25,21:15,1,3,4
79,2025-05-25T13:20:00+02:00,2025-05-25,21:20,3,4,7
79,2025-05-25T13:21:00+02:00,2025-05-25,21:21,6,5,11
85,2025-05-25T13:20:00+02:00,2025-05-25,21:20,0,1,1
86,2025-05-25T13:11:00+02:00,2025-05-25,21:11,0,1,1
86,2025-05-25T13:14:00+02:00,2025-05-25,21:14,1,0,1
86,2025-05-25T13:16:00+02:00,2025-05-25,21:16,1,1,2
86,2025-05-25T13:24:00+02:00,2025-05-25,21:24,0,2,2
109,2025-05-25T13:15:00+02:00,2025-05-25,21:15,3,4,7
130,2025-05-25T13:15:00+02:00,2025-05-25,21:15,1,1,2
137,2025-05-25T13:10:00+02:00,2025-05-25,21:10,1,0,1
139,2025-05-25T13:20:00+02:00,2025-05-25,21:20,1,6,7
141,2025-05-25T13:20:00+02:00,2025-05-25,21:20,8,3,11
142,2025-05-25T13:10:00+02:00,2025-05-25,21:10,2,2,4
3,2025-05-25T13:30:00+02:00,2025-05-25,21:30,22,14,36
3,2025-05-25T13:33:00+02:00,2025-05-25,21:33,10,10,20
3,2025-05-25T13:38:00+02:00,2025-05-25,21:38,9,7,16
4,2025-05-25T13:25:00+02:00,2025-05-25,21:25,0,9,9
4,2025-05-25T13:26:00+02:00,2025-05-25,21:26,7,9,16
4,2025-05-25T13:28:00+02:00,2025-05-25,21:28,9,2,11
4,2025-05-25T13:33:00+02:00,2025-05-25,21:33,4,12,16
4,2025-05-25T13:34:00+02:00,2025-05-25,21:34,9,13,22
4,2025-05-25T13:39:00+02:00,2025-05-25,21:39,8,11,19
5,2025-05-25T13:30:00+02:00,2025-05-25,21:30,8,19,27
6,2025-05-25T13:25:00+02:00,2025-05-25,21:25,10,3,13
6,2025-05-25T13:29:00+02:00,2025-05-25,21:29,15,2,17
6,2025-05-25T13:33:00+02:00,2025-05-25,21:33,2,4,6
6,2025-05-25T13:35:00+02:00,2025-05-25,21:35,8,4,12
6,2025-05-25T13:36:00+02:00,2025-05-25,21:36,9,4,13
6,2025-05-25T13:39:00+02:00,2025-05-25,21:39,7,8,15
28,2025-05-25T13:33:00+02:00,2025-05-25,21:33,2,0,2
28,2025-05-25T13:35:00+02:00,2025-05-25,21:35,2,1,3
28,2025-05-25T13:36:00+02:00,2025-05-25,21:36,5,0,5
28,2025-05-25T13:37:00+02:00,2025-05-25,21:37,0,4,4
28,2025-05-25T13:38:00+02:00,2025-05-25,21:38,4,0,4
28,2025-05-25T13:39:00+02:00,2025-05-25,21:39,3,0,3
29,2025-05-25T13:27:00+02:00,2025-05-25,21:27,0,4,4
29,2025-05-25T13:28:00+02:00,2025-05-25,21:28,0,1,1
29,2025-05-25T13:29:00+02:00,2025-05-25,21:29,0,6,6
29,2025-05-25T13:34:00+02:00,2025-05-25,21:34,2,7,9
29,2025-05-25T13:37:00+02:00,2025-05-25,21:37,2,0,2
31,2025-05-25T13:27:00+02:00,2025-05-25,21:27,1,7,8
31,2025-05-25T13:28:00+02:00,2025-05-25,21:28,4,5,9
31,2025-05-25T13:29:00+02:00,2025-05-25,21:29,12,3,15
31,2025-05-25T13:34:00+02:00,2025-05-25,21:34,3,5,8
31,2025-05-25T13:37:00+02:00,2025-05-25,21:37,1,18,19
31,2025-05-25T13:39:00+02:00,2025-05-25,21:39,0,1,1
36,2025-05-25T13:25:00+02:00,2025-05-25,21:25,0,1,1
36,2025-05-25T13:28:00+02:00,2025-05-25,21:28,0,1,1
36,2025-05-25T13:31:00+02:00,2025-05-25,21:31,0,3,3
36,2025-05-25T13:32:00+02:00,2025-05-25,21:32,1,0,1
40,2025-05-25T13:25:00+02:00,2025-05-25,21:25,1,0,1
40,2025-05-25T13:32:00+02:00,2025-05-25,21:32,0,3,3
40,2025-05-25T13:33:00+02:00,2025-05-25,21:33,2,0,2
40,2025-05-25T13:37:00+02:00,2025-05-25,21:37,0,1,1
41,2025-05-25T13:28:00+02:00,2025-05-25,21:28,3,2,5
41,2025-05-25T13:29:00+02:00,2025-05-25,21:29,1,0,1
41,2025-05-25T13:34:00+02:00,2025-05-25,21:34,1,0,1
41,2025-05-25T13:38:00+02:00,2025-05-25,21:38,3,3,6
41,2025-05-25T13:39:00+02:00,2025-05-25,21:39,5,3,8
44,2025-05-25T13:30:00+02:00,2025-05-25,21:30,4,0,4
45,2025-05-25T13:25:00+02:00,2025-05-25,21:25,7,15,22
45,2025-05-25T13:26:00+02:00,2025-05-25,21:26,2,1,3
45,2025-05-25T13:28:00+02:00,2025-05-25,21:28,2,3,5
45,2025-05-25T13:33:00+02:00,2025-05-25,21:33,2,2,4
45,2025-05-25T13:36:00+02:00,2025-05-25,21:36,7,7,14
45,2025-05-25T13:39:00+02:00,2025-05-25,21:39,4,8,12
47,2025-05-25T13:34:00+02:00,2025-05-25,21:34,10,2,12
47,2025-05-25T13:35:00+02:00,2025-05-25,21:35,9,8,17
50,2025-05-25T13:37:00+02:00,2025-05-25,21:37,5,0,5
54,2025-05-25T13:27:00+02:00,2025-05-25,21:27,2,0,2
54,2025-05-25T13:28:00+02:00,2025-05-25,21:28,3,1,4
54,2025-05-25T13:30:00+02:00,2025-05-25,21:30,2,0,2
54,2025-05-25T13:33:00+02:00,2025-05-25,21:33,7,1,8
54,2025-05-25T13:37:00+02:00,2025-05-25,21:37,0,1,1
54,2025-05-25T13:39:00+02:00,2025-05-25,21:39,0,4,4
59,2025-05-25T13:25:00+02:00,2025-05-25,21:25,12,19,31
59,2025-05-25T13:35:00+02:00,2025-05-25,21:35,15,8,23
61,2025-05-25T13:30:00+02:00,2025-05-25,21:30,2,2,4
61,2025-05-25T13:33:00+02:00,2025-05-25,21:33,6,1,7
61,2025-05-25T13:38:00+02:00,2025-05-25,21:38,2,1,3
61,2025-05-25T13:39:00+02:00,2025-05-25,21:39,5,0,5
66,2025-05-25T13:26:00+02:00,2025-05-25,21:26,6,9,15
66,2025-05-25T13:28:00+02:00,2025-05-25,21:28,15,20,35
66,2025-05-25T13:30:00+02:00,2025-05-25,21:30,8,7,15
66,2025-05-25T13:39:00+02:00,2025-05-25,21:39,10,3,13
69,2025-05-25T13:26:00+02:00,2025-05-25,21:26,1,0,1
70,2025-05-25T13:25:00+02:00,2025-05-25,21:25,2,3,5
70,2025-05-25T13:28:00+02:00,2025-05-25,21:28,14,0,14
70,2025-05-25T13:30:00+02:00,2025-05-25,21:30,17,2,19
70,2025-05-25T13:31:00+02:00,2025-05-25,21:31,35,3,38
70,2025-05-25T13:33:00+02:00,2025-05-25,21:33,29,2,31
70,2025-05-25T13:34:00+02:00,2025-05-25,21:34,30,2,32
70,2025-05-25T13:36:00+02:00,2025-05-25,21:36,8,0,8
78,2025-05-25T13:33:00+02:00,2025-05-25,21:33,0,1,1
84,2025-05-25T13:30:00+02:00,2025-05-25,21:30,41,34,75
87,2025-05-25T13:30:00+02:00,2025-05-25,21:30,1,1,2
87,2025-05-25T13:32:00+02:00,2025-05-25,21:32,2,2,4
87,2025-05-25T13:33:00+02:00,2025-05-25,21:33,5,0,5
87,2025-05-25T13:35:00+02:00,2025-05-25,21:35,2,7,9
87,2025-05-25T13:36:00+02:00,2025-05-25,21:36,1,20,21
107,2025-05-25T13:25:00+02:00,2025-05-25,21:25,1,5,6
108,2025-05-25T13:26:00+02:00,2025-05-25,21:26,0,1,1
108,2025-05-25T13:27:00+02:00,2025-05-25,21:27,2,1,3
108,2025-05-25T13:33:00+02:00,2025-05-25,21:33,5,1,6
108,2025-05-25T13:35:00+02:00,2025-05-25,21:35,2,0,2
108,2025-05-25T13:36:00+02:00,2025-05-25,21:36,4,0,4
108,2025-05-25T13:39:00+02:00,2025-05-25,21:39,0,1,1
131,2025-05-25T13:30:00+02:00,2025-05-25,21:30,7,4,11
132,2025-05-25T13:30:00+02:00,2025-05-25,21:30,7,6,13
133,2025-05-25T13:35:00+02:00,2025-05-25,21:35,20,13,33
134,2025-05-25T13:35:00+02:00,2025-05-25,21:35,17,13,30
162,2025-05-25T13:25:00+02:00,2025-05-25,21:25,3,3,6
162,2025-05-25T13:30:00+02:00,2025-05-25,21:30,3,11,14
167,2025-05-25T13:25:00+02:00,2025-05-25,21:25,2,3,5
179,2025-05-25T13:25:00+02:00,2025-05-25,21:25,4,3,7
1,2025-05-25T13:25:00+02:00,2025-05-25,21:25,0,1,1
1,2025-05-25T13:32:00+02:00,2025-05-25,21:32,2,3,5
1,2025-05-25T13:37:00+02:00,2025-05-25,21:37,1,1,2
2,2025-05-25T13:37:00+02:00,2025-05-25,21:37,0,1,1
10,2025-05-25T13:36:00+02:00,2025-05-25,21:36,1,0,1
12,2025-05-25T13:25:00+02:00,2025-05-25,21:25,0,2,2
12,2025-05-25T13:28:00+02:00,2025-05-25,21:28,0,2,2
12,2025-05-25T13:29:00+02:00,2025-05-25,21:29,1,2,3
12,2025-05-25T13:38:00+02:00,2025-05-25,21:38,1,2,3
17,2025-05-25T13:28:00+02:00,2025-05-25,21:28,0,1,1
19,2025-05-25T13:25:00+02:00,2025-05-25,21:25,13,10,23
19,2025-05-25T13:26:00+02:00,2025-05-25,21:26,2,3,5
19,2025-05-25T13:28:00+02:00,2025-05-25,21:28,3,8,11
20,2025-05-25T13:28:00+02:00,2025-05-25,21:28,3,4,7
20,2025-05-25T13:29:00+02:00,2025-05-25,21:29,5,8,13
20,2025-05-25T13:31:00+02:00,2025-05-25,21:31,1,6,7
20,2025-05-25T13:34:00+02:00,2025-05-25,21:34,1,2,3
20,2025-05-25T13:35:00+02:00,2025-05-25,21:35,5,3,8
20,2025-05-25T13:37:00+02:00,2025-05-25,21:37,0,7,7
23,2025-05-25T13:26:00+02:00,2025-05-25,21:26,2,1,3
23,2025-05-25T13:35:00+02:00,2025-05-25,21:35,0,8,8
23,2025-05-25T13:38:00+02:00,2025-05-25,21:38,2,7,9
24,2025-05-25T13:27:00+02:00,2025-05-25,21:27,1,20,21
24,2025-05-25T13:28:00+02:00,2025-05-25,21:28,8,2,10
24,2025-05-25T13:29:00+02:00,2025-05-25,21:29,4,7,11
24,2025-05-25T13:37:00+02:00,2025-05-25,21:37,4,9,13
24,2025-05-25T13:39:00+02:00,2025-05-25,21:39,10,0,10
25,2025-05-25T13:25:00+02:00,2025-05-25,21:25,15,6,21
25,2025-05-25T13:30:00+02:00,2025-05-25,21:30,9,8,17
27,2025-05-25T13:25:00+02:00,2025-05-25,21:25,0,1,1
27,2025-05-25T13:32:00+02:00,2025-05-25,21:32,1,0,1
27,2025-05-25T13:35:00+02:00,2025-05-25,21:35,3,0,3
27,2025-05-25T13:37:00+02:00,2025-05-25,21:37,1,2,3
27,2025-05-25T13:39:00+02:00,2025-05-25,21:39,1,0,1
30,2025-05-25T13:25:00+02:00,2025-05-25,21:25,12,7,19
30,2025-05-25T13:28:00+02:00,2025-05-25,21:28,0,3,3
30,2025-05-25T13:36:00+02:00,2025-05-25,21:36,1,5,6
30,2025-05-25T13:37:00+02:00,2025-05-25,21:37,4,15,19
35,2025-05-25T13:25:00+02:00,2025-05-25,21:25,3,8,11
35,2025-05-25T13:26:00+02:00,2025-05-25,21:26,3,8,11
35,2025-05-25T13:28:00+02:00,2025-05-25,21:28,3,8,11
35,2025-05-25T13:30:00+02:00,2025-05-25,21:30,2,8,10
35,2025-05-25T13:32:00+02:00,2025-05-25,21:32,4,5,9
35,2025-05-25T13:33:00+02:00,2025-05-25,21:33,6,2,8
35,2025-05-25T13:35:00+02:00,2025-05-25,21:35,8,2,10
35,2025-05-25T13:36:00+02:00,2025-05-25,21:36,2,4,6
35,2025-05-25T13:39:00+02:00,2025-05-25,21:39,2,3,5
48,2025-05-25T13:28:00+02:00,2025-05-25,21:28,4,0,4
48,2025-05-25T13:29:00+02:00,2025-05-25,21:29,0,2,2
48,2025-05-25T13:32:00+02:00,2025-05-25,21:32,0,7,7
48,2025-05-25T13:33:00+02:00,2025-05-25,21:33,1,3,4
48,2025-05-25T13:36:00+02:00,2025-05-25,21:36,0,1,1
48,2025-05-25T13:38:00+02:00,2025-05-25,21:38,0,2,2
49,2025-05-25T13:28:00+02:00,2025-05-25,21:28,7,7,14
49,2025-05-25T13:30:00+02:00,2025-05-25,21:30,0,8,8
49,2025-05-25T13:31:00+02:00,2025-05-25,21:31,4,0,4
49,2025-05-25T13:32:00+02:00,2025-05-25,21:32,8,1,9
49,2025-05-25T13:34:00+02:00,2025-05-25,21:34,2,5,7
49,2025-05-25T13:36:00+02:00,2025-05-25,21:36,2,2,4
49,2025-05-25T13:39:00+02:00,2025-05-25,21:39,1,1,2
51,2025-05-25T13:29:00+02:00,2025-05-25,21:29,3,2,5
51,2025-05-25T13:32:00+02:00,2025-05-25,21:32,0,1,1
51,2025-05-25T13:36:00+02:00,2025-05-25,21:36,1,0,1
52,2025-05-25T13:26:00+02:00,2025-05-25,21:26,0,2,2
52,2025-05-25T13:28:00+02:00,2025-05-25,21:28,3,1,4
52,2025-05-25T13:29:00+02:00,2025-05-25,21:29,3,0,3
52,2025-05-25T13:32:00+02:00,2025-05-25,21:32,2,2,4
52,2025-05-25T13:33:00+02:00,2025-05-25,21:33,0,1,1
52,2025-05-25T13:37:00+02:00,2025-05-25,21:37,7,7,14
53,2025-05-25T13:25:00+02:00,2025-05-25,21:25,1,0,1
53,2025-05-25T13:29:00+02:00,2025-05-25,21:29,3,0,3
53,2025-05-25T13:30:00+02:00,2025-05-25,21:30,0,1,1
53,2025-05-25T13:32:00+02:00,2025-05-25,21:32,0,1,1
53,2025-05-25T13:35:00+02:00,2025-05-25,21:35,0,1,1
53,2025-05-25T13:37:00+02:00,2025-05-25,21:37,1,0,1
56,2025-05-25T13:26:00+02:00,2025-05-25,21:26,2,5,7
56,2025-05-25T13:27:00+02:00,2025-05-25,21:27,2,6,8
56,2025-05-25T13:29:00+02:00,2025-05-25,21:29,14,1,15
56,2025-05-25T13:32:00+02:00,2025-05-25,21:32,2,4,6
56,2025-05-25T13:33:00+02:00,2025-05-25,21:33,2,9,11
56,2025-05-25T13:36:00+02:00,2025-05-25,21:36,9,3,12
56,2025-05-25T13:37:00+02:00,2025-05-25,21:37,3,2,5
56,2025-05-25T13:38:00+02:00,2025-05-25,21:38,8,0,8
58,2025-05-25T13:25:00+02:00,2025-05-25,21:25,2,2,4
58,2025-05-25T13:26:00+02:00,2025-05-25,21:26,8,6,14
58,2025-05-25T13:29:00+02:00,2025-05-25,21:29,1,1,2
58,2025-05-25T13:30:00+02:00,2025-05-25,21:30,1,11,12
58,2025-05-25T13:31:00+02:00,2025-05-25,21:31,7,7,14
58,2025-05-25T13:36:00+02:00,2025-05-25,21:36,4,0,4
58,2025-05-25T13:37:00+02:00,2025-05-25,21:37,3,0,3
58,2025-05-25T13:39:00+02:00,2025-05-25,21:39,0,1,1
62,2025-05-25T13:26:00+02:00,2025-05-25,21:26,4,2,6
62,2025-05-25T13:28:00+02:00,2025-05-25,21:28,2,0,2
62,2025-05-25T13:29:00+02:00,2025-05-25,21:29,1,6,7
62,2025-05-25T13:32:00+02:00,2025-05-25,21:32,3,1,4
62,2025-05-25T13:33:00+02:00,2025-05-25,21:33,1,7,8
62,2025-05-25T13:34:00+02:00,2025-05-25,21:34,1,1,2
62,2025-05-25T13:35:00+02:00,2025-05-25,21:35,1,0,1
62,2025-05-25T13:38:00+02:00,2025-05-25,21:38,2,2,4
62,2025-05-25T13:39:00+02:00,2025-05-25,21:39,1,2,3
63,2025-05-25T13:25:00+02:00,2025-05-25,21:25,0,1,1
63,2025-05-25T13:30:00+02:00,2025-05-25,21:30,3,2,5
63,2025-05-25T13:38:00+02:00,2025-05-25,21:38,0,2,2
63,2025-05-25T13:39:00+02:00,2025-05-25,21:39,0,1,1
67,2025-05-25T13:29:00+02:00,2025-05-25,21:29,0,2,2
67,2025-05-25T13:30:00+02:00,2025-05-25,21:30,1,2,3
67,2025-05-25T13:35:00+02:00,2025-05-25,21:35,2,6,8
67,2025-05-25T13:36:00+02:00,2025-05-25,21:36,0,4,4
67,2025-05-25T13:37:00+02:00,2025-05-25,21:37,0,5,5
67,2025-05-25T13:38:00+02:00,2025-05-25,21:38,0,4,4
68,2025-05-25T13:27:00+02:00,2025-05-25,21:27,2,0,2
68,2025-05-25T13:29:00+02:00,2025-05-25,21:29,2,1,3
68,2025-05-25T13:35:00+02:00,2025-05-25,21:35,0,1,1
68,2025-05-25T13:37:00+02:00,2025-05-25,21:37,0,1,1
72,2025-05-25T13:31:00+02:00,2025-05-25,21:31,1,0,1
72,2025-05-25T13:36:00+02:00,2025-05-25,21:36,5,1,6
72,2025-05-25T13:38:00+02:00,2025-05-25,21:38,6,1,7
72,2025-05-25T13:39:00+02:00,2025-05-25,21:39,3,1,4
79,2025-05-25T13:25:00+02:00,2025-05-25,21:25,1,7,8
79,2025-05-25T13:32:00+02:00,2025-05-25,21:32,1,5,6
79,2025-05-25T13:33:00+02:00,2025-05-25,21:33,1,0,1
79,2025-05-25T13:38:00+02:00,2025-05-25,21:38,1,5,6
79,2025-05-25T13:39:00+02:00,2025-05-25,21:39,1,7,8
85,2025-05-25T13:38:00+02:00,2025-05-25,21:38,1,0,1
86,2025-05-25T13:27:00+02:00,2025-05-25,21:27,0,2,2
86,2025-05-25T13:32:00+02:00,2025-05-25,21:32,0,6,6
86,2025-05-25T13:34:00+02:00,2025-05-25,21:34,0,2,2
86,2025-05-25T13:35:00+02:00,2025-05-25,21:35,2,10,12
109,2025-05-25T13:25:00+02:00,2025-05-25,21:25,0,11,11
109,2025-05-25T13:30:00+02:00,2025-05-25,21:30,7,7,14
109,2025-05-25T13:35:00+02:00,2025-05-25,21:35,0,8,8
117,2025-05-25T13:30:00+02:00,2025-05-25,21:30,8,6,14
117,2025-05-25T13:35:00+02:00,2025-05-25,21:35,11,16,27
123,2025-05-25T13:25:00+02:00,2025-05-25,21:25,0,1,1
136,2025-05-25T13:30:00+02:00,2025-05-25,21:30,0,15,15
141,2025-05-25T13:30:00+02:00,2025-05-25,21:30,4,7,11
142,2025-05-25T13:30:00+02:00,2025-05-25,21:30,1,1,2
164,2025-05-25T13:25:00+02:00,2025-05-25,21:25,4,3,7
164,2025-05-25T13:35:00+02:00,2025-05-25,21:35,1,2,3
3,2025-05-25T13:42:00+02:00,2025-05-25,21:42,13,5,18
3,2025-05-25T13:43:00+02:00,2025-05-25,21:43,13,4,17
3,2025-05-25T13:45:00+02:00,2025-05-25,21:45,6,8,14
3,2025-05-25T13:47:00+02:00,2025-05-25,21:47,6,12,18
3,2025-05-25T13:50:00+02:00,2025-05-25,21:50,10,2,12
3,2025-05-25T13:51:00+02:00,2025-05-25,21:51,2,2,4
3,2025-05-25T13:52:00+02:00,2025-05-25,21:52,14,8,22
3,2025-05-25T13:54:00+02:00,2025-05-25,21:54,7,11,18
4,2025-05-25T13:40:00+02:00,2025-05-25,21:40,12,14,26
4,2025-05-25T13:46:00+02:00,2025-05-25,21:46,4,8,12
4,2025-05-25T13:48:00+02:00,2025-05-25,21:48,9,22,31
4,2025-05-25T13:54:00+02:00,2025-05-25,21:54,8,9,17
5,2025-05-25T13:50:00+02:00,2025-05-25,21:50,23,52,75
6,2025-05-25T13:42:00+02:00,2025-05-25,21:42,3,2,5
6,2025-05-25T13:43:00+02:00,2025-05-25,21:43,4,6,10
6,2025-05-25T13:45:00+02:00,2025-05-25,21:45,6,9,15
6,2025-05-25T13:49:00+02:00,2025-05-25,21:49,6,10,16
6,2025-05-25T13:51:00+02:00,2025-05-25,21:51,3,13,16
6,2025-05-25T13:52:00+02:00,2025-05-25,21:52,12,0,12
8,2025-05-25T13:50:00+02:00,2025-05-25,21:50,0,1,1
8,2025-05-25T13:53:00+02:00,2025-05-25,21:53,1,0,1
28,2025-05-25T13:43:00+02:00,2025-05-25,21:43,4,1,5
28,2025-05-25T13:48:00+02:00,2025-05-25,21:48,5,1,6
28,2025-05-25T13:51:00+02:00,2025-05-25,21:51,3,1,4
29,2025-05-25T13:43:00+02:00,2025-05-25,21:43,3,9,12
29,2025-05-25T13:44:00+02:00,2025-05-25,21:44,0,5,5
29,2025-05-25T13:45:00+02:00,2025-05-25,21:45,0,1,1
29,2025-05-25T13:47:00+02:00,2025-05-25,21:47,1,5,6
29,2025-05-25T13:51:00+02:00,2025-05-25,21:51,2,1,3
31,2025-05-25T13:40:00+02:00,2025-05-25,21:40,2,1,3
31,2025-05-25T13:41:00+02:00,2025-05-25,21:41,1,9,10
31,2025-05-25T13:45:00+02:00,2025-05-25,21:45,1,10,11
31,2025-05-25T13:49:00+02:00,2025-05-25,21:49,1,4,5
31,2025-05-25T13:53:00+02:00,2025-05-25,21:53,0,1,1
36,2025-05-25T13:42:00+02:00,2025-05-25,21:42,0,2,2
36,2025-05-25T13:44:00+02:00,2025-05-25,21:44,5,0,5
36,2025-05-25T13:45:00+02:00,2025-05-25,21:45,0,7,7
36,2025-05-25T13:50:00+02:00,2025-05-25,21:50,0,3,3
39,2025-05-25T13:48:00+02:00,2025-05-25,21:48,0,2,2
40,2025-05-25T13:41:00+02:00,2025-05-25,21:41,1,0,1
40,2025-05-25T13:50:00+02:00,2025-05-25,21:50,0,2,2
40,2025-05-25T13:52:00+02:00,2025-05-25,21:52,0,2,2
41,2025-05-25T13:43:00+02:00,2025-05-25,21:43,2,4,6
41,2025-05-25T13:44:00+02:00,2025-05-25,21:44,3,0,3
41,2025-05-25T13:45:00+02:00,2025-05-25,21:45,0,2,2
41,2025-05-25T13:50:00+02:00,2025-05-25,21:50,25,3,28
41,2025-05-25T13:54:00+02:00,2025-05-25,21:54,1,0,1
44,2025-05-25T13:45:00+02:00,2025-05-25,21:45,2,0,2
44,2025-05-25T13:50:00+02:00,2025-05-25,21:50,1,0,1
45,2025-05-25T13:44:00+02:00,2025-05-25,21:44,8,5,13
45,2025-05-25T13:47:00+02:00,2025-05-25,21:47,13,10,23
47,2025-05-25T13:41:00+02:00,2025-05-25,21:41,4,4,8
47,2025-05-25T13:46:00+02:00,2025-05-25,21:46,1,5,6
47,2025-05-25T13:48:00+02:00,2025-05-25,21:48,5,1,6
47,2025-05-25T13:51:00+02:00,2025-05-25,21:51,4,1,5
47,2025-05-25T13:52:00+02:00,2025-05-25,21:52,6,5,11
50,2025-05-25T13:40:00+02:00,2025-05-25,21:40,2,0,2
50,2025-05-25T13:43:00+02:00,2025-05-25,21:43,2,1,3
50,2025-05-25T13:44:00+02:00,2025-05-25,21:44,3,0,3
54,2025-05-25T13:44:00+02:00,2025-05-25,21:44,0,6,6
54,2025-05-25T13:46:00+02:00,2025-05-25,21:46,3,0,3
54,2025-05-25T13:47:00+02:00,2025-05-25,21:47,1,3,4
54,2025-05-25T13:54:00+02:00,2025-05-25,21:54,0,4,4
59,2025-05-25T13:40:00+02:00,2025-05-25,21:40,6,16,22
59,2025-05-25T13:50:00+02:00,2025-05-25,21:50,8,10,18
61,2025-05-25T13:40:00+02:00,2025-05-25,21:40,6,0,6
61,2025-05-25T13:42:00+02:00,2025-05-25,21:42,0,2,2
61,2025-05-25T13:50:00+02:00,2025-05-25,21:50,1,1,2
61,2025-05-25T13:53:00+02:00,2025-05-25,21:53,3,0,3
61,2025-05-25T13:54:00+02:00,2025-05-25,21:54,2,0,2
66,2025-05-25T13:40:00+02:00,2025-05-25,21:40,16,10,26
66,2025-05-25T13:49:00+02:00,2025-05-25,21:49,2,12,14
66,2025-05-25T13:50:00+02:00,2025-05-25,21:50,9,9,18
66,2025-05-25T13:54:00+02:00,2025-05-25,21:54,6,1,7
69,2025-05-25T13:52:00+02:00,2025-05-25,21:52,0,1,1
70,2025-05-25T13:45:00+02:00,2025-05-25,21:45,2,0,2
70,2025-05-25T13:47:00+02:00,2025-05-25,21:47,1,0,1
70,2025-05-25T13:48:00+02:00,2025-05-25,21:48,1,1,2
70,2025-05-25T13:51:00+02:00,2025-05-25,21:51,1,1,2
70,2025-05-25T13:54:00+02:00,2025-05-25,21:54,2,0,2
75,2025-05-25T13:45:00+02:00,2025-05-25,21:45,1,0,1
75,2025-05-25T13:46:00+02:00,2025-05-25,21:46,1,1,2
75,2025-05-25T13:52:00+02:00,2025-05-25,21:52,0,2,2
77,2025-05-25T13:50:00+02:00,2025-05-25,21:50,10,11,21
78,2025-05-25T13:53:00+02:00,2025-05-25,21:53,1,0,1
87,2025-05-25T13:40:00+02:00,2025-05-25,21:40,1,1,2
87,2025-05-25T13:44:00+02:00,2025-05-25,21:44,3,0,3
87,2025-05-25T13:45:00+02:00,2025-05-25,21:45,0,3,3
87,2025-05-25T13:46:00+02:00,2025-05-25,21:46,1,2,3
107,2025-05-25T13:45:00+02:00,2025-05-25,21:45,2,2,4
108,2025-05-25T13:40:00+02:00,2025-05-25,21:40,0,3,3
108,2025-05-25T13:43:00+02:00,2025-05-25,21:43,1,0,1
108,2025-05-25T13:44:00+02:00,2025-05-25,21:44,0,2,2
108,2025-05-25T13:45:00+02:00,2025-05-25,21:45,0,1,1
108,2025-05-25T13:46:00+02:00,2025-05-25,21:46,1,6,7
108,2025-05-25T13:48:00+02:00,2025-05-25,21:48,3,1,4
108,2025-05-25T13:49:00+02:00,2025-05-25,21:49,1,0,1
108,2025-05-25T13:51:00+02:00,2025-05-25,21:51,1,3,4
118,2025-05-25T13:50:00+02:00,2025-05-25,21:50,6,0,6
131,2025-05-25T13:45:00+02:00,2025-05-25,21:45,13,2,15
132,2025-05-25T13:40:00+02:00,2025-05-25,21:40,3,11,14
133,2025-05-25T13:45:00+02:00,2025-05-25,21:45,18,10,28
162,2025-05-25T13:40:00+02:00,2025-05-25,21:40,3,2,5
162,2025-05-25T13:50:00+02:00,2025-05-25,21:50,6,2,8
165,2025-05-25T13:40:00+02:00,2025-05-25,21:40,0,1,1
165,2025-05-25T13:50:00+02:00,2025-05-25,21:50,1,0,1
167,2025-05-25T13:40:00+02:00,2025-05-25,21:40,0,4,4
167,2025-05-25T13:45:00+02:00,2025-05-25,21:45,0,3,3
167,2025-05-25T13:50:00+02:00,2025-05-25,21:50,1,0,1
1,2025-05-25T13:43:00+02:00,2025-05-25,21:43,3,3,6
1,2025-05-25T13:51:00+02:00,2025-05-25,21:51,1,4,5
1,2025-05-25T13:54:00+02:00,2025-05-25,21:54,0,6,6
2,2025-05-25T13:40:00+02:00,2025-05-25,21:40,0,3,3
2,2025-05-25T13:46:00+02:00,2025-05-25,21:46,1,1,2
9,2025-05-25T13:41:00+02:00,2025-05-25,21:41,0,1,1
9,2025-05-25T13:53:00+02:00,2025-05-25,21:53,1,3,4
10,2025-05-25T13:41:00+02:00,2025-05-25,21:41,0,3,3
12,2025-05-25T13:40:00+02:00,2025-05-25,21:40,2,2,4
12,2025-05-25T13:46:00+02:00,2025-05-25,21:46,0,1,1
12,2025-05-25T13:50:00+02:00,2025-05-25,21:50,3,1,4
12,2025-05-25T13:51:00+02:00,2025-05-25,21:51,6,0,6
12,2025-05-25T13:53:00+02:00,2025-05-25,21:53,1,0,1
12,2025-05-25T13:54:00+02:00,2025-05-25,21:54,1,0,1
17,2025-05-25T13:40:00+02:00,2025-05-25,21:40,0,1,1
17,2025-05-25T13:52:00+02:00,2025-05-25,21:52,0,2,2
17,2025-05-25T13:54:00+02:00,2025-05-25,21:54,0,4,4
19,2025-05-25T13:42:00+02:00,2025-05-25,21:42,4,9,13
19,2025-05-25T13:44:00+02:00,2025-05-25,21:44,8,9,17
19,2025-05-25T13:45:00+02:00,2025-05-25,21:45,1,4,5
19,2025-05-25T13:47:00+02:00,2025-05-25,21:47,0,11,11
19,2025-05-25T13:48:00+02:00,2025-05-25,21:48,6,16,22
19,2025-05-25T13:49:00+02:00,2025-05-25,21:49,10,4,14
19,2025-05-25T13:51:00+02:00,2025-05-25,21:51,10,12,22
19,2025-05-25T13:53:00+02:00,2025-05-25,21:53,12,0,12
20,2025-05-25T13:41:00+02:00,2025-05-25,21:41,0,15,15
20,2025-05-25T13:42:00+02:00,2025-05-25,21:42,0,8,8
20,2025-05-25T13:45:00+02:00,2025-05-25,21:45,1,4,5
20,2025-05-25T13:46:00+02:00,2025-05-25,21:46,3,0,3
20,2025-05-25T13:49:00+02:00,2025-05-25,21:49,0,3,3
23,2025-05-25T13:45:00+02:00,2025-05-25,21:45,3,2,5
23,2025-05-25T13:51:00+02:00,2025-05-25,21:51,2,4,6
23,2025-05-25T13:54:00+02:00,2025-05-25,21:54,0,3,3
24,2025-05-25T13:46:00+02:00,2025-05-25,21:46,1,3,4
24,2025-05-25T13:50:00+02:00,2025-05-25,21:50,3,16,19
24,2025-05-25T13:53:00+02:00,2025-05-25,21:53,2,4,6
24,2025-05-25T13:54:00+02:00,2025-05-25,21:54,3,5,8
25,2025-05-25T13:40:00+02:00,2025-05-25,21:40,4,10,14
30,2025-05-25T13:41:00+02:00,2025-05-25,21:41,2,9,11
30,2025-05-25T13:44:00+02:00,2025-05-25,21:44,0,4,4
30,2025-05-25T13:45:00+02:00,2025-05-25,21:45,3,4,7
30,2025-05-25T13:47:00+02:00,2025-05-25,21:47,4,5,9
30,2025-05-25T13:48:00+02:00,2025-05-25,21:48,2,3,5
30,2025-05-25T13:50:00+02:00,2025-05-25,21:50,7,8,15
30,2025-05-25T13:51:00+02:00,2025-05-25,21:51,1,9,10
30,2025-05-25T13:52:00+02:00,2025-05-25,21:52,1,3,4
30,2025-05-25T13:54:00+02:00,2025-05-25,21:54,2,0,2
35,2025-05-25T13:40:00+02:00,2025-05-25,21:40,8,18,26
35,2025-05-25T13:44:00+02:00,2025-05-25,21:44,1,12,13
35,2025-05-25T13:49:00+02:00,2025-05-25,21:49,2,7,9
35,2025-05-25T13:50:00+02:00,2025-05-25,21:50,2,12,14
48,2025-05-25T13:40:00+02:00,2025-05-25,21:40,2,0,2
48,2025-05-25T13:44:00+02:00,2025-05-25,21:44,0,6,6
48,2025-05-25T13:46:00+02:00,2025-05-25,21:46,2,0,2
49,2025-05-25T13:42:00+02:00,2025-05-25,21:42,4,0,4
49,2025-05-25T13:44:00+02:00,2025-05-25,21:44,0,4,4
49,2025-05-25T13:50:00+02:00,2025-05-25,21:50,6,5,11
51,2025-05-25T13:53:00+02:00,2025-05-25,21:53,4,0,4
51,2025-05-25T13:54:00+02:00,2025-05-25,21:54,0,1,1
52,2025-05-25T13:41:00+02:00,2025-05-25,21:41,1,1,2
52,2025-05-25T13:42:00+02:00,2025-05-25,21:42,4,2,6
52,2025-05-25T13:45:00+02:00,2025-05-25,21:45,5,5,10
52,2025-05-25T13:46:00+02:00,2025-05-25,21:46,3,2,5
52,2025-05-25T13:47:00+02:00,2025-05-25,21:47,0,11,11
52,2025-05-25T13:48:00+02:00,2025-05-25,21:48,2,2,4
52,2025-05-25T13:49:00+02:00,2025-05-25,21:49,6,0,6
52,2025-05-25T13:50:00+02:00,2025-05-25,21:50,2,1,3
52,2025-05-25T13:52:00+02:00,2025-05-25,21:52,0,5,5
52,2025-05-25T13:54:00+02:00,2025-05-25,21:54,1,3,4
53,2025-05-25T13:40:00+02:00,2025-05-25,21:40,1,4,5
53,2025-05-25T13:43:00+02:00,2025-05-25,21:43,1,0,1
53,2025-05-25T13:44:00+02:00,2025-05-25,21:44,0,5,5
53,2025-05-25T13:51:00+02:00,2025-05-25,21:51,0,3,3
56,2025-05-25T13:42:00+02:00,2025-05-25,21:42,0,6,6
56,2025-05-25T13:47:00+02:00,2025-05-25,21:47,1,0,1
58,2025-05-25T13:40:00+02:00,2025-05-25,21:40,4,5,9
58,2025-05-25T13:42:00+02:00,2025-05-25,21:42,5,0,5
58,2025-05-25T13:43:00+02:00,2025-05-25,21:43,2,4,6
58,2025-05-25T13:44:00+02:00,2025-05-25,21:44,2,3,5
58,2025-05-25T13:45:00+02:00,2025-05-25,21:45,1,3,4
58,2025-05-25T13:47:00+02:00,2025-05-25,21:47,3,4,7
58,2025-05-25T13:48:00+02:00,2025-05-25,21:48,1,5,6
58,2025-05-25T13:53:00+02:00,2025-05-25,21:53,2,2,4
62,2025-05-25T13:41:00+02:00,2025-05-25,21:41,2,1,3
62,2025-05-25T13:42:00+02:00,2025-05-25,21:42,1,1,2
62,2025-05-25T13:44:00+02:00,2025-05-25,21:44,4,2,6
62,2025-05-25T13:46:00+02:00,2025-05-25,21:46,0,1,1
62,2025-05-25T13:52:00+02:00,2025-05-25,21:52,2,2,4
62,2025-05-25T13:53:00+02:00,2025-05-25,21:53,0,1,1
63,2025-05-25T13:46:00+02:00,2025-05-25,21:46,1,2,3
63,2025-05-25T13:49:00+02:00,2025-05-25,21:49,2,10,12
63,2025-05-25T13:52:00+02:00,2025-05-25,21:52,0,1,1
67,2025-05-25T13:44:00+02:00,2025-05-25,21:44,0,2,2
67,2025-05-25T13:45:00+02:00,2025-05-25,21:45,0,5,5
67,2025-05-25T13:48:00+02:00,2025-05-25,21:48,2,2,4
67,2025-05-25T13:52:00+02:00,2025-05-25,21:52,2,8,10
67,2025-05-25T13:53:00+02:00,2025-05-25,21:53,5,0,5
68,2025-05-25T13:48:00+02:00,2025-05-25,21:48,4,1,5
72,2025-05-25T13:44:00+02:00,2025-05-25,21:44,1,2,3
72,2025-05-25T13:48:00+02:00,2025-05-25,21:48,3,0,3
72,2025-05-25T13:50:00+02:00,2025-05-25,21:50,12,6,18
72,2025-05-25T13:51:00+02:00,2025-05-25,21:51,1,0,1
72,2025-05-25T13:54:00+02:00,2025-05-25,21:54,1,4,5
79,2025-05-25T13:43:00+02:00,2025-05-25,21:43,8,4,12
79,2025-05-25T13:48:00+02:00,2025-05-25,21:48,6,7,13
79,2025-05-25T13:49:00+02:00,2025-05-25,21:49,3,5,8
85,2025-05-25T13:52:00+02:00,2025-05-25,21:52,3,0,3
86,2025-05-25T13:40:00+02:00,2025-05-25,21:40,0,2,2
86,2025-05-25T13:45:00+02:00,2025-05-25,21:45,0,2,2
86,2025-05-25T13:53:00+02:00,2025-05-25,21:53,0,1,1
109,2025-05-25T13:40:00+02:00,2025-05-25,21:40,6,2,8
109,2025-05-25T13:45:00+02:00,2025-05-25,21:45,1,3,4
117,2025-05-25T13:40:00+02:00,2025-05-25,21:40,7,17,24
130,2025-05-25T13:45:00+02:00,2025-05-25,21:45,1,2,3
141,2025-05-25T13:40:00+02:00,2025-05-25,21:40,3,8,11
141,2025-05-25T13:50:00+02:00,2025-05-25,21:50,0,12,12
164,2025-05-25T13:40:00+02:00,2025-05-25,21:40,1,17,18
3,2025-05-25T13:55:00+02:00,2025-05-25,21:55,8,17,25
3,2025-05-25T14:00:00+02:00,2025-05-25,22:00,3,1,4
3,2025-05-25T14:05:00+02:00,2025-05-25,22:05,12,3,15
3,2025-05-25T14:08:00+02:00,2025-05-25,22:08,10,7,17
4,2025-05-25T13:55:00+02:00,2025-05-25,21:55,12,15,27
4,2025-05-25T14:06:00+02:00,2025-05-25,22:06,7,5,12
4,2025-05-25T14:09:00+02:00,2025-05-25,22:09,8,14,22
5,2025-05-25T14:00:00+02:00,2025-05-25,22:00,247,18,265
6,2025-05-25T13:55:00+02:00,2025-05-25,21:55,4,3,7
6,2025-05-25T13:59:00+02:00,2025-05-25,21:59,5,3,8
6,2025-05-25T14:02:00+02:00,2025-05-25,22:02,2,2,4
6,2025-05-25T14:05:00+02:00,2025-05-25,22:05,5,5,10
6,2025-05-25T14:08:00+02:00,2025-05-25,22:08,5,3,8
8,2025-05-25T14:09:00+02:00,2025-05-25,22:09,1,0,1
28,2025-05-25T13:57:00+02:00,2025-05-25,21:57,13,4,17
28,2025-05-25T13:58:00+02:00,2025-05-25,21:58,38,0,38
28,2025-05-25T13:59:00+02:00,2025-05-25,21:59,71,0,71
28,2025-05-25T14:03:00+02:00,2025-05-25,22:03,65,0,65
28,2025-05-25T14:08:00+02:00,2025-05-25,22:08,13,1,14
29,2025-05-25T13:58:00+02:00,2025-05-25,21:58,4,0,4
29,2025-05-25T14:01:00+02:00,2025-05-25,22:01,5,2,7
29,2025-05-25T14:09:00+02:00,2025-05-25,22:09,0,5,5
31,2025-05-25T13:57:00+02:00,2025-05-25,21:57,1,1,2
31,2025-05-25T13:58:00+02:00,2025-05-25,21:58,3,1,4
31,2025-05-25T14:02:00+02:00,2025-05-25,22:02,2,0,2
31,2025-05-25T14:05:00+02:00,2025-05-25,22:05,0,3,3
36,2025-05-25T13:55:00+02:00,2025-05-25,21:55,3,0,3
36,2025-05-25T13:57:00+02:00,2025-05-25,21:57,1,0,1
36,2025-05-25T14:02:00+02:00,2025-05-25,22:02,1,0,1
39,2025-05-25T14:08:00+02:00,2025-05-25,22:08,1,0,1
40,2025-05-25T14:02:00+02:00,2025-05-25,22:02,2,0,2
41,2025-05-25T14:00:00+02:00,2025-05-25,22:00,0,4,4
41,2025-05-25T14:01:00+02:00,2025-05-25,22:01,2,4,6
43,2025-05-25T13:55:00+02:00,2025-05-25,21:55,2,1,3
43,2025-05-25T14:05:00+02:00,2025-05-25,22:05,3,4,7
44,2025-05-25T14:00:00+02:00,2025-05-25,22:00,1,1,2
45,2025-05-25T13:55:00+02:00,2025-05-25,21:55,6,4,10
45,2025-05-25T13:58:00+02:00,2025-05-25,21:58,6,7,13
45,2025-05-25T13:59:00+02:00,2025-05-25,21:59,7,2,9
45,2025-05-25T14:00:00+02:00,2025-05-25,22:00,10,6,16
45,2025-05-25T14:01:00+02:00,2025-05-25,22:01,0,6,6
45,2025-05-25T14:04:00+02:00,2025-05-25,22:04,0,3,3
45,2025-05-25T14:08:00+02:00,2025-05-25,22:08,8,6,14
47,2025-05-25T13:56:00+02:00,2025-05-25,21:56,12,3,15
47,2025-05-25T14:00:00+02:00,2025-05-25,22:00,4,2,6
47,2025-05-25T14:01:00+02:00,2025-05-25,22:01,6,15,21
47,2025-05-25T14:08:00+02:00,2025-05-25,22:08,0,10,10
47,2025-05-25T14:09:00+02:00,2025-05-25,22:09,6,5,11
50,2025-05-25T13:55:00+02:00,2025-05-25,21:55,6,0,6
50,2025-05-25T13:57:00+02:00,2025-05-25,21:57,2,0,2
54,2025-05-25T14:00:00+02:00,2025-05-25,22:00,0,2,2
54,2025-05-25T14:01:00+02:00,2025-05-25,22:01,1,0,1
54,2025-05-25T14:07:00+02:00,2025-05-25,22:07,1,1,2
54,2025-05-25T14:08:00+02:00,2025-05-25,22:08,0,1,1
59,2025-05-25T14:00:00+02:00,2025-05-25,22:00,23,18,41
59,2025-05-25T14:05:00+02:00,2025-05-25,22:05,8,21,29
61,2025-05-25T13:57:00+02:00,2025-05-25,21:57,3,2,5
61,2025-05-25T14:02:00+02:00,2025-05-25,22:02,4,1,5
61,2025-05-25T14:03:00+02:00,2025-05-25,22:03,4,2,6
61,2025-05-25T14:06:00+02:00,2025-05-25,22:06,5,0,5
66,2025-05-25T13:56:00+02:00,2025-05-25,21:56,25,3,28
66,2025-05-25T14:00:00+02:00,2025-05-25,22:00,8,1,9
66,2025-05-25T14:01:00+02:00,2025-05-25,22:01,10,14,24
69,2025-05-25T13:58:00+02:00,2025-05-25,21:58,1,1,2
69,2025-05-25T14:00:00+02:00,2025-05-25,22:00,2,1,3
69,2025-05-25T14:02:00+02:00,2025-05-25,22:02,1,1,2
69,2025-05-25T14:08:00+02:00,2025-05-25,22:08,1,1,2
70,2025-05-25T13:56:00+02:00,2025-05-25,21:56,1,3,4
70,2025-05-25T13:57:00+02:00,2025-05-25,21:57,2,0,2
70,2025-05-25T13:58:00+02:00,2025-05-25,21:58,4,1,5
70,2025-05-25T14:00:00+02:00,2025-05-25,22:00,1,0,1
70,2025-05-25T14:03:00+02:00,2025-05-25,22:03,0,1,1
75,2025-05-25T14:02:00+02:00,2025-05-25,22:02,2,0,2
75,2025-05-25T14:04:00+02:00,2025-05-25,22:04,1,0,1
77,2025-05-25T13:55:00+02:00,2025-05-25,21:55,3,0,3
84,2025-05-25T13:55:00+02:00,2025-05-25,21:55,45,41,86
84,2025-05-25T14:05:00+02:00,2025-05-25,22:05,41,14,55
87,2025-05-25T13:58:00+02:00,2025-05-25,21:58,1,1,2
108,2025-05-25T13:55:00+02:00,2025-05-25,21:55,2,2,4
108,2025-05-25T13:56:00+02:00,2025-05-25,21:56,1,0,1
108,2025-05-25T13:59:00+02:00,2025-05-25,21:59,4,2,6
108,2025-05-25T14:04:00+02:00,2025-05-25,22:04,2,5,7
108,2025-05-25T14:07:00+02:00,2025-05-25,22:07,3,3,6
108,2025-05-25T14:09:00+02:00,2025-05-25,22:09,6,2,8
118,2025-05-25T14:00:00+02:00,2025-05-25,22:00,0,1,1
131,2025-05-25T14:00:00+02:00,2025-05-25,22:00,4,2,6
132,2025-05-25T13:55:00+02:00,2025-05-25,21:55,7,3,10
133,2025-05-25T14:00:00+02:00,2025-05-25,22:00,33,15,48
134,2025-05-25T14:00:00+02:00,2025-05-25,22:00,19,15,34
134,2025-05-25T14:05:00+02:00,2025-05-25,22:05,16,7,23
165,2025-05-25T13:55:00+02:00,2025-05-25,21:55,1,2,3
165,2025-05-25T14:05:00+02:00,2025-05-25,22:05,0,2,2
166,2025-05-25T14:05:00+02:00,2025-05-25,22:05,1,0,1
179,2025-05-25T13:55:00+02:00,2025-05-25,21:55,2,3,5
1,2025-05-25T13:55:00+02:00,2025-05-25,21:55,0,1,1
1,2025-05-25T13:56:00+02:00,2025-05-25,21:56,2,1,3
1,2025-05-25T13:59:00+02:00,2025-05-25,21:59,0,2,2
1,2025-05-25T14:02:00+02:00,2025-05-25,22:02,1,1,2
1,2025-05-25T14:04:00+02:00,2025-05-25,22:04,4,2,6
2,2025-05-25T13:59:00+02:00,2025-05-25,21:59,0,2,2
2,2025-05-25T14:01:00+02:00,2025-05-25,22:01,0,4,4
2,2025-05-25T14:05:00+02:00,2025-05-25,22:05,0,2,2
2,2025-05-25T14:07:00+02:00,2025-05-25,22:07,3,4,7
2,2025-05-25T14:09:00+02:00,2025-05-25,22:09,3,1,4
9,2025-05-25T14:04:00+02:00,2025-05-25,22:04,1,2,3
9,2025-05-25T14:07:00+02:00,2025-05-25,22:07,0,2,2
10,2025-05-25T14:01:00+02:00,2025-05-25,22:01,1,0,1
11,2025-05-25T14:00:00+02:00,2025-05-25,22:00,1,1,2
12,2025-05-25T13:57:00+02:00,2025-05-25,21:57,0,4,4
12,2025-05-25T14:07:00+02:00,2025-05-25,22:07,0,2,2
12,2025-05-25T14:08:00+02:00,2025-05-25,22:08,3,4,7
17,2025-05-25T13:55:00+02:00,2025-05-25,21:55,1,1,2
18,2025-05-25T13:58:00+02:00,2025-05-25,21:58,1,0,1
18,2025-05-25T14:01:00+02:00,2025-05-25,22:01,1,0,1
19,2025-05-25T13:55:00+02:00,2025-05-25,21:55,2,3,5
19,2025-05-25T13:56:00+02:00,2025-05-25,21:56,0,7,7
19,2025-05-25T14:09:00+02:00,2025-05-25,22:09,0,6,6
20,2025-05-25T13:55:00+02:00,2025-05-25,21:55,0,6,6
20,2025-05-25T13:56:00+02:00,2025-05-25,21:56,1,2,3
20,2025-05-25T13:59:00+02:00,2025-05-25,21:59,4,2,6
20,2025-05-25T14:01:00+02:00,2025-05-25,22:01,1,7,8
20,2025-05-25T14:04:00+02:00,2025-05-25,22:04,0,3,3
20,2025-05-25T14:07:00+02:00,2025-05-25,22:07,1,6,7
23,2025-05-25T14:00:00+02:00,2025-05-25,22:00,0,1,1
23,2025-05-25T14:04:00+02:00,2025-05-25,22:04,1,2,3
23,2025-05-25T14:09:00+02:00,2025-05-25,22:09,2,5,7
24,2025-05-25T13:55:00+02:00,2025-05-25,21:55,1,7,8
24,2025-05-25T14:01:00+02:00,2025-05-25,22:01,7,2,9
24,2025-05-25T14:02:00+02:00,2025-05-25,22:02,4,5,9
24,2025-05-25T14:04:00+02:00,2025-05-25,22:04,5,4,9
24,2025-05-25T14:05:00+02:00,2025-05-25,22:05,1,19,20
24,2025-05-25T14:06:00+02:00,2025-05-25,22:06,3,2,5
24,2025-05-25T14:08:00+02:00,2025-05-25,22:08,2,0,2
25,2025-05-25T14:00:00+02:00,2025-05-25,22:00,3,2,5
27,2025-05-25T13:55:00+02:00,2025-05-25,21:55,4,0,4
27,2025-05-25T13:56:00+02:00,2025-05-25,21:56,1,1,2
27,2025-05-25T14:02:00+02:00,2025-05-25,22:02,1,0,1
27,2025-05-25T14:03:00+02:00,2025-05-25,22:03,2,0,2
27,2025-05-25T14:04:00+02:00,2025-05-25,22:04,4,0,4
27,2025-05-25T14:05:00+02:00,2025-05-25,22:05,3,0,3
27,2025-05-25T14:06:00+02:00,2025-05-25,22:06,5,0,5
27,2025-05-25T14:09:00+02:00,2025-05-25,22:09,1,0,1
30,2025-05-25T13:56:00+02:00,2025-05-25,21:56,10,7,17
30,2025-05-25T13:57:00+02:00,2025-05-25,21:57,4,4,8
30,2025-05-25T14:00:00+02:00,2025-05-25,22:00,2,5,7
30,2025-05-25T14:06:00+02:00,2025-05-25,22:06,2,4,6
30,2025-05-25T14:08:00+02:00,2025-05-25,22:08,7,5,12
35,2025-05-25T13:56:00+02:00,2025-05-25,21:56,2,4,6
35,2025-05-25T13:58:00+02:00,2025-05-25,21:58,2,10,12
35,2025-05-25T14:02:00+02:00,2025-05-25,22:02,0,10,10
46,2025-05-25T14:05:00+02:00,2025-05-25,22:05,1,0,1
48,2025-05-25T13:55:00+02:00,2025-05-25,21:55,0,1,1
48,2025-05-25T13:58:00+02:00,2025-05-25,21:58,3,0,3
48,2025-05-25T13:59:00+02:00,2025-05-25,21:59,1,2,3
48,2025-05-25T14:01:00+02:00,2025-05-25,22:01,3,7,10
48,2025-05-25T14:08:00+02:00,2025-05-25,22:08,0,2,2
49,2025-05-25T13:55:00+02:00,2025-05-25,21:55,0,2,2
49,2025-05-25T14:02:00+02:00,2025-05-25,22:02,2,0,2
49,2025-05-25T14:03:00+02:00,2025-05-25,22:03,1,2,3
49,2025-05-25T14:08:00+02:00,2025-05-25,22:08,0,5,5
51,2025-05-25T13:58:00+02:00,2025-05-25,21:58,2,0,2
51,2025-05-25T14:02:00+02:00,2025-05-25,22:02,1,0,1
51,2025-05-25T14:04:00+02:00,2025-05-25,22:04,3,1,4
51,2025-05-25T14:05:00+02:00,2025-05-25,22:05,2,1,3
52,2025-05-25T13:55:00+02:00,2025-05-25,21:55,5,0,5
52,2025-05-25T13:56:00+02:00,2025-05-25,21:56,2,3,5
52,2025-05-25T13:57:00+02:00,2025-05-25,21:57,2,4,6
52,2025-05-25T13:58:00+02:00,2025-05-25,21:58,0,2,2
52,2025-05-25T14:01:00+02:00,2025-05-25,22:01,0,10,10
53,2025-05-25T14:02:00+02:00,2025-05-25,22:02,1,0,1
53,2025-05-25T14:04:00+02:00,2025-05-25,22:04,2,3,5
53,2025-05-25T14:08:00+02:00,2025-05-25,22:08,0,1,1
56,2025-05-25T13:55:00+02:00,2025-05-25,21:55,0,7,7
56,2025-05-25T13:56:00+02:00,2025-05-25,21:56,1,6,7
56,2025-05-25T13:59:00+02:00,2025-05-25,21:59,0,1,1
56,2025-05-25T14:05:00+02:00,2025-05-25,22:05,1,4,5
56,2025-05-25T14:06:00+02:00,2025-05-25,22:06,2,0,2
58,2025-05-25T13:55:00+02:00,2025-05-25,21:55,0,6,6
58,2025-05-25T13:57:00+02:00,2025-05-25,21:57,3,1,4
58,2025-05-25T13:58:00+02:00,2025-05-25,21:58,2,15,17
58,2025-05-25T14:00:00+02:00,2025-05-25,22:00,4,0,4
58,2025-05-25T14:05:00+02:00,2025-05-25,22:05,1,1,2
58,2025-05-25T14:06:00+02:00,2025-05-25,22:06,3,2,5
58,2025-05-25T14:07:00+02:00,2025-05-25,22:07,5,0,5
62,2025-05-25T14:02:00+02:00,2025-05-25,22:02,0,3,3
62,2025-05-25T14:03:00+02:00,2025-05-25,22:03,1,0,1
62,2025-05-25T14:05:00+02:00,2025-05-25,22:05,1,5,6
62,2025-05-25T14:08:00+02:00,2025-05-25,22:08,2,0,2
62,2025-05-25T14:09:00+02:00,2025-05-25,22:09,2,0,2
63,2025-05-25T13:57:00+02:00,2025-05-25,21:57,0,2,2
63,2025-05-25T14:00:00+02:00,2025-05-25,22:00,0,3,3
63,2025-05-25T14:05:00+02:00,2025-05-25,22:05,0,1,1
63,2025-05-25T14:06:00+02:00,2025-05-25,22:06,0,2,2
67,2025-05-25T13:55:00+02:00,2025-05-25,21:55,3,0,3
67,2025-05-25T13:57:00+02:00,2025-05-25,21:57,2,2,4
67,2025-05-25T14:02:00+02:00,2025-05-25,22:02,0,5,5
67,2025-05-25T14:03:00+02:00,2025-05-25,22:03,2,0,2
67,2025-05-25T14:04:00+02:00,2025-05-25,22:04,1,3,4
67,2025-05-25T14:05:00+02:00,2025-05-25,22:05,1,4,5
67,2025-05-25T14:06:00+02:00,2025-05-25,22:06,2,1,3
68,2025-05-25T13:56:00+02:00,2025-05-25,21:56,0,4,4
68,2025-05-25T13:58:00+02:00,2025-05-25,21:58,1,1,2
68,2025-05-25T14:01:00+02:00,2025-05-25,22:01,1,0,1
68,2025-05-25T14:04:00+02:00,2025-05-25,22:04,0,1,1
72,2025-05-25T13:58:00+02:00,2025-05-25,21:58,0,5,5
72,2025-05-25T13:59:00+02:00,2025-05-25,21:59,0,5,5
72,2025-05-25T14:05:00+02:00,2025-05-25,22:05,4,1,5
72,2025-05-25T14:07:00+02:00,2025-05-25,22:07,1,0,1
72,2025-05-25T14:08:00+02:00,2025-05-25,22:08,7,4,11
79,2025-05-25T13:58:00+02:00,2025-05-25,21:58,0,1,1
79,2025-05-25T13:59:00+02:00,2025-05-25,21:59,1,0,1
85,2025-05-25T13:56:00+02:00,2025-05-25,21:56,1,0,1
85,2025-05-25T13:59:00+02:00,2025-05-25,21:59,0,3,3
86,2025-05-25T13:56:00+02:00,2025-05-25,21:56,1,0,1
86,2025-05-25T13:59:00+02:00,2025-05-25,21:59,0,1,1
86,2025-05-25T14:02:00+02:00,2025-05-25,22:02,1,0,1
109,2025-05-25T14:00:00+02:00,2025-05-25,22:00,4,2,6
123,2025-05-25T14:00:00+02:00,2025-05-25,22:00,1,0,1
130,2025-05-25T14:00:00+02:00,2025-05-25,22:00,0,1,1
136,2025-05-25T13:55:00+02:00,2025-05-25,21:55,1,0,1
139,2025-05-25T13:55:00+02:00,2025-05-25,21:55,0,1,1
139,2025-05-25T14:05:00+02:00,2025-05-25,22:05,2,0,2
164,2025-05-25T14:05:00+02:00,2025-05-25,22:05,2,4,6
181,2025-05-25T13:40:00+02:00,2025-05-25,21:40,4,14,18
181,2025-05-25T13:41:00+02:00,2025-05-25,21:41,6,5,11
181,2025-05-25T13:43:00+02:00,2025-05-25,21:43,12,11,23
181,2025-05-25T13:44:00+02:00,2025-05-25,21:44,19,5,24
181,2025-05-25T13:45:00+02:00,2025-05-25,21:45,6,8,14
181,2025-05-25T13:48:00+02:00,2025-05-25,21:48,4,5,9
181,2025-05-25T13:50:00+02:00,2025-05-25,21:50,16,4,20
181,2025-05-25T13:52:00+02:00,2025-05-25,21:52,5,4,9
181,2025-05-25T13:55:00+02:00,2025-05-25,21:55,15,4,19
181,2025-05-25T13:57:00+02:00,2025-05-25,21:57,6,2,8
181,2025-05-25T14:00:00+02:00,2025-05-25,22:00,12,4,16
181,2025-05-25T14:04:00+02:00,2025-05-25,22:04,18,7,25
181,2025-05-25T14:05:00+02:00,2025-05-25,22:05,12,1,13
182,2025-05-25T14:00:00+02:00,2025-05-25,22:00,6,13,19
3,2025-05-25T14:13:00+02:00,2025-05-25,22:13,8,0,8
3,2025-05-25T14:16:00+02:00,2025-05-25,22:16,4,3,7
3,2025-05-25T14:17:00+02:00,2025-05-25,22:17,7,8,15
3,2025-05-25T14:18:00+02:00,2025-05-25,22:18,4,9,13
3,2025-05-25T14:19:00+02:00,2025-05-25,22:19,15,5,20
3,2025-05-25T14:20:00+02:00,2025-05-25,22:20,9,5,14
3,2025-05-25T14:24:00+02:00,2025-05-25,22:24,6,4,10
4,2025-05-25T14:10:00+02:00,2025-05-25,22:10,2,6,8
4,2025-05-25T14:20:00+02:00,2025-05-25,22:20,0,3,3
4,2025-05-25T14:21:00+02:00,2025-05-25,22:21,0,4,4
4,2025-05-25T14:23:00+02:00,2025-05-25,22:23,1,7,8
6,2025-05-25T14:12:00+02:00,2025-05-25,22:12,9,0,9
6,2025-05-25T14:15:00+02:00,2025-05-25,22:15,3,1,4
6,2025-05-25T14:18:00+02:00,2025-05-25,22:18,5,4,9
6,2025-05-25T14:19:00+02:00,2025-05-25,22:19,5,2,7
6,2025-05-25T14:20:00+02:00,2025-05-25,22:20,3,0,3
6,2025-05-25T14:21:00+02:00,2025-05-25,22:21,12,3,15
6,2025-05-25T14:23:00+02:00,2025-05-25,22:23,6,4,10
8,2025-05-25T14:10:00+02:00,2025-05-25,22:10,1,0,1
21,2025-05-25T14:15:00+02:00,2025-05-25,22:15,4,18,22
21,2025-05-25T14:20:00+02:00,2025-05-25,22:20,10,15,25
28,2025-05-25T14:14:00+02:00,2025-05-25,22:14,5,1,6
28,2025-05-25T14:20:00+02:00,2025-05-25,22:20,4,0,4
28,2025-05-25T14:21:00+02:00,2025-05-25,22:21,0,2,2
29,2025-05-25T14:10:00+02:00,2025-05-25,22:10,1,3,4
29,2025-05-25T14:20:00+02:00,2025-05-25,22:20,1,2,3
29,2025-05-25T14:21:00+02:00,2025-05-25,22:21,0,3,3
29,2025-05-25T14:24:00+02:00,2025-05-25,22:24,0,1,1
31,2025-05-25T14:12:00+02:00,2025-05-25,22:12,1,4,5
31,2025-05-25T14:18:00+02:00,2025-05-25,22:18,2,2,4
31,2025-05-25T14:24:00+02:00,2025-05-25,22:24,2,1,3
36,2025-05-25T14:12:00+02:00,2025-05-25,22:12,1,2,3
36,2025-05-25T14:13:00+02:00,2025-05-25,22:13,2,0,2
36,2025-05-25T14:14:00+02:00,2025-05-25,22:14,1,3,4
36,2025-05-25T14:15:00+02:00,2025-05-25,22:15,0,1,1
36,2025-05-25T14:16:00+02:00,2025-05-25,22:16,1,1,2
36,2025-05-25T14:19:00+02:00,2025-05-25,22:19,1,1,2
36,2025-05-25T14:21:00+02:00,2025-05-25,22:21,1,0,1
36,2025-05-25T14:23:00+02:00,2025-05-25,22:23,0,3,3
40,2025-05-25T14:12:00+02:00,2025-05-25,22:12,2,0,2
40,2025-05-25T14:18:00+02:00,2025-05-25,22:18,0,1,1
40,2025-05-25T14:21:00+02:00,2025-05-25,22:21,2,0,2
41,2025-05-25T14:14:00+02:00,2025-05-25,22:14,1,2,3
41,2025-05-25T14:17:00+02:00,2025-05-25,22:17,4,0,4
41,2025-05-25T14:23:00+02:00,2025-05-25,22:23,1,0,1
41,2025-05-25T14:24:00+02:00,2025-05-25,22:24,0,1,1
44,2025-05-25T14:10:00+02:00,2025-05-25,22:10,1,6,7
45,2025-05-25T14:11:00+02:00,2025-05-25,22:11,5,5,10
45,2025-05-25T14:13:00+02:00,2025-05-25,22:13,9,4,13
45,2025-05-25T14:14:00+02:00,2025-05-25,22:14,2,9,11
45,2025-05-25T14:15:00+02:00,2025-05-25,22:15,3,2,5
45,2025-05-25T14:19:00+02:00,2025-05-25,22:19,12,2,14
45,2025-05-25T14:21:00+02:00,2025-05-25,22:21,5,2,7
45,2025-05-25T14:23:00+02:00,2025-05-25,22:23,2,4,6
45,2025-05-25T14:24:00+02:00,2025-05-25,22:24,0,1,1
47,2025-05-25T14:12:00+02:00,2025-05-25,22:12,5,2,7
47,2025-05-25T14:13:00+02:00,2025-05-25,22:13,1,1,2
47,2025-05-25T14:14:00+02:00,2025-05-25,22:14,4,1,5
47,2025-05-25T14:16:00+02:00,2025-05-25,22:16,0,5,5
47,2025-05-25T14:18:00+02:00,2025-05-25,22:18,9,3,12
47,2025-05-25T14:20:00+02:00,2025-05-25,22:20,12,3,15
47,2025-05-25T14:22:00+02:00,2025-05-25,22:22,5,1,6
47,2025-05-25T14:23:00+02:00,2025-05-25,22:23,1,0,1
50,2025-05-25T14:17:00+02:00,2025-05-25,22:17,0,2,2
50,2025-05-25T14:18:00+02:00,2025-05-25,22:18,4,0,4
50,2025-05-25T14:21:00+02:00,2025-05-25,22:21,3,0,3
50,2025-05-25T14:23:00+02:00,2025-05-25,22:23,2,0,2
50,2025-05-25T14:24:00+02:00,2025-05-25,22:24,2,0,2
54,2025-05-25T14:11:00+02:00,2025-05-25,22:11,2,0,2
54,2025-05-25T14:13:00+02:00,2025-05-25,22:13,2,1,3
54,2025-05-25T14:19:00+02:00,2025-05-25,22:19,1,2,3
54,2025-05-25T14:24:00+02:00,2025-05-25,22:24,0,5,5
61,2025-05-25T14:17:00+02:00,2025-05-25,22:17,0,3,3
61,2025-05-25T14:24:00+02:00,2025-05-25,22:24,7,0,7
66,2025-05-25T14:10:00+02:00,2025-05-25,22:10,3,12,15
66,2025-05-25T14:15:00+02:00,2025-05-25,22:15,4,7,11
66,2025-05-25T14:19:00+02:00,2025-05-25,22:19,5,1,6
66,2025-05-25T14:24:00+02:00,2025-05-25,22:24,3,6,9
69,2025-05-25T14:11:00+02:00,2025-05-25,22:11,1,0,1
70,2025-05-25T14:11:00+02:00,2025-05-25,22:11,1,1,2
70,2025-05-25T14:14:00+02:00,2025-05-25,22:14,1,1,2
70,2025-05-25T14:15:00+02:00,2025-05-25,22:15,1,0,1
70,2025-05-25T14:16:00+02:00,2025-05-25,22:16,1,0,1
75,2025-05-25T14:23:00+02:00,2025-05-25,22:23,1,0,1
77,2025-05-25T14:10:00+02:00,2025-05-25,22:10,2,1,3
77,2025-05-25T14:20:00+02:00,2025-05-25,22:20,0,3,3
84,2025-05-25T14:20:00+02:00,2025-05-25,22:20,33,28,61
87,2025-05-25T14:22:00+02:00,2025-05-25,22:22,0,2,2
107,2025-05-25T14:10:00+02:00,2025-05-25,22:10,5,1,6
108,2025-05-25T14:12:00+02:00,2025-05-25,22:12,1,3,4
108,2025-05-25T14:14:00+02:00,2025-05-25,22:14,2,1,3
108,2025-05-25T14:15:00+02:00,2025-05-25,22:15,2,2,4
108,2025-05-25T14:16:00+02:00,2025-05-25,22:16,3,1,4
108,2025-05-25T14:17:00+02:00,2025-05-25,22:17,2,3,5
108,2025-05-25T14:20:00+02:00,2025-05-25,22:20,3,0,3
118,2025-05-25T14:20:00+02:00,2025-05-25,22:20,1,0,1
133,2025-05-25T14:20:00+02:00,2025-05-25,22:20,18,11,29
134,2025-05-25T14:10:00+02:00,2025-05-25,22:10,9,12,21
134,2025-05-25T14:20:00+02:00,2025-05-25,22:20,14,9,23
135,2025-05-25T14:15:00+02:00,2025-05-25,22:15,4,12,16
162,2025-05-25T14:10:00+02:00,2025-05-25,22:10,2,7,9
165,2025-05-25T14:10:00+02:00,2025-05-25,22:10,2,0,2
165,2025-05-25T14:20:00+02:00,2025-05-25,22:20,1,0,1
167,2025-05-25T14:15:00+02:00,2025-05-25,22:15,1,1,2
179,2025-05-25T14:15:00+02:00,2025-05-25,22:15,8,3,11
1,2025-05-25T14:12:00+02:00,2025-05-25,22:12,1,3,4
1,2025-05-25T14:13:00+02:00,2025-05-25,22:13,3,0,3
1,2025-05-25T14:18:00+02:00,2025-05-25,22:18,7,2,9
1,2025-05-25T14:23:00+02:00,2025-05-25,22:23,2,2,4
2,2025-05-25T14:11:00+02:00,2025-05-25,22:11,0,4,4
2,2025-05-25T14:13:00+02:00,2025-05-25,22:13,0,1,1
2,2025-05-25T14:15:00+02:00,2025-05-25,22:15,0,1,1
2,2025-05-25T14:17:00+02:00,2025-05-25,22:17,2,4,6
9,2025-05-25T14:15:00+02:00,2025-05-25,22:15,0,2,2
9,2025-05-25T14:20:00+02:00,2025-05-25,22:20,0,1,1
9,2025-05-25T14:21:00+02:00,2025-05-25,22:21,0,1,1
12,2025-05-25T14:14:00+02:00,2025-05-25,22:14,2,0,2
12,2025-05-25T14:16:00+02:00,2025-05-25,22:16,5,1,6
12,2025-05-25T14:24:00+02:00,2025-05-25,22:24,1,0,1
17,2025-05-25T14:14:00+02:00,2025-05-25,22:14,0,1,1
17,2025-05-25T14:16:00+02:00,2025-05-25,22:16,0,1,1
17,2025-05-25T14:19:00+02:00,2025-05-25,22:19,0,1,1
19,2025-05-25T14:14:00+02:00,2025-05-25,22:14,4,3,7
19,2025-05-25T14:15:00+02:00,2025-05-25,22:15,2,7,9
19,2025-05-25T14:16:00+02:00,2025-05-25,22:16,3,1,4
19,2025-05-25T14:17:00+02:00,2025-05-25,22:17,4,1,5
19,2025-05-25T14:21:00+02:00,2025-05-25,22:21,2,6,8
19,2025-05-25T14:22:00+02:00,2025-05-25,22:22,1,0,1
20,2025-05-25T14:12:00+02:00,2025-05-25,22:12,0,1,1
20,2025-05-25T14:13:00+02:00,2025-05-25,22:13,0,1,1
20,2025-05-25T14:16:00+02:00,2025-05-25,22:16,2,0,2
20,2025-05-25T14:17:00+02:00,2025-05-25,22:17,1,7,8
20,2025-05-25T14:21:00+02:00,2025-05-25,22:21,0,1,1
23,2025-05-25T14:18:00+02:00,2025-05-25,22:18,1,5,6
23,2025-05-25T14:19:00+02:00,2025-05-25,22:19,1,6,7
23,2025-05-25T14:22:00+02:00,2025-05-25,22:22,0,2,2
23,2025-05-25T14:23:00+02:00,2025-05-25,22:23,0,3,3
24,2025-05-25T14:15:00+02:00,2025-05-25,22:15,2,2,4
24,2025-05-25T14:18:00+02:00,2025-05-25,22:18,1,5,6
24,2025-05-25T14:19:00+02:00,2025-05-25,22:19,0,3,3
24,2025-05-25T14:23:00+02:00,2025-05-25,22:23,4,6,10
27,2025-05-25T14:18:00+02:00,2025-05-25,22:18,1,3,4
27,2025-05-25T14:20:00+02:00,2025-05-25,22:20,0,3,3
27,2025-05-25T14:24:00+02:00,2025-05-25,22:24,3,0,3
30,2025-05-25T14:10:00+02:00,2025-05-25,22:10,4,3,7
30,2025-05-25T14:11:00+02:00,2025-05-25,22:11,2,1,3
30,2025-05-25T14:12:00+02:00,2025-05-25,22:12,1,4,5
30,2025-05-25T14:13:00+02:00,2025-05-25,22:13,0,2,2
30,2025-05-25T14:17:00+02:00,2025-05-25,22:17,3,4,7
30,2025-05-25T14:18:00+02:00,2025-05-25,22:18,4,6,10
35,2025-05-25T14:11:00+02:00,2025-05-25,22:11,2,9,11
35,2025-05-25T14:17:00+02:00,2025-05-25,22:17,4,6,10
35,2025-05-25T14:19:00+02:00,2025-05-25,22:19,1,7,8
35,2025-05-25T14:22:00+02:00,2025-05-25,22:22,1,1,2
48,2025-05-25T14:10:00+02:00,2025-05-25,22:10,1,0,1
48,2025-05-25T14:11:00+02:00,2025-05-25,22:11,1,0,1
48,2025-05-25T14:14:00+02:00,2025-05-25,22:14,2,1,3
49,2025-05-25T14:11:00+02:00,2025-05-25,22:11,4,5,9
49,2025-05-25T14:16:00+02:00,2025-05-25,22:16,1,1,2
49,2025-05-25T14:17:00+02:00,2025-05-25,22:17,1,0,1
49,2025-05-25T14:19:00+02:00,2025-05-25,22:19,2,4,6
51,2025-05-25T14:15:00+02:00,2025-05-25,22:15,1,0,1
51,2025-05-25T14:19:00+02:00,2025-05-25,22:19,0,1,1
51,2025-05-25T14:22:00+02:00,2025-05-25,22:22,0,1,1
51,2025-05-25T14:24:00+02:00,2025-05-25,22:24,0,2,2
52,2025-05-25T14:15:00+02:00,2025-05-25,22:15,1,1,2
52,2025-05-25T14:19:00+02:00,2025-05-25,22:19,1,0,1
52,2025-05-25T14:20:00+02:00,2025-05-25,22:20,1,2,3
52,2025-05-25T14:24:00+02:00,2025-05-25,22:24,1,0,1
53,2025-05-25T14:16:00+02:00,2025-05-25,22:16,0,1,1
56,2025-05-25T14:12:00+02:00,2025-05-25,22:12,0,2,2
56,2025-05-25T14:13:00+02:00,2025-05-25,22:13,12,1,13
56,2025-05-25T14:15:00+02:00,2025-05-25,22:15,2,3,5
56,2025-05-25T14:16:00+02:00,2025-05-25,22:16,2,5,7
56,2025-05-25T14:17:00+02:00,2025-05-25,22:17,2,8,10
56,2025-05-25T14:22:00+02:00,2025-05-25,22:22,3,4,7
58,2025-05-25T14:11:00+02:00,2025-05-25,22:11,2,2,4
58,2025-05-25T14:14:00+02:00,2025-05-25,22:14,4,1,5
58,2025-05-25T14:17:00+02:00,2025-05-25,22:17,4,3,7
62,2025-05-25T14:10:00+02:00,2025-05-25,22:10,0,2,2
62,2025-05-25T14:16:00+02:00,2025-05-25,22:16,1,3,4
62,2025-05-25T14:17:00+02:00,2025-05-25,22:17,0,2,2
62,2025-05-25T14:19:00+02:00,2025-05-25,22:19,0,1,1
62,2025-05-25T14:20:00+02:00,2025-05-25,22:20,0,1,1
62,2025-05-25T14:21:00+02:00,2025-05-25,22:21,1,2,3
63,2025-05-25T14:10:00+02:00,2025-05-25,22:10,2,0,2
63,2025-05-25T14:11:00+02:00,2025-05-25,22:11,1,3,4
63,2025-05-25T14:20:00+02:00,2025-05-25,22:20,0,1,1
67,2025-05-25T14:10:00+02:00,2025-05-25,22:10,0,3,3
67,2025-05-25T14:14:00+02:00,2025-05-25,22:14,0,3,3
67,2025-05-25T14:17:00+02:00,2025-05-25,22:17,0,1,1
67,2025-05-25T14:21:00+02:00,2025-05-25,22:21,2,0,2
67,2025-05-25T14:22:00+02:00,2025-05-25,22:22,0,2,2
68,2025-05-25T14:15:00+02:00,2025-05-25,22:15,1,0,1
72,2025-05-25T14:11:00+02:00,2025-05-25,22:11,7,1,8
72,2025-05-25T14:23:00+02:00,2025-05-25,22:23,0,1,1
79,2025-05-25T14:13:00+02:00,2025-05-25,22:13,1,8,9
79,2025-05-25T14:14:00+02:00,2025-05-25,22:14,2,2,4
79,2025-05-25T14:15:00+02:00,2025-05-25,22:15,3,1,4
79,2025-05-25T14:21:00+02:00,2025-05-25,22:21,0,1,1
79,2025-05-25T14:22:00+02:00,2025-05-25,22:22,1,3,4
79,2025-05-25T14:24:00+02:00,2025-05-25,22:24,1,3,4
86,2025-05-25T14:11:00+02:00,2025-05-25,22:11,0,2,2
86,2025-05-25T14:13:00+02:00,2025-05-25,22:13,1,0,1
109,2025-05-25T14:10:00+02:00,2025-05-25,22:10,0,8,8
117,2025-05-25T14:15:00+02:00,2025-05-25,22:15,10,4,14
130,2025-05-25T14:15:00+02:00,2025-05-25,22:15,1,0,1
136,2025-05-25T14:10:00+02:00,2025-05-25,22:10,2,0,2
141,2025-05-25T14:10:00+02:00,2025-05-25,22:10,7,11,18
141,2025-05-25T14:20:00+02:00,2025-05-25,22:20,0,22,22
164,2025-05-25T14:10:00+02:00,2025-05-25,22:10,2,8,10
164,2025-05-25T14:15:00+02:00,2025-05-25,22:15,4,2,6
164,2025-05-25T14:20:00+02:00,2025-05-25,22:20,0,1,1
3,2025-05-25T14:25:00+02:00,2025-05-25,22:25,4,5,9
3,2025-05-25T14:29:00+02:00,2025-05-25,22:29,2,6,8
3,2025-05-25T14:30:00+02:00,2025-05-25,22:30,5,2,7
3,2025-05-25T14:31:00+02:00,2025-05-25,22:31,6,2,8
3,2025-05-25T14:35:00+02:00,2025-05-25,22:35,2,5,7
4,2025-05-25T14:26:00+02:00,2025-05-25,22:26,5,5,10
4,2025-05-25T14:32:00+02:00,2025-05-25,22:32,0,5,5
4,2025-05-25T14:33:00+02:00,2025-05-25,22:33,6,6,12
4,2025-05-25T14:34:00+02:00,2025-05-25,22:34,3,0,3
6,2025-05-25T14:27:00+02:00,2025-05-25,22:27,1,0,1
6,2025-05-25T14:29:00+02:00,2025-05-25,22:29,2,3,5
6,2025-05-25T14:33:00+02:00,2025-05-25,22:33,2,4,6
6,2025-05-25T14:38:00+02:00,2025-05-25,22:38,0,1,1
6,2025-05-25T14:39:00+02:00,2025-05-25,22:39,6,2,8
28,2025-05-25T14:29:00+02:00,2025-05-25,22:29,1,2,3
29,2025-05-25T14:25:00+02:00,2025-05-25,22:25,0,2,2
29,2025-05-25T14:30:00+02:00,2025-05-25,22:30,2,1,3
29,2025-05-25T14:38:00+02:00,2025-05-25,22:38,0,3,3
29,2025-05-25T14:39:00+02:00,2025-05-25,22:39,4,0,4
31,2025-05-25T14:32:00+02:00,2025-05-25,22:32,0,1,1
31,2025-05-25T14:34:00+02:00,2025-05-25,22:34,0,1,1
31,2025-05-25T14:36:00+02:00,2025-05-25,22:36,0,2,2
31,2025-05-25T14:37:00+02:00,2025-05-25,22:37,0,3,3
31,2025-05-25T14:38:00+02:00,2025-05-25,22:38,1,0,1
36,2025-05-25T14:35:00+02:00,2025-05-25,22:35,0,2,2
37,2025-05-25T14:27:00+02:00,2025-05-25,22:27,0,1,1
37,2025-05-25T14:29:00+02:00,2025-05-25,22:29,6,0,6
37,2025-05-25T14:35:00+02:00,2025-05-25,22:35,4,2,6
37,2025-05-25T14:39:00+02:00,2025-05-25,22:39,3,0,3
40,2025-05-25T14:28:00+02:00,2025-05-25,22:28,2,4,6
41,2025-05-25T14:28:00+02:00,2025-05-25,22:28,2,2,4
41,2025-05-25T14:29:00+02:00,2025-05-25,22:29,0,3,3
41,2025-05-25T14:34:00+02:00,2025-05-25,22:34,0,1,1
41,2025-05-25T14:35:00+02:00,2025-05-25,22:35,0,1,1
43,2025-05-25T14:30:00+02:00,2025-05-25,22:30,0,2,2
44,2025-05-25T14:25:00+02:00,2025-05-25,22:25,2,0,2
44,2025-05-25T14:35:00+02:00,2025-05-25,22:35,3,1,4
45,2025-05-25T14:26:00+02:00,2025-05-25,22:26,3,1,4
45,2025-05-25T14:29:00+02:00,2025-05-25,22:29,0,6,6
45,2025-05-25T14:33:00+02:00,2025-05-25,22:33,0,8,8
45,2025-05-25T14:34:00+02:00,2025-05-25,22:34,0,3,3
47,2025-05-25T14:26:00+02:00,2025-05-25,22:26,1,1,2
47,2025-05-25T14:28:00+02:00,2025-05-25,22:28,4,2,6
47,2025-05-25T14:29:00+02:00,2025-05-25,22:29,9,4,13
47,2025-05-25T14:30:00+02:00,2025-05-25,22:30,0,4,4
47,2025-05-25T14:31:00+02:00,2025-05-25,22:31,8,2,10
47,2025-05-25T14:32:00+02:00,2025-05-25,22:32,2,0,2
47,2025-05-25T14:37:00+02:00,2025-05-25,22:37,2,1,3
47,2025-05-25T14:39:00+02:00,2025-05-25,22:39,2,2,4
50,2025-05-25T14:25:00+02:00,2025-05-25,22:25,7,0,7
50,2025-05-25T14:30:00+02:00,2025-05-25,22:30,3,0,3
50,2025-05-25T14:31:00+02:00,2025-05-25,22:31,2,0,2
54,2025-05-25T14:29:00+02:00,2025-05-25,22:29,0,3,3
54,2025-05-25T14:37:00+02:00,2025-05-25,22:37,0,1,1
59,2025-05-25T14:25:00+02:00,2025-05-25,22:25,10,9,19
61,2025-05-25T14:25:00+02:00,2025-05-25,22:25,6,0,6
61,2025-05-25T14:26:00+02:00,2025-05-25,22:26,2,1,3
61,2025-05-25T14:31:00+02:00,2025-05-25,22:31,1,2,3
61,2025-05-25T14:34:00+02:00,2025-05-25,22:34,3,1,4
61,2025-05-25T14:35:00+02:00,2025-05-25,22:35,2,0,2
61,2025-05-25T14:38:00+02:00,2025-05-25,22:38,2,1,3
61,2025-05-25T14:39:00+02:00,2025-05-25,22:39,6,1,7
66,2025-05-25T14:28:00+02:00,2025-05-25,22:28,0,7,7
66,2025-05-25T14:35:00+02:00,2025-05-25,22:35,2,16,18
66,2025-05-25T14:36:00+02:00,2025-05-25,22:36,3,1,4
66,2025-05-25T14:38:00+02:00,2025-05-25,22:38,1,0,1
69,2025-05-25T14:25:00+02:00,2025-05-25,22:25,1,0,1
70,2025-05-25T14:31:00+02:00,2025-05-25,22:31,1,0,1
70,2025-05-25T14:35:00+02:00,2025-05-25,22:35,2,0,2
77,2025-05-25T14:35:00+02:00,2025-05-25,22:35,2,2,4
87,2025-05-25T14:32:00+02:00,2025-05-25,22:32,1,0,1
87,2025-05-25T14:38:00+02:00,2025-05-25,22:38,2,0,2
108,2025-05-25T14:26:00+02:00,2025-05-25,22:26,2,2,4
108,2025-05-25T14:28:00+02:00,2025-05-25,22:28,1,0,1
132,2025-05-25T14:25:00+02:00,2025-05-25,22:25,3,6,9
135,2025-05-25T14:30:00+02:00,2025-05-25,22:30,5,2,7
162,2025-05-25T14:25:00+02:00,2025-05-25,22:25,3,4,7
162,2025-05-25T14:30:00+02:00,2025-05-25,22:30,0,7,7
167,2025-05-25T14:25:00+02:00,2025-05-25,22:25,1,1,2
167,2025-05-25T14:35:00+02:00,2025-05-25,22:35,0,4,4
179,2025-05-25T14:35:00+02:00,2025-05-25,22:35,2,6,8
1,2025-05-25T14:33:00+02:00,2025-05-25,22:33,1,0,1
2,2025-05-25T14:25:00+02:00,2025-05-25,22:25,0,2,2
2,2025-05-25T14:26:00+02:00,2025-05-25,22:26,1,2,3
2,2025-05-25T14:33:00+02:00,2025-05-25,22:33,0,1,1
2,2025-05-25T14:37:00+02:00,2025-05-25,22:37,1,0,1
2,2025-05-25T14:38:00+02:00,2025-05-25,22:38,3,2,5
9,2025-05-25T14:26:00+02:00,2025-05-25,22:26,1,0,1
9,2025-05-25T14:30:00+02:00,2025-05-25,22:30,2,0,2
11,2025-05-25T14:30:00+02:00,2025-05-25,22:30,0,2,2
11,2025-05-25T14:35:00+02:00,2025-05-25,22:35,1,0,1
12,2025-05-25T14:30:00+02:00,2025-05-25,22:30,3,0,3
12,2025-05-25T14:32:00+02:00,2025-05-25,22:32,1,0,1
17,2025-05-25T14:25:00+02:00,2025-05-25,22:25,0,2,2
17,2025-05-25T14:26:00+02:00,2025-05-25,22:26,2,0,2
17,2025-05-25T14:37:00+02:00,2025-05-25,22:37,0,2,2
18,2025-05-25T14:29:00+02:00,2025-05-25,22:29,1,0,1
19,2025-05-25T14:29:00+02:00,2025-05-25,22:29,6,1,7
19,2025-05-25T14:35:00+02:00,2025-05-25,22:35,3,5,8
19,2025-05-25T14:39:00+02:00,2025-05-25,22:39,0,4,4
20,2025-05-25T14:31:00+02:00,2025-05-25,22:31,2,3,5
20,2025-05-25T14:34:00+02:00,2025-05-25,22:34,7,0,7
20,2025-05-25T14:37:00+02:00,2025-05-25,22:37,1,5,6
23,2025-05-25T14:29:00+02:00,2025-05-25,22:29,0,1,1
23,2025-05-25T14:33:00+02:00,2025-05-25,22:33,0,7,7
23,2025-05-25T14:36:00+02:00,2025-05-25,22:36,1,1,2
24,2025-05-25T14:28:00+02:00,2025-05-25,22:28,1,4,5
24,2025-05-25T14:30:00+02:00,2025-05-25,22:30,3,2,5
24,2025-05-25T14:31:00+02:00,2025-05-25,22:31,0,2,2
24,2025-05-25T14:32:00+02:00,2025-05-25,22:32,5,4,9
24,2025-05-25T14:34:00+02:00,2025-05-25,22:34,4,1,5
24,2025-05-25T14:36:00+02:00,2025-05-25,22:36,1,2,3
27,2025-05-25T14:30:00+02:00,2025-05-25,22:30,3,0,3
27,2025-05-25T14:35:00+02:00,2025-05-25,22:35,0,1,1
27,2025-05-25T14:39:00+02:00,2025-05-25,22:39,1,0,1
30,2025-05-25T14:25:00+02:00,2025-05-25,22:25,2,4,6
30,2025-05-25T14:26:00+02:00,2025-05-25,22:26,3,2,5
30,2025-05-25T14:27:00+02:00,2025-05-25,22:27,0,4,4
30,2025-05-25T14:29:00+02:00,2025-05-25,22:29,13,9,22
30,2025-05-25T14:30:00+02:00,2025-05-25,22:30,4,5,9
30,2025-05-25T14:31:00+02:00,2025-05-25,22:31,0,2,2
30,2025-05-25T14:34:00+02:00,2025-05-25,22:34,3,3,6
35,2025-05-25T14:25:00+02:00,2025-05-25,22:25,5,1,6
35,2025-05-25T14:26:00+02:00,2025-05-25,22:26,2,6,8
35,2025-05-25T14:27:00+02:00,2025-05-25,22:27,2,2,4
35,2025-05-25T14:30:00+02:00,2025-05-25,22:30,1,0,1
35,2025-05-25T14:33:00+02:00,2025-05-25,22:33,3,3,6
35,2025-05-25T14:35:00+02:00,2025-05-25,22:35,1,0,1
48,2025-05-25T14:26:00+02:00,2025-05-25,22:26,3,1,4
48,2025-05-25T14:29:00+02:00,2025-05-25,22:29,2,1,3
48,2025-05-25T14:33:00+02:00,2025-05-25,22:33,0,3,3
48,2025-05-25T14:39:00+02:00,2025-05-25,22:39,0,2,2
49,2025-05-25T14:25:00+02:00,2025-05-25,22:25,2,2,4
49,2025-05-25T14:26:00+02:00,2025-05-25,22:26,4,3,7
49,2025-05-25T14:27:00+02:00,2025-05-25,22:27,2,0,2
49,2025-05-25T14:28:00+02:00,2025-05-25,22:28,3,2,5
49,2025-05-25T14:32:00+02:00,2025-05-25,22:32,1,1,2
49,2025-05-25T14:33:00+02:00,2025-05-25,22:33,0,3,3
49,2025-05-25T14:34:00+02:00,2025-05-25,22:34,4,0,4
49,2025-05-25T14:35:00+02:00,2025-05-25,22:35,0,3,3
49,2025-05-25T14:36:00+02:00,2025-05-25,22:36,0,1,1
49,2025-05-25T14:37:00+02:00,2025-05-25,22:37,3,0,3
49,2025-05-25T14:39:00+02:00,2025-05-25,22:39,1,2,3
51,2025-05-25T14:29:00+02:00,2025-05-25,22:29,3,0,3
51,2025-05-25T14:34:00+02:00,2025-05-25,22:34,1,0,1
52,2025-05-25T14:27:00+02:00,2025-05-25,22:27,0,3,3
52,2025-05-25T14:30:00+02:00,2025-05-25,22:30,3,0,3
53,2025-05-25T14:28:00+02:00,2025-05-25,22:28,3,1,4
53,2025-05-25T14:33:00+02:00,2025-05-25,22:33,0,1,1
53,2025-05-25T14:39:00+02:00,2025-05-25,22:39,4,0,4
56,2025-05-25T14:28:00+02:00,2025-05-25,22:28,0,1,1
56,2025-05-25T14:29:00+02:00,2025-05-25,22:29,0,1,1
56,2025-05-25T14:33:00+02:00,2025-05-25,22:33,1,3,4
56,2025-05-25T14:36:00+02:00,2025-05-25,22:36,1,4,5
56,2025-05-25T14:38:00+02:00,2025-05-25,22:38,0,1,1
58,2025-05-25T14:25:00+02:00,2025-05-25,22:25,2,0,2
58,2025-05-25T14:27:00+02:00,2025-05-25,22:27,0,1,1
58,2025-05-25T14:28:00+02:00,2025-05-25,22:28,2,10,12
58,2025-05-25T14:29:00+02:00,2025-05-25,22:29,1,8,9
58,2025-05-25T14:34:00+02:00,2025-05-25,22:34,1,5,6
58,2025-05-25T14:35:00+02:00,2025-05-25,22:35,3,0,3
58,2025-05-25T14:36:00+02:00,2025-05-25,22:36,0,1,1
62,2025-05-25T14:25:00+02:00,2025-05-25,22:25,1,2,3
62,2025-05-25T14:33:00+02:00,2025-05-25,22:33,1,1,2
62,2025-05-25T14:34:00+02:00,2025-05-25,22:34,0,1,1
63,2025-05-25T14:25:00+02:00,2025-05-25,22:25,2,7,9
63,2025-05-25T14:29:00+02:00,2025-05-25,22:29,0,2,2
63,2025-05-25T14:32:00+02:00,2025-05-25,22:32,1,0,1
67,2025-05-25T14:32:00+02:00,2025-05-25,22:32,1,1,2
67,2025-05-25T14:38:00+02:00,2025-05-25,22:38,1,2,3
68,2025-05-25T14:33:00+02:00,2025-05-25,22:33,2,1,3
68,2025-05-25T14:34:00+02:00,2025-05-25,22:34,2,1,3
68,2025-05-25T14:35:00+02:00,2025-05-25,22:35,1,1,2
72,2025-05-25T14:29:00+02:00,2025-05-25,22:29,0,2,2
72,2025-05-25T14:38:00+02:00,2025-05-25,22:38,0,1,1
79,2025-05-25T14:30:00+02:00,2025-05-25,22:30,1,3,4
79,2025-05-25T14:37:00+02:00,2025-05-25,22:37,0,3,3
79,2025-05-25T14:39:00+02:00,2025-05-25,22:39,4,0,4
85,2025-05-25T14:28:00+02:00,2025-05-25,22:28,0,1,1
85,2025-05-25T14:29:00+02:00,2025-05-25,22:29,0,2,2
85,2025-05-25T14:30:00+02:00,2025-05-25,22:30,0,1,1
86,2025-05-25T14:31:00+02:00,2025-05-25,22:31,0,1,1
86,2025-05-25T14:32:00+02:00,2025-05-25,22:32,0,1,1
86,2025-05-25T14:35:00+02:00,2025-05-25,22:35,0,1,1
109,2025-05-25T14:30:00+02:00,2025-05-25,22:30,0,4,4
109,2025-05-25T14:35:00+02:00,2025-05-25,22:35,1,2,3
141,2025-05-25T14:30:00+02:00,2025-05-25,22:30,6,3,9
164,2025-05-25T14:30:00+02:00,2025-05-25,22:30,1,2,3
181,2025-05-25T14:27:00+02:00,2025-05-25,22:27,11,6,17
181,2025-05-25T14:35:00+02:00,2025-05-25,22:35,6,4,10
181,2025-05-25T14:37:00+02:00,2025-05-25,22:37,3,0,3
181,2025-05-25T14:38:00+02:00,2025-05-25,22:38,9,9,18
181,2025-05-25T14:39:00+02:00,2025-05-25,22:39,12,5,17
181,2025-05-25T14:13:00+02:00,2025-05-25,22:13,5,8,13
181,2025-05-25T14:14:00+02:00,2025-05-25,22:14,7,9,16
181,2025-05-25T14:15:00+02:00,2025-05-25,22:15,4,5,9
181,2025-05-25T14:18:00+02:00,2025-05-25,22:18,5,7,12
181,2025-05-25T14:20:00+02:00,2025-05-25,22:20,11,1,12
181,2025-05-25T14:23:00+02:00,2025-05-25,22:23,9,7,16
182,2025-05-25T14:15:00+02:00,2025-05-25,22:15,13,4,17
182,2025-05-25T14:20:00+02:00,2025-05-25,22:20,7,11,18
181,2025-05-25T14:41:00+02:00,2025-05-25,22:41,12,8,20
181,2025-05-25T14:43:00+02:00,2025-05-25,22:43,9,2,11
181,2025-05-25T14:44:00+02:00,2025-05-25,22:44,2,12,14
181,2025-05-25T14:47:00+02:00,2025-05-25,22:47,9,10,19
181,2025-05-25T14:53:00+02:00,2025-05-25,22:53,8,4,12
182,2025-05-25T14:40:00+02:00,2025-05-25,22:40,9,10,19
182,2025-05-25T14:45:00+02:00,2025-05-25,22:45,8,12,20
3,2025-05-25T14:54:00+02:00,2025-05-25,22:54,5,7,12
4,2025-05-25T14:41:00+02:00,2025-05-25,22:41,3,4,7
4,2025-05-25T14:46:00+02:00,2025-05-25,22:46,0,3,3
4,2025-05-25T14:49:00+02:00,2025-05-25,22:49,1,2,3
4,2025-05-25T14:50:00+02:00,2025-05-25,22:50,0,9,9
6,2025-05-25T14:46:00+02:00,2025-05-25,22:46,3,2,5
6,2025-05-25T14:48:00+02:00,2025-05-25,22:48,2,1,3
6,2025-05-25T14:52:00+02:00,2025-05-25,22:52,3,1,4
6,2025-05-25T14:53:00+02:00,2025-05-25,22:53,2,2,4
21,2025-05-25T14:45:00+02:00,2025-05-25,22:45,10,10,20
21,2025-05-25T14:50:00+02:00,2025-05-25,22:50,5,14,19
28,2025-05-25T14:42:00+02:00,2025-05-25,22:42,2,0,2
28,2025-05-25T14:47:00+02:00,2025-05-25,22:47,3,0,3
28,2025-05-25T14:52:00+02:00,2025-05-25,22:52,1,0,1
29,2025-05-25T14:47:00+02:00,2025-05-25,22:47,0,1,1
29,2025-05-25T14:50:00+02:00,2025-05-25,22:50,2,0,2
31,2025-05-25T14:41:00+02:00,2025-05-25,22:41,0,1,1
31,2025-05-25T14:44:00+02:00,2025-05-25,22:44,1,2,3
31,2025-05-25T14:47:00+02:00,2025-05-25,22:47,0,2,2
31,2025-05-25T14:48:00+02:00,2025-05-25,22:48,0,3,3
36,2025-05-25T14:40:00+02:00,2025-05-25,22:40,1,0,1
36,2025-05-25T14:53:00+02:00,2025-05-25,22:53,0,1,1
36,2025-05-25T14:54:00+02:00,2025-05-25,22:54,0,2,2
37,2025-05-25T14:48:00+02:00,2025-05-25,22:48,15,0,15
37,2025-05-25T14:50:00+02:00,2025-05-25,22:50,1,0,1
37,2025-05-25T14:52:00+02:00,2025-05-25,22:52,1,0,1
40,2025-05-25T14:52:00+02:00,2025-05-25,22:52,0,1,1
41,2025-05-25T14:42:00+02:00,2025-05-25,22:42,1,0,1
41,2025-05-25T14:53:00+02:00,2025-05-25,22:53,0,5,5
43,2025-05-25T14:40:00+02:00,2025-05-25,22:40,4,0,4
44,2025-05-25T14:40:00+02:00,2025-05-25,22:40,3,0,3
45,2025-05-25T14:42:00+02:00,2025-05-25,22:42,0,5,5
45,2025-05-25T14:47:00+02:00,2025-05-25,22:47,0,2,2
45,2025-05-25T14:53:00+02:00,2025-05-25,22:53,0,2,2
45,2025-05-25T14:54:00+02:00,2025-05-25,22:54,2,7,9
47,2025-05-25T14:48:00+02:00,2025-05-25,22:48,3,1,4
47,2025-05-25T14:53:00+02:00,2025-05-25,22:53,0,1,1
47,2025-05-25T14:54:00+02:00,2025-05-25,22:54,8,4,12
50,2025-05-25T14:44:00+02:00,2025-05-25,22:44,0,1,1
54,2025-05-25T14:49:00+02:00,2025-05-25,22:49,0,2,2
54,2025-05-25T14:53:00+02:00,2025-05-25,22:53,2,1,3
59,2025-05-25T14:45:00+02:00,2025-05-25,22:45,6,16,22
61,2025-05-25T14:43:00+02:00,2025-05-25,22:43,4,3,7
61,2025-05-25T14:44:00+02:00,2025-05-25,22:44,1,0,1
61,2025-05-25T14:45:00+02:00,2025-05-25,22:45,1,0,1
66,2025-05-25T14:40:00+02:00,2025-05-25,22:40,3,3,6
66,2025-05-25T14:42:00+02:00,2025-05-25,22:42,2,1,3
66,2025-05-25T14:43:00+02:00,2025-05-25,22:43,6,4,10
66,2025-05-25T14:44:00+02:00,2025-05-25,22:44,4,1,5
66,2025-05-25T14:48:00+02:00,2025-05-25,22:48,5,2,7
66,2025-05-25T14:49:00+02:00,2025-05-25,22:49,11,1,12
66,2025-05-25T14:50:00+02:00,2025-05-25,22:50,11,4,15
66,2025-05-25T14:54:00+02:00,2025-05-25,22:54,1,4,5
70,2025-05-25T14:44:00+02:00,2025-05-25,22:44,0,1,1
70,2025-05-25T14:50:00+02:00,2025-05-25,22:50,1,0,1
71,2025-05-25T14:48:00+02:00,2025-05-25,22:48,0,2,2
77,2025-05-25T14:45:00+02:00,2025-05-25,22:45,1,4,5
78,2025-05-25T14:44:00+02:00,2025-05-25,22:44,0,1,1
84,2025-05-25T14:45:00+02:00,2025-05-25,22:45,21,18,39
84,2025-05-25T14:50:00+02:00,2025-05-25,22:50,21,12,33
87,2025-05-25T14:45:00+02:00,2025-05-25,22:45,1,0,1
107,2025-05-25T14:45:00+02:00,2025-05-25,22:45,2,4,6
108,2025-05-25T14:41:00+02:00,2025-05-25,22:41,4,0,4
108,2025-05-25T14:51:00+02:00,2025-05-25,22:51,1,2,3
108,2025-05-25T14:54:00+02:00,2025-05-25,22:54,2,0,2
118,2025-05-25T14:40:00+02:00,2025-05-25,22:40,0,1,1
132,2025-05-25T14:40:00+02:00,2025-05-25,22:40,5,7,12
132,2025-05-25T14:45:00+02:00,2025-05-25,22:45,5,6,11
132,2025-05-25T14:50:00+02:00,2025-05-25,22:50,6,5,11
133,2025-05-25T14:40:00+02:00,2025-05-25,22:40,12,1,13
134,2025-05-25T14:40:00+02:00,2025-05-25,22:40,11,5,16
162,2025-05-25T14:45:00+02:00,2025-05-25,22:45,0,2,2
165,2025-05-25T14:45:00+02:00,2025-05-25,22:45,2,0,2
167,2025-05-25T14:40:00+02:00,2025-05-25,22:40,0,1,1
167,2025-05-25T14:50:00+02:00,2025-05-25,22:50,0,1,1
179,2025-05-25T14:45:00+02:00,2025-05-25,22:45,1,1,2
1,2025-05-25T14:43:00+02:00,2025-05-25,22:43,1,1,2
1,2025-05-25T14:46:00+02:00,2025-05-25,22:46,3,2,5
1,2025-05-25T14:51:00+02:00,2025-05-25,22:51,1,2,3
1,2025-05-25T14:52:00+02:00,2025-05-25,22:52,2,3,5
2,2025-05-25T14:41:00+02:00,2025-05-25,22:41,0,1,1
2,2025-05-25T14:47:00+02:00,2025-05-25,22:47,0,2,2
2,2025-05-25T14:48:00+02:00,2025-05-25,22:48,1,1,2
2,2025-05-25T14:53:00+02:00,2025-05-25,22:53,0,1,1
2,2025-05-25T14:54:00+02:00,2025-05-25,22:54,0,2,2
11,2025-05-25T14:40:00+02:00,2025-05-25,22:40,1,1,2
11,2025-05-25T14:45:00+02:00,2025-05-25,22:45,0,1,1
12,2025-05-25T14:44:00+02:00,2025-05-25,22:44,2,1,3
12,2025-05-25T14:47:00+02:00,2025-05-25,22:47,1,2,3
12,2025-05-25T14:48:00+02:00,2025-05-25,22:48,0,1,1
12,2025-05-25T14:50:00+02:00,2025-05-25,22:50,0,6,6
17,2025-05-25T14:43:00+02:00,2025-05-25,22:43,0,1,1
18,2025-05-25T14:42:00+02:00,2025-05-25,22:42,1,0,1
19,2025-05-25T14:44:00+02:00,2025-05-25,22:44,0,5,5
19,2025-05-25T14:46:00+02:00,2025-05-25,22:46,2,0,2
19,2025-05-25T14:51:00+02:00,2025-05-25,22:51,3,3,6
20,2025-05-25T14:40:00+02:00,2025-05-25,22:40,1,0,1
20,2025-05-25T14:43:00+02:00,2025-05-25,22:43,0,3,3
20,2025-05-25T14:46:00+02:00,2025-05-25,22:46,9,4,13
20,2025-05-25T14:50:00+02:00,2025-05-25,22:50,4,2,6
20,2025-05-25T14:52:00+02:00,2025-05-25,22:52,6,3,9
20,2025-05-25T14:53:00+02:00,2025-05-25,22:53,7,5,12
24,2025-05-25T14:46:00+02:00,2025-05-25,22:46,2,0,2
24,2025-05-25T14:51:00+02:00,2025-05-25,22:51,0,1,1
27,2025-05-25T14:41:00+02:00,2025-05-25,22:41,1,0,1
27,2025-05-25T14:47:00+02:00,2025-05-25,22:47,0,1,1
27,2025-05-25T14:48:00+02:00,2025-05-25,22:48,0,1,1
27,2025-05-25T14:50:00+02:00,2025-05-25,22:50,0,1,1
27,2025-05-25T14:53:00+02:00,2025-05-25,22:53,1,0,1
30,2025-05-25T14:40:00+02:00,2025-05-25,22:40,1,11,12
30,2025-05-25T14:41:00+02:00,2025-05-25,22:41,3,6,9
30,2025-05-25T14:46:00+02:00,2025-05-25,22:46,2,1,3
30,2025-05-25T14:47:00+02:00,2025-05-25,22:47,0,5,5
30,2025-05-25T14:48:00+02:00,2025-05-25,22:48,10,4,14
35,2025-05-25T14:41:00+02:00,2025-05-25,22:41,0,1,1
35,2025-05-25T14:54:00+02:00,2025-05-25,22:54,7,3,10
48,2025-05-25T14:43:00+02:00,2025-05-25,22:43,1,0,1
48,2025-05-25T14:50:00+02:00,2025-05-25,22:50,0,2,2
48,2025-05-25T14:52:00+02:00,2025-05-25,22:52,1,2,3
48,2025-05-25T14:54:00+02:00,2025-05-25,22:54,0,1,1
49,2025-05-25T14:40:00+02:00,2025-05-25,22:40,2,0,2
49,2025-05-25T14:41:00+02:00,2025-05-25,22:41,0,1,1
49,2025-05-25T14:42:00+02:00,2025-05-25,22:42,7,4,11
49,2025-05-25T14:47:00+02:00,2025-05-25,22:47,1,3,4
49,2025-05-25T14:49:00+02:00,2025-05-25,22:49,2,3,5
49,2025-05-25T14:51:00+02:00,2025-05-25,22:51,0,1,1
51,2025-05-25T14:41:00+02:00,2025-05-25,22:41,1,1,2
51,2025-05-25T14:42:00+02:00,2025-05-25,22:42,2,1,3
51,2025-05-25T14:45:00+02:00,2025-05-25,22:45,1,1,2
51,2025-05-25T14:46:00+02:00,2025-05-25,22:46,1,2,3
51,2025-05-25T14:50:00+02:00,2025-05-25,22:50,4,0,4
51,2025-05-25T14:52:00+02:00,2025-05-25,22:52,2,0,2
51,2025-05-25T14:54:00+02:00,2025-05-25,22:54,1,2,3
52,2025-05-25T14:47:00+02:00,2025-05-25,22:47,3,4,7
52,2025-05-25T14:51:00+02:00,2025-05-25,22:51,0,2,2
52,2025-05-25T14:52:00+02:00,2025-05-25,22:52,0,3,3
53,2025-05-25T14:45:00+02:00,2025-05-25,22:45,0,2,2
56,2025-05-25T14:42:00+02:00,2025-05-25,22:42,0,3,3
56,2025-05-25T14:45:00+02:00,2025-05-25,22:45,4,2,6
56,2025-05-25T14:46:00+02:00,2025-05-25,22:46,1,3,4
56,2025-05-25T14:47:00+02:00,2025-05-25,22:47,3,4,7
56,2025-05-25T14:52:00+02:00,2025-05-25,22:52,0,1,1
56,2025-05-25T14:54:00+02:00,2025-05-25,22:54,0,2,2
58,2025-05-25T14:40:00+02:00,2025-05-25,22:40,0,1,1
58,2025-05-25T14:47:00+02:00,2025-05-25,22:47,6,0,6
58,2025-05-25T14:49:00+02:00,2025-05-25,22:49,2,2,4
58,2025-05-25T14:53:00+02:00,2025-05-25,22:53,1,1,2
62,2025-05-25T14:45:00+02:00,2025-05-25,22:45,0,2,2
62,2025-05-25T14:49:00+02:00,2025-05-25,22:49,3,3,6
62,2025-05-25T14:50:00+02:00,2025-05-25,22:50,2,1,3
62,2025-05-25T14:54:00+02:00,2025-05-25,22:54,4,2,6
63,2025-05-25T14:49:00+02:00,2025-05-25,22:49,0,1,1
67,2025-05-25T14:41:00+02:00,2025-05-25,22:41,2,0,2
67,2025-05-25T14:45:00+02:00,2025-05-25,22:45,1,0,1
67,2025-05-25T14:48:00+02:00,2025-05-25,22:48,0,2,2
67,2025-05-25T14:49:00+02:00,2025-05-25,22:49,1,2,3
67,2025-05-25T14:50:00+02:00,2025-05-25,22:50,0,1,1
67,2025-05-25T14:51:00+02:00,2025-05-25,22:51,0,1,1
68,2025-05-25T14:53:00+02:00,2025-05-25,22:53,1,0,1
72,2025-05-25T14:41:00+02:00,2025-05-25,22:41,0,1,1
79,2025-05-25T14:44:00+02:00,2025-05-25,22:44,0,2,2
79,2025-05-25T14:45:00+02:00,2025-05-25,22:45,1,0,1
79,2025-05-25T14:46:00+02:00,2025-05-25,22:46,1,2,3
79,2025-05-25T14:50:00+02:00,2025-05-25,22:50,2,3,5
79,2025-05-25T14:52:00+02:00,2025-05-25,22:52,1,2,3
79,2025-05-25T14:53:00+02:00,2025-05-25,22:53,1,3,4
117,2025-05-25T14:45:00+02:00,2025-05-25,22:45,6,6,12
3,2025-05-25T14:58:00+02:00,2025-05-25,22:58,4,2,6
3,2025-05-25T14:59:00+02:00,2025-05-25,22:59,0,1,1
3,2025-05-25T15:01:00+02:00,2025-05-25,23:01,2,4,6
3,2025-05-25T15:04:00+02:00,2025-05-25,23:04,4,0,4
3,2025-05-25T15:08:00+02:00,2025-05-25,23:08,0,1,1
3,2025-05-25T15:10:00+02:00,2025-05-25,23:10,7,8,15
3,2025-05-25T15:12:00+02:00,2025-05-25,23:12,1,3,4
3,2025-05-25T15:13:00+02:00,2025-05-25,23:13,1,2,3
3,2025-05-25T15:14:00+02:00,2025-05-25,23:14,6,1,7
3,2025-05-25T15:16:00+02:00,2025-05-25,23:16,0,4,4
3,2025-05-25T15:19:00+02:00,2025-05-25,23:19,2,0,2
3,2025-05-25T15:25:00+02:00,2025-05-25,23:25,0,1,1
3,2025-05-25T15:26:00+02:00,2025-05-25,23:26,3,2,5
3,2025-05-25T15:27:00+02:00,2025-05-25,23:27,2,0,2
3,2025-05-25T15:32:00+02:00,2025-05-25,23:32,3,3,6
3,2025-05-25T15:35:00+02:00,2025-05-25,23:35,1,4,5
3,2025-05-25T15:36:00+02:00,2025-05-25,23:36,3,3,6
3,2025-05-25T15:39:00+02:00,2025-05-25,23:39,3,1,4
3,2025-05-25T15:50:00+02:00,2025-05-25,23:50,1,6,7
3,2025-05-25T15:52:00+02:00,2025-05-25,23:52,1,2,3
3,2025-05-25T15:53:00+02:00,2025-05-25,23:53,4,2,6
4,2025-05-25T14:57:00+02:00,2025-05-25,22:57,0,2,2
4,2025-05-25T14:59:00+02:00,2025-05-25,22:59,4,2,6
4,2025-05-25T15:00:00+02:00,2025-05-25,23:00,2,3,5
4,2025-05-25T15:01:00+02:00,2025-05-25,23:01,0,13,13
4,2025-05-25T15:04:00+02:00,2025-05-25,23:04,4,4,8
4,2025-05-25T15:07:00+02:00,2025-05-25,23:07,1,6,7
4,2025-05-25T15:08:00+02:00,2025-05-25,23:08,1,1,2
4,2025-05-25T15:09:00+02:00,2025-05-25,23:09,1,9,10
4,2025-05-25T15:11:00+02:00,2025-05-25,23:11,0,1,1
4,2025-05-25T15:13:00+02:00,2025-05-25,23:13,1,2,3
4,2025-05-25T15:17:00+02:00,2025-05-25,23:17,5,2,7
4,2025-05-25T15:18:00+02:00,2025-05-25,23:18,4,1,5
4,2025-05-25T15:20:00+02:00,2025-05-25,23:20,3,3,6
4,2025-05-25T15:21:00+02:00,2025-05-25,23:21,2,0,2
4,2025-05-25T15:22:00+02:00,2025-05-25,23:22,1,2,3
4,2025-05-25T15:34:00+02:00,2025-05-25,23:34,3,2,5
4,2025-05-25T15:36:00+02:00,2025-05-25,23:36,1,2,3
4,2025-05-25T15:44:00+02:00,2025-05-25,23:44,0,2,2
4,2025-05-25T15:52:00+02:00,2025-05-25,23:52,3,1,4
4,2025-05-25T15:54:00+02:00,2025-05-25,23:54,0,1,1
5,2025-05-25T14:55:00+02:00,2025-05-25,22:55,3,7,10
5,2025-05-25T15:20:00+02:00,2025-05-25,23:20,8,9,17
5,2025-05-25T15:40:00+02:00,2025-05-25,23:40,0,3,3
6,2025-05-25T15:00:00+02:00,2025-05-25,23:00,0,1,1
6,2025-05-25T15:01:00+02:00,2025-05-25,23:01,7,1,8
6,2025-05-25T15:02:00+02:00,2025-05-25,23:02,6,3,9
6,2025-05-25T15:12:00+02:00,2025-05-25,23:12,2,1,3
6,2025-05-25T15:15:00+02:00,2025-05-25,23:15,5,1,6
6,2025-05-25T15:18:00+02:00,2025-05-25,23:18,8,0,8
6,2025-05-25T15:19:00+02:00,2025-05-25,23:19,2,8,10
6,2025-05-25T15:21:00+02:00,2025-05-25,23:21,0,3,3
6,2025-05-25T15:23:00+02:00,2025-05-25,23:23,3,0,3
6,2025-05-25T15:24:00+02:00,2025-05-25,23:24,3,1,4
6,2025-05-25T15:26:00+02:00,2025-05-25,23:26,2,1,3
6,2025-05-25T15:28:00+02:00,2025-05-25,23:28,1,1,2
6,2025-05-25T15:31:00+02:00,2025-05-25,23:31,2,1,3
6,2025-05-25T15:36:00+02:00,2025-05-25,23:36,4,3,7
6,2025-05-25T15:37:00+02:00,2025-05-25,23:37,1,2,3
6,2025-05-25T15:44:00+02:00,2025-05-25,23:44,0,3,3
6,2025-05-25T15:51:00+02:00,2025-05-25,23:51,9,0,9
8,2025-05-25T14:58:00+02:00,2025-05-25,22:58,0,1,1
8,2025-05-25T15:05:00+02:00,2025-05-25,23:05,1,0,1
8,2025-05-25T15:38:00+02:00,2025-05-25,23:38,0,1,1
21,2025-05-25T15:05:00+02:00,2025-05-25,23:05,18,14,32
21,2025-05-25T15:15:00+02:00,2025-05-25,23:15,4,11,15
28,2025-05-25T15:02:00+02:00,2025-05-25,23:02,1,0,1
28,2025-05-25T15:14:00+02:00,2025-05-25,23:14,2,1,3
28,2025-05-25T15:21:00+02:00,2025-05-25,23:21,6,0,6
28,2025-05-25T15:22:00+02:00,2025-05-25,23:22,0,4,4
28,2025-05-25T15:40:00+02:00,2025-05-25,23:40,2,0,2
28,2025-05-25T15:47:00+02:00,2025-05-25,23:47,2,0,2
29,2025-05-25T14:57:00+02:00,2025-05-25,22:57,0,1,1
29,2025-05-25T15:01:00+02:00,2025-05-25,23:01,0,3,3
29,2025-05-25T15:02:00+02:00,2025-05-25,23:02,0,2,2
29,2025-05-25T15:10:00+02:00,2025-05-25,23:10,0,2,2
29,2025-05-25T15:20:00+02:00,2025-05-25,23:20,1,0,1
29,2025-05-25T15:33:00+02:00,2025-05-25,23:33,2,0,2
29,2025-05-25T15:43:00+02:00,2025-05-25,23:43,0,2,2
29,2025-05-25T15:53:00+02:00,2025-05-25,23:53,0,1,1
31,2025-05-25T14:57:00+02:00,2025-05-25,22:57,2,4,6
31,2025-05-25T15:07:00+02:00,2025-05-25,23:07,0,1,1
31,2025-05-25T15:22:00+02:00,2025-05-25,23:22,0,3,3
31,2025-05-25T15:37:00+02:00,2025-05-25,23:37,0,2,2
31,2025-05-25T15:39:00+02:00,2025-05-25,23:39,2,2,4
31,2025-05-25T15:47:00+02:00,2025-05-25,23:47,1,1,2
36,2025-05-25T14:57:00+02:00,2025-05-25,22:57,6,0,6
36,2025-05-25T14:58:00+02:00,2025-05-25,22:58,2,0,2
36,2025-05-25T15:02:00+02:00,2025-05-25,23:02,0,1,1
36,2025-05-25T15:22:00+02:00,2025-05-25,23:22,3,0,3
36,2025-05-25T15:28:00+02:00,2025-05-25,23:28,1,1,2
37,2025-05-25T14:57:00+02:00,2025-05-25,22:57,3,2,5
37,2025-05-25T15:08:00+02:00,2025-05-25,23:08,2,0,2
37,2025-05-25T15:09:00+02:00,2025-05-25,23:09,1,1,2
37,2025-05-25T15:22:00+02:00,2025-05-25,23:22,0,2,2
37,2025-05-25T15:25:00+02:00,2025-05-25,23:25,1,0,1
37,2025-05-25T15:29:00+02:00,2025-05-25,23:29,0,1,1
37,2025-05-25T15:32:00+02:00,2025-05-25,23:32,2,1,3
37,2025-05-25T15:54:00+02:00,2025-05-25,23:54,0,1,1
39,2025-05-25T15:47:00+02:00,2025-05-25,23:47,1,0,1
40,2025-05-25T14:56:00+02:00,2025-05-25,22:56,1,0,1
40,2025-05-25T14:57:00+02:00,2025-05-25,22:57,1,0,1
40,2025-05-25T15:01:00+02:00,2025-05-25,23:01,2,2,4
40,2025-05-25T15:10:00+02:00,2025-05-25,23:10,0,2,2
41,2025-05-25T14:55:00+02:00,2025-05-25,22:55,0,1,1
41,2025-05-25T14:58:00+02:00,2025-05-25,22:58,3,3,6
41,2025-05-25T14:59:00+02:00,2025-05-25,22:59,2,3,5
41,2025-05-25T15:00:00+02:00,2025-05-25,23:00,1,0,1
41,2025-05-25T15:03:00+02:00,2025-05-25,23:03,0,1,1
41,2025-05-25T15:08:00+02:00,2025-05-25,23:08,5,1,6
41,2025-05-25T15:17:00+02:00,2025-05-25,23:17,6,1,7
41,2025-05-25T15:23:00+02:00,2025-05-25,23:23,1,4,5
41,2025-05-25T15:25:00+02:00,2025-05-25,23:25,2,0,2
41,2025-05-25T15:30:00+02:00,2025-05-25,23:30,0,1,1
41,2025-05-25T15:35:00+02:00,2025-05-25,23:35,3,7,10
41,2025-05-25T15:38:00+02:00,2025-05-25,23:38,1,2,3
41,2025-05-25T15:39:00+02:00,2025-05-25,23:39,0,1,1
41,2025-05-25T15:42:00+02:00,2025-05-25,23:42,0,2,2
41,2025-05-25T15:47:00+02:00,2025-05-25,23:47,2,3,5
41,2025-05-25T15:51:00+02:00,2025-05-25,23:51,0,1,1
41,2025-05-25T15:52:00+02:00,2025-05-25,23:52,0,2,2
41,2025-05-25T15:53:00+02:00,2025-05-25,23:53,5,6,11
41,2025-05-25T15:55:00+02:00,2025-05-25,23:55,1,2,3
43,2025-05-25T15:05:00+02:00,2025-05-25,23:05,1,2,3
43,2025-05-25T15:30:00+02:00,2025-05-25,23:30,1,0,1
43,2025-05-25T15:35:00+02:00,2025-05-25,23:35,0,2,2
43,2025-05-25T15:45:00+02:00,2025-05-25,23:45,0,1,1
44,2025-05-25T14:55:00+02:00,2025-05-25,22:55,1,0,1
44,2025-05-25T15:10:00+02:00,2025-05-25,23:10,0,1,1
44,2025-05-25T15:15:00+02:00,2025-05-25,23:15,1,0,1
44,2025-05-25T15:30:00+02:00,2025-05-25,23:30,2,1,3
45,2025-05-25T14:55:00+02:00,2025-05-25,22:55,1,7,8
45,2025-05-25T14:58:00+02:00,2025-05-25,22:58,2,2,4
45,2025-05-25T14:59:00+02:00,2025-05-25,22:59,2,1,3
45,2025-05-25T15:00:00+02:00,2025-05-25,23:00,2,4,6
45,2025-05-25T15:01:00+02:00,2025-05-25,23:01,0,5,5
45,2025-05-25T15:03:00+02:00,2025-05-25,23:03,2,3,5
45,2025-05-25T15:06:00+02:00,2025-05-25,23:06,3,5,8
45,2025-05-25T15:11:00+02:00,2025-05-25,23:11,1,1,2
45,2025-05-25T15:12:00+02:00,2025-05-25,23:12,0,6,6
45,2025-05-25T15:14:00+02:00,2025-05-25,23:14,0,2,2
45,2025-05-25T15:16:00+02:00,2025-05-25,23:16,2,2,4
45,2025-05-25T15:20:00+02:00,2025-05-25,23:20,0,1,1
45,2025-05-25T15:21:00+02:00,2025-05-25,23:21,1,3,4
45,2025-05-25T15:24:00+02:00,2025-05-25,23:24,1,12,13
45,2025-05-25T15:34:00+02:00,2025-05-25,23:34,0,2,2
45,2025-05-25T15:38:00+02:00,2025-05-25,23:38,0,1,1
45,2025-05-25T15:39:00+02:00,2025-05-25,23:39,0,1,1
45,2025-05-25T15:40:00+02:00,2025-05-25,23:40,1,2,3
45,2025-05-25T15:41:00+02:00,2025-05-25,23:41,0,1,1
45,2025-05-25T15:46:00+02:00,2025-05-25,23:46,0,1,1
45,2025-05-25T15:49:00+02:00,2025-05-25,23:49,0,1,1
45,2025-05-25T15:52:00+02:00,2025-05-25,23:52,2,3,5
45,2025-05-25T15:53:00+02:00,2025-05-25,23:53,0,1,1
47,2025-05-25T15:04:00+02:00,2025-05-25,23:04,3,0,3
47,2025-05-25T15:10:00+02:00,2025-05-25,23:10,0,1,1
47,2025-05-25T15:13:00+02:00,2025-05-25,23:13,3,4,7
47,2025-05-25T15:14:00+02:00,2025-05-25,23:14,0,2,2
47,2025-05-25T15:15:00+02:00,2025-05-25,23:15,1,3,4
47,2025-05-25T15:18:00+02:00,2025-05-25,23:18,2,1,3
47,2025-05-25T15:20:00+02:00,2025-05-25,23:20,1,0,1
47,2025-05-25T15:21:00+02:00,2025-05-25,23:21,0,1,1
47,2025-05-25T15:23:00+02:00,2025-05-25,23:23,0,4,4
47,2025-05-25T15:30:00+02:00,2025-05-25,23:30,1,0,1
47,2025-05-25T15:35:00+02:00,2025-05-25,23:35,0,1,1
47,2025-05-25T15:36:00+02:00,2025-05-25,23:36,0,1,1
47,2025-05-25T15:37:00+02:00,2025-05-25,23:37,1,2,3
47,2025-05-25T15:44:00+02:00,2025-05-25,23:44,0,3,3
47,2025-05-25T15:45:00+02:00,2025-05-25,23:45,0,1,1
47,2025-05-25T15:46:00+02:00,2025-05-25,23:46,1,0,1
47,2025-05-25T15:47:00+02:00,2025-05-25,23:47,2,0,2
50,2025-05-25T15:10:00+02:00,2025-05-25,23:10,1,0,1
50,2025-05-25T15:34:00+02:00,2025-05-25,23:34,2,0,2
50,2025-05-25T15:52:00+02:00,2025-05-25,23:52,1,0,1
54,2025-05-25T15:02:00+02:00,2025-05-25,23:02,3,5,8
54,2025-05-25T15:05:00+02:00,2025-05-25,23:05,1,1,2
54,2025-05-25T15:07:00+02:00,2025-05-25,23:07,0,2,2
54,2025-05-25T15:10:00+02:00,2025-05-25,23:10,1,0,1
54,2025-05-25T15:11:00+02:00,2025-05-25,23:11,1,1,2
54,2025-05-25T15:12:00+02:00,2025-05-25,23:12,0,1,1
54,2025-05-25T15:22:00+02:00,2025-05-25,23:22,1,1,2
54,2025-05-25T15:50:00+02:00,2025-05-25,23:50,1,2,3
59,2025-05-25T15:00:00+02:00,2025-05-25,23:00,2,3,5
59,2025-05-25T15:10:00+02:00,2025-05-25,23:10,6,5,11
59,2025-05-25T15:20:00+02:00,2025-05-25,23:20,0,6,6
59,2025-05-25T15:30:00+02:00,2025-05-25,23:30,5,2,7
59,2025-05-25T15:45:00+02:00,2025-05-25,23:45,5,2,7
59,2025-05-25T15:50:00+02:00,2025-05-25,23:50,9,2,11
61,2025-05-25T14:58:00+02:00,2025-05-25,22:58,1,1,2
61,2025-05-25T14:59:00+02:00,2025-05-25,22:59,0,1,1
61,2025-05-25T15:01:00+02:00,2025-05-25,23:01,0,1,1
61,2025-05-25T15:04:00+02:00,2025-05-25,23:04,3,3,6
61,2025-05-25T15:05:00+02:00,2025-05-25,23:05,1,0,1
61,2025-05-25T15:09:00+02:00,2025-05-25,23:09,1,0,1
61,2025-05-25T15:12:00+02:00,2025-05-25,23:12,0,1,1
61,2025-05-25T15:15:00+02:00,2025-05-25,23:15,1,0,1
61,2025-05-25T15:20:00+02:00,2025-05-25,23:20,2,0,2
61,2025-05-25T15:24:00+02:00,2025-05-25,23:24,1,0,1
61,2025-05-25T15:27:00+02:00,2025-05-25,23:27,1,0,1
61,2025-05-25T15:30:00+02:00,2025-05-25,23:30,2,0,2
61,2025-05-25T15:35:00+02:00,2025-05-25,23:35,2,1,3
61,2025-05-25T15:38:00+02:00,2025-05-25,23:38,4,1,5
61,2025-05-25T15:40:00+02:00,2025-05-25,23:40,5,0,5
61,2025-05-25T15:43:00+02:00,2025-05-25,23:43,2,0,2
61,2025-05-25T15:44:00+02:00,2025-05-25,23:44,2,0,2
61,2025-05-25T15:47:00+02:00,2025-05-25,23:47,5,0,5
61,2025-05-25T15:53:00+02:00,2025-05-25,23:53,0,1,1
66,2025-05-25T14:56:00+02:00,2025-05-25,22:56,1,10,11
66,2025-05-25T14:58:00+02:00,2025-05-25,22:58,0,3,3
66,2025-05-25T15:01:00+02:00,2025-05-25,23:01,6,7,13
66,2025-05-25T15:06:00+02:00,2025-05-25,23:06,4,4,8
66,2025-05-25T15:10:00+02:00,2025-05-25,23:10,4,2,6
66,2025-05-25T15:13:00+02:00,2025-05-25,23:13,1,2,3
66,2025-05-25T15:18:00+02:00,2025-05-25,23:18,0,1,1
66,2025-05-25T15:19:00+02:00,2025-05-25,23:19,3,0,3
66,2025-05-25T15:24:00+02:00,2025-05-25,23:24,8,2,10
66,2025-05-25T15:33:00+02:00,2025-05-25,23:33,5,0,5
66,2025-05-25T15:42:00+02:00,2025-05-25,23:42,3,6,9
66,2025-05-25T15:46:00+02:00,2025-05-25,23:46,2,1,3
66,2025-05-25T15:47:00+02:00,2025-05-25,23:47,0,4,4
66,2025-05-25T15:48:00+02:00,2025-05-25,23:48,1,0,1
66,2025-05-25T15:52:00+02:00,2025-05-25,23:52,1,1,2
66,2025-05-25T15:55:00+02:00,2025-05-25,23:55,5,2,7
70,2025-05-25T15:11:00+02:00,2025-05-25,23:11,0,1,1
71,2025-05-25T15:13:00+02:00,2025-05-25,23:13,1,0,1
71,2025-05-25T15:24:00+02:00,2025-05-25,23:24,0,1,1
75,2025-05-25T15:52:00+02:00,2025-05-25,23:52,0,1,1
77,2025-05-25T15:15:00+02:00,2025-05-25,23:15,4,1,5
77,2025-05-25T15:50:00+02:00,2025-05-25,23:50,0,2,2
78,2025-05-25T15:47:00+02:00,2025-05-25,23:47,1,0,1
84,2025-05-25T15:05:00+02:00,2025-05-25,23:05,8,13,21
84,2025-05-25T15:50:00+02:00,2025-05-25,23:50,1,1,2
87,2025-05-25T15:04:00+02:00,2025-05-25,23:04,1,0,1
87,2025-05-25T15:07:00+02:00,2025-05-25,23:07,0,1,1
107,2025-05-25T15:35:00+02:00,2025-05-25,23:35,0,1,1
107,2025-05-25T15:40:00+02:00,2025-05-25,23:40,2,0,2
108,2025-05-25T14:55:00+02:00,2025-05-25,22:55,0,2,2
108,2025-05-25T15:02:00+02:00,2025-05-25,23:02,3,5,8
108,2025-05-25T15:04:00+02:00,2025-05-25,23:04,1,0,1
108,2025-05-25T15:08:00+02:00,2025-05-25,23:08,1,0,1
108,2025-05-25T15:22:00+02:00,2025-05-25,23:22,0,1,1
108,2025-05-25T15:24:00+02:00,2025-05-25,23:24,2,0,2
108,2025-05-25T15:45:00+02:00,2025-05-25,23:45,0,3,3
108,2025-05-25T15:53:00+02:00,2025-05-25,23:53,1,1,2
131,2025-05-25T14:55:00+02:00,2025-05-25,22:55,2,0,2
131,2025-05-25T15:10:00+02:00,2025-05-25,23:10,2,0,2
131,2025-05-25T15:20:00+02:00,2025-05-25,23:20,1,0,1
132,2025-05-25T15:05:00+02:00,2025-05-25,23:05,5,2,7
132,2025-05-25T15:10:00+02:00,2025-05-25,23:10,2,6,8
132,2025-05-25T15:15:00+02:00,2025-05-25,23:15,9,1,10
132,2025-05-25T15:45:00+02:00,2025-05-25,23:45,3,1,4
133,2025-05-25T15:15:00+02:00,2025-05-25,23:15,5,1,6
133,2025-05-25T15:20:00+02:00,2025-05-25,23:20,6,4,10
133,2025-05-25T15:50:00+02:00,2025-05-25,23:50,0,3,3
133,2025-05-25T15:55:00+02:00,2025-05-25,23:55,1,5,6
134,2025-05-25T15:30:00+02:00,2025-05-25,23:30,6,3,9
134,2025-05-25T15:50:00+02:00,2025-05-25,23:50,0,1,1
135,2025-05-25T15:00:00+02:00,2025-05-25,23:00,4,3,7
135,2025-05-25T15:10:00+02:00,2025-05-25,23:10,4,0,4
135,2025-05-25T15:25:00+02:00,2025-05-25,23:25,3,4,7
135,2025-05-25T15:35:00+02:00,2025-05-25,23:35,3,4,7
135,2025-05-25T15:50:00+02:00,2025-05-25,23:50,0,2,2
135,2025-05-25T15:55:00+02:00,2025-05-25,23:55,3,6,9
162,2025-05-25T14:55:00+02:00,2025-05-25,22:55,6,5,11
162,2025-05-25T15:15:00+02:00,2025-05-25,23:15,2,4,6
162,2025-05-25T15:25:00+02:00,2025-05-25,23:25,6,2,8
167,2025-05-25T15:25:00+02:00,2025-05-25,23:25,0,2,2
167,2025-05-25T15:45:00+02:00,2025-05-25,23:45,1,0,1
179,2025-05-25T15:00:00+02:00,2025-05-25,23:00,2,1,3
179,2025-05-25T15:05:00+02:00,2025-05-25,23:05,2,3,5
179,2025-05-25T15:25:00+02:00,2025-05-25,23:25,0,1,1
179,2025-05-25T15:50:00+02:00,2025-05-25,23:50,1,1,2
1,2025-05-25T14:58:00+02:00,2025-05-25,22:58,2,2,4
1,2025-05-25T14:59:00+02:00,2025-05-25,22:59,1,1,2
1,2025-05-25T15:01:00+02:00,2025-05-25,23:01,0,2,2
1,2025-05-25T15:12:00+02:00,2025-05-25,23:12,0,3,3
1,2025-05-25T15:14:00+02:00,2025-05-25,23:14,4,0,4
1,2025-05-25T15:16:00+02:00,2025-05-25,23:16,3,0,3
1,2025-05-25T15:26:00+02:00,2025-05-25,23:26,1,0,1
1,2025-05-25T15:36:00+02:00,2025-05-25,23:36,2,0,2
1,2025-05-25T15:37:00+02:00,2025-05-25,23:37,1,0,1
1,2025-05-25T15:55:00+02:00,2025-05-25,23:55,1,3,4
2,2025-05-25T14:55:00+02:00,2025-05-25,22:55,0,1,1
2,2025-05-25T15:00:00+02:00,2025-05-25,23:00,0,1,1
2,2025-05-25T15:20:00+02:00,2025-05-25,23:20,0,1,1
2,2025-05-25T15:26:00+02:00,2025-05-25,23:26,1,0,1
2,2025-05-25T15:28:00+02:00,2025-05-25,23:28,0,1,1
2,2025-05-25T15:31:00+02:00,2025-05-25,23:31,0,1,1
2,2025-05-25T15:35:00+02:00,2025-05-25,23:35,0,1,1
2,2025-05-25T15:36:00+02:00,2025-05-25,23:36,1,0,1
2,2025-05-25T15:52:00+02:00,2025-05-25,23:52,0,2,2
2,2025-05-25T15:53:00+02:00,2025-05-25,23:53,1,0,1
9,2025-05-25T14:59:00+02:00,2025-05-25,22:59,0,1,1
9,2025-05-25T15:00:00+02:00,2025-05-25,23:00,0,1,1
9,2025-05-25T15:10:00+02:00,2025-05-25,23:10,1,0,1
9,2025-05-25T15:11:00+02:00,2025-05-25,23:11,2,0,2
9,2025-05-25T15:31:00+02:00,2025-05-25,23:31,0,1,1
9,2025-05-25T15:39:00+02:00,2025-05-25,23:39,0,2,2
9,2025-05-25T15:43:00+02:00,2025-05-25,23:43,0,1,1
9,2025-05-25T15:44:00+02:00,2025-05-25,23:44,1,0,1
9,2025-05-25T15:53:00+02:00,2025-05-25,23:53,2,0,2
10,2025-05-25T15:21:00+02:00,2025-05-25,23:21,2,0,2
10,2025-05-25T15:43:00+02:00,2025-05-25,23:43,3,0,3
10,2025-05-25T15:48:00+02:00,2025-05-25,23:48,2,0,2
11,2025-05-25T15:20:00+02:00,2025-05-25,23:20,1,0,1
11,2025-05-25T15:30:00+02:00,2025-05-25,23:30,0,1,1
11,2025-05-25T15:55:00+02:00,2025-05-25,23:55,0,1,1
12,2025-05-25T14:57:00+02:00,2025-05-25,22:57,2,0,2
12,2025-05-25T14:59:00+02:00,2025-05-25,22:59,2,0,2
12,2025-05-25T15:07:00+02:00,2025-05-25,23:07,1,0,1
12,2025-05-25T15:12:00+02:00,2025-05-25,23:12,0,2,2
12,2025-05-25T15:19:00+02:00,2025-05-25,23:19,0,2,2
12,2025-05-25T15:25:00+02:00,2025-05-25,23:25,2,0,2
12,2025-05-25T15:29:00+02:00,2025-05-25,23:29,0,1,1
12,2025-05-25T15:31:00+02:00,2025-05-25,23:31,0,2,2
12,2025-05-25T15:33:00+02:00,2025-05-25,23:33,2,0,2
12,2025-05-25T15:42:00+02:00,2025-05-25,23:42,1,2,3
12,2025-05-25T15:43:00+02:00,2025-05-25,23:43,7,0,7
12,2025-05-25T15:48:00+02:00,2025-05-25,23:48,2,0,2
12,2025-05-25T15:54:00+02:00,2025-05-25,23:54,0,1,1
17,2025-05-25T14:58:00+02:00,2025-05-25,22:58,0,1,1
17,2025-05-25T15:08:00+02:00,2025-05-25,23:08,1,1,2
17,2025-05-25T15:19:00+02:00,2025-05-25,23:19,1,0,1
17,2025-05-25T15:47:00+02:00,2025-05-25,23:47,0,3,3
17,2025-05-25T15:49:00+02:00,2025-05-25,23:49,1,0,1
19,2025-05-25T15:23:00+02:00,2025-05-25,23:23,1,0,1
19,2025-05-25T15:30:00+02:00,2025-05-25,23:30,2,3,5
19,2025-05-25T15:31:00+02:00,2025-05-25,23:31,1,2,3
19,2025-05-25T15:34:00+02:00,2025-05-25,23:34,0,11,11
19,2025-05-25T15:39:00+02:00,2025-05-25,23:39,8,0,8
19,2025-05-25T15:44:00+02:00,2025-05-25,23:44,2,0,2
19,2025-05-25T15:47:00+02:00,2025-05-25,23:47,2,3,5
19,2025-05-25T15:52:00+02:00,2025-05-25,23:52,8,0,8
19,2025-05-25T15:53:00+02:00,2025-05-25,23:53,1,3,4
20,2025-05-25T14:55:00+02:00,2025-05-25,22:55,0,3,3
20,2025-05-25T15:00:00+02:00,2025-05-25,23:00,2,1,3
20,2025-05-25T15:01:00+02:00,2025-05-25,23:01,2,2,4
20,2025-05-25T15:03:00+02:00,2025-05-25,23:03,6,2,8
20,2025-05-25T15:08:00+02:00,2025-05-25,23:08,2,4,6
20,2025-05-25T15:10:00+02:00,2025-05-25,23:10,0,4,4
20,2025-05-25T15:13:00+02:00,2025-05-25,23:13,0,2,2
20,2025-05-25T15:14:00+02:00,2025-05-25,23:14,0,2,2
20,2025-05-25T15:18:00+02:00,2025-05-25,23:18,1,0,1
20,2025-05-25T15:33:00+02:00,2025-05-25,23:33,2,0,2
20,2025-05-25T15:36:00+02:00,2025-05-25,23:36,2,0,2
20,2025-05-25T15:50:00+02:00,2025-05-25,23:50,0,4,4
23,2025-05-25T14:56:00+02:00,2025-05-25,22:56,0,2,2
23,2025-05-25T15:00:00+02:00,2025-05-25,23:00,0,5,5
23,2025-05-25T15:02:00+02:00,2025-05-25,23:02,2,0,2
23,2025-05-25T15:13:00+02:00,2025-05-25,23:13,1,0,1
23,2025-05-25T15:15:00+02:00,2025-05-25,23:15,2,1,3
23,2025-05-25T15:23:00+02:00,2025-05-25,23:23,0,1,1
23,2025-05-25T15:49:00+02:00,2025-05-25,23:49,0,2,2
24,2025-05-25T14:56:00+02:00,2025-05-25,22:56,6,1,7
24,2025-05-25T15:00:00+02:00,2025-05-25,23:00,0,2,2
24,2025-05-25T15:02:00+02:00,2025-05-25,23:02,5,0,5
24,2025-05-25T15:03:00+02:00,2025-05-25,23:03,4,1,5
24,2025-05-25T15:04:00+02:00,2025-05-25,23:04,0,2,2
24,2025-05-25T15:05:00+02:00,2025-05-25,23:05,3,11,14
24,2025-05-25T15:06:00+02:00,2025-05-25,23:06,0,1,1
24,2025-05-25T15:08:00+02:00,2025-05-25,23:08,0,4,4
24,2025-05-25T15:09:00+02:00,2025-05-25,23:09,0,10,10
24,2025-05-25T15:10:00+02:00,2025-05-25,23:10,4,8,12
24,2025-05-25T15:13:00+02:00,2025-05-25,23:13,5,0,5
24,2025-05-25T15:15:00+02:00,2025-05-25,23:15,1,3,4
24,2025-05-25T15:16:00+02:00,2025-05-25,23:16,6,0,6
24,2025-05-25T15:19:00+02:00,2025-05-25,23:19,1,2,3
24,2025-05-25T15:20:00+02:00,2025-05-25,23:20,3,9,12
24,2025-05-25T15:25:00+02:00,2025-05-25,23:25,0,1,1
24,2025-05-25T15:28:00+02:00,2025-05-25,23:28,2,0,2
24,2025-05-25T15:30:00+02:00,2025-05-25,23:30,4,0,4
24,2025-05-25T15:35:00+02:00,2025-05-25,23:35,1,1,2
24,2025-05-25T15:50:00+02:00,2025-05-25,23:50,0,5,5
24,2025-05-25T15:51:00+02:00,2025-05-25,23:51,3,5,8
24,2025-05-25T15:52:00+02:00,2025-05-25,23:52,3,5,8
25,2025-05-25T14:55:00+02:00,2025-05-25,22:55,3,2,5
25,2025-05-25T15:00:00+02:00,2025-05-25,23:00,1,1,2
25,2025-05-25T15:10:00+02:00,2025-05-25,23:10,3,2,5
25,2025-05-25T15:30:00+02:00,2025-05-25,23:30,2,1,3
25,2025-05-25T15:35:00+02:00,2025-05-25,23:35,0,1,1
25,2025-05-25T15:55:00+02:00,2025-05-25,23:55,1,1,2
27,2025-05-25T15:03:00+02:00,2025-05-25,23:03,1,0,1
27,2025-05-25T15:24:00+02:00,2025-05-25,23:24,0,1,1
27,2025-05-25T15:27:00+02:00,2025-05-25,23:27,1,0,1
27,2025-05-25T15:30:00+02:00,2025-05-25,23:30,1,0,1
27,2025-05-25T15:34:00+02:00,2025-05-25,23:34,0,1,1
27,2025-05-25T15:51:00+02:00,2025-05-25,23:51,1,0,1
30,2025-05-25T14:55:00+02:00,2025-05-25,22:55,2,1,3
30,2025-05-25T14:59:00+02:00,2025-05-25,22:59,2,2,4
30,2025-05-25T15:01:00+02:00,2025-05-25,23:01,5,1,6
30,2025-05-25T15:11:00+02:00,2025-05-25,23:11,4,4,8
30,2025-05-25T15:14:00+02:00,2025-05-25,23:14,2,5,7
30,2025-05-25T15:16:00+02:00,2025-05-25,23:16,2,2,4
30,2025-05-25T15:17:00+02:00,2025-05-25,23:17,2,4,6
30,2025-05-25T15:18:00+02:00,2025-05-25,23:18,0,2,2
30,2025-05-25T15:25:00+02:00,2025-05-25,23:25,0,7,7
30,2025-05-25T15:30:00+02:00,2025-05-25,23:30,1,4,5
30,2025-05-25T15:47:00+02:00,2025-05-25,23:47,2,0,2
30,2025-05-25T15:53:00+02:00,2025-05-25,23:53,2,0,2
35,2025-05-25T14:55:00+02:00,2025-05-25,22:55,1,3,4
35,2025-05-25T14:56:00+02:00,2025-05-25,22:56,3,3,6
35,2025-05-25T14:58:00+02:00,2025-05-25,22:58,3,2,5
35,2025-05-25T14:59:00+02:00,2025-05-25,22:59,0,3,3
35,2025-05-25T15:03:00+02:00,2025-05-25,23:03,3,3,6
35,2025-05-25T15:05:00+02:00,2025-05-25,23:05,0,5,5
35,2025-05-25T15:09:00+02:00,2025-05-25,23:09,0,2,2
35,2025-05-25T15:10:00+02:00,2025-05-25,23:10,1,3,4
35,2025-05-25T15:11:00+02:00,2025-05-25,23:11,0,1,1
35,2025-05-25T15:14:00+02:00,2025-05-25,23:14,0,3,3
35,2025-05-25T15:36:00+02:00,2025-05-25,23:36,0,2,2
35,2025-05-25T15:38:00+02:00,2025-05-25,23:38,0,1,1
35,2025-05-25T15:39:00+02:00,2025-05-25,23:39,1,3,4
35,2025-05-25T15:40:00+02:00,2025-05-25,23:40,4,1,5
35,2025-05-25T15:41:00+02:00,2025-05-25,23:41,0,2,2
35,2025-05-25T15:46:00+02:00,2025-05-25,23:46,0,1,1
35,2025-05-25T15:49:00+02:00,2025-05-25,23:49,2,0,2
35,2025-05-25T15:50:00+02:00,2025-05-25,23:50,1,0,1
49,2025-05-25T14:57:00+02:00,2025-05-25,22:57,1,2,3
49,2025-05-25T15:00:00+02:00,2025-05-25,23:00,0,1,1
49,2025-05-25T15:01:00+02:00,2025-05-25,23:01,7,3,10
49,2025-05-25T15:03:00+02:00,2025-05-25,23:03,3,0,3
49,2025-05-25T15:06:00+02:00,2025-05-25,23:06,2,0,2
49,2025-05-25T15:17:00+02:00,2025-05-25,23:17,2,3,5
49,2025-05-25T15:23:00+02:00,2025-05-25,23:23,3,2,5
49,2025-05-25T15:27:00+02:00,2025-05-25,23:27,0,5,5
49,2025-05-25T15:28:00+02:00,2025-05-25,23:28,0,1,1
49,2025-05-25T15:31:00+02:00,2025-05-25,23:31,3,2,5
49,2025-05-25T15:32:00+02:00,2025-05-25,23:32,1,0,1
49,2025-05-25T15:33:00+02:00,2025-05-25,23:33,1,3,4
49,2025-05-25T15:47:00+02:00,2025-05-25,23:47,2,2,4
49,2025-05-25T15:50:00+02:00,2025-05-25,23:50,2,2,4
49,2025-05-25T15:55:00+02:00,2025-05-25,23:55,4,0,4
51,2025-05-25T14:58:00+02:00,2025-05-25,22:58,0,1,1
51,2025-05-25T15:04:00+02:00,2025-05-25,23:04,0,1,1
51,2025-05-25T15:12:00+02:00,2025-05-25,23:12,3,0,3
51,2025-05-25T15:13:00+02:00,2025-05-25,23:13,1,1,2
51,2025-05-25T15:14:00+02:00,2025-05-25,23:14,0,1,1
51,2025-05-25T15:18:00+02:00,2025-05-25,23:18,0,3,3
51,2025-05-25T15:22:00+02:00,2025-05-25,23:22,2,1,3
51,2025-05-25T15:24:00+02:00,2025-05-25,23:24,6,1,7
51,2025-05-25T15:33:00+02:00,2025-05-25,23:33,3,3,6
51,2025-05-25T15:35:00+02:00,2025-05-25,23:35,1,0,1
51,2025-05-25T15:47:00+02:00,2025-05-25,23:47,0,1,1
51,2025-05-25T15:51:00+02:00,2025-05-25,23:51,1,0,1
51,2025-05-25T15:55:00+02:00,2025-05-25,23:55,1,0,1
52,2025-05-25T14:58:00+02:00,2025-05-25,22:58,0,1,1
52,2025-05-25T15:00:00+02:00,2025-05-25,23:00,0,2,2
52,2025-05-25T15:01:00+02:00,2025-05-25,23:01,3,1,4
52,2025-05-25T15:02:00+02:00,2025-05-25,23:02,0,2,2
52,2025-05-25T15:04:00+02:00,2025-05-25,23:04,2,3,5
52,2025-05-25T15:17:00+02:00,2025-05-25,23:17,3,6,9
52,2025-05-25T15:22:00+02:00,2025-05-25,23:22,4,0,4
52,2025-05-25T15:27:00+02:00,2025-05-25,23:27,0,2,2
52,2025-05-25T15:33:00+02:00,2025-05-25,23:33,0,1,1
52,2025-05-25T15:54:00+02:00,2025-05-25,23:54,2,0,2
53,2025-05-25T14:55:00+02:00,2025-05-25,22:55,1,1,2
53,2025-05-25T15:01:00+02:00,2025-05-25,23:01,0,1,1
53,2025-05-25T15:02:00+02:00,2025-05-25,23:02,2,0,2
53,2025-05-25T15:12:00+02:00,2025-05-25,23:12,3,1,4
53,2025-05-25T15:14:00+02:00,2025-05-25,23:14,0,2,2
53,2025-05-25T15:17:00+02:00,2025-05-25,23:17,1,0,1
53,2025-05-25T15:28:00+02:00,2025-05-25,23:28,0,1,1
53,2025-05-25T15:32:00+02:00,2025-05-25,23:32,2,1,3
53,2025-05-25T15:44:00+02:00,2025-05-25,23:44,0,1,1
53,2025-05-25T15:53:00+02:00,2025-05-25,23:53,0,1,1
53,2025-05-25T15:54:00+02:00,2025-05-25,23:54,0,1,1
56,2025-05-25T14:58:00+02:00,2025-05-25,22:58,0,1,1
56,2025-05-25T14:59:00+02:00,2025-05-25,22:59,0,2,2
56,2025-05-25T15:05:00+02:00,2025-05-25,23:05,0,1,1
56,2025-05-25T15:06:00+02:00,2025-05-25,23:06,0,3,3
56,2025-05-25T15:08:00+02:00,2025-05-25,23:08,2,0,2
56,2025-05-25T15:10:00+02:00,2025-05-25,23:10,0,1,1
56,2025-05-25T15:12:00+02:00,2025-05-25,23:12,0,6,6
56,2025-05-25T15:13:00+02:00,2025-05-25,23:13,4,3,7
56,2025-05-25T15:14:00+02:00,2025-05-25,23:14,0,4,4
56,2025-05-25T15:15:00+02:00,2025-05-25,23:15,0,2,2
56,2025-05-25T15:16:00+02:00,2025-05-25,23:16,5,1,6
56,2025-05-25T15:24:00+02:00,2025-05-25,23:24,1,2,3
56,2025-05-25T15:27:00+02:00,2025-05-25,23:27,3,1,4
56,2025-05-25T15:31:00+02:00,2025-05-25,23:31,0,1,1
56,2025-05-25T15:54:00+02:00,2025-05-25,23:54,2,3,5
58,2025-05-25T14:56:00+02:00,2025-05-25,22:56,2,0,2
58,2025-05-25T15:02:00+02:00,2025-05-25,23:02,0,1,1
58,2025-05-25T15:06:00+02:00,2025-05-25,23:06,0,1,1
58,2025-05-25T15:08:00+02:00,2025-05-25,23:08,2,3,5
58,2025-05-25T15:10:00+02:00,2025-05-25,23:10,1,0,1
58,2025-05-25T15:16:00+02:00,2025-05-25,23:16,2,2,4
58,2025-05-25T15:18:00+02:00,2025-05-25,23:18,2,1,3
58,2025-05-25T15:22:00+02:00,2025-05-25,23:22,0,5,5
58,2025-05-25T15:25:00+02:00,2025-05-25,23:25,0,2,2
58,2025-05-25T15:26:00+02:00,2025-05-25,23:26,0,1,1
58,2025-05-25T15:27:00+02:00,2025-05-25,23:27,2,0,2
58,2025-05-25T15:33:00+02:00,2025-05-25,23:33,1,0,1
58,2025-05-25T15:35:00+02:00,2025-05-25,23:35,0,1,1
58,2025-05-25T15:40:00+02:00,2025-05-25,23:40,0,1,1
58,2025-05-25T15:42:00+02:00,2025-05-25,23:42,0,3,3
58,2025-05-25T15:45:00+02:00,2025-05-25,23:45,0,2,2
58,2025-05-25T15:46:00+02:00,2025-05-25,23:46,0,1,1
58,2025-05-25T15:52:00+02:00,2025-05-25,23:52,1,0,1
62,2025-05-25T14:56:00+02:00,2025-05-25,22:56,5,1,6
62,2025-05-25T14:57:00+02:00,2025-05-25,22:57,0,2,2
62,2025-05-25T15:02:00+02:00,2025-05-25,23:02,0,1,1
62,2025-05-25T15:04:00+02:00,2025-05-25,23:04,0,1,1
62,2025-05-25T15:07:00+02:00,2025-05-25,23:07,3,1,4
62,2025-05-25T15:08:00+02:00,2025-05-25,23:08,0,4,4
62,2025-05-25T15:09:00+02:00,2025-05-25,23:09,2,1,3
62,2025-05-25T15:11:00+02:00,2025-05-25,23:11,0,2,2
62,2025-05-25T15:12:00+02:00,2025-05-25,23:12,0,1,1
62,2025-05-25T15:15:00+02:00,2025-05-25,23:15,1,0,1
62,2025-05-25T15:17:00+02:00,2025-05-25,23:17,2,2,4
62,2025-05-25T15:18:00+02:00,2025-05-25,23:18,2,0,2
62,2025-05-25T15:19:00+02:00,2025-05-25,23:19,2,1,3
62,2025-05-25T15:20:00+02:00,2025-05-25,23:20,1,1,2
62,2025-05-25T15:26:00+02:00,2025-05-25,23:26,1,2,3
62,2025-05-25T15:27:00+02:00,2025-05-25,23:27,1,3,4
62,2025-05-25T15:28:00+02:00,2025-05-25,23:28,1,3,4
62,2025-05-25T15:34:00+02:00,2025-05-25,23:34,1,0,1
62,2025-05-25T15:39:00+02:00,2025-05-25,23:39,1,0,1
62,2025-05-25T15:46:00+02:00,2025-05-25,23:46,3,0,3
62,2025-05-25T15:51:00+02:00,2025-05-25,23:51,1,7,8
62,2025-05-25T15:52:00+02:00,2025-05-25,23:52,2,1,3
62,2025-05-25T15:54:00+02:00,2025-05-25,23:54,1,0,1
63,2025-05-25T14:57:00+02:00,2025-05-25,22:57,0,1,1
63,2025-05-25T14:59:00+02:00,2025-05-25,22:59,0,1,1
63,2025-05-25T15:01:00+02:00,2025-05-25,23:01,0,1,1
63,2025-05-25T15:25:00+02:00,2025-05-25,23:25,0,2,2
63,2025-05-25T15:26:00+02:00,2025-05-25,23:26,0,1,1
63,2025-05-25T15:33:00+02:00,2025-05-25,23:33,0,1,1
63,2025-05-25T15:40:00+02:00,2025-05-25,23:40,0,3,3
63,2025-05-25T15:47:00+02:00,2025-05-25,23:47,0,4,4
63,2025-05-25T15:48:00+02:00,2025-05-25,23:48,0,1,1
67,2025-05-25T15:00:00+02:00,2025-05-25,23:00,0,1,1
67,2025-05-25T15:13:00+02:00,2025-05-25,23:13,0,1,1
67,2025-05-25T15:15:00+02:00,2025-05-25,23:15,0,3,3
67,2025-05-25T15:17:00+02:00,2025-05-25,23:17,0,1,1
67,2025-05-25T15:18:00+02:00,2025-05-25,23:18,0,3,3
67,2025-05-25T15:30:00+02:00,2025-05-25,23:30,1,2,3
67,2025-05-25T15:36:00+02:00,2025-05-25,23:36,2,0,2
68,2025-05-25T15:52:00+02:00,2025-05-25,23:52,0,1,1
72,2025-05-25T14:57:00+02:00,2025-05-25,22:57,0,4,4
72,2025-05-25T14:58:00+02:00,2025-05-25,22:58,0,1,1
72,2025-05-25T15:03:00+02:00,2025-05-25,23:03,0,1,1
72,2025-05-25T15:11:00+02:00,2025-05-25,23:11,0,2,2
72,2025-05-25T15:17:00+02:00,2025-05-25,23:17,0,2,2
72,2025-05-25T15:26:00+02:00,2025-05-25,23:26,0,1,1
79,2025-05-25T15:03:00+02:00,2025-05-25,23:03,3,1,4
79,2025-05-25T15:18:00+02:00,2025-05-25,23:18,1,0,1
79,2025-05-25T15:20:00+02:00,2025-05-25,23:20,2,0,2
79,2025-05-25T15:21:00+02:00,2025-05-25,23:21,1,1,2
79,2025-05-25T15:22:00+02:00,2025-05-25,23:22,1,1,2
79,2025-05-25T15:28:00+02:00,2025-05-25,23:28,1,0,1
79,2025-05-25T15:32:00+02:00,2025-05-25,23:32,1,2,3
79,2025-05-25T15:33:00+02:00,2025-05-25,23:33,1,0,1
79,2025-05-25T15:36:00+02:00,2025-05-25,23:36,1,1,2
79,2025-05-25T15:37:00+02:00,2025-05-25,23:37,0,2,2
79,2025-05-25T15:38:00+02:00,2025-05-25,23:38,0,1,1
79,2025-05-25T15:42:00+02:00,2025-05-25,23:42,1,0,1
79,2025-05-25T15:44:00+02:00,2025-05-25,23:44,0,2,2
79,2025-05-25T15:53:00+02:00,2025-05-25,23:53,2,1,3
86,2025-05-25T15:16:00+02:00,2025-05-25,23:16,0,2,2
109,2025-05-25T15:00:00+02:00,2025-05-25,23:00,0,3,3
109,2025-05-25T15:20:00+02:00,2025-05-25,23:20,1,5,6
109,2025-05-25T15:25:00+02:00,2025-05-25,23:25,1,4,5
109,2025-05-25T15:30:00+02:00,2025-05-25,23:30,1,5,6
109,2025-05-25T15:50:00+02:00,2025-05-25,23:50,1,3,4
109,2025-05-25T15:55:00+02:00,2025-05-25,23:55,0,4,4
117,2025-05-25T14:55:00+02:00,2025-05-25,22:55,2,0,2
117,2025-05-25T15:00:00+02:00,2025-05-25,23:00,8,3,11
117,2025-05-25T15:20:00+02:00,2025-05-25,23:20,4,2,6
117,2025-05-25T15:50:00+02:00,2025-05-25,23:50,0,1,1
117,2025-05-25T15:55:00+02:00,2025-05-25,23:55,0,3,3
136,2025-05-25T15:40:00+02:00,2025-05-25,23:40,1,0,1
137,2025-05-25T15:35:00+02:00,2025-05-25,23:35,0,1,1
139,2025-05-25T15:20:00+02:00,2025-05-25,23:20,1,0,1
139,2025-05-25T15:30:00+02:00,2025-05-25,23:30,0,2,2
141,2025-05-25T15:00:00+02:00,2025-05-25,23:00,2,1,3
141,2025-05-25T15:15:00+02:00,2025-05-25,23:15,5,3,8
141,2025-05-25T15:20:00+02:00,2025-05-25,23:20,0,5,5
141,2025-05-25T15:55:00+02:00,2025-05-25,23:55,1,3,4
142,2025-05-25T15:25:00+02:00,2025-05-25,23:25,0,1,1
164,2025-05-25T14:55:00+02:00,2025-05-25,22:55,0,2,2
164,2025-05-25T15:10:00+02:00,2025-05-25,23:10,0,9,9
164,2025-05-25T15:15:00+02:00,2025-05-25,23:15,0,1,1
164,2025-05-25T15:20:00+02:00,2025-05-25,23:20,0,2,2
164,2025-05-25T15:35:00+02:00,2025-05-25,23:35,0,1,1
164,2025-05-25T15:40:00+02:00,2025-05-25,23:40,1,2,3
164,2025-05-25T15:55:00+02:00,2025-05-25,23:55,4,2,6
181,2025-05-25T14:55:00+02:00,2025-05-25,22:55,6,12,18
181,2025-05-25T15:01:00+02:00,2025-05-25,23:01,6,0,6
181,2025-05-25T15:05:00+02:00,2025-05-25,23:05,3,4,7
181,2025-05-25T15:21:00+02:00,2025-05-25,23:21,5,1,6
181,2025-05-25T15:22:00+02:00,2025-05-25,23:22,3,5,8
181,2025-05-25T15:26:00+02:00,2025-05-25,23:26,5,3,8
181,2025-05-25T15:27:00+02:00,2025-05-25,23:27,9,2,11
181,2025-05-25T15:28:00+02:00,2025-05-25,23:28,6,3,9
181,2025-05-25T15:32:00+02:00,2025-05-25,23:32,5,0,5
181,2025-05-25T15:34:00+02:00,2025-05-25,23:34,4,4,8
181,2025-05-25T15:37:00+02:00,2025-05-25,23:37,4,5,9
181,2025-05-25T15:43:00+02:00,2025-05-25,23:43,7,9,16
181,2025-05-25T15:48:00+02:00,2025-05-25,23:48,1,1,2
181,2025-05-25T15:51:00+02:00,2025-05-25,23:51,13,2,15
181,2025-05-25T15:52:00+02:00,2025-05-25,23:52,1,3,4
181,2025-05-25T15:54:00+02:00,2025-05-25,23:54,0,8,8
182,2025-05-25T15:20:00+02:00,2025-05-25,23:20,12,7,19
47,2025-05-24T16:11:00+02:00,2025-05-25,00:11,6,6,12
47,2025-05-24T16:13:00+02:00,2025-05-25,00:13,10,5,15
47,2025-05-24T16:15:00+02:00,2025-05-25,00:15,2,0,2
47,2025-05-24T16:17:00+02:00,2025-05-25,00:17,2,1,3
47,2025-05-24T16:18:00+02:00,2025-05-25,00:18,1,2,3
47,2025-05-24T16:20:00+02:00,2025-05-25,00:20,4,1,5
50,2025-05-24T16:10:00+02:00,2025-05-25,00:10,1,0,1
50,2025-05-24T16:12:00+02:00,2025-05-25,00:12,0,1,1
50,2025-05-24T16:14:00+02:00,2025-05-25,00:14,1,0,1
50,2025-05-24T16:21:00+02:00,2025-05-25,00:21,1,0,1
54,2025-05-24T16:13:00+02:00,2025-05-25,00:13,2,1,3
54,2025-05-24T16:14:00+02:00,2025-05-25,00:14,2,2,4
54,2025-05-24T16:15:00+02:00,2025-05-25,00:15,2,0,2
61,2025-05-24T16:12:00+02:00,2025-05-25,00:12,7,3,10
61,2025-05-24T16:22:00+02:00,2025-05-25,00:22,1,0,1
61,2025-05-24T16:24:00+02:00,2025-05-25,00:24,1,6,7
66,2025-05-24T16:10:00+02:00,2025-05-25,00:10,0,6,6
66,2025-05-24T16:12:00+02:00,2025-05-25,00:12,4,5,9
66,2025-05-24T16:14:00+02:00,2025-05-25,00:14,9,9,18
69,2025-05-24T16:13:00+02:00,2025-05-25,00:13,1,0,1
69,2025-05-24T16:17:00+02:00,2025-05-25,00:17,0,1,1
70,2025-05-24T16:21:00+02:00,2025-05-25,00:21,0,1,1
71,2025-05-24T16:18:00+02:00,2025-05-25,00:18,1,0,1
78,2025-05-24T16:10:00+02:00,2025-05-25,00:10,0,2,2
87,2025-05-24T16:12:00+02:00,2025-05-25,00:12,0,2,2
87,2025-05-24T16:13:00+02:00,2025-05-25,00:13,0,1,1
87,2025-05-24T16:16:00+02:00,2025-05-25,00:16,1,0,1
107,2025-05-24T16:10:00+02:00,2025-05-25,00:10,1,14,15
107,2025-05-24T16:15:00+02:00,2025-05-25,00:15,3,3,6
108,2025-05-24T16:12:00+02:00,2025-05-25,00:12,3,1,4
131,2025-05-24T16:15:00+02:00,2025-05-25,00:15,5,38,43
132,2025-05-24T16:15:00+02:00,2025-05-25,00:15,5,4,9
135,2025-05-24T16:15:00+02:00,2025-05-25,00:15,0,4,4
162,2025-05-24T16:10:00+02:00,2025-05-25,00:10,5,3,8
166,2025-05-24T16:15:00+02:00,2025-05-25,00:15,1,0,1
179,2025-05-24T16:10:00+02:00,2025-05-25,00:10,0,1,1
1,2025-05-24T16:11:00+02:00,2025-05-25,00:11,4,3,7
1,2025-05-24T16:19:00+02:00,2025-05-25,00:19,0,1,1
1,2025-05-24T16:22:00+02:00,2025-05-25,00:22,0,2,2
9,2025-05-24T16:14:00+02:00,2025-05-25,00:14,1,0,1
10,2025-05-24T16:23:00+02:00,2025-05-25,00:23,4,1,5
11,2025-05-24T16:11:00+02:00,2025-05-25,00:11,2,0,2
12,2025-05-24T16:10:00+02:00,2025-05-25,00:10,0,3,3
12,2025-05-24T16:15:00+02:00,2025-05-25,00:15,0,2,2
12,2025-05-24T16:20:00+02:00,2025-05-25,00:20,2,3,5
12,2025-05-24T16:22:00+02:00,2025-05-25,00:22,0,1,1
12,2025-05-24T16:23:00+02:00,2025-05-25,00:23,0,1,1
12,2025-05-24T16:24:00+02:00,2025-05-25,00:24,2,0,2
17,2025-05-24T16:18:00+02:00,2025-05-25,00:18,1,0,1
17,2025-05-24T16:20:00+02:00,2025-05-25,00:20,0,1,1
17,2025-05-24T16:22:00+02:00,2025-05-25,00:22,1,0,1
18,2025-05-24T16:11:00+02:00,2025-05-25,00:11,3,0,3
18,2025-05-24T16:18:00+02:00,2025-05-25,00:18,1,0,1
19,2025-05-24T16:12:00+02:00,2025-05-25,00:12,3,5,8
19,2025-05-24T16:13:00+02:00,2025-05-25,00:13,10,0,10
19,2025-05-24T16:15:00+02:00,2025-05-25,00:15,2,8,10
19,2025-05-24T16:16:00+02:00,2025-05-25,00:16,6,9,15
19,2025-05-24T16:24:00+02:00,2025-05-25,00:24,5,5,10
20,2025-05-24T16:10:00+02:00,2025-05-25,00:10,4,7,11
20,2025-05-24T16:11:00+02:00,2025-05-25,00:11,6,2,8
20,2025-05-24T16:15:00+02:00,2025-05-25,00:15,4,8,12
20,2025-05-24T16:16:00+02:00,2025-05-25,00:16,2,18,20
20,2025-05-24T16:22:00+02:00,2025-05-25,00:22,3,6,9
20,2025-05-24T16:23:00+02:00,2025-05-25,00:23,1,5,6
23,2025-05-24T16:18:00+02:00,2025-05-25,00:18,0,4,4
24,2025-05-24T16:11:00+02:00,2025-05-25,00:11,2,4,6
24,2025-05-24T16:12:00+02:00,2025-05-25,00:12,1,4,5
24,2025-05-24T16:17:00+02:00,2025-05-25,00:17,2,3,5
24,2025-05-24T16:18:00+02:00,2025-05-25,00:18,7,3,10
24,2025-05-24T16:23:00+02:00,2025-05-25,00:23,3,16,19
25,2025-05-24T16:20:00+02:00,2025-05-25,00:20,2,15,17
27,2025-05-24T16:13:00+02:00,2025-05-25,00:13,0,1,1
27,2025-05-24T16:15:00+02:00,2025-05-25,00:15,2,0,2
27,2025-05-24T16:16:00+02:00,2025-05-25,00:16,1,0,1
30,2025-05-24T16:13:00+02:00,2025-05-25,00:13,5,3,8
30,2025-05-24T16:14:00+02:00,2025-05-25,00:14,5,4,9
30,2025-05-24T16:16:00+02:00,2025-05-25,00:16,4,8,12
30,2025-05-24T16:17:00+02:00,2025-05-25,00:17,6,12,18
30,2025-05-24T16:20:00+02:00,2025-05-25,00:20,7,8,15
30,2025-05-24T16:21:00+02:00,2025-05-25,00:21,7,6,13
30,2025-05-24T16:22:00+02:00,2025-05-25,00:22,8,2,10
30,2025-05-24T16:23:00+02:00,2025-05-25,00:23,0,9,9
30,2025-05-24T16:24:00+02:00,2025-05-25,00:24,7,1,8
35,2025-05-24T16:11:00+02:00,2025-05-25,00:11,5,7,12
35,2025-05-24T16:12:00+02:00,2025-05-25,00:12,6,14,20
35,2025-05-24T16:13:00+02:00,2025-05-25,00:13,9,3,12
35,2025-05-24T16:18:00+02:00,2025-05-25,00:18,0,16,16
35,2025-05-24T16:24:00+02:00,2025-05-25,00:24,1,5,6
49,2025-05-24T16:14:00+02:00,2025-05-25,00:14,2,1,3
49,2025-05-24T16:16:00+02:00,2025-05-25,00:16,3,2,5
49,2025-05-24T16:21:00+02:00,2025-05-25,00:21,1,2,3
51,2025-05-24T16:10:00+02:00,2025-05-25,00:10,0,1,1
51,2025-05-24T16:14:00+02:00,2025-05-25,00:14,2,0,2
51,2025-05-24T16:16:00+02:00,2025-05-25,00:16,1,3,4
51,2025-05-24T16:20:00+02:00,2025-05-25,00:20,0,1,1
51,2025-05-24T16:23:00+02:00,2025-05-25,00:23,1,0,1
52,2025-05-24T16:10:00+02:00,2025-05-25,00:10,4,3,7
52,2025-05-24T16:12:00+02:00,2025-05-25,00:12,1,13,14
52,2025-05-24T16:14:00+02:00,2025-05-25,00:14,3,5,8
52,2025-05-24T16:15:00+02:00,2025-05-25,00:15,7,2,9
52,2025-05-24T16:16:00+02:00,2025-05-25,00:16,7,0,7
52,2025-05-24T16:20:00+02:00,2025-05-25,00:20,2,1,3
52,2025-05-24T16:23:00+02:00,2025-05-25,00:23,5,5,10
52,2025-05-24T16:24:00+02:00,2025-05-25,00:24,1,8,9
53,2025-05-24T16:11:00+02:00,2025-05-25,00:11,0,3,3
53,2025-05-24T16:17:00+02:00,2025-05-25,00:17,0,1,1
56,2025-05-24T16:10:00+02:00,2025-05-25,00:10,4,1,5
56,2025-05-24T16:16:00+02:00,2025-05-25,00:16,2,4,6
56,2025-05-24T16:19:00+02:00,2025-05-25,00:19,2,0,2
56,2025-05-24T16:21:00+02:00,2025-05-25,00:21,3,2,5
58,2025-05-24T16:12:00+02:00,2025-05-25,00:12,2,5,7
58,2025-05-24T16:14:00+02:00,2025-05-25,00:14,1,6,7
58,2025-05-24T16:15:00+02:00,2025-05-25,00:15,2,11,13
58,2025-05-24T16:16:00+02:00,2025-05-25,00:16,1,0,1
58,2025-05-24T16:18:00+02:00,2025-05-25,00:18,6,2,8
58,2025-05-24T16:22:00+02:00,2025-05-25,00:22,3,5,8
58,2025-05-24T16:23:00+02:00,2025-05-25,00:23,1,11,12
62,2025-05-24T16:12:00+02:00,2025-05-25,00:12,2,1,3
62,2025-05-24T16:14:00+02:00,2025-05-25,00:14,1,0,1
62,2025-05-24T16:16:00+02:00,2025-05-25,00:16,2,3,5
62,2025-05-24T16:23:00+02:00,2025-05-25,00:23,1,1,2
62,2025-05-24T16:24:00+02:00,2025-05-25,00:24,6,1,7
63,2025-05-24T16:17:00+02:00,2025-05-25,00:17,0,3,3
63,2025-05-24T16:19:00+02:00,2025-05-25,00:19,1,0,1
63,2025-05-24T16:20:00+02:00,2025-05-25,00:20,0,1,1
67,2025-05-24T16:13:00+02:00,2025-05-25,00:13,1,1,2
67,2025-05-24T16:14:00+02:00,2025-05-25,00:14,2,0,2
67,2025-05-24T16:15:00+02:00,2025-05-25,00:15,0,4,4
67,2025-05-24T16:18:00+02:00,2025-05-25,00:18,0,4,4
67,2025-05-24T16:20:00+02:00,2025-05-25,00:20,0,1,1
67,2025-05-24T16:21:00+02:00,2025-05-25,00:21,2,0,2
67,2025-05-24T16:23:00+02:00,2025-05-25,00:23,0,3,3
67,2025-05-24T16:24:00+02:00,2025-05-25,00:24,1,3,4
72,2025-05-24T16:10:00+02:00,2025-05-25,00:10,0,3,3
72,2025-05-24T16:11:00+02:00,2025-05-25,00:11,0,10,10
72,2025-05-24T16:14:00+02:00,2025-05-25,00:14,0,2,2
72,2025-05-24T16:16:00+02:00,2025-05-25,00:16,0,3,3
72,2025-05-24T16:17:00+02:00,2025-05-25,00:17,0,2,2
72,2025-05-24T16:20:00+02:00,2025-05-25,00:20,0,4,4
72,2025-05-24T16:21:00+02:00,2025-05-25,00:21,0,3,3
79,2025-05-24T16:10:00+02:00,2025-05-25,00:10,2,4,6
79,2025-05-24T16:11:00+02:00,2025-05-25,00:11,0,1,1
79,2025-05-24T16:16:00+02:00,2025-05-25,00:16,2,5,7
79,2025-05-24T16:17:00+02:00,2025-05-25,00:17,4,1,5
79,2025-05-24T16:21:00+02:00,2025-05-25,00:21,1,3,4
117,2025-05-24T16:10:00+02:00,2025-05-25,00:10,8,8,16
136,2025-05-24T16:20:00+02:00,2025-05-25,00:20,1,0,1
137,2025-05-24T16:10:00+02:00,2025-05-25,00:10,1,0,1
141,2025-05-24T16:10:00+02:00,2025-05-25,00:10,9,10,19
181,2025-05-24T16:10:00+02:00,2025-05-25,00:10,7,5,12
181,2025-05-24T16:11:00+02:00,2025-05-25,00:11,1,8,9
181,2025-05-24T16:17:00+02:00,2025-05-25,00:17,10,11,21
181,2025-05-24T16:18:00+02:00,2025-05-25,00:18,2,6,8
181,2025-05-24T16:19:00+02:00,2025-05-25,00:19,5,2,7
181,2025-05-24T16:20:00+02:00,2025-05-25,00:20,5,8,13
181,2025-05-24T16:24:00+02:00,2025-05-25,00:24,8,6,14
182,2025-05-24T16:20:00+02:00,2025-05-25,00:20,5,10,15
3,2025-05-24T16:10:00+02:00,2025-05-25,00:10,6,6,12
3,2025-05-24T16:11:00+02:00,2025-05-25,00:11,3,4,7
3,2025-05-24T16:14:00+02:00,2025-05-25,00:14,1,11,12
3,2025-05-24T16:15:00+02:00,2025-05-25,00:15,1,10,11
3,2025-05-24T16:17:00+02:00,2025-05-25,00:17,4,3,7
3,2025-05-24T16:20:00+02:00,2025-05-25,00:20,0,19,19
3,2025-05-24T16:23:00+02:00,2025-05-25,00:23,7,0,7
4,2025-05-24T16:10:00+02:00,2025-05-25,00:10,0,9,9
4,2025-05-24T16:11:00+02:00,2025-05-25,00:11,12,13,25
4,2025-05-24T16:13:00+02:00,2025-05-25,00:13,1,6,7
4,2025-05-24T16:15:00+02:00,2025-05-25,00:15,1,5,6
4,2025-05-24T16:17:00+02:00,2025-05-25,00:17,2,4,6
4,2025-05-24T16:18:00+02:00,2025-05-25,00:18,1,1,2
5,2025-05-24T16:15:00+02:00,2025-05-25,00:15,15,15,30
6,2025-05-24T16:11:00+02:00,2025-05-25,00:11,1,3,4
6,2025-05-24T16:16:00+02:00,2025-05-25,00:16,4,5,9
6,2025-05-24T16:23:00+02:00,2025-05-25,00:23,4,1,5
28,2025-05-24T16:13:00+02:00,2025-05-25,00:13,2,2,4
28,2025-05-24T16:15:00+02:00,2025-05-25,00:15,3,0,3
28,2025-05-24T16:17:00+02:00,2025-05-25,00:17,1,2,3
28,2025-05-24T16:21:00+02:00,2025-05-25,00:21,5,0,5
28,2025-05-24T16:22:00+02:00,2025-05-25,00:22,3,2,5
28,2025-05-24T16:23:00+02:00,2025-05-25,00:23,1,0,1
29,2025-05-24T16:13:00+02:00,2025-05-25,00:13,0,9,9
29,2025-05-24T16:19:00+02:00,2025-05-25,00:19,1,0,1
29,2025-05-24T16:23:00+02:00,2025-05-25,00:23,0,4,4
31,2025-05-24T16:21:00+02:00,2025-05-25,00:21,0,2,2
31,2025-05-24T16:24:00+02:00,2025-05-25,00:24,1,0,1
36,2025-05-24T16:12:00+02:00,2025-05-25,00:12,2,5,7
36,2025-05-24T16:24:00+02:00,2025-05-25,00:24,4,3,7
37,2025-05-24T16:11:00+02:00,2025-05-25,00:11,0,1,1
37,2025-05-24T16:12:00+02:00,2025-05-25,00:12,0,2,2
37,2025-05-24T16:17:00+02:00,2025-05-25,00:17,1,1,2
39,2025-05-24T16:22:00+02:00,2025-05-25,00:22,1,0,1
39,2025-05-24T16:23:00+02:00,2025-05-25,00:23,3,1,4
40,2025-05-24T16:13:00+02:00,2025-05-25,00:13,2,0,2
40,2025-05-24T16:15:00+02:00,2025-05-25,00:15,5,0,5
40,2025-05-24T16:17:00+02:00,2025-05-25,00:17,3,0,3
40,2025-05-24T16:24:00+02:00,2025-05-25,00:24,0,1,1
41,2025-05-24T16:18:00+02:00,2025-05-25,00:18,2,1,3
41,2025-05-24T16:19:00+02:00,2025-05-25,00:19,0,2,2
41,2025-05-24T16:22:00+02:00,2025-05-25,00:22,1,2,3
41,2025-05-24T16:23:00+02:00,2025-05-25,00:23,3,1,4
41,2025-05-24T16:24:00+02:00,2025-05-25,00:24,0,1,1
45,2025-05-24T16:16:00+02:00,2025-05-25,00:16,2,12,14
45,2025-05-24T16:18:00+02:00,2025-05-25,00:18,2,6,8
3,2025-05-25T04:56:00+02:00,2025-05-25,12:56,12,29,41
3,2025-05-25T05:01:00+02:00,2025-05-25,13:01,10,34,44
3,2025-05-25T05:02:00+02:00,2025-05-25,13:02,18,18,36
3,2025-05-25T05:05:00+02:00,2025-05-25,13:05,13,23,36
3,2025-05-25T05:07:00+02:00,2025-05-25,13:07,30,27,57
3,2025-05-25T05:09:00+02:00,2025-05-25,13:09,11,22,33
4,2025-05-25T04:58:00+02:00,2025-05-25,12:58,25,27,52
4,2025-05-25T05:01:00+02:00,2025-05-25,13:01,52,20,72
4,2025-05-25T05:02:00+02:00,2025-05-25,13:02,30,14,44
4,2025-05-25T05:05:00+02:00,2025-05-25,13:05,44,19,63
4,2025-05-25T05:09:00+02:00,2025-05-25,13:09,42,23,65
5,2025-05-25T05:00:00+02:00,2025-05-25,13:00,93,66,159
6,2025-05-25T04:56:00+02:00,2025-05-25,12:56,8,8,16
6,2025-05-25T05:05:00+02:00,2025-05-25,13:05,8,25,33
6,2025-05-25T05:08:00+02:00,2025-05-25,13:08,3,18,21
8,2025-05-25T04:55:00+02:00,2025-05-25,12:55,3,2,5
8,2025-05-25T04:56:00+02:00,2025-05-25,12:56,1,7,8
8,2025-05-25T05:00:00+02:00,2025-05-25,13:00,4,8,12
8,2025-05-25T05:01:00+02:00,2025-05-25,13:01,3,10,13
8,2025-05-25T05:05:00+02:00,2025-05-25,13:05,3,10,13
8,2025-05-25T05:07:00+02:00,2025-05-25,13:07,9,7,16
8,2025-05-25T05:09:00+02:00,2025-05-25,13:09,0,6,6
28,2025-05-25T04:57:00+02:00,2025-05-25,12:57,5,14,19
28,2025-05-25T04:59:00+02:00,2025-05-25,12:59,9,12,21
28,2025-05-25T05:00:00+02:00,2025-05-25,13:00,12,9,21
28,2025-05-25T05:02:00+02:00,2025-05-25,13:02,11,9,20
28,2025-05-25T05:03:00+02:00,2025-05-25,13:03,8,19,27
28,2025-05-25T05:04:00+02:00,2025-05-25,13:04,7,8,15
29,2025-05-25T04:56:00+02:00,2025-05-25,12:56,12,13,25
29,2025-05-25T04:58:00+02:00,2025-05-25,12:58,10,14,24
29,2025-05-25T04:59:00+02:00,2025-05-25,12:59,15,14,29
29,2025-05-25T05:00:00+02:00,2025-05-25,13:00,8,16,24
29,2025-05-25T05:01:00+02:00,2025-05-25,13:01,17,7,24
29,2025-05-25T05:02:00+02:00,2025-05-25,13:02,22,7,29
29,2025-05-25T05:05:00+02:00,2025-05-25,13:05,6,14,20
31,2025-05-25T04:58:00+02:00,2025-05-25,12:58,0,4,4
31,2025-05-25T05:01:00+02:00,2025-05-25,13:01,0,7,7
31,2025-05-25T05:02:00+02:00,2025-05-25,13:02,5,7,12
31,2025-05-25T05:09:00+02:00,2025-05-25,13:09,3,6,9
36,2025-05-25T04:55:00+02:00,2025-05-25,12:55,0,4,4
36,2025-05-25T04:57:00+02:00,2025-05-25,12:57,2,1,3
36,2025-05-25T05:02:00+02:00,2025-05-25,13:02,0,1,1
36,2025-05-25T05:07:00+02:00,2025-05-25,13:07,1,0,1
39,2025-05-25T04:56:00+02:00,2025-05-25,12:56,2,0,2
40,2025-05-25T04:58:00+02:00,2025-05-25,12:58,6,6,12
40,2025-05-25T05:02:00+02:00,2025-05-25,13:02,1,2,3
40,2025-05-25T05:03:00+02:00,2025-05-25,13:03,2,1,3
40,2025-05-25T05:05:00+02:00,2025-05-25,13:05,1,5,6
40,2025-05-25T05:06:00+02:00,2025-05-25,13:06,3,5,8
40,2025-05-25T05:08:00+02:00,2025-05-25,13:08,1,4,5
41,2025-05-25T05:02:00+02:00,2025-05-25,13:02,7,19,26
41,2025-05-25T05:06:00+02:00,2025-05-25,13:06,26,6,32
41,2025-05-25T05:09:00+02:00,2025-05-25,13:09,25,3,28
45,2025-05-25T04:55:00+02:00,2025-05-25,12:55,19,19,38
45,2025-05-25T05:01:00+02:00,2025-05-25,13:01,13,18,31
45,2025-05-25T05:02:00+02:00,2025-05-25,13:02,11,15,26
45,2025-05-25T05:05:00+02:00,2025-05-25,13:05,19,40,59
45,2025-05-25T05:07:00+02:00,2025-05-25,13:07,23,40,63
45,2025-05-25T05:09:00+02:00,2025-05-25,13:09,22,16,38
47,2025-05-25T04:59:00+02:00,2025-05-25,12:59,16,12,28
47,2025-05-25T05:01:00+02:00,2025-05-25,13:01,16,17,33
47,2025-05-25T05:02:00+02:00,2025-05-25,13:02,21,15,36
47,2025-05-25T05:06:00+02:00,2025-05-25,13:06,15,10,25
47,2025-05-25T05:08:00+02:00,2025-05-25,13:08,23,28,51
50,2025-05-25T05:01:00+02:00,2025-05-25,13:01,2,1,3
50,2025-05-25T05:02:00+02:00,2025-05-25,13:02,5,4,9
50,2025-05-25T05:04:00+02:00,2025-05-25,13:04,10,2,12
50,2025-05-25T05:06:00+02:00,2025-05-25,13:06,5,2,7
54,2025-05-25T05:04:00+02:00,2025-05-25,13:04,4,1,5
54,2025-05-25T05:07:00+02:00,2025-05-25,13:07,4,2,6
54,2025-05-25T05:08:00+02:00,2025-05-25,13:08,1,2,3
61,2025-05-25T04:58:00+02:00,2025-05-25,12:58,9,11,20
61,2025-05-25T04:59:00+02:00,2025-05-25,12:59,7,12,19
61,2025-05-25T05:00:00+02:00,2025-05-25,13:00,6,11,17
61,2025-05-25T05:01:00+02:00,2025-05-25,13:01,11,4,15
61,2025-05-25T05:02:00+02:00,2025-05-25,13:02,20,8,28
61,2025-05-25T05:04:00+02:00,2025-05-25,13:04,13,15,28
61,2025-05-25T05:05:00+02:00,2025-05-25,13:05,7,5,12
66,2025-05-25T04:58:00+02:00,2025-05-25,12:58,17,32,49
66,2025-05-25T05:05:00+02:00,2025-05-25,13:05,21,48,69
69,2025-05-25T04:58:00+02:00,2025-05-25,12:58,3,0,3
69,2025-05-25T04:59:00+02:00,2025-05-25,12:59,5,2,7
69,2025-05-25T05:03:00+02:00,2025-05-25,13:03,9,9,18
70,2025-05-25T04:56:00+02:00,2025-05-25,12:56,4,4,8
70,2025-05-25T05:01:00+02:00,2025-05-25,13:01,0,2,2
70,2025-05-25T05:02:00+02:00,2025-05-25,13:02,3,1,4
70,2025-05-25T05:03:00+02:00,2025-05-25,13:03,6,3,9
70,2025-05-25T05:05:00+02:00,2025-05-25,13:05,5,2,7
70,2025-05-25T05:06:00+02:00,2025-05-25,13:06,6,1,7
70,2025-05-25T05:07:00+02:00,2025-05-25,13:07,1,3,4
75,2025-05-25T04:55:00+02:00,2025-05-25,12:55,2,2,4
75,2025-05-25T05:01:00+02:00,2025-05-25,13:01,1,2,3
77,2025-05-25T04:55:00+02:00,2025-05-25,12:55,10,5,15
78,2025-05-25T04:57:00+02:00,2025-05-25,12:57,2,1,3
78,2025-05-25T04:59:00+02:00,2025-05-25,12:59,2,0,2
78,2025-05-25T05:01:00+02:00,2025-05-25,13:01,0,2,2
78,2025-05-25T05:02:00+02:00,2025-05-25,13:02,1,0,1
78,2025-05-25T05:05:00+02:00,2025-05-25,13:05,0,2,2
78,2025-05-25T05:08:00+02:00,2025-05-25,13:08,0,1,1
84,2025-05-25T04:55:00+02:00,2025-05-25,12:55,67,89,156
84,2025-05-25T05:00:00+02:00,2025-05-25,13:00,71,94,165
87,2025-05-25T04:56:00+02:00,2025-05-25,12:56,2,0,2
87,2025-05-25T04:57:00+02:00,2025-05-25,12:57,3,1,4
87,2025-05-25T04:59:00+02:00,2025-05-25,12:59,4,0,4
87,2025-05-25T05:00:00+02:00,2025-05-25,13:00,1,3,4
87,2025-05-25T05:02:00+02:00,2025-05-25,13:02,0,3,3
87,2025-05-25T05:07:00+02:00,2025-05-25,13:07,4,7,11
87,2025-05-25T05:08:00+02:00,2025-05-25,13:08,1,3,4
107,2025-05-25T04:55:00+02:00,2025-05-25,12:55,20,5,25
107,2025-05-25T05:00:00+02:00,2025-05-25,13:00,19,13,32
108,2025-05-25T04:57:00+02:00,2025-05-25,12:57,3,3,6
108,2025-05-25T04:58:00+02:00,2025-05-25,12:58,5,2,7
108,2025-05-25T04:59:00+02:00,2025-05-25,12:59,1,7,8
108,2025-05-25T05:06:00+02:00,2025-05-25,13:06,0,3,3
108,2025-05-25T05:07:00+02:00,2025-05-25,13:07,2,4,6
131,2025-05-25T05:00:00+02:00,2025-05-25,13:00,7,10,17
131,2025-05-25T05:05:00+02:00,2025-05-25,13:05,12,11,23
132,2025-05-25T04:55:00+02:00,2025-05-25,12:55,16,13,29
132,2025-05-25T05:05:00+02:00,2025-05-25,13:05,16,10,26
133,2025-05-25T05:05:00+02:00,2025-05-25,13:05,30,41,71
135,2025-05-25T04:55:00+02:00,2025-05-25,12:55,31,40,71
135,2025-05-25T05:00:00+02:00,2025-05-25,13:00,21,45,66
140,2025-05-25T04:55:00+02:00,2025-05-25,12:55,13,9,22
162,2025-05-25T05:05:00+02:00,2025-05-25,13:05,59,100,159
165,2025-05-25T04:55:00+02:00,2025-05-25,12:55,0,10,10
165,2025-05-25T05:05:00+02:00,2025-05-25,13:05,1,2,3
166,2025-05-25T04:55:00+02:00,2025-05-25,12:55,8,1,9
167,2025-05-25T05:05:00+02:00,2025-05-25,13:05,0,3,3
179,2025-05-25T05:05:00+02:00,2025-05-25,13:05,8,7,15
1,2025-05-25T04:56:00+02:00,2025-05-25,12:56,29,28,57
1,2025-05-25T04:57:00+02:00,2025-05-25,12:57,14,22,36
1,2025-05-25T04:59:00+02:00,2025-05-25,12:59,27,28,55
1,2025-05-25T05:00:00+02:00,2025-05-25,13:00,19,13,32
1,2025-05-25T05:01:00+02:00,2025-05-25,13:01,6,15,21
1,2025-05-25T05:02:00+02:00,2025-05-25,13:02,8,36,44
1,2025-05-25T05:03:00+02:00,2025-05-25,13:03,20,55,75
1,2025-05-25T05:08:00+02:00,2025-05-25,13:08,32,19,51
2,2025-05-25T04:55:00+02:00,2025-05-25,12:55,13,8,21
2,2025-05-25T04:56:00+02:00,2025-05-25,12:56,15,13,28
2,2025-05-25T04:59:00+02:00,2025-05-25,12:59,10,19,29
2,2025-05-25T05:06:00+02:00,2025-05-25,13:06,9,15,24
2,2025-05-25T05:07:00+02:00,2025-05-25,13:07,8,20,28
9,2025-05-25T04:58:00+02:00,2025-05-25,12:58,2,0,2
9,2025-05-25T04:59:00+02:00,2025-05-25,12:59,0,2,2
9,2025-05-25T05:00:00+02:00,2025-05-25,13:00,0,1,1
9,2025-05-25T05:06:00+02:00,2025-05-25,13:06,0,2,2
10,2025-05-25T04:56:00+02:00,2025-05-25,12:56,1,2,3
10,2025-05-25T05:00:00+02:00,2025-05-25,13:00,2,0,2
10,2025-05-25T05:01:00+02:00,2025-05-25,13:01,4,4,8
10,2025-05-25T05:07:00+02:00,2025-05-25,13:07,1,0,1
11,2025-05-25T05:01:00+02:00,2025-05-25,13:01,0,1,1
11,2025-05-25T05:02:00+02:00,2025-05-25,13:02,6,6,12
11,2025-05-25T05:09:00+02:00,2025-05-25,13:09,0,4,4
12,2025-05-25T04:55:00+02:00,2025-05-25,12:55,0,8,8
12,2025-05-25T05:00:00+02:00,2025-05-25,13:00,3,4,7
12,2025-05-25T05:02:00+02:00,2025-05-25,13:02,2,4,6
12,2025-05-25T05:03:00+02:00,2025-05-25,13:03,6,0,6
12,2025-05-25T05:05:00+02:00,2025-05-25,13:05,4,3,7
12,2025-05-25T05:09:00+02:00,2025-05-25,13:09,5,2,7
17,2025-05-25T04:55:00+02:00,2025-05-25,12:55,2,0,2
17,2025-05-25T05:01:00+02:00,2025-05-25,13:01,5,4,9
17,2025-05-25T05:02:00+02:00,2025-05-25,13:02,4,0,4
17,2025-05-25T05:04:00+02:00,2025-05-25,13:04,3,0,3
17,2025-05-25T05:05:00+02:00,2025-05-25,13:05,1,0,1
17,2025-05-25T05:07:00+02:00,2025-05-25,13:07,4,2,6
17,2025-05-25T05:08:00+02:00,2025-05-25,13:08,0,2,2
17,2025-05-25T05:09:00+02:00,2025-05-25,13:09,3,3,6
18,2025-05-25T04:55:00+02:00,2025-05-25,12:55,1,0,1
18,2025-05-25T05:08:00+02:00,2025-05-25,13:08,1,3,4
19,2025-05-25T05:05:00+02:00,2025-05-25,13:05,12,3,15
19,2025-05-25T05:06:00+02:00,2025-05-25,13:06,14,5,19
19,2025-05-25T05:08:00+02:00,2025-05-25,13:08,6,11,17
19,2025-05-25T05:09:00+02:00,2025-05-25,13:09,12,13,25
20,2025-05-25T05:00:00+02:00,2025-05-25,13:00,5,5,10
20,2025-05-25T05:01:00+02:00,2025-05-25,13:01,8,10,18
20,2025-05-25T05:02:00+02:00,2025-05-25,13:02,1,7,8
20,2025-05-25T05:03:00+02:00,2025-05-25,13:03,10,7,17
20,2025-05-25T05:05:00+02:00,2025-05-25,13:05,6,5,11
20,2025-05-25T05:09:00+02:00,2025-05-25,13:09,5,9,14
23,2025-05-25T05:00:00+02:00,2025-05-25,13:00,1,9,10
23,2025-05-25T05:04:00+02:00,2025-05-25,13:04,1,2,3
24,2025-05-25T04:57:00+02:00,2025-05-25,12:57,8,7,15
24,2025-05-25T05:00:00+02:00,2025-05-25,13:00,14,2,16
24,2025-05-25T05:03:00+02:00,2025-05-25,13:03,7,14,21
24,2025-05-25T05:04:00+02:00,2025-05-25,13:04,6,9,15
24,2025-05-25T05:05:00+02:00,2025-05-25,13:05,21,3,24
24,2025-05-25T05:08:00+02:00,2025-05-25,13:08,9,15,24
25,2025-05-25T05:00:00+02:00,2025-05-25,13:00,92,113,205
25,2025-05-25T05:05:00+02:00,2025-05-25,13:05,84,83,167
27,2025-05-25T04:57:00+02:00,2025-05-25,12:57,12,8,20
27,2025-05-25T04:58:00+02:00,2025-05-25,12:58,9,8,17
27,2025-05-25T05:03:00+02:00,2025-05-25,13:03,9,11,20
27,2025-05-25T05:06:00+02:00,2025-05-25,13:06,4,2,6
30,2025-05-25T04:58:00+02:00,2025-05-25,12:58,2,17,19
30,2025-05-25T04:59:00+02:00,2025-05-25,12:59,2,11,13
30,2025-05-25T05:03:00+02:00,2025-05-25,13:03,12,2,14
30,2025-05-25T05:04:00+02:00,2025-05-25,13:04,3,0,3
30,2025-05-25T05:05:00+02:00,2025-05-25,13:05,4,4,8
30,2025-05-25T05:08:00+02:00,2025-05-25,13:08,4,5,9
30,2025-05-25T05:09:00+02:00,2025-05-25,13:09,3,15,18
35,2025-05-25T04:55:00+02:00,2025-05-25,12:55,18,21,39
35,2025-05-25T04:56:00+02:00,2025-05-25,12:56,8,26,34
35,2025-05-25T05:07:00+02:00,2025-05-25,13:07,24,20,44
35,2025-05-25T05:08:00+02:00,2025-05-25,13:08,16,32,48
48,2025-05-25T04:55:00+02:00,2025-05-25,12:55,6,14,20
48,2025-05-25T05:01:00+02:00,2025-05-25,13:01,11,2,13
48,2025-05-25T05:02:00+02:00,2025-05-25,13:02,12,5,17
48,2025-05-25T05:04:00+02:00,2025-05-25,13:04,9,1,10
48,2025-05-25T05:05:00+02:00,2025-05-25,13:05,6,11,17
48,2025-05-25T05:06:00+02:00,2025-05-25,13:06,13,4,17
48,2025-05-25T05:07:00+02:00,2025-05-25,13:07,14,8,22
49,2025-05-25T04:55:00+02:00,2025-05-25,12:55,5,11,16
49,2025-05-25T04:56:00+02:00,2025-05-25,12:56,6,9,15
49,2025-05-25T04:59:00+02:00,2025-05-25,12:59,4,10,14
49,2025-05-25T05:01:00+02:00,2025-05-25,13:01,7,11,18
49,2025-05-25T05:06:00+02:00,2025-05-25,13:06,3,17,20
49,2025-05-25T05:08:00+02:00,2025-05-25,13:08,4,26,30
51,2025-05-25T04:59:00+02:00,2025-05-25,12:59,3,2,5
51,2025-05-25T05:01:00+02:00,2025-05-25,13:01,6,2,8
51,2025-05-25T05:02:00+02:00,2025-05-25,13:02,1,3,4
52,2025-05-25T04:55:00+02:00,2025-05-25,12:55,9,5,14
52,2025-05-25T04:59:00+02:00,2025-05-25,12:59,5,2,7
53,2025-05-25T05:03:00+02:00,2025-05-25,13:03,6,6,12
53,2025-05-25T05:06:00+02:00,2025-05-25,13:06,7,12,19
53,2025-05-25T05:07:00+02:00,2025-05-25,13:07,10,8,18
56,2025-05-25T04:58:00+02:00,2025-05-25,12:58,9,4,13
58,2025-05-25T04:57:00+02:00,2025-05-25,12:57,10,14,24
58,2025-05-25T04:58:00+02:00,2025-05-25,12:58,15,3,18
58,2025-05-25T05:01:00+02:00,2025-05-25,13:01,4,11,15
58,2025-05-25T05:04:00+02:00,2025-05-25,13:04,11,6,17
58,2025-05-25T05:05:00+02:00,2025-05-25,13:05,19,9,28
62,2025-05-25T04:58:00+02:00,2025-05-25,12:58,2,3,5
62,2025-05-25T04:59:00+02:00,2025-05-25,12:59,6,1,7
63,2025-05-25T05:00:00+02:00,2025-05-25,13:00,6,12,18
63,2025-05-25T05:01:00+02:00,2025-05-25,13:01,2,6,8
63,2025-05-25T05:07:00+02:00,2025-05-25,13:07,14,3,17
67,2025-05-25T05:04:00+02:00,2025-05-25,13:04,11,10,21
67,2025-05-25T05:09:00+02:00,2025-05-25,13:09,14,15,29
68,2025-05-25T04:55:00+02:00,2025-05-25,12:55,5,4,9
68,2025-05-25T04:57:00+02:00,2025-05-25,12:57,5,3,8
68,2025-05-25T05:04:00+02:00,2025-05-25,13:04,4,6,10
72,2025-05-25T04:57:00+02:00,2025-05-25,12:57,3,5,8
72,2025-05-25T05:04:00+02:00,2025-05-25,13:04,10,3,13
72,2025-05-25T05:06:00+02:00,2025-05-25,13:06,2,12,14
72,2025-05-25T05:08:00+02:00,2025-05-25,13:08,4,6,10
76,2025-05-25T04:57:00+02:00,2025-05-25,12:57,0,1,1
76,2025-05-25T05:05:00+02:00,2025-05-25,13:05,1,4,5
79,2025-05-25T04:55:00+02:00,2025-05-25,12:55,8,5,13
79,2025-05-25T04:57:00+02:00,2025-05-25,12:57,7,4,11
79,2025-05-25T05:08:00+02:00,2025-05-25,13:08,11,8,19
85,2025-05-25T04:59:00+02:00,2025-05-25,12:59,2,0,2
85,2025-05-25T05:02:00+02:00,2025-05-25,13:02,2,0,2
85,2025-05-25T05:03:00+02:00,2025-05-25,13:03,2,0,2
85,2025-05-25T05:04:00+02:00,2025-05-25,13:04,1,2,3
85,2025-05-25T05:08:00+02:00,2025-05-25,13:08,1,3,4
86,2025-05-25T05:01:00+02:00,2025-05-25,13:01,0,1,1
86,2025-05-25T05:05:00+02:00,2025-05-25,13:05,2,0,2
109,2025-05-25T04:55:00+02:00,2025-05-25,12:55,4,11,15
109,2025-05-25T05:00:00+02:00,2025-05-25,13:00,2,10,12
117,2025-05-25T04:55:00+02:00,2025-05-25,12:55,12,23,35
117,2025-05-25T05:00:00+02:00,2025-05-25,13:00,7,17,24
123,2025-05-25T05:00:00+02:00,2025-05-25,13:00,6,2,8
123,2025-05-25T05:05:00+02:00,2025-05-25,13:05,4,0,4
136,2025-05-25T05:00:00+02:00,2025-05-25,13:00,25,6,31
136,2025-05-25T05:05:00+02:00,2025-05-25,13:05,16,9,25
139,2025-05-25T05:00:00+02:00,2025-05-25,13:00,4,2,6
141,2025-05-25T04:55:00+02:00,2025-05-25,12:55,4,14,18
142,2025-05-25T05:00:00+02:00,2025-05-25,13:00,34,37,71
142,2025-05-25T05:05:00+02:00,2025-05-25,13:05,53,35,88
161,2025-05-25T04:55:00+02:00,2025-05-25,12:55,19,16,35
161,2025-05-25T05:00:00+02:00,2025-05-25,13:00,39,18,57
181,2025-05-25T05:12:00+02:00,2025-05-25,13:12,4,25,29
181,2025-05-25T05:14:00+02:00,2025-05-25,13:14,23,14,37
181,2025-05-25T05:18:00+02:00,2025-05-25,13:18,10,23,33
181,2025-05-25T05:24:00+02:00,2025-05-25,13:24,16,12,28
182,2025-05-25T05:20:00+02:00,2025-05-25,13:20,16,13,29
180,2025-05-25T05:19:00+02:00,2025-05-25,13:19,2,0,2
180,2025-05-25T05:21:00+02:00,2025-05-25,13:21,1,0,1
180,2025-05-25T05:23:00+02:00,2025-05-25,13:23,0,1,1
180,2025-05-25T05:24:00+02:00,2025-05-25,13:24,0,6,6
181,2025-05-25T04:55:00+02:00,2025-05-25,12:55,9,17,26
181,2025-05-25T04:59:00+02:00,2025-05-25,12:59,11,23,34
181,2025-05-25T05:01:00+02:00,2025-05-25,13:01,7,18,25
181,2025-05-25T05:03:00+02:00,2025-05-25,13:03,6,16,22
181,2025-05-25T05:04:00+02:00,2025-05-25,13:04,23,27,50
181,2025-05-25T05:05:00+02:00,2025-05-25,13:05,19,24,43
182,2025-05-25T05:00:00+02:00,2025-05-25,13:00,25,17,42
180,2025-05-25T04:57:00+02:00,2025-05-25,12:57,2,1,3
180,2025-05-25T04:58:00+02:00,2025-05-25,12:58,3,3,6
180,2025-05-25T05:06:00+02:00,2025-05-25,13:06,0,1,1
3,2025-05-25T05:10:00+02:00,2025-05-25,13:10,33,17,50
3,2025-05-25T05:16:00+02:00,2025-05-25,13:16,18,27,45
3,2025-05-25T05:17:00+02:00,2025-05-25,13:17,12,29,41
4,2025-05-25T05:10:00+02:00,2025-05-25,13:10,28,17,45
4,2025-05-25T05:18:00+02:00,2025-05-25,13:18,22,22,44
4,2025-05-25T05:21:00+02:00,2025-05-25,13:21,39,16,55
4,2025-05-25T05:22:00+02:00,2025-05-25,13:22,26,38,64
6,2025-05-25T05:10:00+02:00,2025-05-25,13:10,7,12,19
6,2025-05-25T05:13:00+02:00,2025-05-25,13:13,12,6,18
6,2025-05-25T05:22:00+02:00,2025-05-25,13:22,11,13,24
6,2025-05-25T05:23:00+02:00,2025-05-25,13:23,21,7,28
6,2025-05-25T05:24:00+02:00,2025-05-25,13:24,19,13,32
8,2025-05-25T05:14:00+02:00,2025-05-25,13:14,4,4,8
8,2025-05-25T05:18:00+02:00,2025-05-25,13:18,3,3,6
8,2025-05-25T05:22:00+02:00,2025-05-25,13:22,1,8,9
28,2025-05-25T05:13:00+02:00,2025-05-25,13:13,10,7,17
28,2025-05-25T05:14:00+02:00,2025-05-25,13:14,13,8,21
28,2025-05-25T05:15:00+02:00,2025-05-25,13:15,3,5,8
28,2025-05-25T05:18:00+02:00,2025-05-25,13:18,5,13,18
28,2025-05-25T05:23:00+02:00,2025-05-25,13:23,14,10,24
29,2025-05-25T05:15:00+02:00,2025-05-25,13:15,0,16,16
29,2025-05-25T05:16:00+02:00,2025-05-25,13:16,4,12,16
29,2025-05-25T05:17:00+02:00,2025-05-25,13:17,6,8,14
29,2025-05-25T05:21:00+02:00,2025-05-25,13:21,5,19,24
29,2025-05-25T05:23:00+02:00,2025-05-25,13:23,29,10,39
31,2025-05-25T05:10:00+02:00,2025-05-25,13:10,3,8,11
31,2025-05-25T05:14:00+02:00,2025-05-25,13:14,3,3,6
31,2025-05-25T05:16:00+02:00,2025-05-25,13:16,3,3,6
31,2025-05-25T05:20:00+02:00,2025-05-25,13:20,4,2,6
36,2025-05-25T05:11:00+02:00,2025-05-25,13:11,0,4,4
36,2025-05-25T05:18:00+02:00,2025-05-25,13:18,1,0,1
36,2025-05-25T05:21:00+02:00,2025-05-25,13:21,8,0,8
39,2025-05-25T05:13:00+02:00,2025-05-25,13:13,1,1,2
39,2025-05-25T05:14:00+02:00,2025-05-25,13:14,0,1,1
39,2025-05-25T05:18:00+02:00,2025-05-25,13:18,3,0,3
39,2025-05-25T05:20:00+02:00,2025-05-25,13:20,1,0,1
39,2025-05-25T05:22:00+02:00,2025-05-25,13:22,1,0,1
40,2025-05-25T05:15:00+02:00,2025-05-25,13:15,1,7,8
40,2025-05-25T05:20:00+02:00,2025-05-25,13:20,2,5,7
40,2025-05-25T05:23:00+02:00,2025-05-25,13:23,4,8,12
41,2025-05-25T05:10:00+02:00,2025-05-25,13:10,23,9,32
41,2025-05-25T05:11:00+02:00,2025-05-25,13:11,9,21,30
41,2025-05-25T05:12:00+02:00,2025-05-25,13:12,23,4,27
41,2025-05-25T05:16:00+02:00,2025-05-25,13:16,8,0,8
41,2025-05-25T05:18:00+02:00,2025-05-25,13:18,5,2,7
41,2025-05-25T05:23:00+02:00,2025-05-25,13:23,2,12,14
41,2025-05-25T05:24:00+02:00,2025-05-25,13:24,5,4,9
43,2025-05-25T05:20:00+02:00,2025-05-25,13:20,11,5,16
44,2025-05-25T05:15:00+02:00,2025-05-25,13:15,1,4,5
45,2025-05-25T05:11:00+02:00,2025-05-25,13:11,17,17,34
45,2025-05-25T05:16:00+02:00,2025-05-25,13:16,21,16,37
45,2025-05-25T05:18:00+02:00,2025-05-25,13:18,10,18,28
45,2025-05-25T05:24:00+02:00,2025-05-25,13:24,9,23,32
47,2025-05-25T05:11:00+02:00,2025-05-25,13:11,15,20,35
47,2025-05-25T05:12:00+02:00,2025-05-25,13:12,13,16,29
47,2025-05-25T05:15:00+02:00,2025-05-25,13:15,15,6,21
47,2025-05-25T05:16:00+02:00,2025-05-25,13:16,12,20,32
47,2025-05-25T05:19:00+02:00,2025-05-25,13:19,10,36,46
47,2025-05-25T05:20:00+02:00,2025-05-25,13:20,16,22,38
47,2025-05-25T05:21:00+02:00,2025-05-25,13:21,9,6,15
47,2025-05-25T05:22:00+02:00,2025-05-25,13:22,8,20,28
47,2025-05-25T05:24:00+02:00,2025-05-25,13:24,21,7,28
50,2025-05-25T05:10:00+02:00,2025-05-25,13:10,4,7,11
50,2025-05-25T05:11:00+02:00,2025-05-25,13:11,0,9,9
50,2025-05-25T05:12:00+02:00,2025-05-25,13:12,9,9,18
50,2025-05-25T05:16:00+02:00,2025-05-25,13:16,7,5,12
50,2025-05-25T05:17:00+02:00,2025-05-25,13:17,1,4,5
50,2025-05-25T05:19:00+02:00,2025-05-25,13:19,4,17,21
50,2025-05-25T05:21:00+02:00,2025-05-25,13:21,6,6,12
54,2025-05-25T05:12:00+02:00,2025-05-25,13:12,1,4,5
54,2025-05-25T05:14:00+02:00,2025-05-25,13:14,3,0,3
54,2025-05-25T05:16:00+02:00,2025-05-25,13:16,0,5,5
54,2025-05-25T05:20:00+02:00,2025-05-25,13:20,4,4,8
54,2025-05-25T05:23:00+02:00,2025-05-25,13:23,3,0,3
59,2025-05-25T05:20:00+02:00,2025-05-25,13:20,19,30,49
61,2025-05-25T05:14:00+02:00,2025-05-25,13:14,13,3,16
61,2025-05-25T05:16:00+02:00,2025-05-25,13:16,12,14,26
61,2025-05-25T05:17:00+02:00,2025-05-25,13:17,19,2,21
61,2025-05-25T05:18:00+02:00,2025-05-25,13:18,11,3,14
61,2025-05-25T05:19:00+02:00,2025-05-25,13:19,10,16,26
61,2025-05-25T05:20:00+02:00,2025-05-25,13:20,2,9,11
61,2025-05-25T05:22:00+02:00,2025-05-25,13:22,7,2,9
66,2025-05-25T05:12:00+02:00,2025-05-25,13:12,29,12,41
66,2025-05-25T05:18:00+02:00,2025-05-25,13:18,18,13,31
66,2025-05-25T05:19:00+02:00,2025-05-25,13:19,19,24,43
66,2025-05-25T05:23:00+02:00,2025-05-25,13:23,24,11,35
66,2025-05-25T05:24:00+02:00,2025-05-25,13:24,26,33,59
69,2025-05-25T05:10:00+02:00,2025-05-25,13:10,0,5,5
69,2025-05-25T05:11:00+02:00,2025-05-25,13:11,2,5,7
69,2025-05-25T05:13:00+02:00,2025-05-25,13:13,4,2,6
69,2025-05-25T05:14:00+02:00,2025-05-25,13:14,3,1,4
69,2025-05-25T05:16:00+02:00,2025-05-25,13:16,1,1,2
69,2025-05-25T05:19:00+02:00,2025-05-25,13:19,4,12,16
69,2025-05-25T05:20:00+02:00,2025-05-25,13:20,6,3,9
69,2025-05-25T05:21:00+02:00,2025-05-25,13:21,0,5,5
69,2025-05-25T05:23:00+02:00,2025-05-25,13:23,3,6,9
70,2025-05-25T05:10:00+02:00,2025-05-25,13:10,4,5,9
70,2025-05-25T05:12:00+02:00,2025-05-25,13:12,5,0,5
70,2025-05-25T05:14:00+02:00,2025-05-25,13:14,5,9,14
70,2025-05-25T05:18:00+02:00,2025-05-25,13:18,2,1,3
70,2025-05-25T05:19:00+02:00,2025-05-25,13:19,1,2,3
70,2025-05-25T05:20:00+02:00,2025-05-25,13:20,8,0,8
75,2025-05-25T05:15:00+02:00,2025-05-25,13:15,1,0,1
75,2025-05-25T05:17:00+02:00,2025-05-25,13:17,2,1,3
75,2025-05-25T05:21:00+02:00,2025-05-25,13:21,0,2,2
77,2025-05-25T05:20:00+02:00,2025-05-25,13:20,29,8,37
78,2025-05-25T05:10:00+02:00,2025-05-25,13:10,0,4,4
78,2025-05-25T05:12:00+02:00,2025-05-25,13:12,1,7,8
78,2025-05-25T05:18:00+02:00,2025-05-25,13:18,1,1,2
78,2025-05-25T05:21:00+02:00,2025-05-25,13:21,2,0,2
78,2025-05-25T05:23:00+02:00,2025-05-25,13:23,2,0,2
84,2025-05-25T05:20:00+02:00,2025-05-25,13:20,100,87,187
87,2025-05-25T05:11:00+02:00,2025-05-25,13:11,3,4,7
87,2025-05-25T05:13:00+02:00,2025-05-25,13:13,2,0,2
87,2025-05-25T05:20:00+02:00,2025-05-25,13:20,3,2,5
87,2025-05-25T05:23:00+02:00,2025-05-25,13:23,3,1,4
107,2025-05-25T05:10:00+02:00,2025-05-25,13:10,1,13,14
107,2025-05-25T05:20:00+02:00,2025-05-25,13:20,11,9,20
108,2025-05-25T05:10:00+02:00,2025-05-25,13:10,1,4,5
108,2025-05-25T05:11:00+02:00,2025-05-25,13:11,3,2,5
108,2025-05-25T05:15:00+02:00,2025-05-25,13:15,3,0,3
108,2025-05-25T05:21:00+02:00,2025-05-25,13:21,6,1,7
108,2025-05-25T05:24:00+02:00,2025-05-25,13:24,3,6,9
118,2025-05-25T05:10:00+02:00,2025-05-25,13:10,1,1,2
118,2025-05-25T05:15:00+02:00,2025-05-25,13:15,1,3,4
133,2025-05-25T05:15:00+02:00,2025-05-25,13:15,28,39,67
134,2025-05-25T05:15:00+02:00,2025-05-25,13:15,25,24,49
140,2025-05-25T05:10:00+02:00,2025-05-25,13:10,10,4,14
162,2025-05-25T05:10:00+02:00,2025-05-25,13:10,81,63,144
165,2025-05-25T05:10:00+02:00,2025-05-25,13:10,3,2,5
165,2025-05-25T05:20:00+02:00,2025-05-25,13:20,3,4,7
167,2025-05-25T05:15:00+02:00,2025-05-25,13:15,1,0,1
167,2025-05-25T05:20:00+02:00,2025-05-25,13:20,1,1,2
179,2025-05-25T05:15:00+02:00,2025-05-25,13:15,18,3,21
1,2025-05-25T05:15:00+02:00,2025-05-25,13:15,46,22,68
1,2025-05-25T05:17:00+02:00,2025-05-25,13:17,18,21,39
1,2025-05-25T05:18:00+02:00,2025-05-25,13:18,14,27,41
1,2025-05-25T05:21:00+02:00,2025-05-25,13:21,12,20,32
1,2025-05-25T05:23:00+02:00,2025-05-25,13:23,24,14,38
1,2025-05-25T05:24:00+02:00,2025-05-25,13:24,31,17,48
2,2025-05-25T05:10:00+02:00,2025-05-25,13:10,7,11,18
2,2025-05-25T05:11:00+02:00,2025-05-25,13:11,15,18,33
2,2025-05-25T05:12:00+02:00,2025-05-25,13:12,17,11,28
2,2025-05-25T05:16:00+02:00,2025-05-25,13:16,10,15,25
2,2025-05-25T05:21:00+02:00,2025-05-25,13:21,14,8,22
2,2025-05-25T05:22:00+02:00,2025-05-25,13:22,16,6,22
2,2025-05-25T05:24:00+02:00,2025-05-25,13:24,11,18,29
9,2025-05-25T05:11:00+02:00,2025-05-25,13:11,2,1,3
10,2025-05-25T05:13:00+02:00,2025-05-25,13:13,1,2,3
10,2025-05-25T05:15:00+02:00,2025-05-25,13:15,2,0,2
10,2025-05-25T05:18:00+02:00,2025-05-25,13:18,1,3,4
10,2025-05-25T05:20:00+02:00,2025-05-25,13:20,1,2,3
10,2025-05-25T05:22:00+02:00,2025-05-25,13:22,0,1,1
10,2025-05-25T05:24:00+02:00,2025-05-25,13:24,0,1,1
11,2025-05-25T05:19:00+02:00,2025-05-25,13:19,1,1,2
11,2025-05-25T05:20:00+02:00,2025-05-25,13:20,1,5,6
11,2025-05-25T05:22:00+02:00,2025-05-25,13:22,0,2,2
12,2025-05-25T05:11:00+02:00,2025-05-25,13:11,1,2,3
12,2025-05-25T05:16:00+02:00,2025-05-25,13:16,3,5,8
12,2025-05-25T05:17:00+02:00,2025-05-25,13:17,2,2,4
12,2025-05-25T05:18:00+02:00,2025-05-25,13:18,6,3,9
12,2025-05-25T05:19:00+02:00,2025-05-25,13:19,0,3,3
12,2025-05-25T05:20:00+02:00,2025-05-25,13:20,6,3,9
12,2025-05-25T05:23:00+02:00,2025-05-25,13:23,1,1,2
17,2025-05-25T05:11:00+02:00,2025-05-25,13:11,5,3,8
17,2025-05-25T05:12:00+02:00,2025-05-25,13:12,0,2,2
17,2025-05-25T05:15:00+02:00,2025-05-25,13:15,4,0,4
17,2025-05-25T05:20:00+02:00,2025-05-25,13:20,1,1,2
17,2025-05-25T05:21:00+02:00,2025-05-25,13:21,1,1,2
17,2025-05-25T05:22:00+02:00,2025-05-25,13:22,2,2,4
18,2025-05-25T05:17:00+02:00,2025-05-25,13:17,1,1,2
18,2025-05-25T05:20:00+02:00,2025-05-25,13:20,3,0,3
18,2025-05-25T05:22:00+02:00,2025-05-25,13:22,1,0,1
19,2025-05-25T05:16:00+02:00,2025-05-25,13:16,8,4,12
19,2025-05-25T05:19:00+02:00,2025-05-25,13:19,8,9,17
19,2025-05-25T05:20:00+02:00,2025-05-25,13:20,11,9,20
19,2025-05-25T05:21:00+02:00,2025-05-25,13:21,10,5,15
19,2025-05-25T05:23:00+02:00,2025-05-25,13:23,7,22,29
19,2025-05-25T05:24:00+02:00,2025-05-25,13:24,20,10,30
20,2025-05-25T05:10:00+02:00,2025-05-25,13:10,2,4,6
20,2025-05-25T05:13:00+02:00,2025-05-25,13:13,2,3,5
20,2025-05-25T05:17:00+02:00,2025-05-25,13:17,7,3,10
20,2025-05-25T05:20:00+02:00,2025-05-25,13:20,16,5,21
20,2025-05-25T05:21:00+02:00,2025-05-25,13:21,11,7,18
23,2025-05-25T05:14:00+02:00,2025-05-25,13:14,1,2,3
23,2025-05-25T05:17:00+02:00,2025-05-25,13:17,0,1,1
23,2025-05-25T05:21:00+02:00,2025-05-25,13:21,8,2,10
23,2025-05-25T05:22:00+02:00,2025-05-25,13:22,2,1,3
24,2025-05-25T05:11:00+02:00,2025-05-25,13:11,5,0,5
24,2025-05-25T05:12:00+02:00,2025-05-25,13:12,9,22,31
24,2025-05-25T05:13:00+02:00,2025-05-25,13:13,6,4,10
24,2025-05-25T05:18:00+02:00,2025-05-25,13:18,10,8,18
24,2025-05-25T05:20:00+02:00,2025-05-25,13:20,7,2,9
24,2025-05-25T05:21:00+02:00,2025-05-25,13:21,7,2,9
24,2025-05-25T05:22:00+02:00,2025-05-25,13:22,6,2,8
27,2025-05-25T05:10:00+02:00,2025-05-25,13:10,3,7,10
27,2025-05-25T05:11:00+02:00,2025-05-25,13:11,8,1,9
27,2025-05-25T05:12:00+02:00,2025-05-25,13:12,8,0,8
27,2025-05-25T05:13:00+02:00,2025-05-25,13:13,3,1,4
27,2025-05-25T05:16:00+02:00,2025-05-25,13:16,13,0,13
27,2025-05-25T05:17:00+02:00,2025-05-25,13:17,5,5,10
27,2025-05-25T05:19:00+02:00,2025-05-25,13:19,6,2,8
27,2025-05-25T05:21:00+02:00,2025-05-25,13:21,2,4,6
27,2025-05-25T05:23:00+02:00,2025-05-25,13:23,5,3,8
30,2025-05-25T05:12:00+02:00,2025-05-25,13:12,11,14,25
30,2025-05-25T05:14:00+02:00,2025-05-25,13:14,11,13,24
30,2025-05-25T05:20:00+02:00,2025-05-25,13:20,6,8,14
30,2025-05-25T05:23:00+02:00,2025-05-25,13:23,5,14,19
30,2025-05-25T05:24:00+02:00,2025-05-25,13:24,3,7,10
35,2025-05-25T05:11:00+02:00,2025-05-25,13:11,25,46,71
35,2025-05-25T05:15:00+02:00,2025-05-25,13:15,11,18,29
35,2025-05-25T05:16:00+02:00,2025-05-25,13:16,15,18,33
35,2025-05-25T05:22:00+02:00,2025-05-25,13:22,18,17,35
48,2025-05-25T05:12:00+02:00,2025-05-25,13:12,8,3,11
48,2025-05-25T05:20:00+02:00,2025-05-25,13:20,3,4,7
48,2025-05-25T05:23:00+02:00,2025-05-25,13:23,9,5,14
49,2025-05-25T05:13:00+02:00,2025-05-25,13:13,11,17,28
49,2025-05-25T05:19:00+02:00,2025-05-25,13:19,2,13,15
51,2025-05-25T05:11:00+02:00,2025-05-25,13:11,2,1,3
51,2025-05-25T05:12:00+02:00,2025-05-25,13:12,1,3,4
51,2025-05-25T05:13:00+02:00,2025-05-25,13:13,6,3,9
51,2025-05-25T05:14:00+02:00,2025-05-25,13:14,0,1,1
51,2025-05-25T05:17:00+02:00,2025-05-25,13:17,4,3,7
51,2025-05-25T05:19:00+02:00,2025-05-25,13:19,4,5,9
51,2025-05-25T05:20:00+02:00,2025-05-25,13:20,2,4,6
52,2025-05-25T05:12:00+02:00,2025-05-25,13:12,10,5,15
52,2025-05-25T05:13:00+02:00,2025-05-25,13:13,7,4,11
52,2025-05-25T05:15:00+02:00,2025-05-25,13:15,6,16,22
52,2025-05-25T05:18:00+02:00,2025-05-25,13:18,4,8,12
52,2025-05-25T05:23:00+02:00,2025-05-25,13:23,8,13,21
52,2025-05-25T05:24:00+02:00,2025-05-25,13:24,5,8,13
53,2025-05-25T05:11:00+02:00,2025-05-25,13:11,14,15,29
53,2025-05-25T05:13:00+02:00,2025-05-25,13:13,14,4,18
53,2025-05-25T05:21:00+02:00,2025-05-25,13:21,7,3,10
56,2025-05-25T05:10:00+02:00,2025-05-25,13:10,7,2,9
56,2025-05-25T05:14:00+02:00,2025-05-25,13:14,14,7,21
56,2025-05-25T05:15:00+02:00,2025-05-25,13:15,11,0,11
58,2025-05-25T05:18:00+02:00,2025-05-25,13:18,8,14,22
58,2025-05-25T05:20:00+02:00,2025-05-25,13:20,14,1,15
58,2025-05-25T05:24:00+02:00,2025-05-25,13:24,9,4,13
62,2025-05-25T05:11:00+02:00,2025-05-25,13:11,5,3,8
62,2025-05-25T05:14:00+02:00,2025-05-25,13:14,4,0,4
62,2025-05-25T05:17:00+02:00,2025-05-25,13:17,2,5,7
62,2025-05-25T05:22:00+02:00,2025-05-25,13:22,2,3,5
62,2025-05-25T05:23:00+02:00,2025-05-25,13:23,2,1,3
62,2025-05-25T05:24:00+02:00,2025-05-25,13:24,2,5,7
63,2025-05-25T05:10:00+02:00,2025-05-25,13:10,10,9,19
67,2025-05-25T05:10:00+02:00,2025-05-25,13:10,4,17,21
67,2025-05-25T05:11:00+02:00,2025-05-25,13:11,2,2,4
67,2025-05-25T05:14:00+02:00,2025-05-25,13:14,0,8,8
67,2025-05-25T05:18:00+02:00,2025-05-25,13:18,4,10,14
68,2025-05-25T05:11:00+02:00,2025-05-25,13:11,4,1,5
68,2025-05-25T05:13:00+02:00,2025-05-25,13:13,7,9,16
68,2025-05-25T05:15:00+02:00,2025-05-25,13:15,3,7,10
68,2025-05-25T05:18:00+02:00,2025-05-25,13:18,5,5,10
68,2025-05-25T05:23:00+02:00,2025-05-25,13:23,9,6,15
68,2025-05-25T05:24:00+02:00,2025-05-25,13:24,3,2,5
72,2025-05-25T05:10:00+02:00,2025-05-25,13:10,3,16,19
72,2025-05-25T05:15:00+02:00,2025-05-25,13:15,6,7,13
72,2025-05-25T05:23:00+02:00,2025-05-25,13:23,2,9,11
76,2025-05-25T05:13:00+02:00,2025-05-25,13:13,2,0,2
76,2025-05-25T05:16:00+02:00,2025-05-25,13:16,2,0,2
76,2025-05-25T05:20:00+02:00,2025-05-25,13:20,2,1,3
76,2025-05-25T05:21:00+02:00,2025-05-25,13:21,0,1,1
76,2025-05-25T05:22:00+02:00,2025-05-25,13:22,1,0,1
76,2025-05-25T05:23:00+02:00,2025-05-25,13:23,0,3,3
76,2025-05-25T05:24:00+02:00,2025-05-25,13:24,0,2,2
79,2025-05-25T05:13:00+02:00,2025-05-25,13:13,6,9,15
79,2025-05-25T05:16:00+02:00,2025-05-25,13:16,5,4,9
79,2025-05-25T05:21:00+02:00,2025-05-25,13:21,20,11,31
85,2025-05-25T05:12:00+02:00,2025-05-25,13:12,2,1,3
85,2025-05-25T05:15:00+02:00,2025-05-25,13:15,5,2,7
85,2025-05-25T05:19:00+02:00,2025-05-25,13:19,2,0,2
85,2025-05-25T05:21:00+02:00,2025-05-25,13:21,1,3,4
85,2025-05-25T05:22:00+02:00,2025-05-25,13:22,0,1,1
85,2025-05-25T05:23:00+02:00,2025-05-25,13:23,2,2,4
86,2025-05-25T05:12:00+02:00,2025-05-25,13:12,2,1,3
86,2025-05-25T05:18:00+02:00,2025-05-25,13:18,1,3,4
86,2025-05-25T05:19:00+02:00,2025-05-25,13:19,0,3,3
86,2025-05-25T05:20:00+02:00,2025-05-25,13:20,1,0,1
109,2025-05-25T05:15:00+02:00,2025-05-25,13:15,9,12,21
109,2025-05-25T05:20:00+02:00,2025-05-25,13:20,9,7,16
117,2025-05-25T05:15:00+02:00,2025-05-25,13:15,17,36,53
117,2025-05-25T05:20:00+02:00,2025-05-25,13:20,2,18,20
137,2025-05-25T05:15:00+02:00,2025-05-25,13:15,3,0,3
138,2025-05-25T05:10:00+02:00,2025-05-25,13:10,0,1,1
139,2025-05-25T05:20:00+02:00,2025-05-25,13:20,2,3,5
142,2025-05-25T05:10:00+02:00,2025-05-25,13:10,53,44,97
161,2025-05-25T05:15:00+02:00,2025-05-25,13:15,18,14,32
161,2025-05-25T05:20:00+02:00,2025-05-25,13:20,33,33,66
164,2025-05-25T05:10:00+02:00,2025-05-25,13:10,6,7,13
164,2025-05-25T05:20:00+02:00,2025-05-25,13:20,7,9,16
181,2025-05-25T05:25:00+02:00,2025-05-25,13:25,11,21,32
181,2025-05-25T05:30:00+02:00,2025-05-25,13:30,9,29,38
181,2025-05-25T05:34:00+02:00,2025-05-25,13:34,7,19,26
181,2025-05-25T05:35:00+02:00,2025-05-25,13:35,11,18,29
181,2025-05-25T05:36:00+02:00,2025-05-25,13:36,3,26,29
181,2025-05-25T05:38:00+02:00,2025-05-25,13:38,12,34,46
181,2025-05-25T05:39:00+02:00,2025-05-25,13:39,14,32,46
182,2025-05-25T05:30:00+02:00,2025-05-25,13:30,25,14,39
180,2025-05-25T05:31:00+02:00,2025-05-25,13:31,1,0,1
180,2025-05-25T05:33:00+02:00,2025-05-25,13:33,0,2,2
180,2025-05-25T05:36:00+02:00,2025-05-25,13:36,1,0,1
180,2025-05-25T05:38:00+02:00,2025-05-25,13:38,3,0,3
180,2025-05-25T05:39:00+02:00,2025-05-25,13:39,0,2,2
3,2025-05-25T06:10:00+02:00,2025-05-25,14:10,27,25,52
3,2025-05-25T06:12:00+02:00,2025-05-25,14:12,12,30,42
3,2025-05-25T06:15:00+02:00,2025-05-25,14:15,20,27,47
3,2025-05-25T06:23:00+02:00,2025-05-25,14:23,19,7,26
4,2025-05-25T06:13:00+02:00,2025-05-25,14:13,30,23,53
4,2025-05-25T06:14:00+02:00,2025-05-25,14:14,19,23,42
4,2025-05-25T06:16:00+02:00,2025-05-25,14:16,29,30,59
4,2025-05-25T06:20:00+02:00,2025-05-25,14:20,47,29,76
4,2025-05-25T06:23:00+02:00,2025-05-25,14:23,22,27,49
6,2025-05-25T06:11:00+02:00,2025-05-25,14:11,24,5,29
6,2025-05-25T06:14:00+02:00,2025-05-25,14:14,18,12,30
6,2025-05-25T06:19:00+02:00,2025-05-25,14:19,8,13,21
8,2025-05-25T06:11:00+02:00,2025-05-25,14:11,3,5,8
8,2025-05-25T06:16:00+02:00,2025-05-25,14:16,4,5,9
8,2025-05-25T06:18:00+02:00,2025-05-25,14:18,3,3,6
8,2025-05-25T06:21:00+02:00,2025-05-25,14:21,1,1,2
8,2025-05-25T06:22:00+02:00,2025-05-25,14:22,10,4,14
28,2025-05-25T06:13:00+02:00,2025-05-25,14:13,8,8,16
28,2025-05-25T06:14:00+02:00,2025-05-25,14:14,14,14,28
28,2025-05-25T06:15:00+02:00,2025-05-25,14:15,5,8,13
28,2025-05-25T06:16:00+02:00,2025-05-25,14:16,6,11,17
28,2025-05-25T06:17:00+02:00,2025-05-25,14:17,16,19,35
28,2025-05-25T06:18:00+02:00,2025-05-25,14:18,8,17,25
28,2025-05-25T06:19:00+02:00,2025-05-25,14:19,4,11,15
28,2025-05-25T06:22:00+02:00,2025-05-25,14:22,7,12,19
29,2025-05-25T06:13:00+02:00,2025-05-25,14:13,19,11,30
29,2025-05-25T06:16:00+02:00,2025-05-25,14:16,20,6,26
29,2025-05-25T06:21:00+02:00,2025-05-25,14:21,15,19,34
31,2025-05-25T06:16:00+02:00,2025-05-25,14:16,9,0,9
31,2025-05-25T06:18:00+02:00,2025-05-25,14:18,6,10,16
31,2025-05-25T06:20:00+02:00,2025-05-25,14:20,2,0,2
31,2025-05-25T06:21:00+02:00,2025-05-25,14:21,2,2,4
31,2025-05-25T06:23:00+02:00,2025-05-25,14:23,4,6,10
36,2025-05-25T06:10:00+02:00,2025-05-25,14:10,1,2,3
36,2025-05-25T06:16:00+02:00,2025-05-25,14:16,2,1,3
36,2025-05-25T06:20:00+02:00,2025-05-25,14:20,2,3,5
39,2025-05-25T06:11:00+02:00,2025-05-25,14:11,0,1,1
39,2025-05-25T06:14:00+02:00,2025-05-25,14:14,3,0,3
39,2025-05-25T06:21:00+02:00,2025-05-25,14:21,0,4,4
39,2025-05-25T06:23:00+02:00,2025-05-25,14:23,3,0,3
40,2025-05-25T06:12:00+02:00,2025-05-25,14:12,2,0,2
40,2025-05-25T06:20:00+02:00,2025-05-25,14:20,12,0,12
40,2025-05-25T06:24:00+02:00,2025-05-25,14:24,2,1,3
41,2025-05-25T06:16:00+02:00,2025-05-25,14:16,0,2,2
41,2025-05-25T06:17:00+02:00,2025-05-25,14:17,7,7,14
41,2025-05-25T06:22:00+02:00,2025-05-25,14:22,20,8,28
41,2025-05-25T06:23:00+02:00,2025-05-25,14:23,4,5,9
41,2025-05-25T06:24:00+02:00,2025-05-25,14:24,8,3,11
44,2025-05-25T06:10:00+02:00,2025-05-25,14:10,2,5,7
44,2025-05-25T06:20:00+02:00,2025-05-25,14:20,4,2,6
45,2025-05-25T06:12:00+02:00,2025-05-25,14:12,13,24,37
45,2025-05-25T06:13:00+02:00,2025-05-25,14:13,21,17,38
45,2025-05-25T06:20:00+02:00,2025-05-25,14:20,23,26,49
45,2025-05-25T06:21:00+02:00,2025-05-25,14:21,23,7,30
45,2025-05-25T06:22:00+02:00,2025-05-25,14:22,9,26,35
47,2025-05-25T06:11:00+02:00,2025-05-25,14:11,6,13,19
47,2025-05-25T06:14:00+02:00,2025-05-25,14:14,11,19,30
47,2025-05-25T06:17:00+02:00,2025-05-25,14:17,11,8,19
47,2025-05-25T06:21:00+02:00,2025-05-25,14:21,11,11,22
47,2025-05-25T06:24:00+02:00,2025-05-25,14:24,12,15,27
50,2025-05-25T06:11:00+02:00,2025-05-25,14:11,5,3,8
50,2025-05-25T06:14:00+02:00,2025-05-25,14:14,4,2,6
50,2025-05-25T06:19:00+02:00,2025-05-25,14:19,10,14,24
50,2025-05-25T06:22:00+02:00,2025-05-25,14:22,1,7,8
50,2025-05-25T06:23:00+02:00,2025-05-25,14:23,2,4,6
54,2025-05-25T06:14:00+02:00,2025-05-25,14:14,5,0,5
54,2025-05-25T06:17:00+02:00,2025-05-25,14:17,1,1,2
54,2025-05-25T06:20:00+02:00,2025-05-25,14:20,9,1,10
54,2025-05-25T06:23:00+02:00,2025-05-25,14:23,4,2,6
59,2025-05-25T06:15:00+02:00,2025-05-25,14:15,18,52,70
59,2025-05-25T06:20:00+02:00,2025-05-25,14:20,23,38,61
61,2025-05-25T06:11:00+02:00,2025-05-25,14:11,8,5,13
61,2025-05-25T06:13:00+02:00,2025-05-25,14:13,6,4,10
61,2025-05-25T06:19:00+02:00,2025-05-25,14:19,13,8,21
66,2025-05-25T06:11:00+02:00,2025-05-25,14:11,28,26,54
66,2025-05-25T06:12:00+02:00,2025-05-25,14:12,10,16,26
66,2025-05-25T06:13:00+02:00,2025-05-25,14:13,16,24,40
66,2025-05-25T06:14:00+02:00,2025-05-25,14:14,26,38,64
66,2025-05-25T06:19:00+02:00,2025-05-25,14:19,28,11,39
66,2025-05-25T06:20:00+02:00,2025-05-25,14:20,17,23,40
66,2025-05-25T06:22:00+02:00,2025-05-25,14:22,19,14,33
69,2025-05-25T06:12:00+02:00,2025-05-25,14:12,6,5,11
69,2025-05-25T06:14:00+02:00,2025-05-25,14:14,3,6,9
69,2025-05-25T06:15:00+02:00,2025-05-25,14:15,1,5,6
69,2025-05-25T06:17:00+02:00,2025-05-25,14:17,1,5,6
69,2025-05-25T06:19:00+02:00,2025-05-25,14:19,13,5,18
69,2025-05-25T06:21:00+02:00,2025-05-25,14:21,7,4,11
69,2025-05-25T06:24:00+02:00,2025-05-25,14:24,4,5,9
70,2025-05-25T06:13:00+02:00,2025-05-25,14:13,3,6,9
70,2025-05-25T06:15:00+02:00,2025-05-25,14:15,1,3,4
70,2025-05-25T06:18:00+02:00,2025-05-25,14:18,0,2,2
70,2025-05-25T06:19:00+02:00,2025-05-25,14:19,11,3,14
70,2025-05-25T06:20:00+02:00,2025-05-25,14:20,6,2,8
70,2025-05-25T06:21:00+02:00,2025-05-25,14:21,1,0,1
75,2025-05-25T06:14:00+02:00,2025-05-25,14:14,0,3,3
75,2025-05-25T06:19:00+02:00,2025-05-25,14:19,0,2,2
77,2025-05-25T06:20:00+02:00,2025-05-25,14:20,13,6,19
78,2025-05-25T06:10:00+02:00,2025-05-25,14:10,2,0,2
78,2025-05-25T06:11:00+02:00,2025-05-25,14:11,0,2,2
78,2025-05-25T06:12:00+02:00,2025-05-25,14:12,4,4,8
78,2025-05-25T06:16:00+02:00,2025-05-25,14:16,1,3,4
78,2025-05-25T06:17:00+02:00,2025-05-25,14:17,1,0,1
78,2025-05-25T06:22:00+02:00,2025-05-25,14:22,1,0,1
87,2025-05-25T06:12:00+02:00,2025-05-25,14:12,0,4,4
87,2025-05-25T06:15:00+02:00,2025-05-25,14:15,3,1,4
87,2025-05-25T06:17:00+02:00,2025-05-25,14:17,1,2,3
87,2025-05-25T06:20:00+02:00,2025-05-25,14:20,1,1,2
107,2025-05-25T06:15:00+02:00,2025-05-25,14:15,10,13,23
107,2025-05-25T06:20:00+02:00,2025-05-25,14:20,5,16,21
108,2025-05-25T06:11:00+02:00,2025-05-25,14:11,7,7,14
108,2025-05-25T06:22:00+02:00,2025-05-25,14:22,4,2,6
131,2025-05-25T06:20:00+02:00,2025-05-25,14:20,15,11,26
133,2025-05-25T06:15:00+02:00,2025-05-25,14:15,37,50,87
135,2025-05-25T06:20:00+02:00,2025-05-25,14:20,27,47,74
140,2025-05-25T06:10:00+02:00,2025-05-25,14:10,13,11,24
140,2025-05-25T06:15:00+02:00,2025-05-25,14:15,6,2,8
140,2025-05-25T06:20:00+02:00,2025-05-25,14:20,9,8,17
165,2025-05-25T06:15:00+02:00,2025-05-25,14:15,3,6,9
165,2025-05-25T06:20:00+02:00,2025-05-25,14:20,3,3,6
167,2025-05-25T06:10:00+02:00,2025-05-25,14:10,2,3,5
167,2025-05-25T06:15:00+02:00,2025-05-25,14:15,1,0,1
179,2025-05-25T06:15:00+02:00,2025-05-25,14:15,4,0,4
1,2025-05-25T06:10:00+02:00,2025-05-25,14:10,25,29,54
1,2025-05-25T06:12:00+02:00,2025-05-25,14:12,16,18,34
1,2025-05-25T06:14:00+02:00,2025-05-25,14:14,29,34,63
1,2025-05-25T06:16:00+02:00,2025-05-25,14:16,19,32,51
1,2025-05-25T06:20:00+02:00,2025-05-25,14:20,23,23,46
1,2025-05-25T06:21:00+02:00,2025-05-25,14:21,17,18,35
1,2025-05-25T06:22:00+02:00,2025-05-25,14:22,44,21,65
2,2025-05-25T06:15:00+02:00,2025-05-25,14:15,8,7,15
2,2025-05-25T06:16:00+02:00,2025-05-25,14:16,9,6,15
2,2025-05-25T06:18:00+02:00,2025-05-25,14:18,15,4,19
9,2025-05-25T06:13:00+02:00,2025-05-25,14:13,0,1,1
9,2025-05-25T06:19:00+02:00,2025-05-25,14:19,2,2,4
10,2025-05-25T06:10:00+02:00,2025-05-25,14:10,1,2,3
10,2025-05-25T06:14:00+02:00,2025-05-25,14:14,0,1,1
10,2025-05-25T06:15:00+02:00,2025-05-25,14:15,6,3,9
10,2025-05-25T06:19:00+02:00,2025-05-25,14:19,1,1,2
10,2025-05-25T06:23:00+02:00,2025-05-25,14:23,2,2,4
11,2025-05-25T06:12:00+02:00,2025-05-25,14:12,0,2,2
11,2025-05-25T06:13:00+02:00,2025-05-25,14:13,3,7,10
11,2025-05-25T06:15:00+02:00,2025-05-25,14:15,7,45,52
11,2025-05-25T06:16:00+02:00,2025-05-25,14:16,0,3,3
11,2025-05-25T06:17:00+02:00,2025-05-25,14:17,3,9,12
11,2025-05-25T06:18:00+02:00,2025-05-25,14:18,1,4,5
11,2025-05-25T06:19:00+02:00,2025-05-25,14:19,0,4,4
11,2025-05-25T06:22:00+02:00,2025-05-25,14:22,0,3,3
12,2025-05-25T06:13:00+02:00,2025-05-25,14:13,7,4,11
12,2025-05-25T06:15:00+02:00,2025-05-25,14:15,2,7,9
12,2025-05-25T06:17:00+02:00,2025-05-25,14:17,0,11,11
12,2025-05-25T06:23:00+02:00,2025-05-25,14:23,9,3,12
17,2025-05-25T06:12:00+02:00,2025-05-25,14:12,1,6,7
17,2025-05-25T06:16:00+02:00,2025-05-25,14:16,0,2,2
18,2025-05-25T06:19:00+02:00,2025-05-25,14:19,6,0,6
18,2025-05-25T06:21:00+02:00,2025-05-25,14:21,1,0,1
18,2025-05-25T06:23:00+02:00,2025-05-25,14:23,1,0,1
19,2025-05-25T06:11:00+02:00,2025-05-25,14:11,10,3,13
19,2025-05-25T06:13:00+02:00,2025-05-25,14:13,13,11,24
19,2025-05-25T06:14:00+02:00,2025-05-25,14:14,1,11,12
19,2025-05-25T06:24:00+02:00,2025-05-25,14:24,8,11,19
20,2025-05-25T06:11:00+02:00,2025-05-25,14:11,5,3,8
20,2025-05-25T06:12:00+02:00,2025-05-25,14:12,3,3,6
20,2025-05-25T06:13:00+02:00,2025-05-25,14:13,1,13,14
20,2025-05-25T06:19:00+02:00,2025-05-25,14:19,3,5,8
23,2025-05-25T06:14:00+02:00,2025-05-25,14:14,2,1,3
23,2025-05-25T06:16:00+02:00,2025-05-25,14:16,5,0,5
23,2025-05-25T06:17:00+02:00,2025-05-25,14:17,3,3,6
23,2025-05-25T06:19:00+02:00,2025-05-25,14:19,3,0,3
24,2025-05-25T06:13:00+02:00,2025-05-25,14:13,8,9,17
24,2025-05-25T06:15:00+02:00,2025-05-25,14:15,15,5,20
24,2025-05-25T06:19:00+02:00,2025-05-25,14:19,2,7,9
24,2025-05-25T06:21:00+02:00,2025-05-25,14:21,3,9,12
24,2025-05-25T06:24:00+02:00,2025-05-25,14:24,5,13,18
25,2025-05-25T06:15:00+02:00,2025-05-25,14:15,72,96,168
27,2025-05-25T06:10:00+02:00,2025-05-25,14:10,9,0,9
27,2025-05-25T06:13:00+02:00,2025-05-25,14:13,7,3,10
27,2025-05-25T06:22:00+02:00,2025-05-25,14:22,2,11,13
27,2025-05-25T06:24:00+02:00,2025-05-25,14:24,1,5,6
30,2025-05-25T06:10:00+02:00,2025-05-25,14:10,1,5,6
30,2025-05-25T06:11:00+02:00,2025-05-25,14:11,7,10,17
30,2025-05-25T06:12:00+02:00,2025-05-25,14:12,5,9,14
30,2025-05-25T06:14:00+02:00,2025-05-25,14:14,12,10,22
30,2025-05-25T06:15:00+02:00,2025-05-25,14:15,3,10,13
30,2025-05-25T06:18:00+02:00,2025-05-25,14:18,6,4,10
35,2025-05-25T06:10:00+02:00,2025-05-25,14:10,14,18,32
35,2025-05-25T06:15:00+02:00,2025-05-25,14:15,16,26,42
35,2025-05-25T06:19:00+02:00,2025-05-25,14:19,16,27,43
35,2025-05-25T06:21:00+02:00,2025-05-25,14:21,22,30,52
46,2025-05-25T06:10:00+02:00,2025-05-25,14:10,2,8,10
46,2025-05-25T06:15:00+02:00,2025-05-25,14:15,3,5,8
48,2025-05-25T06:10:00+02:00,2025-05-25,14:10,5,1,6
48,2025-05-25T06:13:00+02:00,2025-05-25,14:13,9,5,14
48,2025-05-25T06:18:00+02:00,2025-05-25,14:18,10,10,20
48,2025-05-25T06:23:00+02:00,2025-05-25,14:23,8,13,21
49,2025-05-25T06:14:00+02:00,2025-05-25,14:14,0,12,12
49,2025-05-25T06:17:00+02:00,2025-05-25,14:17,13,10,23
49,2025-05-25T06:18:00+02:00,2025-05-25,14:18,4,7,11
49,2025-05-25T06:21:00+02:00,2025-05-25,14:21,17,5,22
51,2025-05-25T06:23:00+02:00,2025-05-25,14:23,10,3,13
51,2025-05-25T06:24:00+02:00,2025-05-25,14:24,0,5,5
52,2025-05-25T06:13:00+02:00,2025-05-25,14:13,5,2,7
52,2025-05-25T06:15:00+02:00,2025-05-25,14:15,25,5,30
52,2025-05-25T06:17:00+02:00,2025-05-25,14:17,12,9,21
52,2025-05-25T06:23:00+02:00,2025-05-25,14:23,8,12,20
53,2025-05-25T06:10:00+02:00,2025-05-25,14:10,5,9,14
53,2025-05-25T06:11:00+02:00,2025-05-25,14:11,14,5,19
53,2025-05-25T06:12:00+02:00,2025-05-25,14:12,5,4,9
53,2025-05-25T06:13:00+02:00,2025-05-25,14:13,19,6,25
53,2025-05-25T06:21:00+02:00,2025-05-25,14:21,16,11,27
56,2025-05-25T06:11:00+02:00,2025-05-25,14:11,11,11,22
56,2025-05-25T06:13:00+02:00,2025-05-25,14:13,14,20,34
56,2025-05-25T06:14:00+02:00,2025-05-25,14:14,16,7,23
56,2025-05-25T06:16:00+02:00,2025-05-25,14:16,15,13,28
56,2025-05-25T06:17:00+02:00,2025-05-25,14:17,26,4,30
56,2025-05-25T06:19:00+02:00,2025-05-25,14:19,11,7,18
56,2025-05-25T06:21:00+02:00,2025-05-25,14:21,6,2,8
58,2025-05-25T06:11:00+02:00,2025-05-25,14:11,14,2,16
58,2025-05-25T06:12:00+02:00,2025-05-25,14:12,6,8,14
58,2025-05-25T06:16:00+02:00,2025-05-25,14:16,3,2,5
58,2025-05-25T06:17:00+02:00,2025-05-25,14:17,7,8,15
58,2025-05-25T06:20:00+02:00,2025-05-25,14:20,8,2,10
58,2025-05-25T06:21:00+02:00,2025-05-25,14:21,8,3,11
58,2025-05-25T06:23:00+02:00,2025-05-25,14:23,6,2,8
62,2025-05-25T06:10:00+02:00,2025-05-25,14:10,12,3,15
62,2025-05-25T06:18:00+02:00,2025-05-25,14:18,4,0,4
62,2025-05-25T06:21:00+02:00,2025-05-25,14:21,2,10,12
63,2025-05-25T06:12:00+02:00,2025-05-25,14:12,4,8,12
63,2025-05-25T06:14:00+02:00,2025-05-25,14:14,5,11,16
63,2025-05-25T06:15:00+02:00,2025-05-25,14:15,7,0,7
63,2025-05-25T06:17:00+02:00,2025-05-25,14:17,10,12,22
63,2025-05-25T06:22:00+02:00,2025-05-25,14:22,4,12,16
63,2025-05-25T06:23:00+02:00,2025-05-25,14:23,7,9,16
67,2025-05-25T06:12:00+02:00,2025-05-25,14:12,11,9,20
67,2025-05-25T06:14:00+02:00,2025-05-25,14:14,10,7,17
67,2025-05-25T06:16:00+02:00,2025-05-25,14:16,6,14,20
67,2025-05-25T06:18:00+02:00,2025-05-25,14:18,9,16,25
67,2025-05-25T06:19:00+02:00,2025-05-25,14:19,2,8,10
67,2025-05-25T06:21:00+02:00,2025-05-25,14:21,2,23,25
67,2025-05-25T06:23:00+02:00,2025-05-25,14:23,5,16,21
67,2025-05-25T06:24:00+02:00,2025-05-25,14:24,2,13,15
68,2025-05-25T06:16:00+02:00,2025-05-25,14:16,7,5,12
68,2025-05-25T06:17:00+02:00,2025-05-25,14:17,5,7,12
68,2025-05-25T06:21:00+02:00,2025-05-25,14:21,4,3,7
68,2025-05-25T06:22:00+02:00,2025-05-25,14:22,4,6,10
68,2025-05-25T06:23:00+02:00,2025-05-25,14:23,8,7,15
72,2025-05-25T06:12:00+02:00,2025-05-25,14:12,6,11,17
72,2025-05-25T06:15:00+02:00,2025-05-25,14:15,7,15,22
72,2025-05-25T06:17:00+02:00,2025-05-25,14:17,3,6,9
72,2025-05-25T06:21:00+02:00,2025-05-25,14:21,5,19,24
72,2025-05-25T06:22:00+02:00,2025-05-25,14:22,0,3,3
76,2025-05-25T06:11:00+02:00,2025-05-25,14:11,1,1,2
76,2025-05-25T06:13:00+02:00,2025-05-25,14:13,1,0,1
76,2025-05-25T06:19:00+02:00,2025-05-25,14:19,0,1,1
76,2025-05-25T06:21:00+02:00,2025-05-25,14:21,0,1,1
76,2025-05-25T06:24:00+02:00,2025-05-25,14:24,1,0,1
79,2025-05-25T06:10:00+02:00,2025-05-25,14:10,11,6,17
79,2025-05-25T06:11:00+02:00,2025-05-25,14:11,9,4,13
79,2025-05-25T06:13:00+02:00,2025-05-25,14:13,7,9,16
79,2025-05-25T06:14:00+02:00,2025-05-25,14:14,4,10,14
79,2025-05-25T06:15:00+02:00,2025-05-25,14:15,12,10,22
85,2025-05-25T06:10:00+02:00,2025-05-25,14:10,2,0,2
85,2025-05-25T06:19:00+02:00,2025-05-25,14:19,0,2,2
86,2025-05-25T06:16:00+02:00,2025-05-25,14:16,2,0,2
86,2025-05-25T06:18:00+02:00,2025-05-25,14:18,0,2,2
86,2025-05-25T06:19:00+02:00,2025-05-25,14:19,2,6,8
86,2025-05-25T06:20:00+02:00,2025-05-25,14:20,2,0,2
86,2025-05-25T06:23:00+02:00,2025-05-25,14:23,2,0,2
117,2025-05-25T06:10:00+02:00,2025-05-25,14:10,17,44,61
123,2025-05-25T06:10:00+02:00,2025-05-25,14:10,8,0,8
130,2025-05-25T06:20:00+02:00,2025-05-25,14:20,1,1,2
136,2025-05-25T06:10:00+02:00,2025-05-25,14:10,106,4,110
137,2025-05-25T06:15:00+02:00,2025-05-25,14:15,0,1,1
137,2025-05-25T06:20:00+02:00,2025-05-25,14:20,1,2,3
142,2025-05-25T06:15:00+02:00,2025-05-25,14:15,75,57,132
164,2025-05-25T06:20:00+02:00,2025-05-25,14:20,3,6,9
181,2025-05-25T06:26:00+02:00,2025-05-25,14:26,17,15,32
181,2025-05-25T06:32:00+02:00,2025-05-25,14:32,7,27,34
181,2025-05-25T06:34:00+02:00,2025-05-25,14:34,14,13,27
181,2025-05-25T06:37:00+02:00,2025-05-25,14:37,2,21,23
181,2025-05-25T06:39:00+02:00,2025-05-25,14:39,9,30,39
182,2025-05-25T06:25:00+02:00,2025-05-25,14:25,12,8,20
182,2025-05-25T06:35:00+02:00,2025-05-25,14:35,12,17,29
180,2025-05-25T06:26:00+02:00,2025-05-25,14:26,1,0,1
180,2025-05-25T06:33:00+02:00,2025-05-25,14:33,1,1,2
180,2025-05-25T06:34:00+02:00,2025-05-25,14:34,3,1,4
180,2025-05-25T06:35:00+02:00,2025-05-25,14:35,0,3,3
180,2025-05-25T06:36:00+02:00,2025-05-25,14:36,1,1,2
3,2025-05-25T05:56:00+02:00,2025-05-25,13:56,20,16,36
3,2025-05-25T05:58:00+02:00,2025-05-25,13:58,20,17,37
3,2025-05-25T05:59:00+02:00,2025-05-25,13:59,20,19,39
3,2025-05-25T06:03:00+02:00,2025-05-25,14:03,21,30,51
3,2025-05-25T06:04:00+02:00,2025-05-25,14:04,29,24,53
3,2025-05-25T06:06:00+02:00,2025-05-25,14:06,17,16,33
4,2025-05-25T05:56:00+02:00,2025-05-25,13:56,59,34,93
4,2025-05-25T05:58:00+02:00,2025-05-25,13:58,32,31,63
4,2025-05-25T06:03:00+02:00,2025-05-25,14:03,9,15,24
6,2025-05-25T05:58:00+02:00,2025-05-25,13:58,22,7,29
6,2025-05-25T06:00:00+02:00,2025-05-25,14:00,15,13,28
6,2025-05-25T06:02:00+02:00,2025-05-25,14:02,14,12,26
6,2025-05-25T06:03:00+02:00,2025-05-25,14:03,12,14,26
6,2025-05-25T06:08:00+02:00,2025-05-25,14:08,12,22,34
8,2025-05-25T05:56:00+02:00,2025-05-25,13:56,7,3,10
8,2025-05-25T06:01:00+02:00,2025-05-25,14:01,7,5,12
8,2025-05-25T06:02:00+02:00,2025-05-25,14:02,5,1,6
8,2025-05-25T06:03:00+02:00,2025-05-25,14:03,2,2,4
8,2025-05-25T06:04:00+02:00,2025-05-25,14:04,4,1,5
8,2025-05-25T06:07:00+02:00,2025-05-25,14:07,6,7,13
28,2025-05-25T05:56:00+02:00,2025-05-25,13:56,28,8,36
28,2025-05-25T05:58:00+02:00,2025-05-25,13:58,6,18,24
28,2025-05-25T06:02:00+02:00,2025-05-25,14:02,14,4,18
28,2025-05-25T06:05:00+02:00,2025-05-25,14:05,9,19,28
28,2025-05-25T06:08:00+02:00,2025-05-25,14:08,13,3,16
29,2025-05-25T05:55:00+02:00,2025-05-25,13:55,4,3,7
29,2025-05-25T05:58:00+02:00,2025-05-25,13:58,5,16,21
29,2025-05-25T05:59:00+02:00,2025-05-25,13:59,14,5,19
29,2025-05-25T06:01:00+02:00,2025-05-25,14:01,14,9,23
29,2025-05-25T06:06:00+02:00,2025-05-25,14:06,7,11,18
31,2025-05-25T05:55:00+02:00,2025-05-25,13:55,2,11,13
31,2025-05-25T05:56:00+02:00,2025-05-25,13:56,3,4,7
31,2025-05-25T06:02:00+02:00,2025-05-25,14:02,2,9,11
31,2025-05-25T06:04:00+02:00,2025-05-25,14:04,4,1,5
36,2025-05-25T05:55:00+02:00,2025-05-25,13:55,4,2,6
36,2025-05-25T06:01:00+02:00,2025-05-25,14:01,1,0,1
36,2025-05-25T06:02:00+02:00,2025-05-25,14:02,1,2,3
36,2025-05-25T06:06:00+02:00,2025-05-25,14:06,2,0,2
36,2025-05-25T06:07:00+02:00,2025-05-25,14:07,0,5,5
36,2025-05-25T06:08:00+02:00,2025-05-25,14:08,0,3,3
36,2025-05-25T06:09:00+02:00,2025-05-25,14:09,0,3,3
39,2025-05-25T06:03:00+02:00,2025-05-25,14:03,0,2,2
39,2025-05-25T06:07:00+02:00,2025-05-25,14:07,0,1,1
39,2025-05-25T06:08:00+02:00,2025-05-25,14:08,3,4,7
39,2025-05-25T06:09:00+02:00,2025-05-25,14:09,0,3,3
40,2025-05-25T05:55:00+02:00,2025-05-25,13:55,2,0,2
40,2025-05-25T05:56:00+02:00,2025-05-25,13:56,3,5,8
40,2025-05-25T05:58:00+02:00,2025-05-25,13:58,1,3,4
40,2025-05-25T06:00:00+02:00,2025-05-25,14:00,0,3,3
40,2025-05-25T06:03:00+02:00,2025-05-25,14:03,2,4,6
40,2025-05-25T06:07:00+02:00,2025-05-25,14:07,0,1,1
41,2025-05-25T05:56:00+02:00,2025-05-25,13:56,8,14,22
41,2025-05-25T05:58:00+02:00,2025-05-25,13:58,10,9,19
41,2025-05-25T06:01:00+02:00,2025-05-25,14:01,12,13,25
41,2025-05-25T06:03:00+02:00,2025-05-25,14:03,17,9,26
41,2025-05-25T06:07:00+02:00,2025-05-25,14:07,5,2,7
41,2025-05-25T06:08:00+02:00,2025-05-25,14:08,9,7,16
43,2025-05-25T06:00:00+02:00,2025-05-25,14:00,11,5,16
44,2025-05-25T06:05:00+02:00,2025-05-25,14:05,4,5,9
45,2025-05-25T05:56:00+02:00,2025-05-25,13:56,30,20,50
45,2025-05-25T05:57:00+02:00,2025-05-25,13:57,28,22,50
45,2025-05-25T06:06:00+02:00,2025-05-25,14:06,24,19,43
45,2025-05-25T06:08:00+02:00,2025-05-25,14:08,18,21,39
45,2025-05-25T06:09:00+02:00,2025-05-25,14:09,13,24,37
47,2025-05-25T05:59:00+02:00,2025-05-25,13:59,12,22,34
47,2025-05-25T06:01:00+02:00,2025-05-25,14:01,20,37,57
47,2025-05-25T06:04:00+02:00,2025-05-25,14:04,15,21,36
47,2025-05-25T06:09:00+02:00,2025-05-25,14:09,12,26,38
50,2025-05-25T05:55:00+02:00,2025-05-25,13:55,1,8,9
50,2025-05-25T05:59:00+02:00,2025-05-25,13:59,1,0,1
50,2025-05-25T06:00:00+02:00,2025-05-25,14:00,7,3,10
50,2025-05-25T06:01:00+02:00,2025-05-25,14:01,12,11,23
50,2025-05-25T06:03:00+02:00,2025-05-25,14:03,2,6,8
50,2025-05-25T06:09:00+02:00,2025-05-25,14:09,5,7,12
54,2025-05-25T05:56:00+02:00,2025-05-25,13:56,0,1,1
54,2025-05-25T05:59:00+02:00,2025-05-25,13:59,3,0,3
54,2025-05-25T06:04:00+02:00,2025-05-25,14:04,5,1,6
54,2025-05-25T06:07:00+02:00,2025-05-25,14:07,1,2,3
61,2025-05-25T05:55:00+02:00,2025-05-25,13:55,12,5,17
61,2025-05-25T05:57:00+02:00,2025-05-25,13:57,4,11,15
61,2025-05-25T06:01:00+02:00,2025-05-25,14:01,7,7,14
61,2025-05-25T06:08:00+02:00,2025-05-25,14:08,24,13,37
66,2025-05-25T06:00:00+02:00,2025-05-25,14:00,32,34,66
66,2025-05-25T06:01:00+02:00,2025-05-25,14:01,35,23,58
66,2025-05-25T06:07:00+02:00,2025-05-25,14:07,18,19,37
66,2025-05-25T06:09:00+02:00,2025-05-25,14:09,33,27,60
69,2025-05-25T05:56:00+02:00,2025-05-25,13:56,7,2,9
69,2025-05-25T05:58:00+02:00,2025-05-25,13:58,0,5,5
69,2025-05-25T06:02:00+02:00,2025-05-25,14:02,7,3,10
69,2025-05-25T06:06:00+02:00,2025-05-25,14:06,4,4,8
70,2025-05-25T05:57:00+02:00,2025-05-25,13:57,2,5,7
70,2025-05-25T05:58:00+02:00,2025-05-25,13:58,5,0,5
70,2025-05-25T06:00:00+02:00,2025-05-25,14:00,1,2,3
70,2025-05-25T06:01:00+02:00,2025-05-25,14:01,2,0,2
70,2025-05-25T06:09:00+02:00,2025-05-25,14:09,3,6,9
75,2025-05-25T05:57:00+02:00,2025-05-25,13:57,0,3,3
75,2025-05-25T05:59:00+02:00,2025-05-25,13:59,1,0,1
75,2025-05-25T06:02:00+02:00,2025-05-25,14:02,0,2,2
75,2025-05-25T06:05:00+02:00,2025-05-25,14:05,0,1,1
77,2025-05-25T05:55:00+02:00,2025-05-25,13:55,28,16,44
78,2025-05-25T05:58:00+02:00,2025-05-25,13:58,1,2,3
78,2025-05-25T06:00:00+02:00,2025-05-25,14:00,0,6,6
78,2025-05-25T06:04:00+02:00,2025-05-25,14:04,0,3,3
78,2025-05-25T06:06:00+02:00,2025-05-25,14:06,1,1,2
87,2025-05-25T05:56:00+02:00,2025-05-25,13:56,4,5,9
87,2025-05-25T06:03:00+02:00,2025-05-25,14:03,2,1,3
87,2025-05-25T06:04:00+02:00,2025-05-25,14:04,0,1,1
87,2025-05-25T06:05:00+02:00,2025-05-25,14:05,2,5,7
87,2025-05-25T06:08:00+02:00,2025-05-25,14:08,1,3,4
107,2025-05-25T06:00:00+02:00,2025-05-25,14:00,18,20,38
108,2025-05-25T05:55:00+02:00,2025-05-25,13:55,4,1,5
108,2025-05-25T05:57:00+02:00,2025-05-25,13:57,5,6,11
108,2025-05-25T06:01:00+02:00,2025-05-25,14:01,4,7,11
108,2025-05-25T06:02:00+02:00,2025-05-25,14:02,5,3,8
108,2025-05-25T06:08:00+02:00,2025-05-25,14:08,5,4,9
118,2025-05-25T06:05:00+02:00,2025-05-25,14:05,0,2,2
124,2025-05-25T06:05:00+02:00,2025-05-25,14:05,0,3,3
131,2025-05-25T05:55:00+02:00,2025-05-25,13:55,20,4,24
131,2025-05-25T06:00:00+02:00,2025-05-25,14:00,12,6,18
131,2025-05-25T06:05:00+02:00,2025-05-25,14:05,15,4,19
132,2025-05-25T05:55:00+02:00,2025-05-25,13:55,11,10,21
133,2025-05-25T05:55:00+02:00,2025-05-25,13:55,44,32,76
133,2025-05-25T06:00:00+02:00,2025-05-25,14:00,29,41,70
134,2025-05-25T06:05:00+02:00,2025-05-25,14:05,42,32,74
135,2025-05-25T05:55:00+02:00,2025-05-25,13:55,34,40,74
140,2025-05-25T05:55:00+02:00,2025-05-25,13:55,13,5,18
140,2025-05-25T06:00:00+02:00,2025-05-25,14:00,8,5,13
162,2025-05-25T06:05:00+02:00,2025-05-25,14:05,59,68,127
165,2025-05-25T05:55:00+02:00,2025-05-25,13:55,3,6,9
165,2025-05-25T06:05:00+02:00,2025-05-25,14:05,2,3,5
167,2025-05-25T05:55:00+02:00,2025-05-25,13:55,3,0,3
179,2025-05-25T05:55:00+02:00,2025-05-25,13:55,2,4,6
179,2025-05-25T06:00:00+02:00,2025-05-25,14:00,10,2,12
179,2025-05-25T06:05:00+02:00,2025-05-25,14:05,5,5,10
1,2025-05-25T05:55:00+02:00,2025-05-25,13:55,23,29,52
1,2025-05-25T05:59:00+02:00,2025-05-25,13:59,27,21,48
1,2025-05-25T06:06:00+02:00,2025-05-25,14:06,23,21,44
2,2025-05-25T05:55:00+02:00,2025-05-25,13:55,12,16,28
2,2025-05-25T05:57:00+02:00,2025-05-25,13:57,9,9,18
2,2025-05-25T06:04:00+02:00,2025-05-25,14:04,10,17,27
2,2025-05-25T06:07:00+02:00,2025-05-25,14:07,10,18,28
2,2025-05-25T06:08:00+02:00,2025-05-25,14:08,17,14,31
9,2025-05-25T05:55:00+02:00,2025-05-25,13:55,2,1,3
9,2025-05-25T05:56:00+02:00,2025-05-25,13:56,3,3,6
9,2025-05-25T06:00:00+02:00,2025-05-25,14:00,3,0,3
9,2025-05-25T06:02:00+02:00,2025-05-25,14:02,1,0,1
9,2025-05-25T06:03:00+02:00,2025-05-25,14:03,2,3,5
9,2025-05-25T06:06:00+02:00,2025-05-25,14:06,0,2,2
9,2025-05-25T06:09:00+02:00,2025-05-25,14:09,2,2,4
10,2025-05-25T05:59:00+02:00,2025-05-25,13:59,3,2,5
10,2025-05-25T06:02:00+02:00,2025-05-25,14:02,1,0,1
10,2025-05-25T06:05:00+02:00,2025-05-25,14:05,1,3,4
11,2025-05-25T06:04:00+02:00,2025-05-25,14:04,2,2,4
11,2025-05-25T06:05:00+02:00,2025-05-25,14:05,6,4,10
11,2025-05-25T06:07:00+02:00,2025-05-25,14:07,0,2,2
11,2025-05-25T06:08:00+02:00,2025-05-25,14:08,3,2,5
12,2025-05-25T05:55:00+02:00,2025-05-25,13:55,2,4,6
12,2025-05-25T06:01:00+02:00,2025-05-25,14:01,11,4,15
12,2025-05-25T06:03:00+02:00,2025-05-25,14:03,1,4,5
12,2025-05-25T06:04:00+02:00,2025-05-25,14:04,5,9,14
17,2025-05-25T06:01:00+02:00,2025-05-25,14:01,1,11,12
17,2025-05-25T06:04:00+02:00,2025-05-25,14:04,1,2,3
17,2025-05-25T06:06:00+02:00,2025-05-25,14:06,2,3,5
17,2025-05-25T06:09:00+02:00,2025-05-25,14:09,4,1,5
18,2025-05-25T05:57:00+02:00,2025-05-25,13:57,0,2,2
18,2025-05-25T06:00:00+02:00,2025-05-25,14:00,3,5,8
18,2025-05-25T06:05:00+02:00,2025-05-25,14:05,5,2,7
18,2025-05-25T06:06:00+02:00,2025-05-25,14:06,1,7,8
19,2025-05-25T05:55:00+02:00,2025-05-25,13:55,12,6,18
19,2025-05-25T06:01:00+02:00,2025-05-25,14:01,7,6,13
19,2025-05-25T06:03:00+02:00,2025-05-25,14:03,2,14,16
19,2025-05-25T06:09:00+02:00,2025-05-25,14:09,9,13,22
20,2025-05-25T05:56:00+02:00,2025-05-25,13:56,12,7,19
20,2025-05-25T05:59:00+02:00,2025-05-25,13:59,4,9,13
20,2025-05-25T06:06:00+02:00,2025-05-25,14:06,3,7,10
23,2025-05-25T05:57:00+02:00,2025-05-25,13:57,1,8,9
23,2025-05-25T05:58:00+02:00,2025-05-25,13:58,4,3,7
23,2025-05-25T06:02:00+02:00,2025-05-25,14:02,0,2,2
23,2025-05-25T06:08:00+02:00,2025-05-25,14:08,3,3,6
24,2025-05-25T06:06:00+02:00,2025-05-25,14:06,7,16,23
24,2025-05-25T06:08:00+02:00,2025-05-25,14:08,4,8,12
27,2025-05-25T06:04:00+02:00,2025-05-25,14:04,4,6,10
30,2025-05-25T05:55:00+02:00,2025-05-25,13:55,7,2,9
30,2025-05-25T05:57:00+02:00,2025-05-25,13:57,9,4,13
30,2025-05-25T06:04:00+02:00,2025-05-25,14:04,2,3,5
30,2025-05-25T06:06:00+02:00,2025-05-25,14:06,11,3,14
30,2025-05-25T06:07:00+02:00,2025-05-25,14:07,5,24,29
30,2025-05-25T06:09:00+02:00,2025-05-25,14:09,0,9,9
35,2025-05-25T05:56:00+02:00,2025-05-25,13:56,20,26,46
35,2025-05-25T05:59:00+02:00,2025-05-25,13:59,31,14,45
35,2025-05-25T06:00:00+02:00,2025-05-25,14:00,16,7,23
35,2025-05-25T06:03:00+02:00,2025-05-25,14:03,7,16,23
35,2025-05-25T06:04:00+02:00,2025-05-25,14:04,18,14,32
35,2025-05-25T06:06:00+02:00,2025-05-25,14:06,30,7,37
35,2025-05-25T06:08:00+02:00,2025-05-25,14:08,12,24,36
46,2025-05-25T06:00:00+02:00,2025-05-25,14:00,6,4,10
48,2025-05-25T05:56:00+02:00,2025-05-25,13:56,3,3,6
48,2025-05-25T05:57:00+02:00,2025-05-25,13:57,12,3,15
48,2025-05-25T05:58:00+02:00,2025-05-25,13:58,7,9,16
48,2025-05-25T05:59:00+02:00,2025-05-25,13:59,6,6,12
48,2025-05-25T06:02:00+02:00,2025-05-25,14:02,9,7,16
48,2025-05-25T06:07:00+02:00,2025-05-25,14:07,5,4,9
48,2025-05-25T06:08:00+02:00,2025-05-25,14:08,12,18,30
48,2025-05-25T06:09:00+02:00,2025-05-25,14:09,4,4,8
49,2025-05-25T05:55:00+02:00,2025-05-25,13:55,10,5,15
49,2025-05-25T05:56:00+02:00,2025-05-25,13:56,1,12,13
49,2025-05-25T05:57:00+02:00,2025-05-25,13:57,7,13,20
49,2025-05-25T05:58:00+02:00,2025-05-25,13:58,13,9,22
49,2025-05-25T05:59:00+02:00,2025-05-25,13:59,4,12,16
49,2025-05-25T06:00:00+02:00,2025-05-25,14:00,11,5,16
49,2025-05-25T06:01:00+02:00,2025-05-25,14:01,6,18,24
49,2025-05-25T06:03:00+02:00,2025-05-25,14:03,2,6,8
49,2025-05-25T06:04:00+02:00,2025-05-25,14:04,8,7,15
51,2025-05-25T05:55:00+02:00,2025-05-25,13:55,3,5,8
51,2025-05-25T06:05:00+02:00,2025-05-25,14:05,1,3,4
51,2025-05-25T06:08:00+02:00,2025-05-25,14:08,8,3,11
52,2025-05-25T05:57:00+02:00,2025-05-25,13:57,3,14,17
52,2025-05-25T06:00:00+02:00,2025-05-25,14:00,4,12,16
52,2025-05-25T06:02:00+02:00,2025-05-25,14:02,13,5,18
52,2025-05-25T06:03:00+02:00,2025-05-25,14:03,1,8,9
52,2025-05-25T06:06:00+02:00,2025-05-25,14:06,6,7,13
52,2025-05-25T06:07:00+02:00,2025-05-25,14:07,11,2,13
52,2025-05-25T06:08:00+02:00,2025-05-25,14:08,5,4,9
52,2025-05-25T06:09:00+02:00,2025-05-25,14:09,1,11,12
53,2025-05-25T05:57:00+02:00,2025-05-25,13:57,17,11,28
53,2025-05-25T05:58:00+02:00,2025-05-25,13:58,14,9,23
53,2025-05-25T06:00:00+02:00,2025-05-25,14:00,11,2,13
53,2025-05-25T06:01:00+02:00,2025-05-25,14:01,2,10,12
56,2025-05-25T05:56:00+02:00,2025-05-25,13:56,8,0,8
56,2025-05-25T06:05:00+02:00,2025-05-25,14:05,5,8,13
56,2025-05-25T06:07:00+02:00,2025-05-25,14:07,3,5,8
58,2025-05-25T05:58:00+02:00,2025-05-25,13:58,11,3,14
58,2025-05-25T05:59:00+02:00,2025-05-25,13:59,9,8,17
58,2025-05-25T06:00:00+02:00,2025-05-25,14:00,7,3,10
58,2025-05-25T06:01:00+02:00,2025-05-25,14:01,11,1,12
58,2025-05-25T06:02:00+02:00,2025-05-25,14:02,4,2,6
58,2025-05-25T06:09:00+02:00,2025-05-25,14:09,9,6,15
62,2025-05-25T05:55:00+02:00,2025-05-25,13:55,10,0,10
62,2025-05-25T05:57:00+02:00,2025-05-25,13:57,6,1,7
62,2025-05-25T05:59:00+02:00,2025-05-25,13:59,3,3,6
62,2025-05-25T06:00:00+02:00,2025-05-25,14:00,2,4,6
62,2025-05-25T06:02:00+02:00,2025-05-25,14:02,10,5,15
62,2025-05-25T06:05:00+02:00,2025-05-25,14:05,5,5,10
62,2025-05-25T06:06:00+02:00,2025-05-25,14:06,4,7,11
62,2025-05-25T06:08:00+02:00,2025-05-25,14:08,5,4,9
63,2025-05-25T05:55:00+02:00,2025-05-25,13:55,16,1,17
63,2025-05-25T05:56:00+02:00,2025-05-25,13:56,4,3,7
63,2025-05-25T05:57:00+02:00,2025-05-25,13:57,10,4,14
63,2025-05-25T05:58:00+02:00,2025-05-25,13:58,2,4,6
63,2025-05-25T05:59:00+02:00,2025-05-25,13:59,12,5,17
63,2025-05-25T06:05:00+02:00,2025-05-25,14:05,8,5,13
63,2025-05-25T06:07:00+02:00,2025-05-25,14:07,1,7,8
67,2025-05-25T05:56:00+02:00,2025-05-25,13:56,4,7,11
67,2025-05-25T06:03:00+02:00,2025-05-25,14:03,1,23,24
67,2025-05-25T06:04:00+02:00,2025-05-25,14:04,4,12,16
67,2025-05-25T06:06:00+02:00,2025-05-25,14:06,8,5,13
68,2025-05-25T05:55:00+02:00,2025-05-25,13:55,7,5,12
68,2025-05-25T05:56:00+02:00,2025-05-25,13:56,6,6,12
68,2025-05-25T05:58:00+02:00,2025-05-25,13:58,12,6,18
68,2025-05-25T05:59:00+02:00,2025-05-25,13:59,7,1,8
68,2025-05-25T06:01:00+02:00,2025-05-25,14:01,2,7,9
68,2025-05-25T06:06:00+02:00,2025-05-25,14:06,0,5,5
68,2025-05-25T06:07:00+02:00,2025-05-25,14:07,12,14,26
68,2025-05-25T06:08:00+02:00,2025-05-25,14:08,2,1,3
72,2025-05-25T06:02:00+02:00,2025-05-25,14:02,0,13,13
72,2025-05-25T06:03:00+02:00,2025-05-25,14:03,9,13,22
72,2025-05-25T06:07:00+02:00,2025-05-25,14:07,5,15,20
76,2025-05-25T05:59:00+02:00,2025-05-25,13:59,0,2,2
76,2025-05-25T06:00:00+02:00,2025-05-25,14:00,0,1,1
76,2025-05-25T06:05:00+02:00,2025-05-25,14:05,0,1,1
79,2025-05-25T06:00:00+02:00,2025-05-25,14:00,26,3,29
79,2025-05-25T06:04:00+02:00,2025-05-25,14:04,7,2,9
79,2025-05-25T06:05:00+02:00,2025-05-25,14:05,8,4,12
79,2025-05-25T06:08:00+02:00,2025-05-25,14:08,30,0,30
85,2025-05-25T05:55:00+02:00,2025-05-25,13:55,1,0,1
85,2025-05-25T05:58:00+02:00,2025-05-25,13:58,3,0,3
85,2025-05-25T06:01:00+02:00,2025-05-25,14:01,0,1,1
85,2025-05-25T06:04:00+02:00,2025-05-25,14:04,0,1,1
85,2025-05-25T06:06:00+02:00,2025-05-25,14:06,2,1,3
86,2025-05-25T05:55:00+02:00,2025-05-25,13:55,0,2,2
86,2025-05-25T05:57:00+02:00,2025-05-25,13:57,1,0,1
86,2025-05-25T06:01:00+02:00,2025-05-25,14:01,1,0,1
86,2025-05-25T06:02:00+02:00,2025-05-25,14:02,0,1,1
86,2025-05-25T06:03:00+02:00,2025-05-25,14:03,1,1,2
86,2025-05-25T06:04:00+02:00,2025-05-25,14:04,1,0,1
109,2025-05-25T05:55:00+02:00,2025-05-25,13:55,15,5,20
109,2025-05-25T06:00:00+02:00,2025-05-25,14:00,14,6,20
117,2025-05-25T06:00:00+02:00,2025-05-25,14:00,16,10,26
130,2025-05-25T05:55:00+02:00,2025-05-25,13:55,7,7,14
130,2025-05-25T06:00:00+02:00,2025-05-25,14:00,12,0,12
130,2025-05-25T06:05:00+02:00,2025-05-25,14:05,5,3,8
136,2025-05-25T05:55:00+02:00,2025-05-25,13:55,57,8,65
136,2025-05-25T06:00:00+02:00,2025-05-25,14:00,72,4,76
137,2025-05-25T05:55:00+02:00,2025-05-25,13:55,0,1,1
138,2025-05-25T05:55:00+02:00,2025-05-25,13:55,4,2,6
139,2025-05-25T05:55:00+02:00,2025-05-25,13:55,2,2,4
161,2025-05-25T05:55:00+02:00,2025-05-25,13:55,64,16,80
161,2025-05-25T06:00:00+02:00,2025-05-25,14:00,76,9,85
164,2025-05-25T05:55:00+02:00,2025-05-25,13:55,21,13,34
181,2025-05-25T06:15:00+02:00,2025-05-25,14:15,16,24,40
181,2025-05-25T06:17:00+02:00,2025-05-25,14:17,14,26,40
181,2025-05-25T06:18:00+02:00,2025-05-25,14:18,5,31,36
181,2025-05-25T06:24:00+02:00,2025-05-25,14:24,25,18,43
180,2025-05-25T06:19:00+02:00,2025-05-25,14:19,1,0,1
180,2025-05-25T06:23:00+02:00,2025-05-25,14:23,0,1,1
3,2025-05-25T07:03:00+02:00,2025-05-25,15:03,12,27,39
3,2025-05-25T07:04:00+02:00,2025-05-25,15:04,21,14,35
3,2025-05-25T07:05:00+02:00,2025-05-25,15:05,21,15,36
3,2025-05-25T07:06:00+02:00,2025-05-25,15:06,33,38,71
4,2025-05-25T06:58:00+02:00,2025-05-25,14:58,35,19,54
4,2025-05-25T07:08:00+02:00,2025-05-25,15:08,30,27,57
4,2025-05-25T07:09:00+02:00,2025-05-25,15:09,35,14,49
6,2025-05-25T06:55:00+02:00,2025-05-25,14:55,26,15,41
6,2025-05-25T06:59:00+02:00,2025-05-25,14:59,22,13,35
6,2025-05-25T07:00:00+02:00,2025-05-25,15:00,10,33,43
6,2025-05-25T07:06:00+02:00,2025-05-25,15:06,29,18,47
6,2025-05-25T07:07:00+02:00,2025-05-25,15:07,15,6,21
6,2025-05-25T07:09:00+02:00,2025-05-25,15:09,19,20,39
8,2025-05-25T06:55:00+02:00,2025-05-25,14:55,11,5,16
8,2025-05-25T06:57:00+02:00,2025-05-25,14:57,2,3,5
8,2025-05-25T07:00:00+02:00,2025-05-25,15:00,4,3,7
8,2025-05-25T07:02:00+02:00,2025-05-25,15:02,3,8,11
8,2025-05-25T07:03:00+02:00,2025-05-25,15:03,1,4,5
8,2025-05-25T07:07:00+02:00,2025-05-25,15:07,3,1,4
28,2025-05-25T06:55:00+02:00,2025-05-25,14:55,12,15,27
28,2025-05-25T06:56:00+02:00,2025-05-25,14:56,5,14,19
28,2025-05-25T07:05:00+02:00,2025-05-25,15:05,19,19,38
29,2025-05-25T06:55:00+02:00,2025-05-25,14:55,11,13,24
29,2025-05-25T06:57:00+02:00,2025-05-25,14:57,8,20,28
29,2025-05-25T06:59:00+02:00,2025-05-25,14:59,38,6,44
29,2025-05-25T07:00:00+02:00,2025-05-25,15:00,10,10,20
29,2025-05-25T07:02:00+02:00,2025-05-25,15:02,11,5,16
29,2025-05-25T07:03:00+02:00,2025-05-25,15:03,9,4,13
29,2025-05-25T07:04:00+02:00,2025-05-25,15:04,13,5,18
29,2025-05-25T07:05:00+02:00,2025-05-25,15:05,6,16,22
29,2025-05-25T07:07:00+02:00,2025-05-25,15:07,9,6,15
29,2025-05-25T07:08:00+02:00,2025-05-25,15:08,6,20,26
31,2025-05-25T07:01:00+02:00,2025-05-25,15:01,0,1,1
31,2025-05-25T07:09:00+02:00,2025-05-25,15:09,1,4,5
36,2025-05-25T07:02:00+02:00,2025-05-25,15:02,0,2,2
36,2025-05-25T07:03:00+02:00,2025-05-25,15:03,0,5,5
36,2025-05-25T07:04:00+02:00,2025-05-25,15:04,5,1,6
39,2025-05-25T07:02:00+02:00,2025-05-25,15:02,0,2,2
39,2025-05-25T07:06:00+02:00,2025-05-25,15:06,4,3,7
39,2025-05-25T07:08:00+02:00,2025-05-25,15:08,1,2,3
40,2025-05-25T06:55:00+02:00,2025-05-25,14:55,1,4,5
40,2025-05-25T06:56:00+02:00,2025-05-25,14:56,1,2,3
40,2025-05-25T06:58:00+02:00,2025-05-25,14:58,2,2,4
40,2025-05-25T06:59:00+02:00,2025-05-25,14:59,6,0,6
40,2025-05-25T07:03:00+02:00,2025-05-25,15:03,1,3,4
40,2025-05-25T07:06:00+02:00,2025-05-25,15:06,29,3,32
40,2025-05-25T07:07:00+02:00,2025-05-25,15:07,20,0,20
40,2025-05-25T07:09:00+02:00,2025-05-25,15:09,4,2,6
41,2025-05-25T06:57:00+02:00,2025-05-25,14:57,15,9,24
41,2025-05-25T06:59:00+02:00,2025-05-25,14:59,4,12,16
41,2025-05-25T07:00:00+02:00,2025-05-25,15:00,3,16,19
41,2025-05-25T07:06:00+02:00,2025-05-25,15:06,12,21,33
41,2025-05-25T07:08:00+02:00,2025-05-25,15:08,17,27,44
44,2025-05-25T07:05:00+02:00,2025-05-25,15:05,0,10,10
45,2025-05-25T06:56:00+02:00,2025-05-25,14:56,11,29,40
45,2025-05-25T06:59:00+02:00,2025-05-25,14:59,11,32,43
45,2025-05-25T07:00:00+02:00,2025-05-25,15:00,19,25,44
45,2025-05-25T07:01:00+02:00,2025-05-25,15:01,23,17,40
45,2025-05-25T07:02:00+02:00,2025-05-25,15:02,13,16,29
45,2025-05-25T07:03:00+02:00,2025-05-25,15:03,25,23,48
45,2025-05-25T07:05:00+02:00,2025-05-25,15:05,17,36,53
45,2025-05-25T07:07:00+02:00,2025-05-25,15:07,29,22,51
45,2025-05-25T07:08:00+02:00,2025-05-25,15:08,28,17,45
47,2025-05-25T07:00:00+02:00,2025-05-25,15:00,27,14,41
47,2025-05-25T07:07:00+02:00,2025-05-25,15:07,12,14,26
50,2025-05-25T06:59:00+02:00,2025-05-25,14:59,6,6,12
50,2025-05-25T07:01:00+02:00,2025-05-25,15:01,6,8,14
50,2025-05-25T07:04:00+02:00,2025-05-25,15:04,11,6,17
50,2025-05-25T07:05:00+02:00,2025-05-25,15:05,3,7,10
50,2025-05-25T07:07:00+02:00,2025-05-25,15:07,5,5,10
54,2025-05-25T06:57:00+02:00,2025-05-25,14:57,1,2,3
54,2025-05-25T06:58:00+02:00,2025-05-25,14:58,5,1,6
54,2025-05-25T06:59:00+02:00,2025-05-25,14:59,3,1,4
54,2025-05-25T07:05:00+02:00,2025-05-25,15:05,1,8,9
54,2025-05-25T07:07:00+02:00,2025-05-25,15:07,1,5,6
54,2025-05-25T07:09:00+02:00,2025-05-25,15:09,9,1,10
61,2025-05-25T06:56:00+02:00,2025-05-25,14:56,9,9,18
61,2025-05-25T06:57:00+02:00,2025-05-25,14:57,6,2,8
61,2025-05-25T06:58:00+02:00,2025-05-25,14:58,6,5,11
61,2025-05-25T06:59:00+02:00,2025-05-25,14:59,11,6,17
61,2025-05-25T07:05:00+02:00,2025-05-25,15:05,10,3,13
66,2025-05-25T06:55:00+02:00,2025-05-25,14:55,29,13,42
66,2025-05-25T06:56:00+02:00,2025-05-25,14:56,23,36,59
66,2025-05-25T06:57:00+02:00,2025-05-25,14:57,28,26,54
66,2025-05-25T06:59:00+02:00,2025-05-25,14:59,36,23,59
66,2025-05-25T07:01:00+02:00,2025-05-25,15:01,19,29,48
66,2025-05-25T07:02:00+02:00,2025-05-25,15:02,29,19,48
66,2025-05-25T07:04:00+02:00,2025-05-25,15:04,27,23,50
69,2025-05-25T06:55:00+02:00,2025-05-25,14:55,1,1,2
69,2025-05-25T06:58:00+02:00,2025-05-25,14:58,0,9,9
69,2025-05-25T07:00:00+02:00,2025-05-25,15:00,7,5,12
69,2025-05-25T07:03:00+02:00,2025-05-25,15:03,7,3,10
69,2025-05-25T07:06:00+02:00,2025-05-25,15:06,4,15,19
70,2025-05-25T06:56:00+02:00,2025-05-25,14:56,3,1,4
70,2025-05-25T06:57:00+02:00,2025-05-25,14:57,2,3,5
70,2025-05-25T07:00:00+02:00,2025-05-25,15:00,1,0,1
70,2025-05-25T07:02:00+02:00,2025-05-25,15:02,0,3,3
70,2025-05-25T07:03:00+02:00,2025-05-25,15:03,1,1,2
70,2025-05-25T07:08:00+02:00,2025-05-25,15:08,3,2,5
75,2025-05-25T07:00:00+02:00,2025-05-25,15:00,0,1,1
75,2025-05-25T07:05:00+02:00,2025-05-25,15:05,2,1,3
77,2025-05-25T07:05:00+02:00,2025-05-25,15:05,19,12,31
78,2025-05-25T06:55:00+02:00,2025-05-25,14:55,0,1,1
78,2025-05-25T06:56:00+02:00,2025-05-25,14:56,2,0,2
78,2025-05-25T06:58:00+02:00,2025-05-25,14:58,1,0,1
78,2025-05-25T06:59:00+02:00,2025-05-25,14:59,1,3,4
78,2025-05-25T07:02:00+02:00,2025-05-25,15:02,0,2,2
78,2025-05-25T07:06:00+02:00,2025-05-25,15:06,1,1,2
78,2025-05-25T07:07:00+02:00,2025-05-25,15:07,0,2,2
78,2025-05-25T07:09:00+02:00,2025-05-25,15:09,0,1,1
84,2025-05-25T06:55:00+02:00,2025-05-25,14:55,66,143,209
87,2025-05-25T06:55:00+02:00,2025-05-25,14:55,5,0,5
87,2025-05-25T06:57:00+02:00,2025-05-25,14:57,0,2,2
87,2025-05-25T06:58:00+02:00,2025-05-25,14:58,1,1,2
87,2025-05-25T06:59:00+02:00,2025-05-25,14:59,3,0,3
87,2025-05-25T07:03:00+02:00,2025-05-25,15:03,1,1,2
87,2025-05-25T07:09:00+02:00,2025-05-25,15:09,1,1,2
107,2025-05-25T06:55:00+02:00,2025-05-25,14:55,12,7,19
107,2025-05-25T07:05:00+02:00,2025-05-25,15:05,5,5,10
108,2025-05-25T06:55:00+02:00,2025-05-25,14:55,4,0,4
108,2025-05-25T06:56:00+02:00,2025-05-25,14:56,4,3,7
108,2025-05-25T06:59:00+02:00,2025-05-25,14:59,2,4,6
108,2025-05-25T07:00:00+02:00,2025-05-25,15:00,1,4,5
108,2025-05-25T07:01:00+02:00,2025-05-25,15:01,2,4,6
108,2025-05-25T07:06:00+02:00,2025-05-25,15:06,1,1,2
108,2025-05-25T07:08:00+02:00,2025-05-25,15:08,6,4,10
118,2025-05-25T06:55:00+02:00,2025-05-25,14:55,0,4,4
131,2025-05-25T07:00:00+02:00,2025-05-25,15:00,6,3,9
132,2025-05-25T07:00:00+02:00,2025-05-25,15:00,9,5,14
134,2025-05-25T07:05:00+02:00,2025-05-25,15:05,45,17,62
135,2025-05-25T07:05:00+02:00,2025-05-25,15:05,65,19,84
140,2025-05-25T07:05:00+02:00,2025-05-25,15:05,13,4,17
162,2025-05-25T07:00:00+02:00,2025-05-25,15:00,59,62,121
165,2025-05-25T07:00:00+02:00,2025-05-25,15:00,2,0,2
1,2025-05-25T06:56:00+02:00,2025-05-25,14:56,38,20,58
1,2025-05-25T07:04:00+02:00,2025-05-25,15:04,39,21,60
1,2025-05-25T07:07:00+02:00,2025-05-25,15:07,24,13,37
1,2025-05-25T07:09:00+02:00,2025-05-25,15:09,20,12,32
2,2025-05-25T06:57:00+02:00,2025-05-25,14:57,14,20,34
2,2025-05-25T07:00:00+02:00,2025-05-25,15:00,2,4,6
2,2025-05-25T07:01:00+02:00,2025-05-25,15:01,5,12,17
2,2025-05-25T07:02:00+02:00,2025-05-25,15:02,7,13,20
2,2025-05-25T07:04:00+02:00,2025-05-25,15:04,19,12,31
2,2025-05-25T07:06:00+02:00,2025-05-25,15:06,17,12,29
9,2025-05-25T06:57:00+02:00,2025-05-25,14:57,0,2,2
9,2025-05-25T06:59:00+02:00,2025-05-25,14:59,0,7,7
9,2025-05-25T07:03:00+02:00,2025-05-25,15:03,0,5,5
9,2025-05-25T07:04:00+02:00,2025-05-25,15:04,0,3,3
9,2025-05-25T07:05:00+02:00,2025-05-25,15:05,1,9,10
9,2025-05-25T07:09:00+02:00,2025-05-25,15:09,0,4,4
10,2025-05-25T06:55:00+02:00,2025-05-25,14:55,0,1,1
10,2025-05-25T06:57:00+02:00,2025-05-25,14:57,1,6,7
10,2025-05-25T06:58:00+02:00,2025-05-25,14:58,5,2,7
10,2025-05-25T07:08:00+02:00,2025-05-25,15:08,1,1,2
11,2025-05-25T06:58:00+02:00,2025-05-25,14:58,5,0,5
11,2025-05-25T07:05:00+02:00,2025-05-25,15:05,1,5,6
12,2025-05-25T06:55:00+02:00,2025-05-25,14:55,8,3,11
12,2025-05-25T06:57:00+02:00,2025-05-25,14:57,12,10,22
12,2025-05-25T06:59:00+02:00,2025-05-25,14:59,4,0,4
12,2025-05-25T07:05:00+02:00,2025-05-25,15:05,9,4,13
12,2025-05-25T07:06:00+02:00,2025-05-25,15:06,5,2,7
17,2025-05-25T06:56:00+02:00,2025-05-25,14:56,1,1,2
17,2025-05-25T06:59:00+02:00,2025-05-25,14:59,5,2,7
17,2025-05-25T07:00:00+02:00,2025-05-25,15:00,1,2,3
17,2025-05-25T07:04:00+02:00,2025-05-25,15:04,3,1,4
17,2025-05-25T07:05:00+02:00,2025-05-25,15:05,1,20,21
18,2025-05-25T07:00:00+02:00,2025-05-25,15:00,4,0,4
18,2025-05-25T07:03:00+02:00,2025-05-25,15:03,0,1,1
18,2025-05-25T07:08:00+02:00,2025-05-25,15:08,0,3,3
19,2025-05-25T06:57:00+02:00,2025-05-25,14:57,10,16,26
19,2025-05-25T07:02:00+02:00,2025-05-25,15:02,8,29,37
19,2025-05-25T07:04:00+02:00,2025-05-25,15:04,8,22,30
19,2025-05-25T07:05:00+02:00,2025-05-25,15:05,12,16,28
19,2025-05-25T07:07:00+02:00,2025-05-25,15:07,7,5,12
20,2025-05-25T06:56:00+02:00,2025-05-25,14:56,4,16,20
20,2025-05-25T06:57:00+02:00,2025-05-25,14:57,3,10,13
20,2025-05-25T07:00:00+02:00,2025-05-25,15:00,2,10,12
20,2025-05-25T07:06:00+02:00,2025-05-25,15:06,10,8,18
23,2025-05-25T06:55:00+02:00,2025-05-25,14:55,0,4,4
23,2025-05-25T07:01:00+02:00,2025-05-25,15:01,2,0,2
23,2025-05-25T07:03:00+02:00,2025-05-25,15:03,2,10,12
23,2025-05-25T07:05:00+02:00,2025-05-25,15:05,3,0,3
23,2025-05-25T07:08:00+02:00,2025-05-25,15:08,5,8,13
23,2025-05-25T07:09:00+02:00,2025-05-25,15:09,1,1,2
24,2025-05-25T06:56:00+02:00,2025-05-25,14:56,10,22,32
24,2025-05-25T06:57:00+02:00,2025-05-25,14:57,2,10,12
24,2025-05-25T06:58:00+02:00,2025-05-25,14:58,8,13,21
24,2025-05-25T07:00:00+02:00,2025-05-25,15:00,7,1,8
24,2025-05-25T07:01:00+02:00,2025-05-25,15:01,6,23,29
24,2025-05-25T07:02:00+02:00,2025-05-25,15:02,7,20,27
24,2025-05-25T07:06:00+02:00,2025-05-25,15:06,9,2,11
24,2025-05-25T07:08:00+02:00,2025-05-25,15:08,8,19,27
25,2025-05-25T07:05:00+02:00,2025-05-25,15:05,64,48,112
27,2025-05-25T06:55:00+02:00,2025-05-25,14:55,15,2,17
27,2025-05-25T06:59:00+02:00,2025-05-25,14:59,0,5,5
27,2025-05-25T07:06:00+02:00,2025-05-25,15:06,8,4,12
27,2025-05-25T07:07:00+02:00,2025-05-25,15:07,1,5,6
27,2025-05-25T07:08:00+02:00,2025-05-25,15:08,4,5,9
27,2025-05-25T07:09:00+02:00,2025-05-25,15:09,3,1,4
30,2025-05-25T07:00:00+02:00,2025-05-25,15:00,5,7,12
35,2025-05-25T06:57:00+02:00,2025-05-25,14:57,19,17,36
35,2025-05-25T07:00:00+02:00,2025-05-25,15:00,26,13,39
35,2025-05-25T07:02:00+02:00,2025-05-25,15:02,20,27,47
35,2025-05-25T07:03:00+02:00,2025-05-25,15:03,12,26,38
35,2025-05-25T07:04:00+02:00,2025-05-25,15:04,20,22,42
35,2025-05-25T07:05:00+02:00,2025-05-25,15:05,21,20,41
35,2025-05-25T07:06:00+02:00,2025-05-25,15:06,34,5,39
46,2025-05-25T07:05:00+02:00,2025-05-25,15:05,10,5,15
48,2025-05-25T06:55:00+02:00,2025-05-25,14:55,3,1,4
48,2025-05-25T06:58:00+02:00,2025-05-25,14:58,6,6,12
48,2025-05-25T06:59:00+02:00,2025-05-25,14:59,13,15,28
48,2025-05-25T07:00:00+02:00,2025-05-25,15:00,17,6,23
48,2025-05-25T07:01:00+02:00,2025-05-25,15:01,9,21,30
48,2025-05-25T07:02:00+02:00,2025-05-25,15:02,8,8,16
48,2025-05-25T07:03:00+02:00,2025-05-25,15:03,9,2,11
48,2025-05-25T07:04:00+02:00,2025-05-25,15:04,4,3,7
48,2025-05-25T07:07:00+02:00,2025-05-25,15:07,9,8,17
49,2025-05-25T06:57:00+02:00,2025-05-25,14:57,5,16,21
49,2025-05-25T06:58:00+02:00,2025-05-25,14:58,10,8,18
49,2025-05-25T07:01:00+02:00,2025-05-25,15:01,8,10,18
49,2025-05-25T07:03:00+02:00,2025-05-25,15:03,6,12,18
49,2025-05-25T07:06:00+02:00,2025-05-25,15:06,9,6,15
49,2025-05-25T07:07:00+02:00,2025-05-25,15:07,10,3,13
51,2025-05-25T06:58:00+02:00,2025-05-25,14:58,1,0,1
51,2025-05-25T06:59:00+02:00,2025-05-25,14:59,1,3,4
51,2025-05-25T07:02:00+02:00,2025-05-25,15:02,1,7,8
51,2025-05-25T07:05:00+02:00,2025-05-25,15:05,0,2,2
51,2025-05-25T07:07:00+02:00,2025-05-25,15:07,4,4,8
51,2025-05-25T07:09:00+02:00,2025-05-25,15:09,1,2,3
52,2025-05-25T06:55:00+02:00,2025-05-25,14:55,8,2,10
52,2025-05-25T06:56:00+02:00,2025-05-25,14:56,12,10,22
52,2025-05-25T07:04:00+02:00,2025-05-25,15:04,3,1,4
52,2025-05-25T07:09:00+02:00,2025-05-25,15:09,7,11,18
53,2025-05-25T06:56:00+02:00,2025-05-25,14:56,8,2,10
53,2025-05-25T06:57:00+02:00,2025-05-25,14:57,8,4,12
53,2025-05-25T06:58:00+02:00,2025-05-25,14:58,12,2,14
53,2025-05-25T07:00:00+02:00,2025-05-25,15:00,10,5,15
53,2025-05-25T07:01:00+02:00,2025-05-25,15:01,3,1,4
53,2025-05-25T07:02:00+02:00,2025-05-25,15:02,14,13,27
53,2025-05-25T07:04:00+02:00,2025-05-25,15:04,14,7,21
53,2025-05-25T07:05:00+02:00,2025-05-25,15:05,7,18,25
53,2025-05-25T07:07:00+02:00,2025-05-25,15:07,6,4,10
56,2025-05-25T06:57:00+02:00,2025-05-25,14:57,10,7,17
56,2025-05-25T07:08:00+02:00,2025-05-25,15:08,18,7,25
56,2025-05-25T07:09:00+02:00,2025-05-25,15:09,8,3,11
58,2025-05-25T06:55:00+02:00,2025-05-25,14:55,11,14,25
58,2025-05-25T06:59:00+02:00,2025-05-25,14:59,4,2,6
58,2025-05-25T07:00:00+02:00,2025-05-25,15:00,3,4,7
58,2025-05-25T07:05:00+02:00,2025-05-25,15:05,23,6,29
58,2025-05-25T07:06:00+02:00,2025-05-25,15:06,3,6,9
58,2025-05-25T07:09:00+02:00,2025-05-25,15:09,17,5,22
62,2025-05-25T06:55:00+02:00,2025-05-25,14:55,4,2,6
62,2025-05-25T06:56:00+02:00,2025-05-25,14:56,7,2,9
62,2025-05-25T06:58:00+02:00,2025-05-25,14:58,7,0,7
62,2025-05-25T07:00:00+02:00,2025-05-25,15:00,4,1,5
62,2025-05-25T07:01:00+02:00,2025-05-25,15:01,4,2,6
62,2025-05-25T07:07:00+02:00,2025-05-25,15:07,7,3,10
63,2025-05-25T06:58:00+02:00,2025-05-25,14:58,4,3,7
63,2025-05-25T07:00:00+02:00,2025-05-25,15:00,4,5,9
63,2025-05-25T07:02:00+02:00,2025-05-25,15:02,3,12,15
63,2025-05-25T07:03:00+02:00,2025-05-25,15:03,3,3,6
63,2025-05-25T07:05:00+02:00,2025-05-25,15:05,12,7,19
63,2025-05-25T07:07:00+02:00,2025-05-25,15:07,10,6,16
67,2025-05-25T06:57:00+02:00,2025-05-25,14:57,0,4,4
67,2025-05-25T06:59:00+02:00,2025-05-25,14:59,8,9,17
67,2025-05-25T07:04:00+02:00,2025-05-25,15:04,8,13,21
67,2025-05-25T07:07:00+02:00,2025-05-25,15:07,9,1,10
67,2025-05-25T07:09:00+02:00,2025-05-25,15:09,6,15,21
68,2025-05-25T06:56:00+02:00,2025-05-25,14:56,12,5,17
68,2025-05-25T06:59:00+02:00,2025-05-25,14:59,9,7,16
68,2025-05-25T07:02:00+02:00,2025-05-25,15:02,2,3,5
68,2025-05-25T07:05:00+02:00,2025-05-25,15:05,5,10,15
68,2025-05-25T07:07:00+02:00,2025-05-25,15:07,6,3,9
68,2025-05-25T07:09:00+02:00,2025-05-25,15:09,10,5,15
72,2025-05-25T06:55:00+02:00,2025-05-25,14:55,2,9,11
72,2025-05-25T06:58:00+02:00,2025-05-25,14:58,6,1,7
72,2025-05-25T07:04:00+02:00,2025-05-25,15:04,8,13,21
72,2025-05-25T07:05:00+02:00,2025-05-25,15:05,7,7,14
76,2025-05-25T07:01:00+02:00,2025-05-25,15:01,1,1,2
76,2025-05-25T07:04:00+02:00,2025-05-25,15:04,3,1,4
76,2025-05-25T07:08:00+02:00,2025-05-25,15:08,1,0,1
79,2025-05-25T06:55:00+02:00,2025-05-25,14:55,12,12,24
79,2025-05-25T06:57:00+02:00,2025-05-25,14:57,9,12,21
79,2025-05-25T07:03:00+02:00,2025-05-25,15:03,23,6,29
79,2025-05-25T07:06:00+02:00,2025-05-25,15:06,2,10,12
79,2025-05-25T07:07:00+02:00,2025-05-25,15:07,7,11,18
85,2025-05-25T06:57:00+02:00,2025-05-25,14:57,4,4,8
85,2025-05-25T07:01:00+02:00,2025-05-25,15:01,0,5,5
85,2025-05-25T07:02:00+02:00,2025-05-25,15:02,0,4,4
85,2025-05-25T07:04:00+02:00,2025-05-25,15:04,4,1,5
85,2025-05-25T07:07:00+02:00,2025-05-25,15:07,2,0,2
86,2025-05-25T06:55:00+02:00,2025-05-25,14:55,0,1,1
86,2025-05-25T06:57:00+02:00,2025-05-25,14:57,0,3,3
86,2025-05-25T06:58:00+02:00,2025-05-25,14:58,2,0,2
86,2025-05-25T06:59:00+02:00,2025-05-25,14:59,1,0,1
86,2025-05-25T07:00:00+02:00,2025-05-25,15:00,0,1,1
86,2025-05-25T07:04:00+02:00,2025-05-25,15:04,1,0,1
86,2025-05-25T07:07:00+02:00,2025-05-25,15:07,3,1,4
109,2025-05-25T06:55:00+02:00,2025-05-25,14:55,3,7,10
109,2025-05-25T07:05:00+02:00,2025-05-25,15:05,7,5,12
117,2025-05-25T07:00:00+02:00,2025-05-25,15:00,19,22,41
117,2025-05-25T07:05:00+02:00,2025-05-25,15:05,17,23,40
136,2025-05-25T06:55:00+02:00,2025-05-25,14:55,129,11,140
138,2025-05-25T07:05:00+02:00,2025-05-25,15:05,1,1,2
139,2025-05-25T07:00:00+02:00,2025-05-25,15:00,6,2,8
141,2025-05-25T07:05:00+02:00,2025-05-25,15:05,26,9,35
142,2025-05-25T06:55:00+02:00,2025-05-25,14:55,41,37,78
142,2025-05-25T07:00:00+02:00,2025-05-25,15:00,81,49,130
142,2025-05-25T07:05:00+02:00,2025-05-25,15:05,63,40,103
161,2025-05-25T06:55:00+02:00,2025-05-25,14:55,107,15,122
161,2025-05-25T07:05:00+02:00,2025-05-25,15:05,85,13,98
164,2025-05-25T07:00:00+02:00,2025-05-25,15:00,9,6,15
164,2025-05-25T07:05:00+02:00,2025-05-25,15:05,11,4,15
181,2025-05-25T06:40:00+02:00,2025-05-25,14:40,13,23,36
181,2025-05-25T06:44:00+02:00,2025-05-25,14:44,17,32,49
181,2025-05-25T06:45:00+02:00,2025-05-25,14:45,11,34,45
181,2025-05-25T06:46:00+02:00,2025-05-25,14:46,12,27,39
181,2025-05-25T06:50:00+02:00,2025-05-25,14:50,11,38,49
181,2025-05-25T06:51:00+02:00,2025-05-25,14:51,7,18,25
182,2025-05-25T06:50:00+02:00,2025-05-25,14:50,18,7,25
180,2025-05-25T06:40:00+02:00,2025-05-25,14:40,1,0,1
180,2025-05-25T06:42:00+02:00,2025-05-25,14:42,1,0,1
180,2025-05-25T06:51:00+02:00,2025-05-25,14:51,0,1,1
181,2025-05-25T06:57:00+02:00,2025-05-25,14:57,9,22,31
181,2025-05-25T07:00:00+02:00,2025-05-25,15:00,11,17,28
181,2025-05-25T07:06:00+02:00,2025-05-25,15:06,8,23,31
181,2025-05-25T07:09:00+02:00,2025-05-25,15:09,13,24,37
182,2025-05-25T06:55:00+02:00,2025-05-25,14:55,17,7,24
182,2025-05-25T07:00:00+02:00,2025-05-25,15:00,16,20,36
180,2025-05-25T07:06:00+02:00,2025-05-25,15:06,1,1,2
180,2025-05-25T07:08:00+02:00,2025-05-25,15:08,1,0,1
180,2025-05-25T07:09:00+02:00,2025-05-25,15:09,1,1,2
181,2025-05-25T07:13:00+02:00,2025-05-25,15:13,16,15,31
181,2025-05-25T07:15:00+02:00,2025-05-25,15:15,3,20,23
181,2025-05-25T07:16:00+02:00,2025-05-25,15:16,12,17,29
181,2025-05-25T07:18:00+02:00,2025-05-25,15:18,10,12,22
181,2025-05-25T07:21:00+02:00,2025-05-25,15:21,11,17,28
181,2025-05-25T07:24:00+02:00,2025-05-25,15:24,14,19,33
182,2025-05-25T07:20:00+02:00,2025-05-25,15:20,13,16,29
180,2025-05-25T07:13:00+02:00,2025-05-25,15:13,1,0,1
180,2025-05-25T07:17:00+02:00,2025-05-25,15:17,1,1,2
180,2025-05-25T07:24:00+02:00,2025-05-25,15:24,0,3,3
3,2025-05-25T06:28:00+02:00,2025-05-25,14:28,25,34,59
3,2025-05-25T06:30:00+02:00,2025-05-25,14:30,10,15,25
4,2025-05-25T06:26:00+02:00,2025-05-25,14:26,47,25,72
4,2025-05-25T06:27:00+02:00,2025-05-25,14:27,20,35,55
4,2025-05-25T06:30:00+02:00,2025-05-25,14:30,24,42,66
4,2025-05-25T06:32:00+02:00,2025-05-25,14:32,22,19,41
4,2025-05-25T06:35:00+02:00,2025-05-25,14:35,38,39,77
4,2025-05-25T06:36:00+02:00,2025-05-25,14:36,46,28,74
4,2025-05-25T06:38:00+02:00,2025-05-25,14:38,28,32,60
5,2025-05-25T06:35:00+02:00,2025-05-25,14:35,95,99,194
6,2025-05-25T06:25:00+02:00,2025-05-25,14:25,7,7,14
6,2025-05-25T06:26:00+02:00,2025-05-25,14:26,18,17,35
6,2025-05-25T06:28:00+02:00,2025-05-25,14:28,13,24,37
6,2025-05-25T06:31:00+02:00,2025-05-25,14:31,11,9,20
6,2025-05-25T06:32:00+02:00,2025-05-25,14:32,19,9,28
6,2025-05-25T06:33:00+02:00,2025-05-25,14:33,10,14,24
6,2025-05-25T06:35:00+02:00,2025-05-25,14:35,8,8,16
6,2025-05-25T06:38:00+02:00,2025-05-25,14:38,11,16,27
8,2025-05-25T06:26:00+02:00,2025-05-25,14:26,1,6,7
8,2025-05-25T06:35:00+02:00,2025-05-25,14:35,5,1,6
28,2025-05-25T06:25:00+02:00,2025-05-25,14:25,7,7,14
28,2025-05-25T06:28:00+02:00,2025-05-25,14:28,13,13,26
28,2025-05-25T06:30:00+02:00,2025-05-25,14:30,22,13,35
28,2025-05-25T06:34:00+02:00,2025-05-25,14:34,12,13,25
28,2025-05-25T06:37:00+02:00,2025-05-25,14:37,12,5,17
28,2025-05-25T06:38:00+02:00,2025-05-25,14:38,2,13,15
29,2025-05-25T06:27:00+02:00,2025-05-25,14:27,9,18,27
29,2025-05-25T06:30:00+02:00,2025-05-25,14:30,16,15,31
29,2025-05-25T06:31:00+02:00,2025-05-25,14:31,15,20,35
29,2025-05-25T06:35:00+02:00,2025-05-25,14:35,16,9,25
31,2025-05-25T06:27:00+02:00,2025-05-25,14:27,0,2,2
31,2025-05-25T06:28:00+02:00,2025-05-25,14:28,1,7,8
31,2025-05-25T06:35:00+02:00,2025-05-25,14:35,0,4,4
31,2025-05-25T06:36:00+02:00,2025-05-25,14:36,6,3,9
31,2025-05-25T06:37:00+02:00,2025-05-25,14:37,8,7,15
36,2025-05-25T06:30:00+02:00,2025-05-25,14:30,2,0,2
36,2025-05-25T06:32:00+02:00,2025-05-25,14:32,3,3,6
36,2025-05-25T06:33:00+02:00,2025-05-25,14:33,2,2,4
36,2025-05-25T06:36:00+02:00,2025-05-25,14:36,1,1,2
36,2025-05-25T06:37:00+02:00,2025-05-25,14:37,2,4,6
39,2025-05-25T06:29:00+02:00,2025-05-25,14:29,0,1,1
40,2025-05-25T06:26:00+02:00,2025-05-25,14:26,7,0,7
40,2025-05-25T06:31:00+02:00,2025-05-25,14:31,1,1,2
40,2025-05-25T06:32:00+02:00,2025-05-25,14:32,1,2,3
41,2025-05-25T06:27:00+02:00,2025-05-25,14:27,6,2,8
41,2025-05-25T06:28:00+02:00,2025-05-25,14:28,6,4,10
41,2025-05-25T06:30:00+02:00,2025-05-25,14:30,3,12,15
41,2025-05-25T06:31:00+02:00,2025-05-25,14:31,17,19,36
41,2025-05-25T06:33:00+02:00,2025-05-25,14:33,4,14,18
41,2025-05-25T06:35:00+02:00,2025-05-25,14:35,14,3,17
41,2025-05-25T06:36:00+02:00,2025-05-25,14:36,3,9,12
43,2025-05-25T06:35:00+02:00,2025-05-25,14:35,12,7,19
45,2025-05-25T06:29:00+02:00,2025-05-25,14:29,15,12,27
45,2025-05-25T06:32:00+02:00,2025-05-25,14:32,28,18,46
45,2025-05-25T06:36:00+02:00,2025-05-25,14:36,7,20,27
45,2025-05-25T06:37:00+02:00,2025-05-25,14:37,20,13,33
47,2025-05-25T06:26:00+02:00,2025-05-25,14:26,11,19,30
47,2025-05-25T06:35:00+02:00,2025-05-25,14:35,7,29,36
47,2025-05-25T06:36:00+02:00,2025-05-25,14:36,16,14,30
47,2025-05-25T06:37:00+02:00,2025-05-25,14:37,23,28,51
47,2025-05-25T06:39:00+02:00,2025-05-25,14:39,8,17,25
50,2025-05-25T06:26:00+02:00,2025-05-25,14:26,11,3,14
50,2025-05-25T06:36:00+02:00,2025-05-25,14:36,4,6,10
50,2025-05-25T06:37:00+02:00,2025-05-25,14:37,0,2,2
54,2025-05-25T06:30:00+02:00,2025-05-25,14:30,6,2,8
54,2025-05-25T06:31:00+02:00,2025-05-25,14:31,2,1,3
54,2025-05-25T06:32:00+02:00,2025-05-25,14:32,3,1,4
54,2025-05-25T06:34:00+02:00,2025-05-25,14:34,3,4,7
59,2025-05-25T06:35:00+02:00,2025-05-25,14:35,40,32,72
61,2025-05-25T06:26:00+02:00,2025-05-25,14:26,12,6,18
61,2025-05-25T06:27:00+02:00,2025-05-25,14:27,7,4,11
61,2025-05-25T06:30:00+02:00,2025-05-25,14:30,10,2,12
61,2025-05-25T06:31:00+02:00,2025-05-25,14:31,6,3,9
61,2025-05-25T06:32:00+02:00,2025-05-25,14:32,20,14,34
61,2025-05-25T06:37:00+02:00,2025-05-25,14:37,3,2,5
61,2025-05-25T06:39:00+02:00,2025-05-25,14:39,3,2,5
66,2025-05-25T06:28:00+02:00,2025-05-25,14:28,22,20,42
66,2025-05-25T06:30:00+02:00,2025-05-25,14:30,28,23,51
66,2025-05-25T06:31:00+02:00,2025-05-25,14:31,33,27,60
69,2025-05-25T06:33:00+02:00,2025-05-25,14:33,2,5,7
69,2025-05-25T06:35:00+02:00,2025-05-25,14:35,1,0,1
69,2025-05-25T06:37:00+02:00,2025-05-25,14:37,1,10,11
70,2025-05-25T06:25:00+02:00,2025-05-25,14:25,3,5,8
70,2025-05-25T06:26:00+02:00,2025-05-25,14:26,2,2,4
70,2025-05-25T06:27:00+02:00,2025-05-25,14:27,1,6,7
70,2025-05-25T06:31:00+02:00,2025-05-25,14:31,1,3,4
70,2025-05-25T06:34:00+02:00,2025-05-25,14:34,1,1,2
70,2025-05-25T06:35:00+02:00,2025-05-25,14:35,4,0,4
71,2025-05-25T06:25:00+02:00,2025-05-25,14:25,1,0,1
75,2025-05-25T06:30:00+02:00,2025-05-25,14:30,1,0,1
75,2025-05-25T06:31:00+02:00,2025-05-25,14:31,0,1,1
75,2025-05-25T06:32:00+02:00,2025-05-25,14:32,1,1,2
75,2025-05-25T06:33:00+02:00,2025-05-25,14:33,0,10,10
75,2025-05-25T06:35:00+02:00,2025-05-25,14:35,2,0,2
75,2025-05-25T06:37:00+02:00,2025-05-25,14:37,0,2,2
77,2025-05-25T06:30:00+02:00,2025-05-25,14:30,15,13,28
77,2025-05-25T06:35:00+02:00,2025-05-25,14:35,23,3,26
78,2025-05-25T06:25:00+02:00,2025-05-25,14:25,2,1,3
78,2025-05-25T06:26:00+02:00,2025-05-25,14:26,1,2,3
78,2025-05-25T06:30:00+02:00,2025-05-25,14:30,2,1,3
78,2025-05-25T06:35:00+02:00,2025-05-25,14:35,3,0,3
84,2025-05-25T06:35:00+02:00,2025-05-25,14:35,73,101,174
87,2025-05-25T06:25:00+02:00,2025-05-25,14:25,0,4,4
87,2025-05-25T06:30:00+02:00,2025-05-25,14:30,1,1,2
87,2025-05-25T06:34:00+02:00,2025-05-25,14:34,1,2,3
107,2025-05-25T06:35:00+02:00,2025-05-25,14:35,7,8,15
108,2025-05-25T06:27:00+02:00,2025-05-25,14:27,1,1,2
108,2025-05-25T06:34:00+02:00,2025-05-25,14:34,1,2,3
108,2025-05-25T06:36:00+02:00,2025-05-25,14:36,5,0,5
108,2025-05-25T06:38:00+02:00,2025-05-25,14:38,2,3,5
118,2025-05-25T06:35:00+02:00,2025-05-25,14:35,0,5,5
124,2025-05-25T06:30:00+02:00,2025-05-25,14:30,2,2,4
131,2025-05-25T06:25:00+02:00,2025-05-25,14:25,12,11,23
131,2025-05-25T06:30:00+02:00,2025-05-25,14:30,14,20,34
131,2025-05-25T06:35:00+02:00,2025-05-25,14:35,8,8,16
132,2025-05-25T06:30:00+02:00,2025-05-25,14:30,15,10,25
133,2025-05-25T06:30:00+02:00,2025-05-25,14:30,36,60,96
134,2025-05-25T06:25:00+02:00,2025-05-25,14:25,28,34,62
134,2025-05-25T06:30:00+02:00,2025-05-25,14:30,29,27,56
134,2025-05-25T06:35:00+02:00,2025-05-25,14:35,28,31,59
135,2025-05-25T06:25:00+02:00,2025-05-25,14:25,24,45,69
135,2025-05-25T06:30:00+02:00,2025-05-25,14:30,47,27,74
135,2025-05-25T06:35:00+02:00,2025-05-25,14:35,26,35,61
140,2025-05-25T06:25:00+02:00,2025-05-25,14:25,10,17,27
140,2025-05-25T06:30:00+02:00,2025-05-25,14:30,13,12,25
162,2025-05-25T06:25:00+02:00,2025-05-25,14:25,38,99,137
162,2025-05-25T06:35:00+02:00,2025-05-25,14:35,50,72,122
165,2025-05-25T06:35:00+02:00,2025-05-25,14:35,4,4,8
166,2025-05-25T06:25:00+02:00,2025-05-25,14:25,5,2,7
167,2025-05-25T06:35:00+02:00,2025-05-25,14:35,2,2,4
179,2025-05-25T06:25:00+02:00,2025-05-25,14:25,5,5,10
1,2025-05-25T06:25:00+02:00,2025-05-25,14:25,33,18,51
1,2025-05-25T06:27:00+02:00,2025-05-25,14:27,35,23,58
1,2025-05-25T06:30:00+02:00,2025-05-25,14:30,20,17,37
1,2025-05-25T06:31:00+02:00,2025-05-25,14:31,20,24,44
1,2025-05-25T06:32:00+02:00,2025-05-25,14:32,21,15,36
1,2025-05-25T06:36:00+02:00,2025-05-25,14:36,24,21,45
2,2025-05-25T06:25:00+02:00,2025-05-25,14:25,3,17,20
2,2025-05-25T06:26:00+02:00,2025-05-25,14:26,12,21,33
2,2025-05-25T06:33:00+02:00,2025-05-25,14:33,8,4,12
2,2025-05-25T06:34:00+02:00,2025-05-25,14:34,9,8,17
9,2025-05-25T06:25:00+02:00,2025-05-25,14:25,0,4,4
9,2025-05-25T06:28:00+02:00,2025-05-25,14:28,0,2,2
9,2025-05-25T06:35:00+02:00,2025-05-25,14:35,0,1,1
9,2025-05-25T06:37:00+02:00,2025-05-25,14:37,4,0,4
10,2025-05-25T06:25:00+02:00,2025-05-25,14:25,2,1,3
10,2025-05-25T06:34:00+02:00,2025-05-25,14:34,3,0,3
10,2025-05-25T06:39:00+02:00,2025-05-25,14:39,5,0,5
11,2025-05-25T06:27:00+02:00,2025-05-25,14:27,0,2,2
11,2025-05-25T06:30:00+02:00,2025-05-25,14:30,106,1,107
11,2025-05-25T06:31:00+02:00,2025-05-25,14:31,0,2,2
12,2025-05-25T06:28:00+02:00,2025-05-25,14:28,0,5,5
12,2025-05-25T06:33:00+02:00,2025-05-25,14:33,0,4,4
12,2025-05-25T06:34:00+02:00,2025-05-25,14:34,0,5,5
12,2025-05-25T06:35:00+02:00,2025-05-25,14:35,1,3,4
12,2025-05-25T06:37:00+02:00,2025-05-25,14:37,14,1,15
17,2025-05-25T06:31:00+02:00,2025-05-25,14:31,1,2,3
18,2025-05-25T06:26:00+02:00,2025-05-25,14:26,6,7,13
18,2025-05-25T06:31:00+02:00,2025-05-25,14:31,2,0,2
18,2025-05-25T06:34:00+02:00,2025-05-25,14:34,1,0,1
18,2025-05-25T06:36:00+02:00,2025-05-25,14:36,1,2,3
19,2025-05-25T06:32:00+02:00,2025-05-25,14:32,9,8,17
19,2025-05-25T06:33:00+02:00,2025-05-25,14:33,13,14,27
20,2025-05-25T06:26:00+02:00,2025-05-25,14:26,2,4,6
20,2025-05-25T06:32:00+02:00,2025-05-25,14:32,7,3,10
20,2025-05-25T06:33:00+02:00,2025-05-25,14:33,8,4,12
20,2025-05-25T06:34:00+02:00,2025-05-25,14:34,9,11,20
20,2025-05-25T06:36:00+02:00,2025-05-25,14:36,5,7,12
20,2025-05-25T06:38:00+02:00,2025-05-25,14:38,7,6,13
23,2025-05-25T06:25:00+02:00,2025-05-25,14:25,2,4,6
23,2025-05-25T06:26:00+02:00,2025-05-25,14:26,3,9,12
23,2025-05-25T06:28:00+02:00,2025-05-25,14:28,1,1,2
23,2025-05-25T06:29:00+02:00,2025-05-25,14:29,1,2,3
23,2025-05-25T06:31:00+02:00,2025-05-25,14:31,2,5,7
24,2025-05-25T06:25:00+02:00,2025-05-25,14:25,10,10,20
24,2025-05-25T06:26:00+02:00,2025-05-25,14:26,4,22,26
24,2025-05-25T06:33:00+02:00,2025-05-25,14:33,11,8,19
24,2025-05-25T06:34:00+02:00,2025-05-25,14:34,2,4,6
24,2025-05-25T06:37:00+02:00,2025-05-25,14:37,2,6,8
25,2025-05-25T06:30:00+02:00,2025-05-25,14:30,91,79,170
27,2025-05-25T06:29:00+02:00,2025-05-25,14:29,7,0,7
27,2025-05-25T06:30:00+02:00,2025-05-25,14:30,8,4,12
27,2025-05-25T06:32:00+02:00,2025-05-25,14:32,7,1,8
27,2025-05-25T06:35:00+02:00,2025-05-25,14:35,11,2,13
30,2025-05-25T06:32:00+02:00,2025-05-25,14:32,1,10,11
30,2025-05-25T06:34:00+02:00,2025-05-25,14:34,9,4,13
30,2025-05-25T06:35:00+02:00,2025-05-25,14:35,1,9,10
30,2025-05-25T06:37:00+02:00,2025-05-25,14:37,1,8,9
35,2025-05-25T06:29:00+02:00,2025-05-25,14:29,16,39,55
35,2025-05-25T06:33:00+02:00,2025-05-25,14:33,21,36,57
35,2025-05-25T06:35:00+02:00,2025-05-25,14:35,20,34,54
48,2025-05-25T06:27:00+02:00,2025-05-25,14:27,22,4,26
48,2025-05-25T06:29:00+02:00,2025-05-25,14:29,5,9,14
48,2025-05-25T06:31:00+02:00,2025-05-25,14:31,6,8,14
48,2025-05-25T06:32:00+02:00,2025-05-25,14:32,4,12,16
48,2025-05-25T06:33:00+02:00,2025-05-25,14:33,18,5,23
48,2025-05-25T06:34:00+02:00,2025-05-25,14:34,4,3,7
48,2025-05-25T06:36:00+02:00,2025-05-25,14:36,7,14,21
48,2025-05-25T06:38:00+02:00,2025-05-25,14:38,15,3,18
49,2025-05-25T06:25:00+02:00,2025-05-25,14:25,4,12,16
49,2025-05-25T06:26:00+02:00,2025-05-25,14:26,10,9,19
49,2025-05-25T06:29:00+02:00,2025-05-25,14:29,4,14,18
49,2025-05-25T06:30:00+02:00,2025-05-25,14:30,11,8,19
49,2025-05-25T06:33:00+02:00,2025-05-25,14:33,4,3,7
49,2025-05-25T06:34:00+02:00,2025-05-25,14:34,8,17,25
49,2025-05-25T06:36:00+02:00,2025-05-25,14:36,5,11,16
49,2025-05-25T06:37:00+02:00,2025-05-25,14:37,6,6,12
51,2025-05-25T06:26:00+02:00,2025-05-25,14:26,2,6,8
51,2025-05-25T06:32:00+02:00,2025-05-25,14:32,2,2,4
51,2025-05-25T06:35:00+02:00,2025-05-25,14:35,3,6,9
51,2025-05-25T06:38:00+02:00,2025-05-25,14:38,3,3,6
51,2025-05-25T06:39:00+02:00,2025-05-25,14:39,6,0,6
52,2025-05-25T06:25:00+02:00,2025-05-25,14:25,6,11,17
52,2025-05-25T06:28:00+02:00,2025-05-25,14:28,6,2,8
52,2025-05-25T06:29:00+02:00,2025-05-25,14:29,4,3,7
52,2025-05-25T06:30:00+02:00,2025-05-25,14:30,3,4,7
52,2025-05-25T06:35:00+02:00,2025-05-25,14:35,8,5,13
53,2025-05-25T06:37:00+02:00,2025-05-25,14:37,13,1,14
56,2025-05-25T06:25:00+02:00,2025-05-25,14:25,6,9,15
56,2025-05-25T06:29:00+02:00,2025-05-25,14:29,8,15,23
58,2025-05-25T06:25:00+02:00,2025-05-25,14:25,8,8,16
58,2025-05-25T06:27:00+02:00,2025-05-25,14:27,9,5,14
58,2025-05-25T06:28:00+02:00,2025-05-25,14:28,16,9,25
58,2025-05-25T06:35:00+02:00,2025-05-25,14:35,11,1,12
58,2025-05-25T06:37:00+02:00,2025-05-25,14:37,14,1,15
58,2025-05-25T06:39:00+02:00,2025-05-25,14:39,10,2,12
62,2025-05-25T06:32:00+02:00,2025-05-25,14:32,2,1,3
62,2025-05-25T06:34:00+02:00,2025-05-25,14:34,7,2,9
62,2025-05-25T06:35:00+02:00,2025-05-25,14:35,9,3,12
62,2025-05-25T06:36:00+02:00,2025-05-25,14:36,5,3,8
62,2025-05-25T06:38:00+02:00,2025-05-25,14:38,5,1,6
63,2025-05-25T06:30:00+02:00,2025-05-25,14:30,8,7,15
63,2025-05-25T06:31:00+02:00,2025-05-25,14:31,5,5,10
63,2025-05-25T06:32:00+02:00,2025-05-25,14:32,8,2,10
63,2025-05-25T06:35:00+02:00,2025-05-25,14:35,1,7,8
63,2025-05-25T06:39:00+02:00,2025-05-25,14:39,6,8,14
67,2025-05-25T06:25:00+02:00,2025-05-25,14:25,7,13,20
67,2025-05-25T06:27:00+02:00,2025-05-25,14:27,21,8,29
67,2025-05-25T06:34:00+02:00,2025-05-25,14:34,5,14,19
67,2025-05-25T06:36:00+02:00,2025-05-25,14:36,16,15,31
67,2025-05-25T06:39:00+02:00,2025-05-25,14:39,7,9,16
68,2025-05-25T06:25:00+02:00,2025-05-25,14:25,5,2,7
68,2025-05-25T06:27:00+02:00,2025-05-25,14:27,0,5,5
68,2025-05-25T06:30:00+02:00,2025-05-25,14:30,3,5,8
68,2025-05-25T06:36:00+02:00,2025-05-25,14:36,10,4,14
72,2025-05-25T06:25:00+02:00,2025-05-25,14:25,0,21,21
72,2025-05-25T06:28:00+02:00,2025-05-25,14:28,8,4,12
72,2025-05-25T06:29:00+02:00,2025-05-25,14:29,4,4,8
72,2025-05-25T06:30:00+02:00,2025-05-25,14:30,4,6,10
72,2025-05-25T06:32:00+02:00,2025-05-25,14:32,8,7,15
72,2025-05-25T06:35:00+02:00,2025-05-25,14:35,7,10,17
72,2025-05-25T06:36:00+02:00,2025-05-25,14:36,2,33,35
72,2025-05-25T06:39:00+02:00,2025-05-25,14:39,4,5,9
76,2025-05-25T06:33:00+02:00,2025-05-25,14:33,0,1,1
76,2025-05-25T06:39:00+02:00,2025-05-25,14:39,2,2,4
79,2025-05-25T06:30:00+02:00,2025-05-25,14:30,18,7,25
79,2025-05-25T06:33:00+02:00,2025-05-25,14:33,19,8,27
79,2025-05-25T06:34:00+02:00,2025-05-25,14:34,11,7,18
79,2025-05-25T06:38:00+02:00,2025-05-25,14:38,21,9,30
85,2025-05-25T06:26:00+02:00,2025-05-25,14:26,1,0,1
85,2025-05-25T06:27:00+02:00,2025-05-25,14:27,1,0,1
85,2025-05-25T06:29:00+02:00,2025-05-25,14:29,2,1,3
85,2025-05-25T06:30:00+02:00,2025-05-25,14:30,1,3,4
85,2025-05-25T06:31:00+02:00,2025-05-25,14:31,2,3,5
85,2025-05-25T06:33:00+02:00,2025-05-25,14:33,1,0,1
85,2025-05-25T06:36:00+02:00,2025-05-25,14:36,1,0,1
86,2025-05-25T06:26:00+02:00,2025-05-25,14:26,2,0,2
86,2025-05-25T06:33:00+02:00,2025-05-25,14:33,1,1,2
86,2025-05-25T06:35:00+02:00,2025-05-25,14:35,4,2,6
117,2025-05-25T06:25:00+02:00,2025-05-25,14:25,30,34,64
117,2025-05-25T06:30:00+02:00,2025-05-25,14:30,40,23,63
117,2025-05-25T06:35:00+02:00,2025-05-25,14:35,46,35,81
123,2025-05-25T06:25:00+02:00,2025-05-25,14:25,8,1,9
130,2025-05-25T06:25:00+02:00,2025-05-25,14:25,4,4,8
130,2025-05-25T06:35:00+02:00,2025-05-25,14:35,3,6,9
136,2025-05-25T06:30:00+02:00,2025-05-25,14:30,199,2,201
139,2025-05-25T06:30:00+02:00,2025-05-25,14:30,6,6,12
139,2025-05-25T06:35:00+02:00,2025-05-25,14:35,5,1,6
141,2025-05-25T06:30:00+02:00,2025-05-25,14:30,21,24,45
142,2025-05-25T06:30:00+02:00,2025-05-25,14:30,89,41,130
161,2025-05-25T06:30:00+02:00,2025-05-25,14:30,179,3,182
164,2025-05-25T06:25:00+02:00,2025-05-25,14:25,8,10,18
164,2025-05-25T06:35:00+02:00,2025-05-25,14:35,4,17,21
3,2025-05-25T06:40:00+02:00,2025-05-25,14:40,30,24,54
3,2025-05-25T06:44:00+02:00,2025-05-25,14:44,15,23,38
3,2025-05-25T06:52:00+02:00,2025-05-25,14:52,25,12,37
3,2025-05-25T06:53:00+02:00,2025-05-25,14:53,15,19,34
4,2025-05-25T06:43:00+02:00,2025-05-25,14:43,29,31,60
4,2025-05-25T06:47:00+02:00,2025-05-25,14:47,20,32,52
4,2025-05-25T06:51:00+02:00,2025-05-25,14:51,19,25,44
4,2025-05-25T06:52:00+02:00,2025-05-25,14:52,36,36,72
4,2025-05-25T06:53:00+02:00,2025-05-25,14:53,32,28,60
4,2025-05-25T06:54:00+02:00,2025-05-25,14:54,25,19,44
5,2025-05-25T06:50:00+02:00,2025-05-25,14:50,86,66,152
6,2025-05-25T06:43:00+02:00,2025-05-25,14:43,13,14,27
6,2025-05-25T06:46:00+02:00,2025-05-25,14:46,15,18,33
6,2025-05-25T06:49:00+02:00,2025-05-25,14:49,8,16,24
6,2025-05-25T06:50:00+02:00,2025-05-25,14:50,18,12,30
6,2025-05-25T06:52:00+02:00,2025-05-25,14:52,11,26,37
6,2025-05-25T06:53:00+02:00,2025-05-25,14:53,14,6,20
6,2025-05-25T06:54:00+02:00,2025-05-25,14:54,10,15,25
8,2025-05-25T06:45:00+02:00,2025-05-25,14:45,2,5,7
8,2025-05-25T06:48:00+02:00,2025-05-25,14:48,2,7,9
8,2025-05-25T06:50:00+02:00,2025-05-25,14:50,7,5,12
8,2025-05-25T06:51:00+02:00,2025-05-25,14:51,2,5,7
28,2025-05-25T06:40:00+02:00,2025-05-25,14:40,4,11,15
28,2025-05-25T06:41:00+02:00,2025-05-25,14:41,6,19,25
28,2025-05-25T06:46:00+02:00,2025-05-25,14:46,7,3,10
28,2025-05-25T06:47:00+02:00,2025-05-25,14:47,17,6,23
28,2025-05-25T06:52:00+02:00,2025-05-25,14:52,8,9,17
29,2025-05-25T06:42:00+02:00,2025-05-25,14:42,10,13,23
29,2025-05-25T06:45:00+02:00,2025-05-25,14:45,11,23,34
29,2025-05-25T06:47:00+02:00,2025-05-25,14:47,8,13,21
31,2025-05-25T06:44:00+02:00,2025-05-25,14:44,3,1,4
31,2025-05-25T06:48:00+02:00,2025-05-25,14:48,2,5,7
31,2025-05-25T06:51:00+02:00,2025-05-25,14:51,8,1,9
31,2025-05-25T06:52:00+02:00,2025-05-25,14:52,0,4,4
31,2025-05-25T06:53:00+02:00,2025-05-25,14:53,9,5,14
36,2025-05-25T06:43:00+02:00,2025-05-25,14:43,3,0,3
36,2025-05-25T06:44:00+02:00,2025-05-25,14:44,0,1,1
36,2025-05-25T06:51:00+02:00,2025-05-25,14:51,2,2,4
36,2025-05-25T06:52:00+02:00,2025-05-25,14:52,5,3,8
36,2025-05-25T06:53:00+02:00,2025-05-25,14:53,1,0,1
39,2025-05-25T06:43:00+02:00,2025-05-25,14:43,1,0,1
39,2025-05-25T06:47:00+02:00,2025-05-25,14:47,1,0,1
40,2025-05-25T06:41:00+02:00,2025-05-25,14:41,0,5,5
40,2025-05-25T06:44:00+02:00,2025-05-25,14:44,0,5,5
40,2025-05-25T06:45:00+02:00,2025-05-25,14:45,0,5,5
40,2025-05-25T06:50:00+02:00,2025-05-25,14:50,12,0,12
40,2025-05-25T06:51:00+02:00,2025-05-25,14:51,5,5,10
40,2025-05-25T06:52:00+02:00,2025-05-25,14:52,1,2,3
41,2025-05-25T06:45:00+02:00,2025-05-25,14:45,11,7,18
41,2025-05-25T06:47:00+02:00,2025-05-25,14:47,12,10,22
41,2025-05-25T06:48:00+02:00,2025-05-25,14:48,8,24,32
41,2025-05-25T06:53:00+02:00,2025-05-25,14:53,16,3,19
45,2025-05-25T06:40:00+02:00,2025-05-25,14:40,15,25,40
45,2025-05-25T06:44:00+02:00,2025-05-25,14:44,7,23,30
45,2025-05-25T06:46:00+02:00,2025-05-25,14:46,20,16,36
45,2025-05-25T06:48:00+02:00,2025-05-25,14:48,7,12,19
45,2025-05-25T06:52:00+02:00,2025-05-25,14:52,10,5,15
47,2025-05-25T06:40:00+02:00,2025-05-25,14:40,23,30,53
47,2025-05-25T06:41:00+02:00,2025-05-25,14:41,2,15,17
47,2025-05-25T06:42:00+02:00,2025-05-25,14:42,13,23,36
47,2025-05-25T06:51:00+02:00,2025-05-25,14:51,16,20,36
47,2025-05-25T06:52:00+02:00,2025-05-25,14:52,18,31,49
47,2025-05-25T06:53:00+02:00,2025-05-25,14:53,25,31,56
50,2025-05-25T06:40:00+02:00,2025-05-25,14:40,8,3,11
50,2025-05-25T06:44:00+02:00,2025-05-25,14:44,9,1,10
50,2025-05-25T06:49:00+02:00,2025-05-25,14:49,1,3,4
54,2025-05-25T06:40:00+02:00,2025-05-25,14:40,2,0,2
54,2025-05-25T06:42:00+02:00,2025-05-25,14:42,4,0,4
54,2025-05-25T06:50:00+02:00,2025-05-25,14:50,9,1,10
54,2025-05-25T06:53:00+02:00,2025-05-25,14:53,5,0,5
59,2025-05-25T06:40:00+02:00,2025-05-25,14:40,26,34,60
61,2025-05-25T06:41:00+02:00,2025-05-25,14:41,7,2,9
61,2025-05-25T06:44:00+02:00,2025-05-25,14:44,6,11,17
61,2025-05-25T06:46:00+02:00,2025-05-25,14:46,10,5,15
61,2025-05-25T06:48:00+02:00,2025-05-25,14:48,6,8,14
61,2025-05-25T06:49:00+02:00,2025-05-25,14:49,15,12,27
61,2025-05-25T06:50:00+02:00,2025-05-25,14:50,8,6,14
61,2025-05-25T06:53:00+02:00,2025-05-25,14:53,5,6,11
66,2025-05-25T06:41:00+02:00,2025-05-25,14:41,27,20,47
66,2025-05-25T06:45:00+02:00,2025-05-25,14:45,27,20,47
66,2025-05-25T06:47:00+02:00,2025-05-25,14:47,37,14,51
66,2025-05-25T06:52:00+02:00,2025-05-25,14:52,11,28,39
69,2025-05-25T06:41:00+02:00,2025-05-25,14:41,4,3,7
69,2025-05-25T06:42:00+02:00,2025-05-25,14:42,5,1,6
69,2025-05-25T06:45:00+02:00,2025-05-25,14:45,2,0,2
69,2025-05-25T06:46:00+02:00,2025-05-25,14:46,7,6,13
69,2025-05-25T06:52:00+02:00,2025-05-25,14:52,3,8,11
69,2025-05-25T06:53:00+02:00,2025-05-25,14:53,2,16,18
70,2025-05-25T06:40:00+02:00,2025-05-25,14:40,1,4,5
70,2025-05-25T06:50:00+02:00,2025-05-25,14:50,4,2,6
70,2025-05-25T06:51:00+02:00,2025-05-25,14:51,8,1,9
75,2025-05-25T06:40:00+02:00,2025-05-25,14:40,0,1,1
75,2025-05-25T06:50:00+02:00,2025-05-25,14:50,2,0,2
77,2025-05-25T06:40:00+02:00,2025-05-25,14:40,27,10,37
78,2025-05-25T06:46:00+02:00,2025-05-25,14:46,6,0,6
78,2025-05-25T06:52:00+02:00,2025-05-25,14:52,2,1,3
84,2025-05-25T06:40:00+02:00,2025-05-25,14:40,82,92,174
84,2025-05-25T06:45:00+02:00,2025-05-25,14:45,59,143,202
84,2025-05-25T06:50:00+02:00,2025-05-25,14:50,70,117,187
87,2025-05-25T06:43:00+02:00,2025-05-25,14:43,0,2,2
87,2025-05-25T06:48:00+02:00,2025-05-25,14:48,0,1,1
87,2025-05-25T06:50:00+02:00,2025-05-25,14:50,1,3,4
87,2025-05-25T06:51:00+02:00,2025-05-25,14:51,3,1,4
87,2025-05-25T06:52:00+02:00,2025-05-25,14:52,7,2,9
87,2025-05-25T06:54:00+02:00,2025-05-25,14:54,2,5,7
107,2025-05-25T06:50:00+02:00,2025-05-25,14:50,2,10,12
108,2025-05-25T06:48:00+02:00,2025-05-25,14:48,3,3,6
108,2025-05-25T06:54:00+02:00,2025-05-25,14:54,1,6,7
118,2025-05-25T06:40:00+02:00,2025-05-25,14:40,6,3,9
118,2025-05-25T06:45:00+02:00,2025-05-25,14:45,0,3,3
131,2025-05-25T06:45:00+02:00,2025-05-25,14:45,16,8,24
132,2025-05-25T06:45:00+02:00,2025-05-25,14:45,18,13,31
133,2025-05-25T06:40:00+02:00,2025-05-25,14:40,29,40,69
133,2025-05-25T06:45:00+02:00,2025-05-25,14:45,34,30,64
134,2025-05-25T06:40:00+02:00,2025-05-25,14:40,27,47,74
134,2025-05-25T06:45:00+02:00,2025-05-25,14:45,45,31,76
135,2025-05-25T06:40:00+02:00,2025-05-25,14:40,31,64,95
140,2025-05-25T06:40:00+02:00,2025-05-25,14:40,12,11,23
140,2025-05-25T06:50:00+02:00,2025-05-25,14:50,15,8,23
162,2025-05-25T06:40:00+02:00,2025-05-25,14:40,23,37,60
162,2025-05-25T06:45:00+02:00,2025-05-25,14:45,63,78,141
165,2025-05-25T06:45:00+02:00,2025-05-25,14:45,2,3,5
166,2025-05-25T06:40:00+02:00,2025-05-25,14:40,5,2,7
166,2025-05-25T06:45:00+02:00,2025-05-25,14:45,4,0,4
166,2025-05-25T06:50:00+02:00,2025-05-25,14:50,7,6,13
167,2025-05-25T06:40:00+02:00,2025-05-25,14:40,3,3,6
179,2025-05-25T06:45:00+02:00,2025-05-25,14:45,4,6,10
1,2025-05-25T06:45:00+02:00,2025-05-25,14:45,39,11,50
1,2025-05-25T06:46:00+02:00,2025-05-25,14:46,19,25,44
1,2025-05-25T06:47:00+02:00,2025-05-25,14:47,16,18,34
1,2025-05-25T06:50:00+02:00,2025-05-25,14:50,21,17,38
1,2025-05-25T06:52:00+02:00,2025-05-25,14:52,8,27,35
1,2025-05-25T06:54:00+02:00,2025-05-25,14:54,23,22,45
2,2025-05-25T06:41:00+02:00,2025-05-25,14:41,9,17,26
2,2025-05-25T06:43:00+02:00,2025-05-25,14:43,9,8,17
2,2025-05-25T06:44:00+02:00,2025-05-25,14:44,17,2,19
9,2025-05-25T06:41:00+02:00,2025-05-25,14:41,0,6,6
9,2025-05-25T06:53:00+02:00,2025-05-25,14:53,4,3,7
10,2025-05-25T06:43:00+02:00,2025-05-25,14:43,4,2,6
10,2025-05-25T06:48:00+02:00,2025-05-25,14:48,2,1,3
10,2025-05-25T06:49:00+02:00,2025-05-25,14:49,0,3,3
10,2025-05-25T06:53:00+02:00,2025-05-25,14:53,3,0,3
11,2025-05-25T06:41:00+02:00,2025-05-25,14:41,6,0,6
11,2025-05-25T06:44:00+02:00,2025-05-25,14:44,2,3,5
12,2025-05-25T06:43:00+02:00,2025-05-25,14:43,7,4,11
12,2025-05-25T06:44:00+02:00,2025-05-25,14:44,6,9,15
12,2025-05-25T06:48:00+02:00,2025-05-25,14:48,10,6,16
17,2025-05-25T06:43:00+02:00,2025-05-25,14:43,2,0,2
17,2025-05-25T06:47:00+02:00,2025-05-25,14:47,1,0,1
17,2025-05-25T06:52:00+02:00,2025-05-25,14:52,0,3,3
18,2025-05-25T06:43:00+02:00,2025-05-25,14:43,1,5,6
18,2025-05-25T06:49:00+02:00,2025-05-25,14:49,1,0,1
18,2025-05-25T06:50:00+02:00,2025-05-25,14:50,0,5,5
19,2025-05-25T06:40:00+02:00,2025-05-25,14:40,8,7,15
19,2025-05-25T06:44:00+02:00,2025-05-25,14:44,14,10,24
19,2025-05-25T06:50:00+02:00,2025-05-25,14:50,9,5,14
20,2025-05-25T06:42:00+02:00,2025-05-25,14:42,10,11,21
20,2025-05-25T06:44:00+02:00,2025-05-25,14:44,2,13,15
20,2025-05-25T06:48:00+02:00,2025-05-25,14:48,7,4,11
20,2025-05-25T06:54:00+02:00,2025-05-25,14:54,4,9,13
23,2025-05-25T06:41:00+02:00,2025-05-25,14:41,5,6,11
23,2025-05-25T06:43:00+02:00,2025-05-25,14:43,1,2,3
23,2025-05-25T06:44:00+02:00,2025-05-25,14:44,4,5,9
23,2025-05-25T06:47:00+02:00,2025-05-25,14:47,8,0,8
23,2025-05-25T06:49:00+02:00,2025-05-25,14:49,1,7,8
23,2025-05-25T06:53:00+02:00,2025-05-25,14:53,5,5,10
24,2025-05-25T06:40:00+02:00,2025-05-25,14:40,8,12,20
24,2025-05-25T06:42:00+02:00,2025-05-25,14:42,4,17,21
24,2025-05-25T06:43:00+02:00,2025-05-25,14:43,5,12,17
24,2025-05-25T06:46:00+02:00,2025-05-25,14:46,14,22,36
24,2025-05-25T06:50:00+02:00,2025-05-25,14:50,9,3,12
24,2025-05-25T06:52:00+02:00,2025-05-25,14:52,6,7,13
25,2025-05-25T06:45:00+02:00,2025-05-25,14:45,69,77,146
27,2025-05-25T06:42:00+02:00,2025-05-25,14:42,0,2,2
27,2025-05-25T06:43:00+02:00,2025-05-25,14:43,8,4,12
27,2025-05-25T06:44:00+02:00,2025-05-25,14:44,2,6,8
27,2025-05-25T06:47:00+02:00,2025-05-25,14:47,7,11,18
27,2025-05-25T06:49:00+02:00,2025-05-25,14:49,3,5,8
27,2025-05-25T06:51:00+02:00,2025-05-25,14:51,4,3,7
27,2025-05-25T06:52:00+02:00,2025-05-25,14:52,5,3,8
30,2025-05-25T06:40:00+02:00,2025-05-25,14:40,5,3,8
30,2025-05-25T06:41:00+02:00,2025-05-25,14:41,9,9,18
30,2025-05-25T06:44:00+02:00,2025-05-25,14:44,0,19,19
30,2025-05-25T06:45:00+02:00,2025-05-25,14:45,6,6,12
30,2025-05-25T06:51:00+02:00,2025-05-25,14:51,9,2,11
35,2025-05-25T06:41:00+02:00,2025-05-25,14:41,22,20,42
35,2025-05-25T06:43:00+02:00,2025-05-25,14:43,21,21,42
35,2025-05-25T06:46:00+02:00,2025-05-25,14:46,25,21,46
35,2025-05-25T06:48:00+02:00,2025-05-25,14:48,29,25,54
35,2025-05-25T06:51:00+02:00,2025-05-25,14:51,29,17,46
35,2025-05-25T06:54:00+02:00,2025-05-25,14:54,24,25,49
46,2025-05-25T06:50:00+02:00,2025-05-25,14:50,2,8,10
48,2025-05-25T06:42:00+02:00,2025-05-25,14:42,12,7,19
48,2025-05-25T06:43:00+02:00,2025-05-25,14:43,13,15,28
48,2025-05-25T06:44:00+02:00,2025-05-25,14:44,15,4,19
48,2025-05-25T06:46:00+02:00,2025-05-25,14:46,6,6,12
48,2025-05-25T06:48:00+02:00,2025-05-25,14:48,15,9,24
48,2025-05-25T06:49:00+02:00,2025-05-25,14:49,11,7,18
48,2025-05-25T06:52:00+02:00,2025-05-25,14:52,17,1,18
49,2025-05-25T06:40:00+02:00,2025-05-25,14:40,6,12,18
49,2025-05-25T06:41:00+02:00,2025-05-25,14:41,12,6,18
49,2025-05-25T06:45:00+02:00,2025-05-25,14:45,5,11,16
49,2025-05-25T06:46:00+02:00,2025-05-25,14:46,6,7,13
49,2025-05-25T06:50:00+02:00,2025-05-25,14:50,2,0,2
49,2025-05-25T06:54:00+02:00,2025-05-25,14:54,8,8,16
51,2025-05-25T06:43:00+02:00,2025-05-25,14:43,5,1,6
51,2025-05-25T06:44:00+02:00,2025-05-25,14:44,1,2,3
51,2025-05-25T06:48:00+02:00,2025-05-25,14:48,3,2,5
51,2025-05-25T06:53:00+02:00,2025-05-25,14:53,0,3,3
51,2025-05-25T06:54:00+02:00,2025-05-25,14:54,2,1,3
52,2025-05-25T06:45:00+02:00,2025-05-25,14:45,8,8,16
52,2025-05-25T06:47:00+02:00,2025-05-25,14:47,3,9,12
52,2025-05-25T06:50:00+02:00,2025-05-25,14:50,19,7,26
52,2025-05-25T06:51:00+02:00,2025-05-25,14:51,6,8,14
52,2025-05-25T06:53:00+02:00,2025-05-25,14:53,4,8,12
53,2025-05-25T06:40:00+02:00,2025-05-25,14:40,21,6,27
53,2025-05-25T06:48:00+02:00,2025-05-25,14:48,8,9,17
53,2025-05-25T06:50:00+02:00,2025-05-25,14:50,11,4,15
53,2025-05-25T06:52:00+02:00,2025-05-25,14:52,11,7,18
56,2025-05-25T06:40:00+02:00,2025-05-25,14:40,5,6,11
56,2025-05-25T06:44:00+02:00,2025-05-25,14:44,10,9,19
56,2025-05-25T06:49:00+02:00,2025-05-25,14:49,12,9,21
56,2025-05-25T06:50:00+02:00,2025-05-25,14:50,7,6,13
58,2025-05-25T06:45:00+02:00,2025-05-25,14:45,18,6,24
58,2025-05-25T06:46:00+02:00,2025-05-25,14:46,7,4,11
58,2025-05-25T06:50:00+02:00,2025-05-25,14:50,11,5,16
58,2025-05-25T06:51:00+02:00,2025-05-25,14:51,9,8,17
58,2025-05-25T06:52:00+02:00,2025-05-25,14:52,5,7,12
58,2025-05-25T06:54:00+02:00,2025-05-25,14:54,6,2,8
62,2025-05-25T06:40:00+02:00,2025-05-25,14:40,5,4,9
62,2025-05-25T06:41:00+02:00,2025-05-25,14:41,11,2,13
62,2025-05-25T06:45:00+02:00,2025-05-25,14:45,2,3,5
62,2025-05-25T06:48:00+02:00,2025-05-25,14:48,2,5,7
62,2025-05-25T06:49:00+02:00,2025-05-25,14:49,2,1,3
62,2025-05-25T06:52:00+02:00,2025-05-25,14:52,5,0,5
63,2025-05-25T06:40:00+02:00,2025-05-25,14:40,3,7,10
63,2025-05-25T06:43:00+02:00,2025-05-25,14:43,8,8,16
63,2025-05-25T06:45:00+02:00,2025-05-25,14:45,7,6,13
63,2025-05-25T06:47:00+02:00,2025-05-25,14:47,7,1,8
63,2025-05-25T06:48:00+02:00,2025-05-25,14:48,15,7,22
63,2025-05-25T06:49:00+02:00,2025-05-25,14:49,3,8,11
63,2025-05-25T06:54:00+02:00,2025-05-25,14:54,5,5,10
67,2025-05-25T06:41:00+02:00,2025-05-25,14:41,7,9,16
67,2025-05-25T06:42:00+02:00,2025-05-25,14:42,6,9,15
67,2025-05-25T06:46:00+02:00,2025-05-25,14:46,6,11,17
67,2025-05-25T06:49:00+02:00,2025-05-25,14:49,10,4,14
67,2025-05-25T06:52:00+02:00,2025-05-25,14:52,10,16,26
68,2025-05-25T06:42:00+02:00,2025-05-25,14:42,3,4,7
68,2025-05-25T06:48:00+02:00,2025-05-25,14:48,12,2,14
68,2025-05-25T06:53:00+02:00,2025-05-25,14:53,12,4,16
72,2025-05-25T06:42:00+02:00,2025-05-25,14:42,2,10,12
72,2025-05-25T06:43:00+02:00,2025-05-25,14:43,2,13,15
76,2025-05-25T06:43:00+02:00,2025-05-25,14:43,3,1,4
76,2025-05-25T06:51:00+02:00,2025-05-25,14:51,0,1,1
76,2025-05-25T06:52:00+02:00,2025-05-25,14:52,0,1,1
79,2025-05-25T06:42:00+02:00,2025-05-25,14:42,27,2,29
79,2025-05-25T06:43:00+02:00,2025-05-25,14:43,7,6,13
79,2025-05-25T06:44:00+02:00,2025-05-25,14:44,5,6,11
79,2025-05-25T06:49:00+02:00,2025-05-25,14:49,15,10,25
79,2025-05-25T06:50:00+02:00,2025-05-25,14:50,17,12,29
79,2025-05-25T06:51:00+02:00,2025-05-25,14:51,19,10,29
79,2025-05-25T06:54:00+02:00,2025-05-25,14:54,23,6,29
85,2025-05-25T06:44:00+02:00,2025-05-25,14:44,2,0,2
85,2025-05-25T06:47:00+02:00,2025-05-25,14:47,1,2,3
85,2025-05-25T06:50:00+02:00,2025-05-25,14:50,2,5,7
85,2025-05-25T06:52:00+02:00,2025-05-25,14:52,0,1,1
85,2025-05-25T06:53:00+02:00,2025-05-25,14:53,5,0,5
86,2025-05-25T06:40:00+02:00,2025-05-25,14:40,1,1,2
86,2025-05-25T06:42:00+02:00,2025-05-25,14:42,2,1,3
86,2025-05-25T06:46:00+02:00,2025-05-25,14:46,1,0,1
86,2025-05-25T06:54:00+02:00,2025-05-25,14:54,0,2,2
109,2025-05-25T06:45:00+02:00,2025-05-25,14:45,3,12,15
117,2025-05-25T06:50:00+02:00,2025-05-25,14:50,20,37,57
123,2025-05-25T06:50:00+02:00,2025-05-25,14:50,4,3,7
130,2025-05-25T06:45:00+02:00,2025-05-25,14:45,5,7,12
137,2025-05-25T06:50:00+02:00,2025-05-25,14:50,1,3,4
138,2025-05-25T06:40:00+02:00,2025-05-25,14:40,0,3,3
141,2025-05-25T06:50:00+02:00,2025-05-25,14:50,21,14,35
142,2025-05-25T06:45:00+02:00,2025-05-25,14:45,71,40,111
161,2025-05-25T06:40:00+02:00,2025-05-25,14:40,137,16,153
161,2025-05-25T06:45:00+02:00,2025-05-25,14:45,152,10,162
164,2025-05-25T06:40:00+02:00,2025-05-25,14:40,11,15,26
3,2025-05-25T07:28:00+02:00,2025-05-25,15:28,20,25,45
4,2025-05-25T07:26:00+02:00,2025-05-25,15:26,26,25,51
4,2025-05-25T07:28:00+02:00,2025-05-25,15:28,30,25,55
4,2025-05-25T07:29:00+02:00,2025-05-25,15:29,28,19,47
4,2025-05-25T07:33:00+02:00,2025-05-25,15:33,16,28,44
4,2025-05-25T07:39:00+02:00,2025-05-25,15:39,41,31,72
5,2025-05-25T07:35:00+02:00,2025-05-25,15:35,123,126,249
6,2025-05-25T07:26:00+02:00,2025-05-25,15:26,17,4,21
6,2025-05-25T07:27:00+02:00,2025-05-25,15:27,14,14,28
6,2025-05-25T07:28:00+02:00,2025-05-25,15:28,13,13,26
6,2025-05-25T07:31:00+02:00,2025-05-25,15:31,17,18,35
6,2025-05-25T07:32:00+02:00,2025-05-25,15:32,16,19,35
6,2025-05-25T07:33:00+02:00,2025-05-25,15:33,7,13,20
6,2025-05-25T07:38:00+02:00,2025-05-25,15:38,9,31,40
8,2025-05-25T07:25:00+02:00,2025-05-25,15:25,1,3,4
8,2025-05-25T07:26:00+02:00,2025-05-25,15:26,6,3,9
8,2025-05-25T07:27:00+02:00,2025-05-25,15:27,3,2,5
8,2025-05-25T07:28:00+02:00,2025-05-25,15:28,10,3,13
8,2025-05-25T07:30:00+02:00,2025-05-25,15:30,4,16,20
8,2025-05-25T07:35:00+02:00,2025-05-25,15:35,0,1,1
8,2025-05-25T07:36:00+02:00,2025-05-25,15:36,9,6,15
28,2025-05-25T07:27:00+02:00,2025-05-25,15:27,13,7,20
28,2025-05-25T07:28:00+02:00,2025-05-25,15:28,25,2,27
28,2025-05-25T07:32:00+02:00,2025-05-25,15:32,18,19,37
28,2025-05-25T07:38:00+02:00,2025-05-25,15:38,11,6,17
28,2025-05-25T07:39:00+02:00,2025-05-25,15:39,21,6,27
29,2025-05-25T07:26:00+02:00,2025-05-25,15:26,9,17,26
29,2025-05-25T07:27:00+02:00,2025-05-25,15:27,14,10,24
29,2025-05-25T07:29:00+02:00,2025-05-25,15:29,13,7,20
29,2025-05-25T07:30:00+02:00,2025-05-25,15:30,9,22,31
29,2025-05-25T07:33:00+02:00,2025-05-25,15:33,11,19,30
29,2025-05-25T07:34:00+02:00,2025-05-25,15:34,49,16,65
29,2025-05-25T07:36:00+02:00,2025-05-25,15:36,5,11,16
31,2025-05-25T07:27:00+02:00,2025-05-25,15:27,2,3,5
31,2025-05-25T07:34:00+02:00,2025-05-25,15:34,3,5,8
31,2025-05-25T07:36:00+02:00,2025-05-25,15:36,2,3,5
31,2025-05-25T07:37:00+02:00,2025-05-25,15:37,3,0,3
36,2025-05-25T07:26:00+02:00,2025-05-25,15:26,2,2,4
36,2025-05-25T07:32:00+02:00,2025-05-25,15:32,0,1,1
36,2025-05-25T07:35:00+02:00,2025-05-25,15:35,3,0,3
39,2025-05-25T07:26:00+02:00,2025-05-25,15:26,1,0,1
39,2025-05-25T07:29:00+02:00,2025-05-25,15:29,0,1,1
39,2025-05-25T07:32:00+02:00,2025-05-25,15:32,0,1,1
39,2025-05-25T07:35:00+02:00,2025-05-25,15:35,1,0,1
39,2025-05-25T07:39:00+02:00,2025-05-25,15:39,3,2,5
40,2025-05-25T07:25:00+02:00,2025-05-25,15:25,2,2,4
40,2025-05-25T07:29:00+02:00,2025-05-25,15:29,0,5,5
40,2025-05-25T07:34:00+02:00,2025-05-25,15:34,4,0,4
40,2025-05-25T07:36:00+02:00,2025-05-25,15:36,0,2,2
40,2025-05-25T07:39:00+02:00,2025-05-25,15:39,4,1,5
41,2025-05-25T07:25:00+02:00,2025-05-25,15:25,11,0,11
41,2025-05-25T07:27:00+02:00,2025-05-25,15:27,11,21,32
41,2025-05-25T07:29:00+02:00,2025-05-25,15:29,19,8,27
41,2025-05-25T07:30:00+02:00,2025-05-25,15:30,6,4,10
41,2025-05-25T07:36:00+02:00,2025-05-25,15:36,4,1,5
44,2025-05-25T07:25:00+02:00,2025-05-25,15:25,5,0,5
44,2025-05-25T07:35:00+02:00,2025-05-25,15:35,7,7,14
45,2025-05-25T07:28:00+02:00,2025-05-25,15:28,10,10,20
45,2025-05-25T07:29:00+02:00,2025-05-25,15:29,17,29,46
45,2025-05-25T07:31:00+02:00,2025-05-25,15:31,21,24,45
45,2025-05-25T07:35:00+02:00,2025-05-25,15:35,36,14,50
45,2025-05-25T07:36:00+02:00,2025-05-25,15:36,14,18,32
45,2025-05-25T07:38:00+02:00,2025-05-25,15:38,23,12,35
45,2025-05-25T07:39:00+02:00,2025-05-25,15:39,21,24,45
47,2025-05-25T07:33:00+02:00,2025-05-25,15:33,13,25,38
47,2025-05-25T07:34:00+02:00,2025-05-25,15:34,11,36,47
47,2025-05-25T07:35:00+02:00,2025-05-25,15:35,18,19,37
47,2025-05-25T07:37:00+02:00,2025-05-25,15:37,24,25,49
50,2025-05-25T07:29:00+02:00,2025-05-25,15:29,2,4,6
50,2025-05-25T07:31:00+02:00,2025-05-25,15:31,5,0,5
50,2025-05-25T07:32:00+02:00,2025-05-25,15:32,2,2,4
50,2025-05-25T07:37:00+02:00,2025-05-25,15:37,2,3,5
50,2025-05-25T07:38:00+02:00,2025-05-25,15:38,6,3,9
54,2025-05-25T07:27:00+02:00,2025-05-25,15:27,1,2,3
54,2025-05-25T07:28:00+02:00,2025-05-25,15:28,1,4,5
54,2025-05-25T07:31:00+02:00,2025-05-25,15:31,0,2,2
54,2025-05-25T07:32:00+02:00,2025-05-25,15:32,0,2,2
54,2025-05-25T07:36:00+02:00,2025-05-25,15:36,1,1,2
54,2025-05-25T07:38:00+02:00,2025-05-25,15:38,2,4,6
59,2025-05-25T07:25:00+02:00,2025-05-25,15:25,9,24,33
59,2025-05-25T07:35:00+02:00,2025-05-25,15:35,12,41,53
61,2025-05-25T07:29:00+02:00,2025-05-25,15:29,2,10,12
61,2025-05-25T07:30:00+02:00,2025-05-25,15:30,6,7,13
61,2025-05-25T07:31:00+02:00,2025-05-25,15:31,14,11,25
61,2025-05-25T07:34:00+02:00,2025-05-25,15:34,8,10,18
61,2025-05-25T07:35:00+02:00,2025-05-25,15:35,13,0,13
66,2025-05-25T07:27:00+02:00,2025-05-25,15:27,17,44,61
66,2025-05-25T07:28:00+02:00,2025-05-25,15:28,35,26,61
66,2025-05-25T07:29:00+02:00,2025-05-25,15:29,29,12,41
66,2025-05-25T07:33:00+02:00,2025-05-25,15:33,19,43,62
69,2025-05-25T07:33:00+02:00,2025-05-25,15:33,7,3,10
69,2025-05-25T07:38:00+02:00,2025-05-25,15:38,3,1,4
69,2025-05-25T07:39:00+02:00,2025-05-25,15:39,0,2,2
70,2025-05-25T07:27:00+02:00,2025-05-25,15:27,1,2,3
70,2025-05-25T07:28:00+02:00,2025-05-25,15:28,1,4,5
70,2025-05-25T07:29:00+02:00,2025-05-25,15:29,2,1,3
70,2025-05-25T07:30:00+02:00,2025-05-25,15:30,0,1,1
70,2025-05-25T07:33:00+02:00,2025-05-25,15:33,2,2,4
70,2025-05-25T07:35:00+02:00,2025-05-25,15:35,2,2,4
70,2025-05-25T07:36:00+02:00,2025-05-25,15:36,1,2,3
71,2025-05-25T07:33:00+02:00,2025-05-25,15:33,0,1,1
75,2025-05-25T07:33:00+02:00,2025-05-25,15:33,1,2,3
75,2025-05-25T07:36:00+02:00,2025-05-25,15:36,1,0,1
75,2025-05-25T07:38:00+02:00,2025-05-25,15:38,0,1,1
77,2025-05-25T07:35:00+02:00,2025-05-25,15:35,12,19,31
78,2025-05-25T07:25:00+02:00,2025-05-25,15:25,1,1,2
78,2025-05-25T07:28:00+02:00,2025-05-25,15:28,1,6,7
78,2025-05-25T07:33:00+02:00,2025-05-25,15:33,2,1,3
78,2025-05-25T07:34:00+02:00,2025-05-25,15:34,1,0,1
78,2025-05-25T07:37:00+02:00,2025-05-25,15:37,0,1,1
84,2025-05-25T07:25:00+02:00,2025-05-25,15:25,77,161,238
84,2025-05-25T07:30:00+02:00,2025-05-25,15:30,86,123,209
87,2025-05-25T07:25:00+02:00,2025-05-25,15:25,0,2,2
87,2025-05-25T07:26:00+02:00,2025-05-25,15:26,2,2,4
87,2025-05-25T07:29:00+02:00,2025-05-25,15:29,6,0,6
87,2025-05-25T07:30:00+02:00,2025-05-25,15:30,1,0,1
87,2025-05-25T07:37:00+02:00,2025-05-25,15:37,2,0,2
87,2025-05-25T07:39:00+02:00,2025-05-25,15:39,1,2,3
107,2025-05-25T07:30:00+02:00,2025-05-25,15:30,6,14,20
108,2025-05-25T07:26:00+02:00,2025-05-25,15:26,1,4,5
108,2025-05-25T07:28:00+02:00,2025-05-25,15:28,0,2,2
108,2025-05-25T07:29:00+02:00,2025-05-25,15:29,1,4,5
108,2025-05-25T07:30:00+02:00,2025-05-25,15:30,4,4,8
108,2025-05-25T07:35:00+02:00,2025-05-25,15:35,1,4,5
118,2025-05-25T07:25:00+02:00,2025-05-25,15:25,1,6,7
131,2025-05-25T07:25:00+02:00,2025-05-25,15:25,3,10,13
132,2025-05-25T07:25:00+02:00,2025-05-25,15:25,12,20,32
132,2025-05-25T07:30:00+02:00,2025-05-25,15:30,13,9,22
133,2025-05-25T07:35:00+02:00,2025-05-25,15:35,38,31,69
135,2025-05-25T07:25:00+02:00,2025-05-25,15:25,25,26,51
135,2025-05-25T07:35:00+02:00,2025-05-25,15:35,48,34,82
140,2025-05-25T07:30:00+02:00,2025-05-25,15:30,19,12,31
162,2025-05-25T07:30:00+02:00,2025-05-25,15:30,31,93,124
165,2025-05-25T07:25:00+02:00,2025-05-25,15:25,4,2,6
165,2025-05-25T07:30:00+02:00,2025-05-25,15:30,3,1,4
166,2025-05-25T07:25:00+02:00,2025-05-25,15:25,8,4,12
166,2025-05-25T07:30:00+02:00,2025-05-25,15:30,6,11,17
1,2025-05-25T07:27:00+02:00,2025-05-25,15:27,28,34,62
1,2025-05-25T07:28:00+02:00,2025-05-25,15:28,24,29,53
1,2025-05-25T07:29:00+02:00,2025-05-25,15:29,23,14,37
1,2025-05-25T07:32:00+02:00,2025-05-25,15:32,19,18,37
1,2025-05-25T07:35:00+02:00,2025-05-25,15:35,11,24,35
1,2025-05-25T07:37:00+02:00,2025-05-25,15:37,12,23,35
2,2025-05-25T07:25:00+02:00,2025-05-25,15:25,13,6,19
2,2025-05-25T07:28:00+02:00,2025-05-25,15:28,12,7,19
2,2025-05-25T07:29:00+02:00,2025-05-25,15:29,8,6,14
2,2025-05-25T07:30:00+02:00,2025-05-25,15:30,12,14,26
2,2025-05-25T07:32:00+02:00,2025-05-25,15:32,19,16,35
2,2025-05-25T07:33:00+02:00,2025-05-25,15:33,12,13,25
2,2025-05-25T07:34:00+02:00,2025-05-25,15:34,24,9,33
2,2025-05-25T07:35:00+02:00,2025-05-25,15:35,15,18,33
2,2025-05-25T07:36:00+02:00,2025-05-25,15:36,20,11,31
2,2025-05-25T07:38:00+02:00,2025-05-25,15:38,4,8,12
2,2025-05-25T07:39:00+02:00,2025-05-25,15:39,16,19,35
9,2025-05-25T07:29:00+02:00,2025-05-25,15:29,2,1,3
9,2025-05-25T07:31:00+02:00,2025-05-25,15:31,0,1,1
9,2025-05-25T07:33:00+02:00,2025-05-25,15:33,2,0,2
9,2025-05-25T07:36:00+02:00,2025-05-25,15:36,3,4,7
10,2025-05-25T07:28:00+02:00,2025-05-25,15:28,2,0,2
10,2025-05-25T07:33:00+02:00,2025-05-25,15:33,0,1,1
10,2025-05-25T07:39:00+02:00,2025-05-25,15:39,3,1,4
11,2025-05-25T07:27:00+02:00,2025-05-25,15:27,0,3,3
11,2025-05-25T07:32:00+02:00,2025-05-25,15:32,1,1,2
12,2025-05-25T07:28:00+02:00,2025-05-25,15:28,1,0,1
12,2025-05-25T07:32:00+02:00,2025-05-25,15:32,2,17,19
17,2025-05-25T07:28:00+02:00,2025-05-25,15:28,1,3,4
17,2025-05-25T07:30:00+02:00,2025-05-25,15:30,9,1,10
17,2025-05-25T07:31:00+02:00,2025-05-25,15:31,2,0,2
17,2025-05-25T07:37:00+02:00,2025-05-25,15:37,3,3,6
17,2025-05-25T07:39:00+02:00,2025-05-25,15:39,2,0,2
18,2025-05-25T07:30:00+02:00,2025-05-25,15:30,1,0,1
18,2025-05-25T07:31:00+02:00,2025-05-25,15:31,0,3,3
18,2025-05-25T07:32:00+02:00,2025-05-25,15:32,3,2,5
19,2025-05-25T07:26:00+02:00,2025-05-25,15:26,14,9,23
19,2025-05-25T07:34:00+02:00,2025-05-25,15:34,10,8,18
19,2025-05-25T07:36:00+02:00,2025-05-25,15:36,0,14,14
20,2025-05-25T07:26:00+02:00,2025-05-25,15:26,1,2,3
20,2025-05-25T07:28:00+02:00,2025-05-25,15:28,0,3,3
20,2025-05-25T07:29:00+02:00,2025-05-25,15:29,5,1,6
20,2025-05-25T07:35:00+02:00,2025-05-25,15:35,1,3,4
20,2025-05-25T07:37:00+02:00,2025-05-25,15:37,3,5,8
23,2025-05-25T07:27:00+02:00,2025-05-25,15:27,0,9,9
23,2025-05-25T07:31:00+02:00,2025-05-25,15:31,0,4,4
23,2025-05-25T07:35:00+02:00,2025-05-25,15:35,0,8,8
23,2025-05-25T07:36:00+02:00,2025-05-25,15:36,0,13,13
24,2025-05-25T07:31:00+02:00,2025-05-25,15:31,2,8,10
24,2025-05-25T07:33:00+02:00,2025-05-25,15:33,13,20,33
24,2025-05-25T07:35:00+02:00,2025-05-25,15:35,11,12,23
24,2025-05-25T07:36:00+02:00,2025-05-25,15:36,1,17,18
24,2025-05-25T07:39:00+02:00,2025-05-25,15:39,4,5,9
25,2025-05-25T07:25:00+02:00,2025-05-25,15:25,92,52,144
27,2025-05-25T07:27:00+02:00,2025-05-25,15:27,6,5,11
27,2025-05-25T07:30:00+02:00,2025-05-25,15:30,7,8,15
27,2025-05-25T07:31:00+02:00,2025-05-25,15:31,6,0,6
27,2025-05-25T07:33:00+02:00,2025-05-25,15:33,1,12,13
27,2025-05-25T07:34:00+02:00,2025-05-25,15:34,4,4,8
27,2025-05-25T07:35:00+02:00,2025-05-25,15:35,0,2,2
27,2025-05-25T07:38:00+02:00,2025-05-25,15:38,8,6,14
27,2025-05-25T07:39:00+02:00,2025-05-25,15:39,5,4,9
30,2025-05-25T07:27:00+02:00,2025-05-25,15:27,5,7,12
30,2025-05-25T07:28:00+02:00,2025-05-25,15:28,3,3,6
30,2025-05-25T07:29:00+02:00,2025-05-25,15:29,6,15,21
30,2025-05-25T07:30:00+02:00,2025-05-25,15:30,4,4,8
30,2025-05-25T07:31:00+02:00,2025-05-25,15:31,1,1,2
35,2025-05-25T07:28:00+02:00,2025-05-25,15:28,29,22,51
35,2025-05-25T07:29:00+02:00,2025-05-25,15:29,27,35,62
35,2025-05-25T07:36:00+02:00,2025-05-25,15:36,20,9,29
35,2025-05-25T07:38:00+02:00,2025-05-25,15:38,24,26,50
35,2025-05-25T07:39:00+02:00,2025-05-25,15:39,17,35,52
46,2025-05-25T07:30:00+02:00,2025-05-25,15:30,15,6,21
48,2025-05-25T07:27:00+02:00,2025-05-25,15:27,6,3,9
48,2025-05-25T07:28:00+02:00,2025-05-25,15:28,15,3,18
48,2025-05-25T07:34:00+02:00,2025-05-25,15:34,2,7,9
48,2025-05-25T07:37:00+02:00,2025-05-25,15:37,10,7,17
48,2025-05-25T07:38:00+02:00,2025-05-25,15:38,3,12,15
49,2025-05-25T07:25:00+02:00,2025-05-25,15:25,6,10,16
49,2025-05-25T07:30:00+02:00,2025-05-25,15:30,7,9,16
49,2025-05-25T07:31:00+02:00,2025-05-25,15:31,1,9,10
49,2025-05-25T07:34:00+02:00,2025-05-25,15:34,2,20,22
49,2025-05-25T07:37:00+02:00,2025-05-25,15:37,5,7,12
49,2025-05-25T07:38:00+02:00,2025-05-25,15:38,7,16,23
49,2025-05-25T07:39:00+02:00,2025-05-25,15:39,6,10,16
51,2025-05-25T07:26:00+02:00,2025-05-25,15:26,4,2,6
51,2025-05-25T07:28:00+02:00,2025-05-25,15:28,1,1,2
51,2025-05-25T07:30:00+02:00,2025-05-25,15:30,2,8,10
51,2025-05-25T07:34:00+02:00,2025-05-25,15:34,1,2,3
51,2025-05-25T07:35:00+02:00,2025-05-25,15:35,2,0,2
51,2025-05-25T07:39:00+02:00,2025-05-25,15:39,3,8,11
52,2025-05-25T07:32:00+02:00,2025-05-25,15:32,4,9,13
52,2025-05-25T07:34:00+02:00,2025-05-25,15:34,6,1,7
52,2025-05-25T07:36:00+02:00,2025-05-25,15:36,3,2,5
52,2025-05-25T07:38:00+02:00,2025-05-25,15:38,7,11,18
52,2025-05-25T07:39:00+02:00,2025-05-25,15:39,2,11,13
53,2025-05-25T07:25:00+02:00,2025-05-25,15:25,15,7,22
53,2025-05-25T07:27:00+02:00,2025-05-25,15:27,12,5,17
53,2025-05-25T07:29:00+02:00,2025-05-25,15:29,6,16,22
53,2025-05-25T07:30:00+02:00,2025-05-25,15:30,6,19,25
53,2025-05-25T07:32:00+02:00,2025-05-25,15:32,25,10,35
53,2025-05-25T07:35:00+02:00,2025-05-25,15:35,12,16,28
53,2025-05-25T07:39:00+02:00,2025-05-25,15:39,9,9,18
56,2025-05-25T07:25:00+02:00,2025-05-25,15:25,4,3,7
56,2025-05-25T07:27:00+02:00,2025-05-25,15:27,2,2,4
56,2025-05-25T07:28:00+02:00,2025-05-25,15:28,9,4,13
56,2025-05-25T07:30:00+02:00,2025-05-25,15:30,5,2,7
56,2025-05-25T07:34:00+02:00,2025-05-25,15:34,10,17,27
56,2025-05-25T07:35:00+02:00,2025-05-25,15:35,8,8,16
56,2025-05-25T07:36:00+02:00,2025-05-25,15:36,1,3,4
56,2025-05-25T07:37:00+02:00,2025-05-25,15:37,4,6,10
56,2025-05-25T07:39:00+02:00,2025-05-25,15:39,6,2,8
58,2025-05-25T07:28:00+02:00,2025-05-25,15:28,12,3,15
58,2025-05-25T07:32:00+02:00,2025-05-25,15:32,5,0,5
58,2025-05-25T07:33:00+02:00,2025-05-25,15:33,13,1,14
58,2025-05-25T07:36:00+02:00,2025-05-25,15:36,10,11,21
58,2025-05-25T07:37:00+02:00,2025-05-25,15:37,3,6,9
62,2025-05-25T07:26:00+02:00,2025-05-25,15:26,11,2,13
62,2025-05-25T07:29:00+02:00,2025-05-25,15:29,5,2,7
62,2025-05-25T07:34:00+02:00,2025-05-25,15:34,4,0,4
62,2025-05-25T07:37:00+02:00,2025-05-25,15:37,10,1,11
62,2025-05-25T07:38:00+02:00,2025-05-25,15:38,5,6,11
62,2025-05-25T07:39:00+02:00,2025-05-25,15:39,4,3,7
63,2025-05-25T07:27:00+02:00,2025-05-25,15:27,13,6,19
63,2025-05-25T07:28:00+02:00,2025-05-25,15:28,15,5,20
63,2025-05-25T07:31:00+02:00,2025-05-25,15:31,7,7,14
63,2025-05-25T07:32:00+02:00,2025-05-25,15:32,4,5,9
63,2025-05-25T07:39:00+02:00,2025-05-25,15:39,6,0,6
67,2025-05-25T07:25:00+02:00,2025-05-25,15:25,0,7,7
67,2025-05-25T07:28:00+02:00,2025-05-25,15:28,2,12,14
67,2025-05-25T07:33:00+02:00,2025-05-25,15:33,0,10,10
68,2025-05-25T07:30:00+02:00,2025-05-25,15:30,3,10,13
68,2025-05-25T07:31:00+02:00,2025-05-25,15:31,7,5,12
68,2025-05-25T07:37:00+02:00,2025-05-25,15:37,2,3,5
68,2025-05-25T07:39:00+02:00,2025-05-25,15:39,5,6,11
72,2025-05-25T07:29:00+02:00,2025-05-25,15:29,2,2,4
72,2025-05-25T07:35:00+02:00,2025-05-25,15:35,11,5,16
76,2025-05-25T07:29:00+02:00,2025-05-25,15:29,3,0,3
76,2025-05-25T07:31:00+02:00,2025-05-25,15:31,2,4,6
76,2025-05-25T07:32:00+02:00,2025-05-25,15:32,0,1,1
76,2025-05-25T07:34:00+02:00,2025-05-25,15:34,3,0,3
76,2025-05-25T07:35:00+02:00,2025-05-25,15:35,1,0,1
76,2025-05-25T07:36:00+02:00,2025-05-25,15:36,2,0,2
76,2025-05-25T07:37:00+02:00,2025-05-25,15:37,2,3,5
76,2025-05-25T07:39:00+02:00,2025-05-25,15:39,2,2,4
79,2025-05-25T07:33:00+02:00,2025-05-25,15:33,19,6,25
79,2025-05-25T07:34:00+02:00,2025-05-25,15:34,15,9,24
79,2025-05-25T07:35:00+02:00,2025-05-25,15:35,21,5,26
79,2025-05-25T07:36:00+02:00,2025-05-25,15:36,16,5,21
79,2025-05-25T07:37:00+02:00,2025-05-25,15:37,8,9,17
79,2025-05-25T07:39:00+02:00,2025-05-25,15:39,6,14,20
85,2025-05-25T07:25:00+02:00,2025-05-25,15:25,0,1,1
85,2025-05-25T07:28:00+02:00,2025-05-25,15:28,2,1,3
85,2025-05-25T07:33:00+02:00,2025-05-25,15:33,2,0,2
85,2025-05-25T07:38:00+02:00,2025-05-25,15:38,2,4,6
85,2025-05-25T07:39:00+02:00,2025-05-25,15:39,0,1,1
86,2025-05-25T07:25:00+02:00,2025-05-25,15:25,1,0,1
86,2025-05-25T07:26:00+02:00,2025-05-25,15:26,1,0,1
86,2025-05-25T07:28:00+02:00,2025-05-25,15:28,2,0,2
86,2025-05-25T07:34:00+02:00,2025-05-25,15:34,1,1,2
86,2025-05-25T07:36:00+02:00,2025-05-25,15:36,1,0,1
86,2025-05-25T07:39:00+02:00,2025-05-25,15:39,0,3,3
109,2025-05-25T07:25:00+02:00,2025-05-25,15:25,16,8,24
117,2025-05-25T07:25:00+02:00,2025-05-25,15:25,16,24,40
117,2025-05-25T07:30:00+02:00,2025-05-25,15:30,25,20,45
117,2025-05-25T07:35:00+02:00,2025-05-25,15:35,10,25,35
123,2025-05-25T07:30:00+02:00,2025-05-25,15:30,4,2,6
130,2025-05-25T07:25:00+02:00,2025-05-25,15:25,6,2,8
130,2025-05-25T07:30:00+02:00,2025-05-25,15:30,3,3,6
137,2025-05-25T07:30:00+02:00,2025-05-25,15:30,0,2,2
138,2025-05-25T07:25:00+02:00,2025-05-25,15:25,2,3,5
138,2025-05-25T07:30:00+02:00,2025-05-25,15:30,1,2,3
139,2025-05-25T07:25:00+02:00,2025-05-25,15:25,6,6,12
141,2025-05-25T07:35:00+02:00,2025-05-25,15:35,9,13,22
161,2025-05-25T07:25:00+02:00,2025-05-25,15:25,44,19,63
3,2025-05-25T07:15:00+02:00,2025-05-25,15:15,19,22,41
4,2025-05-25T07:11:00+02:00,2025-05-25,15:11,22,16,38
4,2025-05-25T07:12:00+02:00,2025-05-25,15:12,21,19,40
4,2025-05-25T07:18:00+02:00,2025-05-25,15:18,31,47,78
4,2025-05-25T07:19:00+02:00,2025-05-25,15:19,40,37,77
4,2025-05-25T07:20:00+02:00,2025-05-25,15:20,29,24,53
4,2025-05-25T07:24:00+02:00,2025-05-25,15:24,25,15,40
5,2025-05-25T07:20:00+02:00,2025-05-25,15:20,70,109,179
6,2025-05-25T07:12:00+02:00,2025-05-25,15:12,24,16,40
6,2025-05-25T07:14:00+02:00,2025-05-25,15:14,16,24,40
6,2025-05-25T07:16:00+02:00,2025-05-25,15:16,15,6,21
6,2025-05-25T07:21:00+02:00,2025-05-25,15:21,16,20,36
8,2025-05-25T07:17:00+02:00,2025-05-25,15:17,4,4,8
28,2025-05-25T07:12:00+02:00,2025-05-25,15:12,2,15,17
28,2025-05-25T07:13:00+02:00,2025-05-25,15:13,7,8,15
28,2025-05-25T07:18:00+02:00,2025-05-25,15:18,1,7,8
28,2025-05-25T07:22:00+02:00,2025-05-25,15:22,9,4,13
28,2025-05-25T07:23:00+02:00,2025-05-25,15:23,20,8,28
29,2025-05-25T07:12:00+02:00,2025-05-25,15:12,16,4,20
29,2025-05-25T07:14:00+02:00,2025-05-25,15:14,18,7,25
29,2025-05-25T07:15:00+02:00,2025-05-25,15:15,5,20,25
29,2025-05-25T07:16:00+02:00,2025-05-25,15:16,8,8,16
29,2025-05-25T07:19:00+02:00,2025-05-25,15:19,7,16,23
29,2025-05-25T07:21:00+02:00,2025-05-25,15:21,11,28,39
31,2025-05-25T07:10:00+02:00,2025-05-25,15:10,3,6,9
31,2025-05-25T07:12:00+02:00,2025-05-25,15:12,1,4,5
31,2025-05-25T07:15:00+02:00,2025-05-25,15:15,1,3,4
31,2025-05-25T07:16:00+02:00,2025-05-25,15:16,3,10,13
31,2025-05-25T07:18:00+02:00,2025-05-25,15:18,4,1,5
31,2025-05-25T07:22:00+02:00,2025-05-25,15:22,1,2,3
31,2025-05-25T07:23:00+02:00,2025-05-25,15:23,9,2,11
36,2025-05-25T07:10:00+02:00,2025-05-25,15:10,0,3,3
36,2025-05-25T07:12:00+02:00,2025-05-25,15:12,3,2,5
36,2025-05-25T07:13:00+02:00,2025-05-25,15:13,1,0,1
36,2025-05-25T07:14:00+02:00,2025-05-25,15:14,0,5,5
36,2025-05-25T07:15:00+02:00,2025-05-25,15:15,2,5,7
36,2025-05-25T07:20:00+02:00,2025-05-25,15:20,0,2,2
39,2025-05-25T07:13:00+02:00,2025-05-25,15:13,0,1,1
39,2025-05-25T07:14:00+02:00,2025-05-25,15:14,2,1,3
39,2025-05-25T07:17:00+02:00,2025-05-25,15:17,2,6,8
39,2025-05-25T07:20:00+02:00,2025-05-25,15:20,3,1,4
39,2025-05-25T07:24:00+02:00,2025-05-25,15:24,2,4,6
40,2025-05-25T07:11:00+02:00,2025-05-25,15:11,4,2,6
40,2025-05-25T07:15:00+02:00,2025-05-25,15:15,12,2,14
40,2025-05-25T07:18:00+02:00,2025-05-25,15:18,0,1,1
40,2025-05-25T07:20:00+02:00,2025-05-25,15:20,2,5,7
40,2025-05-25T07:22:00+02:00,2025-05-25,15:22,0,1,1
41,2025-05-25T07:10:00+02:00,2025-05-25,15:10,20,13,33
41,2025-05-25T07:11:00+02:00,2025-05-25,15:11,13,11,24
41,2025-05-25T07:13:00+02:00,2025-05-25,15:13,10,8,18
41,2025-05-25T07:15:00+02:00,2025-05-25,15:15,3,10,13
41,2025-05-25T07:17:00+02:00,2025-05-25,15:17,21,13,34
41,2025-05-25T07:19:00+02:00,2025-05-25,15:19,8,3,11
41,2025-05-25T07:21:00+02:00,2025-05-25,15:21,9,8,17
41,2025-05-25T07:23:00+02:00,2025-05-25,15:23,1,3,4
43,2025-05-25T07:15:00+02:00,2025-05-25,15:15,11,7,18
44,2025-05-25T07:20:00+02:00,2025-05-25,15:20,3,2,5
45,2025-05-25T07:14:00+02:00,2025-05-25,15:14,20,22,42
45,2025-05-25T07:17:00+02:00,2025-05-25,15:17,19,16,35
45,2025-05-25T07:21:00+02:00,2025-05-25,15:21,13,24,37
45,2025-05-25T07:22:00+02:00,2025-05-25,15:22,20,16,36
47,2025-05-25T07:13:00+02:00,2025-05-25,15:13,10,32,42
47,2025-05-25T07:14:00+02:00,2025-05-25,15:14,20,12,32
47,2025-05-25T07:15:00+02:00,2025-05-25,15:15,21,10,31
47,2025-05-25T07:17:00+02:00,2025-05-25,15:17,9,11,20
47,2025-05-25T07:19:00+02:00,2025-05-25,15:19,14,20,34
50,2025-05-25T07:13:00+02:00,2025-05-25,15:13,8,4,12
50,2025-05-25T07:15:00+02:00,2025-05-25,15:15,6,3,9
50,2025-05-25T07:17:00+02:00,2025-05-25,15:17,3,7,10
50,2025-05-25T07:19:00+02:00,2025-05-25,15:19,2,5,7
50,2025-05-25T07:20:00+02:00,2025-05-25,15:20,7,3,10
50,2025-05-25T07:23:00+02:00,2025-05-25,15:23,4,3,7
50,2025-05-25T07:24:00+02:00,2025-05-25,15:24,2,1,3
54,2025-05-25T07:12:00+02:00,2025-05-25,15:12,2,1,3
54,2025-05-25T07:16:00+02:00,2025-05-25,15:16,13,1,14
54,2025-05-25T07:19:00+02:00,2025-05-25,15:19,1,0,1
54,2025-05-25T07:20:00+02:00,2025-05-25,15:20,0,1,1
54,2025-05-25T07:21:00+02:00,2025-05-25,15:21,3,4,7
54,2025-05-25T07:22:00+02:00,2025-05-25,15:22,4,3,7
61,2025-05-25T07:10:00+02:00,2025-05-25,15:10,5,15,20
61,2025-05-25T07:14:00+02:00,2025-05-25,15:14,10,12,22
61,2025-05-25T07:16:00+02:00,2025-05-25,15:16,5,7,12
61,2025-05-25T07:17:00+02:00,2025-05-25,15:17,14,7,21
61,2025-05-25T07:18:00+02:00,2025-05-25,15:18,4,7,11
61,2025-05-25T07:19:00+02:00,2025-05-25,15:19,7,16,23
61,2025-05-25T07:21:00+02:00,2025-05-25,15:21,7,8,15
61,2025-05-25T07:24:00+02:00,2025-05-25,15:24,9,9,18
66,2025-05-25T07:10:00+02:00,2025-05-25,15:10,21,28,49
66,2025-05-25T07:13:00+02:00,2025-05-25,15:13,13,17,30
66,2025-05-25T07:17:00+02:00,2025-05-25,15:17,42,36,78
66,2025-05-25T07:21:00+02:00,2025-05-25,15:21,30,40,70
66,2025-05-25T07:22:00+02:00,2025-05-25,15:22,16,43,59
66,2025-05-25T07:23:00+02:00,2025-05-25,15:23,15,43,58
66,2025-05-25T07:24:00+02:00,2025-05-25,15:24,25,36,61
69,2025-05-25T07:12:00+02:00,2025-05-25,15:12,1,3,4
69,2025-05-25T07:14:00+02:00,2025-05-25,15:14,2,2,4
69,2025-05-25T07:17:00+02:00,2025-05-25,15:17,5,3,8
69,2025-05-25T07:18:00+02:00,2025-05-25,15:18,2,3,5
70,2025-05-25T07:10:00+02:00,2025-05-25,15:10,0,7,7
70,2025-05-25T07:18:00+02:00,2025-05-25,15:18,0,1,1
70,2025-05-25T07:22:00+02:00,2025-05-25,15:22,1,4,5
70,2025-05-25T07:24:00+02:00,2025-05-25,15:24,1,3,4
75,2025-05-25T07:11:00+02:00,2025-05-25,15:11,1,1,2
75,2025-05-25T07:13:00+02:00,2025-05-25,15:13,1,5,6
75,2025-05-25T07:19:00+02:00,2025-05-25,15:19,0,7,7
75,2025-05-25T07:21:00+02:00,2025-05-25,15:21,1,2,3
77,2025-05-25T07:15:00+02:00,2025-05-25,15:15,12,20,32
78,2025-05-25T07:15:00+02:00,2025-05-25,15:15,1,0,1
78,2025-05-25T07:16:00+02:00,2025-05-25,15:16,0,2,2
78,2025-05-25T07:21:00+02:00,2025-05-25,15:21,0,1,1
78,2025-05-25T07:24:00+02:00,2025-05-25,15:24,0,1,1
87,2025-05-25T07:12:00+02:00,2025-05-25,15:12,1,1,2
87,2025-05-25T07:13:00+02:00,2025-05-25,15:13,0,5,5
87,2025-05-25T07:14:00+02:00,2025-05-25,15:14,2,1,3
87,2025-05-25T07:16:00+02:00,2025-05-25,15:16,2,0,2
87,2025-05-25T07:19:00+02:00,2025-05-25,15:19,1,4,5
87,2025-05-25T07:20:00+02:00,2025-05-25,15:20,3,5,8
107,2025-05-25T07:10:00+02:00,2025-05-25,15:10,5,8,13
107,2025-05-25T07:15:00+02:00,2025-05-25,15:15,7,4,11
108,2025-05-25T07:11:00+02:00,2025-05-25,15:11,3,5,8
108,2025-05-25T07:13:00+02:00,2025-05-25,15:13,2,0,2
108,2025-05-25T07:15:00+02:00,2025-05-25,15:15,3,1,4
108,2025-05-25T07:22:00+02:00,2025-05-25,15:22,1,4,5
108,2025-05-25T07:23:00+02:00,2025-05-25,15:23,0,1,1
124,2025-05-25T07:15:00+02:00,2025-05-25,15:15,1,1,2
132,2025-05-25T07:15:00+02:00,2025-05-25,15:15,20,13,33
135,2025-05-25T07:10:00+02:00,2025-05-25,15:10,39,31,70
135,2025-05-25T07:20:00+02:00,2025-05-25,15:20,25,33,58
140,2025-05-25T07:20:00+02:00,2025-05-25,15:20,10,8,18
165,2025-05-25T07:20:00+02:00,2025-05-25,15:20,3,2,5
166,2025-05-25T07:15:00+02:00,2025-05-25,15:15,8,3,11
166,2025-05-25T07:20:00+02:00,2025-05-25,15:20,10,5,15
179,2025-05-25T07:10:00+02:00,2025-05-25,15:10,1,2,3
179,2025-05-25T07:15:00+02:00,2025-05-25,15:15,6,7,13
1,2025-05-25T07:10:00+02:00,2025-05-25,15:10,32,16,48
1,2025-05-25T07:11:00+02:00,2025-05-25,15:11,26,15,41
1,2025-05-25T07:16:00+02:00,2025-05-25,15:16,22,30,52
1,2025-05-25T07:20:00+02:00,2025-05-25,15:20,16,26,42
1,2025-05-25T07:21:00+02:00,2025-05-25,15:21,22,32,54
1,2025-05-25T07:22:00+02:00,2025-05-25,15:22,18,22,40
1,2025-05-25T07:23:00+02:00,2025-05-25,15:23,24,29,53
1,2025-05-25T07:24:00+02:00,2025-05-25,15:24,28,24,52
2,2025-05-25T07:11:00+02:00,2025-05-25,15:11,22,15,37
2,2025-05-25T07:12:00+02:00,2025-05-25,15:12,8,9,17
2,2025-05-25T07:18:00+02:00,2025-05-25,15:18,18,22,40
2,2025-05-25T07:19:00+02:00,2025-05-25,15:19,5,9,14
9,2025-05-25T07:10:00+02:00,2025-05-25,15:10,1,2,3
9,2025-05-25T07:16:00+02:00,2025-05-25,15:16,0,3,3
9,2025-05-25T07:19:00+02:00,2025-05-25,15:19,1,1,2
10,2025-05-25T07:16:00+02:00,2025-05-25,15:16,1,0,1
10,2025-05-25T07:17:00+02:00,2025-05-25,15:17,4,1,5
10,2025-05-25T07:18:00+02:00,2025-05-25,15:18,3,0,3
10,2025-05-25T07:23:00+02:00,2025-05-25,15:23,4,0,4
11,2025-05-25T07:14:00+02:00,2025-05-25,15:14,0,2,2
11,2025-05-25T07:22:00+02:00,2025-05-25,15:22,2,4,6
11,2025-05-25T07:23:00+02:00,2025-05-25,15:23,2,3,5
12,2025-05-25T07:14:00+02:00,2025-05-25,15:14,2,7,9
12,2025-05-25T07:16:00+02:00,2025-05-25,15:16,2,10,12
12,2025-05-25T07:21:00+02:00,2025-05-25,15:21,6,9,15
12,2025-05-25T07:23:00+02:00,2025-05-25,15:23,9,1,10
12,2025-05-25T07:24:00+02:00,2025-05-25,15:24,5,3,8
17,2025-05-25T07:11:00+02:00,2025-05-25,15:11,4,3,7
17,2025-05-25T07:17:00+02:00,2025-05-25,15:17,7,3,10
17,2025-05-25T07:19:00+02:00,2025-05-25,15:19,3,1,4
17,2025-05-25T07:21:00+02:00,2025-05-25,15:21,9,2,11
17,2025-05-25T07:22:00+02:00,2025-05-25,15:22,0,2,2
17,2025-05-25T07:24:00+02:00,2025-05-25,15:24,7,0,7
18,2025-05-25T07:10:00+02:00,2025-05-25,15:10,0,1,1
18,2025-05-25T07:18:00+02:00,2025-05-25,15:18,2,2,4
19,2025-05-25T07:12:00+02:00,2025-05-25,15:12,14,6,20
19,2025-05-25T07:15:00+02:00,2025-05-25,15:15,9,17,26
19,2025-05-25T07:18:00+02:00,2025-05-25,15:18,8,11,19
19,2025-05-25T07:20:00+02:00,2025-05-25,15:20,12,4,16
19,2025-05-25T07:22:00+02:00,2025-05-25,15:22,8,20,28
19,2025-05-25T07:24:00+02:00,2025-05-25,15:24,9,11,20
20,2025-05-25T07:11:00+02:00,2025-05-25,15:11,11,12,23
20,2025-05-25T07:14:00+02:00,2025-05-25,15:14,5,19,24
20,2025-05-25T07:16:00+02:00,2025-05-25,15:16,0,9,9
20,2025-05-25T07:17:00+02:00,2025-05-25,15:17,4,9,13
20,2025-05-25T07:20:00+02:00,2025-05-25,15:20,2,11,13
20,2025-05-25T07:21:00+02:00,2025-05-25,15:21,6,3,9
23,2025-05-25T07:11:00+02:00,2025-05-25,15:11,3,7,10
23,2025-05-25T07:14:00+02:00,2025-05-25,15:14,3,4,7
23,2025-05-25T07:15:00+02:00,2025-05-25,15:15,0,5,5
23,2025-05-25T07:16:00+02:00,2025-05-25,15:16,1,2,3
23,2025-05-25T07:17:00+02:00,2025-05-25,15:17,5,3,8
23,2025-05-25T07:18:00+02:00,2025-05-25,15:18,1,3,4
24,2025-05-25T07:10:00+02:00,2025-05-25,15:10,7,6,13
24,2025-05-25T07:11:00+02:00,2025-05-25,15:11,6,12,18
24,2025-05-25T07:14:00+02:00,2025-05-25,15:14,5,24,29
24,2025-05-25T07:18:00+02:00,2025-05-25,15:18,9,9,18
24,2025-05-25T07:20:00+02:00,2025-05-25,15:20,7,36,43
24,2025-05-25T07:23:00+02:00,2025-05-25,15:23,18,17,35
27,2025-05-25T07:15:00+02:00,2025-05-25,15:15,1,2,3
27,2025-05-25T07:17:00+02:00,2025-05-25,15:17,9,1,10
27,2025-05-25T07:19:00+02:00,2025-05-25,15:19,5,3,8
27,2025-05-25T07:20:00+02:00,2025-05-25,15:20,11,5,16
27,2025-05-25T07:22:00+02:00,2025-05-25,15:22,3,5,8
27,2025-05-25T07:24:00+02:00,2025-05-25,15:24,2,3,5
30,2025-05-25T07:10:00+02:00,2025-05-25,15:10,2,6,8
30,2025-05-25T07:15:00+02:00,2025-05-25,15:15,7,9,16
30,2025-05-25T07:19:00+02:00,2025-05-25,15:19,0,4,4
30,2025-05-25T07:21:00+02:00,2025-05-25,15:21,1,6,7
30,2025-05-25T07:23:00+02:00,2025-05-25,15:23,8,9,17
35,2025-05-25T07:10:00+02:00,2025-05-25,15:10,25,24,49
35,2025-05-25T07:15:00+02:00,2025-05-25,15:15,32,44,76
35,2025-05-25T07:19:00+02:00,2025-05-25,15:19,21,15,36
35,2025-05-25T07:21:00+02:00,2025-05-25,15:21,20,12,32
35,2025-05-25T07:22:00+02:00,2025-05-25,15:22,36,20,56
35,2025-05-25T07:23:00+02:00,2025-05-25,15:23,13,37,50
46,2025-05-25T07:15:00+02:00,2025-05-25,15:15,11,2,13
48,2025-05-25T07:19:00+02:00,2025-05-25,15:19,8,10,18
49,2025-05-25T07:12:00+02:00,2025-05-25,15:12,7,11,18
49,2025-05-25T07:17:00+02:00,2025-05-25,15:17,10,9,19
49,2025-05-25T07:18:00+02:00,2025-05-25,15:18,1,11,12
49,2025-05-25T07:20:00+02:00,2025-05-25,15:20,1,16,17
49,2025-05-25T07:21:00+02:00,2025-05-25,15:21,8,7,15
49,2025-05-25T07:22:00+02:00,2025-05-25,15:22,4,2,6
49,2025-05-25T07:23:00+02:00,2025-05-25,15:23,4,8,12
51,2025-05-25T07:10:00+02:00,2025-05-25,15:10,2,7,9
51,2025-05-25T07:12:00+02:00,2025-05-25,15:12,4,1,5
51,2025-05-25T07:13:00+02:00,2025-05-25,15:13,0,3,3
51,2025-05-25T07:16:00+02:00,2025-05-25,15:16,3,3,6
51,2025-05-25T07:17:00+02:00,2025-05-25,15:17,3,3,6
51,2025-05-25T07:23:00+02:00,2025-05-25,15:23,2,3,5
52,2025-05-25T07:10:00+02:00,2025-05-25,15:10,5,4,9
52,2025-05-25T07:11:00+02:00,2025-05-25,15:11,5,2,7
52,2025-05-25T07:12:00+02:00,2025-05-25,15:12,7,5,12
52,2025-05-25T07:17:00+02:00,2025-05-25,15:17,5,11,16
52,2025-05-25T07:20:00+02:00,2025-05-25,15:20,8,12,20
52,2025-05-25T07:21:00+02:00,2025-05-25,15:21,20,13,33
52,2025-05-25T07:22:00+02:00,2025-05-25,15:22,1,4,5
52,2025-05-25T07:24:00+02:00,2025-05-25,15:24,2,12,14
53,2025-05-25T07:11:00+02:00,2025-05-25,15:11,6,4,10
56,2025-05-25T07:12:00+02:00,2025-05-25,15:12,6,5,11
58,2025-05-25T07:16:00+02:00,2025-05-25,15:16,5,3,8
58,2025-05-25T07:18:00+02:00,2025-05-25,15:18,7,3,10
58,2025-05-25T07:20:00+02:00,2025-05-25,15:20,14,12,26
58,2025-05-25T07:21:00+02:00,2025-05-25,15:21,2,10,12
58,2025-05-25T07:24:00+02:00,2025-05-25,15:24,21,3,24
62,2025-05-25T07:12:00+02:00,2025-05-25,15:12,1,5,6
62,2025-05-25T07:14:00+02:00,2025-05-25,15:14,3,1,4
62,2025-05-25T07:17:00+02:00,2025-05-25,15:17,1,4,5
62,2025-05-25T07:19:00+02:00,2025-05-25,15:19,2,5,7
62,2025-05-25T07:21:00+02:00,2025-05-25,15:21,8,1,9
62,2025-05-25T07:23:00+02:00,2025-05-25,15:23,2,4,6
63,2025-05-25T07:12:00+02:00,2025-05-25,15:12,4,3,7
63,2025-05-25T07:13:00+02:00,2025-05-25,15:13,4,9,13
63,2025-05-25T07:17:00+02:00,2025-05-25,15:17,2,12,14
63,2025-05-25T07:19:00+02:00,2025-05-25,15:19,4,10,14
63,2025-05-25T07:23:00+02:00,2025-05-25,15:23,5,8,13
63,2025-05-25T07:24:00+02:00,2025-05-25,15:24,6,4,10
67,2025-05-25T07:10:00+02:00,2025-05-25,15:10,10,12,22
67,2025-05-25T07:12:00+02:00,2025-05-25,15:12,5,2,7
67,2025-05-25T07:15:00+02:00,2025-05-25,15:15,8,15,23
67,2025-05-25T07:18:00+02:00,2025-05-25,15:18,7,16,23
67,2025-05-25T07:20:00+02:00,2025-05-25,15:20,5,6,11
67,2025-05-25T07:23:00+02:00,2025-05-25,15:23,8,11,19
68,2025-05-25T07:10:00+02:00,2025-05-25,15:10,8,2,10
68,2025-05-25T07:11:00+02:00,2025-05-25,15:11,6,0,6
68,2025-05-25T07:15:00+02:00,2025-05-25,15:15,5,5,10
68,2025-05-25T07:18:00+02:00,2025-05-25,15:18,6,2,8
68,2025-05-25T07:19:00+02:00,2025-05-25,15:19,13,5,18
68,2025-05-25T07:21:00+02:00,2025-05-25,15:21,3,4,7
72,2025-05-25T07:12:00+02:00,2025-05-25,15:12,3,4,7
72,2025-05-25T07:17:00+02:00,2025-05-25,15:17,5,17,22
72,2025-05-25T07:18:00+02:00,2025-05-25,15:18,4,8,12
72,2025-05-25T07:19:00+02:00,2025-05-25,15:19,7,8,15
72,2025-05-25T07:21:00+02:00,2025-05-25,15:21,5,1,6
76,2025-05-25T07:15:00+02:00,2025-05-25,15:15,0,1,1
76,2025-05-25T07:18:00+02:00,2025-05-25,15:18,1,0,1
76,2025-05-25T07:19:00+02:00,2025-05-25,15:19,4,0,4
76,2025-05-25T07:20:00+02:00,2025-05-25,15:20,0,2,2
76,2025-05-25T07:22:00+02:00,2025-05-25,15:22,0,1,1
79,2025-05-25T07:10:00+02:00,2025-05-25,15:10,8,8,16
79,2025-05-25T07:11:00+02:00,2025-05-25,15:11,17,5,22
79,2025-05-25T07:12:00+02:00,2025-05-25,15:12,11,11,22
79,2025-05-25T07:13:00+02:00,2025-05-25,15:13,7,16,23
79,2025-05-25T07:14:00+02:00,2025-05-25,15:14,13,5,18
79,2025-05-25T07:18:00+02:00,2025-05-25,15:18,4,16,20
79,2025-05-25T07:22:00+02:00,2025-05-25,15:22,12,5,17
85,2025-05-25T07:11:00+02:00,2025-05-25,15:11,1,2,3
85,2025-05-25T07:13:00+02:00,2025-05-25,15:13,1,4,5
85,2025-05-25T07:17:00+02:00,2025-05-25,15:17,2,0,2
85,2025-05-25T07:18:00+02:00,2025-05-25,15:18,0,2,2
85,2025-05-25T07:21:00+02:00,2025-05-25,15:21,0,2,2
86,2025-05-25T07:14:00+02:00,2025-05-25,15:14,0,2,2
86,2025-05-25T07:21:00+02:00,2025-05-25,15:21,2,0,2
86,2025-05-25T07:23:00+02:00,2025-05-25,15:23,2,2,4
109,2025-05-25T07:15:00+02:00,2025-05-25,15:15,16,9,25
109,2025-05-25T07:20:00+02:00,2025-05-25,15:20,3,7,10
117,2025-05-25T07:10:00+02:00,2025-05-25,15:10,21,12,33
117,2025-05-25T07:20:00+02:00,2025-05-25,15:20,17,23,40
123,2025-05-25T07:20:00+02:00,2025-05-25,15:20,5,5,10
130,2025-05-25T07:20:00+02:00,2025-05-25,15:20,2,2,4
136,2025-05-25T07:20:00+02:00,2025-05-25,15:20,48,5,53
139,2025-05-25T07:20:00+02:00,2025-05-25,15:20,6,2,8
142,2025-05-25T07:10:00+02:00,2025-05-25,15:10,54,42,96
142,2025-05-25T07:20:00+02:00,2025-05-25,15:20,81,55,136
164,2025-05-25T07:20:00+02:00,2025-05-25,15:20,11,2,13
181,2025-05-25T07:25:00+02:00,2025-05-25,15:25,4,18,22
181,2025-05-25T07:27:00+02:00,2025-05-25,15:27,8,23,31
181,2025-05-25T07:28:00+02:00,2025-05-25,15:28,16,21,37
181,2025-05-25T07:35:00+02:00,2025-05-25,15:35,16,15,31
181,2025-05-25T07:39:00+02:00,2025-05-25,15:39,1,10,11
182,2025-05-25T07:25:00+02:00,2025-05-25,15:25,13,12,25
182,2025-05-25T07:30:00+02:00,2025-05-25,15:30,11,23,34
180,2025-05-25T07:31:00+02:00,2025-05-25,15:31,0,1,1
180,2025-05-25T07:32:00+02:00,2025-05-25,15:32,1,0,1
3,2025-05-25T05:35:00+02:00,2025-05-25,13:35,21,18,39
3,2025-05-25T05:38:00+02:00,2025-05-25,13:38,16,27,43
4,2025-05-25T05:25:00+02:00,2025-05-25,13:25,51,22,73
4,2025-05-25T05:31:00+02:00,2025-05-25,13:31,42,19,61
4,2025-05-25T05:32:00+02:00,2025-05-25,13:32,23,36,59
4,2025-05-25T05:33:00+02:00,2025-05-25,13:33,11,11,22
4,2025-05-25T05:34:00+02:00,2025-05-25,13:34,36,16,52
4,2025-05-25T05:35:00+02:00,2025-05-25,13:35,32,25,57
4,2025-05-25T05:39:00+02:00,2025-05-25,13:39,21,21,42
6,2025-05-25T05:25:00+02:00,2025-05-25,13:25,8,9,17
6,2025-05-25T05:26:00+02:00,2025-05-25,13:26,12,28,40
6,2025-05-25T05:27:00+02:00,2025-05-25,13:27,5,11,16
6,2025-05-25T05:29:00+02:00,2025-05-25,13:29,16,11,27
6,2025-05-25T05:30:00+02:00,2025-05-25,13:30,10,21,31
6,2025-05-25T05:34:00+02:00,2025-05-25,13:34,22,10,32
6,2025-05-25T05:36:00+02:00,2025-05-25,13:36,7,10,17
6,2025-05-25T05:38:00+02:00,2025-05-25,13:38,26,36,62
8,2025-05-25T05:25:00+02:00,2025-05-25,13:25,4,6,10
8,2025-05-25T05:34:00+02:00,2025-05-25,13:34,1,2,3
8,2025-05-25T05:39:00+02:00,2025-05-25,13:39,0,8,8
28,2025-05-25T05:26:00+02:00,2025-05-25,13:26,6,10,16
28,2025-05-25T05:28:00+02:00,2025-05-25,13:28,15,7,22
28,2025-05-25T05:32:00+02:00,2025-05-25,13:32,9,8,17
28,2025-05-25T05:34:00+02:00,2025-05-25,13:34,8,6,14
29,2025-05-25T05:26:00+02:00,2025-05-25,13:26,4,15,19
29,2025-05-25T05:28:00+02:00,2025-05-25,13:28,9,27,36
29,2025-05-25T05:30:00+02:00,2025-05-25,13:30,6,8,14
29,2025-05-25T05:31:00+02:00,2025-05-25,13:31,11,3,14
29,2025-05-25T05:32:00+02:00,2025-05-25,13:32,17,17,34
29,2025-05-25T05:33:00+02:00,2025-05-25,13:33,7,6,13
29,2025-05-25T05:38:00+02:00,2025-05-25,13:38,12,7,19
29,2025-05-25T05:39:00+02:00,2025-05-25,13:39,8,8,16
31,2025-05-25T05:26:00+02:00,2025-05-25,13:26,2,3,5
31,2025-05-25T05:28:00+02:00,2025-05-25,13:28,1,5,6
31,2025-05-25T05:31:00+02:00,2025-05-25,13:31,4,4,8
31,2025-05-25T05:34:00+02:00,2025-05-25,13:34,4,2,6
36,2025-05-25T05:26:00+02:00,2025-05-25,13:26,1,0,1
36,2025-05-25T05:32:00+02:00,2025-05-25,13:32,0,3,3
36,2025-05-25T05:35:00+02:00,2025-05-25,13:35,3,3,6
36,2025-05-25T05:39:00+02:00,2025-05-25,13:39,11,1,12
39,2025-05-25T05:37:00+02:00,2025-05-25,13:37,1,0,1
40,2025-05-25T05:25:00+02:00,2025-05-25,13:25,0,2,2
40,2025-05-25T05:28:00+02:00,2025-05-25,13:28,0,2,2
40,2025-05-25T05:29:00+02:00,2025-05-25,13:29,0,2,2
40,2025-05-25T05:33:00+02:00,2025-05-25,13:33,3,7,10
40,2025-05-25T05:35:00+02:00,2025-05-25,13:35,0,4,4
40,2025-05-25T05:36:00+02:00,2025-05-25,13:36,6,1,7
40,2025-05-25T05:39:00+02:00,2025-05-25,13:39,2,1,3
41,2025-05-25T05:28:00+02:00,2025-05-25,13:28,4,12,16
41,2025-05-25T05:30:00+02:00,2025-05-25,13:30,3,1,4
41,2025-05-25T05:32:00+02:00,2025-05-25,13:32,6,4,10
41,2025-05-25T05:33:00+02:00,2025-05-25,13:33,9,6,15
41,2025-05-25T05:36:00+02:00,2025-05-25,13:36,11,3,14
41,2025-05-25T05:37:00+02:00,2025-05-25,13:37,10,6,16
41,2025-05-25T05:38:00+02:00,2025-05-25,13:38,5,1,6
41,2025-05-25T05:39:00+02:00,2025-05-25,13:39,13,14,27
43,2025-05-25T05:25:00+02:00,2025-05-25,13:25,1,5,6
43,2025-05-25T05:30:00+02:00,2025-05-25,13:30,12,14,26
43,2025-05-25T05:35:00+02:00,2025-05-25,13:35,5,9,14
44,2025-05-25T05:35:00+02:00,2025-05-25,13:35,11,7,18
45,2025-05-25T05:28:00+02:00,2025-05-25,13:28,26,19,45
45,2025-05-25T05:31:00+02:00,2025-05-25,13:31,12,16,28
45,2025-05-25T05:33:00+02:00,2025-05-25,13:33,12,13,25
45,2025-05-25T05:34:00+02:00,2025-05-25,13:34,13,24,37
45,2025-05-25T05:39:00+02:00,2025-05-25,13:39,16,29,45
47,2025-05-25T05:26:00+02:00,2025-05-25,13:26,1,10,11
47,2025-05-25T05:31:00+02:00,2025-05-25,13:31,26,32,58
47,2025-05-25T05:34:00+02:00,2025-05-25,13:34,19,26,45
47,2025-05-25T05:38:00+02:00,2025-05-25,13:38,18,24,42
50,2025-05-25T05:25:00+02:00,2025-05-25,13:25,4,2,6
50,2025-05-25T05:26:00+02:00,2025-05-25,13:26,4,3,7
50,2025-05-25T05:34:00+02:00,2025-05-25,13:34,2,3,5
54,2025-05-25T05:35:00+02:00,2025-05-25,13:35,14,3,17
54,2025-05-25T05:38:00+02:00,2025-05-25,13:38,2,1,3
59,2025-05-25T05:30:00+02:00,2025-05-25,13:30,39,32,71
59,2025-05-25T05:35:00+02:00,2025-05-25,13:35,14,41,55
61,2025-05-25T05:27:00+02:00,2025-05-25,13:27,10,1,11
61,2025-05-25T05:28:00+02:00,2025-05-25,13:28,3,10,13
61,2025-05-25T05:32:00+02:00,2025-05-25,13:32,3,5,8
61,2025-05-25T05:35:00+02:00,2025-05-25,13:35,12,9,21
61,2025-05-25T05:37:00+02:00,2025-05-25,13:37,4,16,20
66,2025-05-25T05:26:00+02:00,2025-05-25,13:26,22,26,48
66,2025-05-25T05:30:00+02:00,2025-05-25,13:30,22,33,55
66,2025-05-25T05:37:00+02:00,2025-05-25,13:37,15,29,44
66,2025-05-25T05:39:00+02:00,2025-05-25,13:39,18,54,72
69,2025-05-25T05:25:00+02:00,2025-05-25,13:25,3,0,3
69,2025-05-25T05:26:00+02:00,2025-05-25,13:26,13,5,18
69,2025-05-25T05:31:00+02:00,2025-05-25,13:31,8,4,12
69,2025-05-25T05:34:00+02:00,2025-05-25,13:34,3,5,8
69,2025-05-25T05:36:00+02:00,2025-05-25,13:36,2,1,3
69,2025-05-25T05:37:00+02:00,2025-05-25,13:37,4,4,8
69,2025-05-25T05:39:00+02:00,2025-05-25,13:39,0,12,12
70,2025-05-25T05:25:00+02:00,2025-05-25,13:25,4,6,10
70,2025-05-25T05:26:00+02:00,2025-05-25,13:26,3,2,5
70,2025-05-25T05:29:00+02:00,2025-05-25,13:29,7,1,8
70,2025-05-25T05:31:00+02:00,2025-05-25,13:31,7,2,9
70,2025-05-25T05:35:00+02:00,2025-05-25,13:35,4,6,10
70,2025-05-25T05:36:00+02:00,2025-05-25,13:36,6,3,9
75,2025-05-25T05:29:00+02:00,2025-05-25,13:29,0,3,3
75,2025-05-25T05:35:00+02:00,2025-05-25,13:35,1,2,3
75,2025-05-25T05:36:00+02:00,2025-05-25,13:36,1,2,3
77,2025-05-25T05:25:00+02:00,2025-05-25,13:25,26,7,33
77,2025-05-25T05:35:00+02:00,2025-05-25,13:35,9,5,14
78,2025-05-25T05:25:00+02:00,2025-05-25,13:25,2,0,2
84,2025-05-25T05:25:00+02:00,2025-05-25,13:25,82,110,192
84,2025-05-25T05:35:00+02:00,2025-05-25,13:35,85,104,189
87,2025-05-25T05:25:00+02:00,2025-05-25,13:25,1,0,1
87,2025-05-25T05:26:00+02:00,2025-05-25,13:26,4,4,8
87,2025-05-25T05:34:00+02:00,2025-05-25,13:34,6,1,7
87,2025-05-25T05:38:00+02:00,2025-05-25,13:38,1,4,5
107,2025-05-25T05:25:00+02:00,2025-05-25,13:25,7,15,22
108,2025-05-25T05:25:00+02:00,2025-05-25,13:25,5,0,5
108,2025-05-25T05:30:00+02:00,2025-05-25,13:30,3,8,11
118,2025-05-25T05:30:00+02:00,2025-05-25,13:30,1,3,4
124,2025-05-25T05:25:00+02:00,2025-05-25,13:25,3,9,12
124,2025-05-25T05:30:00+02:00,2025-05-25,13:30,2,1,3
131,2025-05-25T05:30:00+02:00,2025-05-25,13:30,4,7,11
131,2025-05-25T05:35:00+02:00,2025-05-25,13:35,24,10,34
133,2025-05-25T05:35:00+02:00,2025-05-25,13:35,32,37,69
135,2025-05-25T05:35:00+02:00,2025-05-25,13:35,59,34,93
166,2025-05-25T05:35:00+02:00,2025-05-25,13:35,7,6,13
167,2025-05-25T05:35:00+02:00,2025-05-25,13:35,2,5,7
1,2025-05-25T05:31:00+02:00,2025-05-25,13:31,14,21,35
1,2025-05-25T05:32:00+02:00,2025-05-25,13:32,28,18,46
1,2025-05-25T05:36:00+02:00,2025-05-25,13:36,30,26,56
1,2025-05-25T05:37:00+02:00,2025-05-25,13:37,29,25,54
2,2025-05-25T05:26:00+02:00,2025-05-25,13:26,10,13,23
2,2025-05-25T05:30:00+02:00,2025-05-25,13:30,13,11,24
2,2025-05-25T05:32:00+02:00,2025-05-25,13:32,8,8,16
2,2025-05-25T05:33:00+02:00,2025-05-25,13:33,12,15,27
2,2025-05-25T05:34:00+02:00,2025-05-25,13:34,11,22,33
2,2025-05-25T05:39:00+02:00,2025-05-25,13:39,23,15,38
9,2025-05-25T05:27:00+02:00,2025-05-25,13:27,1,0,1
9,2025-05-25T05:33:00+02:00,2025-05-25,13:33,1,2,3
9,2025-05-25T05:34:00+02:00,2025-05-25,13:34,2,3,5
9,2025-05-25T05:36:00+02:00,2025-05-25,13:36,2,1,3
11,2025-05-25T05:26:00+02:00,2025-05-25,13:26,0,2,2
11,2025-05-25T05:32:00+02:00,2025-05-25,13:32,0,1,1
11,2025-05-25T05:38:00+02:00,2025-05-25,13:38,0,2,2
12,2025-05-25T05:25:00+02:00,2025-05-25,13:25,5,10,15
12,2025-05-25T05:27:00+02:00,2025-05-25,13:27,2,1,3
12,2025-05-25T05:28:00+02:00,2025-05-25,13:28,4,8,12
12,2025-05-25T05:29:00+02:00,2025-05-25,13:29,5,17,22
12,2025-05-25T05:31:00+02:00,2025-05-25,13:31,2,3,5
12,2025-05-25T05:37:00+02:00,2025-05-25,13:37,5,2,7
17,2025-05-25T05:25:00+02:00,2025-05-25,13:25,2,4,6
17,2025-05-25T05:28:00+02:00,2025-05-25,13:28,3,2,5
17,2025-05-25T05:35:00+02:00,2025-05-25,13:35,5,2,7
17,2025-05-25T05:37:00+02:00,2025-05-25,13:37,2,2,4
18,2025-05-25T05:25:00+02:00,2025-05-25,13:25,3,3,6
18,2025-05-25T05:27:00+02:00,2025-05-25,13:27,1,1,2
18,2025-05-25T05:28:00+02:00,2025-05-25,13:28,2,1,3
18,2025-05-25T05:33:00+02:00,2025-05-25,13:33,8,0,8
18,2025-05-25T05:35:00+02:00,2025-05-25,13:35,1,0,1
18,2025-05-25T05:36:00+02:00,2025-05-25,13:36,2,0,2
19,2025-05-25T05:26:00+02:00,2025-05-25,13:26,14,14,28
19,2025-05-25T05:33:00+02:00,2025-05-25,13:33,5,11,16
19,2025-05-25T05:34:00+02:00,2025-05-25,13:34,26,3,29
19,2025-05-25T05:38:00+02:00,2025-05-25,13:38,15,5,20
20,2025-05-25T05:26:00+02:00,2025-05-25,13:26,7,4,11
20,2025-05-25T05:27:00+02:00,2025-05-25,13:27,2,4,6
20,2025-05-25T05:29:00+02:00,2025-05-25,13:29,10,3,13
20,2025-05-25T05:30:00+02:00,2025-05-25,13:30,10,2,12
20,2025-05-25T05:31:00+02:00,2025-05-25,13:31,3,9,12
20,2025-05-25T05:35:00+02:00,2025-05-25,13:35,0,17,17
20,2025-05-25T05:36:00+02:00,2025-05-25,13:36,20,13,33
23,2025-05-25T05:28:00+02:00,2025-05-25,13:28,2,0,2
23,2025-05-25T05:36:00+02:00,2025-05-25,13:36,7,9,16
23,2025-05-25T05:37:00+02:00,2025-05-25,13:37,0,3,3
23,2025-05-25T05:39:00+02:00,2025-05-25,13:39,2,1,3
24,2025-05-25T05:28:00+02:00,2025-05-25,13:28,19,28,47
24,2025-05-25T05:32:00+02:00,2025-05-25,13:32,21,15,36
24,2025-05-25T05:33:00+02:00,2025-05-25,13:33,24,9,33
24,2025-05-25T05:38:00+02:00,2025-05-25,13:38,23,4,27
24,2025-05-25T05:39:00+02:00,2025-05-25,13:39,1,28,29
25,2025-05-25T05:35:00+02:00,2025-05-25,13:35,80,77,157
27,2025-05-25T05:25:00+02:00,2025-05-25,13:25,7,2,9
27,2025-05-25T05:27:00+02:00,2025-05-25,13:27,9,4,13
27,2025-05-25T05:28:00+02:00,2025-05-25,13:28,2,3,5
27,2025-05-25T05:29:00+02:00,2025-05-25,13:29,2,0,2
27,2025-05-25T05:32:00+02:00,2025-05-25,13:32,10,5,15
27,2025-05-25T05:33:00+02:00,2025-05-25,13:33,1,2,3
27,2025-05-25T05:38:00+02:00,2025-05-25,13:38,2,5,7
30,2025-05-25T05:27:00+02:00,2025-05-25,13:27,2,24,26
30,2025-05-25T05:29:00+02:00,2025-05-25,13:29,3,11,14
30,2025-05-25T05:30:00+02:00,2025-05-25,13:30,0,13,13
30,2025-05-25T05:31:00+02:00,2025-05-25,13:31,4,8,12
30,2025-05-25T05:32:00+02:00,2025-05-25,13:32,3,7,10
30,2025-05-25T05:34:00+02:00,2025-05-25,13:34,4,4,8
30,2025-05-25T05:35:00+02:00,2025-05-25,13:35,5,12,17
30,2025-05-25T05:39:00+02:00,2025-05-25,13:39,4,13,17
35,2025-05-25T05:25:00+02:00,2025-05-25,13:25,24,15,39
35,2025-05-25T05:26:00+02:00,2025-05-25,13:26,26,17,43
35,2025-05-25T05:29:00+02:00,2025-05-25,13:29,12,17,29
35,2025-05-25T05:31:00+02:00,2025-05-25,13:31,20,28,48
35,2025-05-25T05:34:00+02:00,2025-05-25,13:34,12,26,38
35,2025-05-25T05:35:00+02:00,2025-05-25,13:35,17,16,33
35,2025-05-25T05:38:00+02:00,2025-05-25,13:38,12,23,35
48,2025-05-25T05:29:00+02:00,2025-05-25,13:29,5,14,19
48,2025-05-25T05:33:00+02:00,2025-05-25,13:33,19,6,25
48,2025-05-25T05:37:00+02:00,2025-05-25,13:37,10,2,12
48,2025-05-25T05:38:00+02:00,2025-05-25,13:38,12,4,16
48,2025-05-25T05:39:00+02:00,2025-05-25,13:39,14,20,34
49,2025-05-25T05:25:00+02:00,2025-05-25,13:25,6,19,25
49,2025-05-25T05:26:00+02:00,2025-05-25,13:26,4,15,19
49,2025-05-25T05:32:00+02:00,2025-05-25,13:32,9,17,26
49,2025-05-25T05:33:00+02:00,2025-05-25,13:33,14,10,24
51,2025-05-25T05:27:00+02:00,2025-05-25,13:27,1,0,1
51,2025-05-25T05:29:00+02:00,2025-05-25,13:29,0,8,8
51,2025-05-25T05:33:00+02:00,2025-05-25,13:33,2,2,4
51,2025-05-25T05:35:00+02:00,2025-05-25,13:35,1,1,2
51,2025-05-25T05:37:00+02:00,2025-05-25,13:37,2,2,4
51,2025-05-25T05:38:00+02:00,2025-05-25,13:38,0,2,2
52,2025-05-25T05:25:00+02:00,2025-05-25,13:25,9,5,14
52,2025-05-25T05:27:00+02:00,2025-05-25,13:27,2,3,5
52,2025-05-25T05:29:00+02:00,2025-05-25,13:29,13,3,16
52,2025-05-25T05:32:00+02:00,2025-05-25,13:32,6,7,13
52,2025-05-25T05:36:00+02:00,2025-05-25,13:36,5,6,11
53,2025-05-25T05:25:00+02:00,2025-05-25,13:25,20,6,26
53,2025-05-25T05:28:00+02:00,2025-05-25,13:28,11,8,19
53,2025-05-25T05:33:00+02:00,2025-05-25,13:33,8,6,14
56,2025-05-25T05:26:00+02:00,2025-05-25,13:26,7,3,10
56,2025-05-25T05:30:00+02:00,2025-05-25,13:30,15,8,23
56,2025-05-25T05:31:00+02:00,2025-05-25,13:31,16,7,23
56,2025-05-25T05:32:00+02:00,2025-05-25,13:32,11,7,18
56,2025-05-25T05:33:00+02:00,2025-05-25,13:33,7,7,14
56,2025-05-25T05:37:00+02:00,2025-05-25,13:37,1,5,6
56,2025-05-25T05:38:00+02:00,2025-05-25,13:38,7,14,21
58,2025-05-25T05:31:00+02:00,2025-05-25,13:31,23,9,32
58,2025-05-25T05:36:00+02:00,2025-05-25,13:36,15,18,33
58,2025-05-25T05:37:00+02:00,2025-05-25,13:37,6,13,19
62,2025-05-25T05:26:00+02:00,2025-05-25,13:26,5,0,5
62,2025-05-25T05:27:00+02:00,2025-05-25,13:27,7,1,8
62,2025-05-25T05:34:00+02:00,2025-05-25,13:34,3,3,6
63,2025-05-25T05:26:00+02:00,2025-05-25,13:26,9,3,12
63,2025-05-25T05:29:00+02:00,2025-05-25,13:29,13,7,20
63,2025-05-25T05:30:00+02:00,2025-05-25,13:30,4,5,9
63,2025-05-25T05:32:00+02:00,2025-05-25,13:32,7,2,9
63,2025-05-25T05:36:00+02:00,2025-05-25,13:36,4,3,7
67,2025-05-25T05:25:00+02:00,2025-05-25,13:25,7,10,17
67,2025-05-25T05:31:00+02:00,2025-05-25,13:31,10,13,23
67,2025-05-25T05:33:00+02:00,2025-05-25,13:33,1,23,24
68,2025-05-25T05:26:00+02:00,2025-05-25,13:26,4,14,18
68,2025-05-25T05:28:00+02:00,2025-05-25,13:28,5,6,11
68,2025-05-25T05:34:00+02:00,2025-05-25,13:34,5,5,10
68,2025-05-25T05:35:00+02:00,2025-05-25,13:35,6,1,7
68,2025-05-25T05:36:00+02:00,2025-05-25,13:36,7,4,11
68,2025-05-25T05:39:00+02:00,2025-05-25,13:39,8,1,9
72,2025-05-25T05:28:00+02:00,2025-05-25,13:28,9,10,19
72,2025-05-25T05:30:00+02:00,2025-05-25,13:30,14,9,23
72,2025-05-25T05:31:00+02:00,2025-05-25,13:31,2,7,9
76,2025-05-25T05:33:00+02:00,2025-05-25,13:33,0,1,1
79,2025-05-25T05:28:00+02:00,2025-05-25,13:28,23,9,32
79,2025-05-25T05:31:00+02:00,2025-05-25,13:31,14,14,28
79,2025-05-25T05:34:00+02:00,2025-05-25,13:34,7,14,21
79,2025-05-25T05:36:00+02:00,2025-05-25,13:36,8,11,19
79,2025-05-25T05:37:00+02:00,2025-05-25,13:37,20,8,28
85,2025-05-25T05:26:00+02:00,2025-05-25,13:26,1,1,2
85,2025-05-25T05:31:00+02:00,2025-05-25,13:31,0,3,3
85,2025-05-25T05:32:00+02:00,2025-05-25,13:32,1,1,2
85,2025-05-25T05:33:00+02:00,2025-05-25,13:33,4,2,6
85,2025-05-25T05:34:00+02:00,2025-05-25,13:34,0,2,2
85,2025-05-25T05:36:00+02:00,2025-05-25,13:36,3,1,4
85,2025-05-25T05:39:00+02:00,2025-05-25,13:39,6,1,7
86,2025-05-25T05:29:00+02:00,2025-05-25,13:29,0,1,1
86,2025-05-25T05:31:00+02:00,2025-05-25,13:31,1,0,1
109,2025-05-25T05:25:00+02:00,2025-05-25,13:25,6,10,16
117,2025-05-25T05:25:00+02:00,2025-05-25,13:25,9,17,26
117,2025-05-25T05:30:00+02:00,2025-05-25,13:30,22,11,33
136,2025-05-25T05:35:00+02:00,2025-05-25,13:35,19,5,24
139,2025-05-25T05:30:00+02:00,2025-05-25,13:30,14,5,19
139,2025-05-25T05:35:00+02:00,2025-05-25,13:35,3,1,4
141,2025-05-25T05:25:00+02:00,2025-05-25,13:25,14,16,30
141,2025-05-25T05:30:00+02:00,2025-05-25,13:30,5,20,25
141,2025-05-25T05:35:00+02:00,2025-05-25,13:35,8,17,25
142,2025-05-25T05:25:00+02:00,2025-05-25,13:25,75,53,128
142,2025-05-25T05:35:00+02:00,2025-05-25,13:35,52,71,123
161,2025-05-25T05:25:00+02:00,2025-05-25,13:25,31,11,42
161,2025-05-25T05:30:00+02:00,2025-05-25,13:30,35,31,66
161,2025-05-25T05:35:00+02:00,2025-05-25,13:35,39,13,52
164,2025-05-25T05:25:00+02:00,2025-05-25,13:25,12,7,19
181,2025-05-25T05:41:00+02:00,2025-05-25,13:41,2,21,23
181,2025-05-25T05:42:00+02:00,2025-05-25,13:42,15,30,45
181,2025-05-25T05:44:00+02:00,2025-05-25,13:44,17,26,43
181,2025-05-25T05:45:00+02:00,2025-05-25,13:45,9,14,23
181,2025-05-25T05:48:00+02:00,2025-05-25,13:48,6,25,31
181,2025-05-25T05:49:00+02:00,2025-05-25,13:49,17,24,41
181,2025-05-25T05:52:00+02:00,2025-05-25,13:52,11,21,32
182,2025-05-25T05:50:00+02:00,2025-05-25,13:50,17,15,32
180,2025-05-25T05:42:00+02:00,2025-05-25,13:42,1,0,1
180,2025-05-25T05:44:00+02:00,2025-05-25,13:44,0,1,1
180,2025-05-25T05:46:00+02:00,2025-05-25,13:46,0,2,2
180,2025-05-25T05:52:00+02:00,2025-05-25,13:52,2,0,2
3,2025-05-25T05:40:00+02:00,2025-05-25,13:40,29,17,46
3,2025-05-25T05:43:00+02:00,2025-05-25,13:43,33,17,50
3,2025-05-25T05:45:00+02:00,2025-05-25,13:45,22,15,37
3,2025-05-25T05:47:00+02:00,2025-05-25,13:47,17,19,36
3,2025-05-25T05:50:00+02:00,2025-05-25,13:50,19,12,31
4,2025-05-25T05:43:00+02:00,2025-05-25,13:43,21,19,40
4,2025-05-25T05:44:00+02:00,2025-05-25,13:44,24,27,51
4,2025-05-25T05:45:00+02:00,2025-05-25,13:45,19,26,45
4,2025-05-25T05:47:00+02:00,2025-05-25,13:47,37,19,56
4,2025-05-25T05:50:00+02:00,2025-05-25,13:50,34,40,74
4,2025-05-25T05:53:00+02:00,2025-05-25,13:53,38,31,69
5,2025-05-25T05:50:00+02:00,2025-05-25,13:50,79,73,152
6,2025-05-25T05:41:00+02:00,2025-05-25,13:41,20,11,31
6,2025-05-25T05:44:00+02:00,2025-05-25,13:44,7,10,17
6,2025-05-25T05:45:00+02:00,2025-05-25,13:45,19,19,38
6,2025-05-25T05:47:00+02:00,2025-05-25,13:47,12,10,22
6,2025-05-25T05:49:00+02:00,2025-05-25,13:49,17,9,26
6,2025-05-25T05:54:00+02:00,2025-05-25,13:54,9,16,25
8,2025-05-25T05:41:00+02:00,2025-05-25,13:41,2,4,6
8,2025-05-25T05:42:00+02:00,2025-05-25,13:42,5,1,6
8,2025-05-25T05:44:00+02:00,2025-05-25,13:44,8,7,15
8,2025-05-25T05:45:00+02:00,2025-05-25,13:45,5,5,10
8,2025-05-25T05:50:00+02:00,2025-05-25,13:50,1,5,6
8,2025-05-25T05:52:00+02:00,2025-05-25,13:52,6,3,9
28,2025-05-25T05:42:00+02:00,2025-05-25,13:42,9,19,28
28,2025-05-25T05:44:00+02:00,2025-05-25,13:44,16,5,21
28,2025-05-25T05:45:00+02:00,2025-05-25,13:45,12,25,37
28,2025-05-25T05:47:00+02:00,2025-05-25,13:47,6,12,18
28,2025-05-25T05:48:00+02:00,2025-05-25,13:48,2,11,13
28,2025-05-25T05:50:00+02:00,2025-05-25,13:50,9,11,20
28,2025-05-25T05:51:00+02:00,2025-05-25,13:51,10,21,31
29,2025-05-25T05:40:00+02:00,2025-05-25,13:40,8,11,19
29,2025-05-25T05:45:00+02:00,2025-05-25,13:45,6,19,25
29,2025-05-25T05:46:00+02:00,2025-05-25,13:46,3,17,20
29,2025-05-25T05:49:00+02:00,2025-05-25,13:49,18,12,30
29,2025-05-25T05:50:00+02:00,2025-05-25,13:50,11,13,24
31,2025-05-25T05:41:00+02:00,2025-05-25,13:41,12,1,13
31,2025-05-25T05:42:00+02:00,2025-05-25,13:42,16,7,23
31,2025-05-25T05:44:00+02:00,2025-05-25,13:44,4,2,6
36,2025-05-25T05:41:00+02:00,2025-05-25,13:41,2,0,2
36,2025-05-25T05:42:00+02:00,2025-05-25,13:42,1,0,1
36,2025-05-25T05:43:00+02:00,2025-05-25,13:43,3,4,7
36,2025-05-25T05:48:00+02:00,2025-05-25,13:48,2,5,7
36,2025-05-25T05:53:00+02:00,2025-05-25,13:53,0,1,1
36,2025-05-25T05:54:00+02:00,2025-05-25,13:54,4,2,6
39,2025-05-25T05:44:00+02:00,2025-05-25,13:44,1,0,1
39,2025-05-25T05:45:00+02:00,2025-05-25,13:45,0,3,3
39,2025-05-25T05:53:00+02:00,2025-05-25,13:53,2,1,3
40,2025-05-25T05:40:00+02:00,2025-05-25,13:40,1,4,5
40,2025-05-25T05:42:00+02:00,2025-05-25,13:42,0,5,5
40,2025-05-25T05:43:00+02:00,2025-05-25,13:43,2,3,5
40,2025-05-25T05:52:00+02:00,2025-05-25,13:52,4,1,5
40,2025-05-25T05:54:00+02:00,2025-05-25,13:54,2,0,2
41,2025-05-25T05:40:00+02:00,2025-05-25,13:40,23,4,27
41,2025-05-25T05:41:00+02:00,2025-05-25,13:41,12,5,17
41,2025-05-25T05:43:00+02:00,2025-05-25,13:43,7,6,13
41,2025-05-25T05:44:00+02:00,2025-05-25,13:44,15,0,15
41,2025-05-25T05:52:00+02:00,2025-05-25,13:52,9,7,16
43,2025-05-25T05:45:00+02:00,2025-05-25,13:45,6,2,8
44,2025-05-25T05:40:00+02:00,2025-05-25,13:40,1,2,3
45,2025-05-25T05:42:00+02:00,2025-05-25,13:42,17,25,42
45,2025-05-25T05:44:00+02:00,2025-05-25,13:44,22,12,34
45,2025-05-25T05:46:00+02:00,2025-05-25,13:46,20,9,29
45,2025-05-25T05:48:00+02:00,2025-05-25,13:48,15,11,26
45,2025-05-25T05:51:00+02:00,2025-05-25,13:51,14,13,27
45,2025-05-25T05:53:00+02:00,2025-05-25,13:53,22,13,35
47,2025-05-25T05:40:00+02:00,2025-05-25,13:40,13,24,37
47,2025-05-25T05:42:00+02:00,2025-05-25,13:42,14,11,25
47,2025-05-25T05:44:00+02:00,2025-05-25,13:44,15,29,44
47,2025-05-25T05:45:00+02:00,2025-05-25,13:45,27,10,37
47,2025-05-25T05:48:00+02:00,2025-05-25,13:48,20,5,25
47,2025-05-25T05:51:00+02:00,2025-05-25,13:51,17,20,37
47,2025-05-25T05:53:00+02:00,2025-05-25,13:53,11,33,44
50,2025-05-25T05:41:00+02:00,2025-05-25,13:41,3,10,13
50,2025-05-25T05:43:00+02:00,2025-05-25,13:43,9,4,13
50,2025-05-25T05:48:00+02:00,2025-05-25,13:48,3,9,12
50,2025-05-25T05:49:00+02:00,2025-05-25,13:49,0,4,4
50,2025-05-25T05:50:00+02:00,2025-05-25,13:50,7,5,12
50,2025-05-25T05:52:00+02:00,2025-05-25,13:52,4,3,7
54,2025-05-25T05:46:00+02:00,2025-05-25,13:46,2,5,7
54,2025-05-25T05:52:00+02:00,2025-05-25,13:52,2,1,3
59,2025-05-25T05:45:00+02:00,2025-05-25,13:45,13,21,34
61,2025-05-25T05:40:00+02:00,2025-05-25,13:40,15,8,23
61,2025-05-25T05:41:00+02:00,2025-05-25,13:41,6,11,17
61,2025-05-25T05:44:00+02:00,2025-05-25,13:44,11,8,19
61,2025-05-25T05:48:00+02:00,2025-05-25,13:48,8,11,19
66,2025-05-25T05:41:00+02:00,2025-05-25,13:41,41,10,51
66,2025-05-25T05:54:00+02:00,2025-05-25,13:54,34,42,76
69,2025-05-25T05:43:00+02:00,2025-05-25,13:43,12,5,17
69,2025-05-25T05:44:00+02:00,2025-05-25,13:44,3,3,6
69,2025-05-25T05:47:00+02:00,2025-05-25,13:47,3,0,3
69,2025-05-25T05:54:00+02:00,2025-05-25,13:54,3,4,7
70,2025-05-25T05:40:00+02:00,2025-05-25,13:40,1,2,3
70,2025-05-25T05:41:00+02:00,2025-05-25,13:41,2,3,5
70,2025-05-25T05:43:00+02:00,2025-05-25,13:43,5,2,7
70,2025-05-25T05:44:00+02:00,2025-05-25,13:44,0,2,2
70,2025-05-25T05:49:00+02:00,2025-05-25,13:49,7,2,9
70,2025-05-25T05:52:00+02:00,2025-05-25,13:52,1,1,2
70,2025-05-25T05:53:00+02:00,2025-05-25,13:53,4,4,8
70,2025-05-25T05:54:00+02:00,2025-05-25,13:54,1,4,5
75,2025-05-25T05:41:00+02:00,2025-05-25,13:41,0,9,9
75,2025-05-25T05:49:00+02:00,2025-05-25,13:49,0,2,2
75,2025-05-25T05:50:00+02:00,2025-05-25,13:50,1,0,1
75,2025-05-25T05:54:00+02:00,2025-05-25,13:54,0,1,1
77,2025-05-25T05:40:00+02:00,2025-05-25,13:40,30,30,60
77,2025-05-25T05:45:00+02:00,2025-05-25,13:45,22,13,35
77,2025-05-25T05:50:00+02:00,2025-05-25,13:50,28,15,43
78,2025-05-25T05:43:00+02:00,2025-05-25,13:43,1,5,6
78,2025-05-25T05:45:00+02:00,2025-05-25,13:45,0,1,1
78,2025-05-25T05:46:00+02:00,2025-05-25,13:46,2,0,2
87,2025-05-25T05:40:00+02:00,2025-05-25,13:40,2,7,9
87,2025-05-25T05:44:00+02:00,2025-05-25,13:44,1,1,2
87,2025-05-25T05:45:00+02:00,2025-05-25,13:45,6,2,8
87,2025-05-25T05:48:00+02:00,2025-05-25,13:48,3,0,3
87,2025-05-25T05:49:00+02:00,2025-05-25,13:49,1,5,6
87,2025-05-25T05:51:00+02:00,2025-05-25,13:51,7,0,7
87,2025-05-25T05:52:00+02:00,2025-05-25,13:52,1,5,6
107,2025-05-25T05:40:00+02:00,2025-05-25,13:40,7,10,17
107,2025-05-25T05:45:00+02:00,2025-05-25,13:45,17,16,33
108,2025-05-25T05:47:00+02:00,2025-05-25,13:47,2,2,4
108,2025-05-25T05:48:00+02:00,2025-05-25,13:48,10,2,12
108,2025-05-25T05:50:00+02:00,2025-05-25,13:50,42,4,46
108,2025-05-25T05:51:00+02:00,2025-05-25,13:51,25,4,29
108,2025-05-25T05:52:00+02:00,2025-05-25,13:52,16,4,20
108,2025-05-25T05:54:00+02:00,2025-05-25,13:54,7,7,14
118,2025-05-25T05:45:00+02:00,2025-05-25,13:45,0,2,2
131,2025-05-25T05:50:00+02:00,2025-05-25,13:50,12,20,32
132,2025-05-25T05:50:00+02:00,2025-05-25,13:50,11,24,35
133,2025-05-25T05:45:00+02:00,2025-05-25,13:45,39,38,77
134,2025-05-25T05:40:00+02:00,2025-05-25,13:40,33,18,51
165,2025-05-25T05:45:00+02:00,2025-05-25,13:45,2,1,3
165,2025-05-25T05:50:00+02:00,2025-05-25,13:50,0,1,1
166,2025-05-25T05:50:00+02:00,2025-05-25,13:50,2,6,8
167,2025-05-25T05:45:00+02:00,2025-05-25,13:45,1,0,1
167,2025-05-25T05:50:00+02:00,2025-05-25,13:50,1,3,4
179,2025-05-25T05:40:00+02:00,2025-05-25,13:40,8,2,10
1,2025-05-25T05:40:00+02:00,2025-05-25,13:40,21,47,68
1,2025-05-25T05:44:00+02:00,2025-05-25,13:44,20,36,56
1,2025-05-25T05:47:00+02:00,2025-05-25,13:47,22,36,58
2,2025-05-25T05:40:00+02:00,2025-05-25,13:40,6,11,17
2,2025-05-25T05:41:00+02:00,2025-05-25,13:41,14,38,52
2,2025-05-25T05:44:00+02:00,2025-05-25,13:44,11,10,21
2,2025-05-25T05:46:00+02:00,2025-05-25,13:46,15,11,26
2,2025-05-25T05:50:00+02:00,2025-05-25,13:50,13,16,29
2,2025-05-25T05:52:00+02:00,2025-05-25,13:52,17,10,27
2,2025-05-25T05:54:00+02:00,2025-05-25,13:54,12,4,16
9,2025-05-25T05:49:00+02:00,2025-05-25,13:49,0,5,5
9,2025-05-25T05:51:00+02:00,2025-05-25,13:51,2,4,6
10,2025-05-25T05:40:00+02:00,2025-05-25,13:40,2,0,2
10,2025-05-25T05:44:00+02:00,2025-05-25,13:44,1,1,2
10,2025-05-25T05:48:00+02:00,2025-05-25,13:48,1,1,2
10,2025-05-25T05:54:00+02:00,2025-05-25,13:54,1,0,1
11,2025-05-25T05:40:00+02:00,2025-05-25,13:40,8,2,10
11,2025-05-25T05:41:00+02:00,2025-05-25,13:41,2,1,3
11,2025-05-25T05:42:00+02:00,2025-05-25,13:42,1,1,2
11,2025-05-25T05:45:00+02:00,2025-05-25,13:45,5,5,10
11,2025-05-25T05:46:00+02:00,2025-05-25,13:46,0,1,1
11,2025-05-25T05:47:00+02:00,2025-05-25,13:47,1,2,3
11,2025-05-25T05:54:00+02:00,2025-05-25,13:54,0,2,2
12,2025-05-25T05:40:00+02:00,2025-05-25,13:40,5,4,9
12,2025-05-25T05:42:00+02:00,2025-05-25,13:42,6,2,8
12,2025-05-25T05:46:00+02:00,2025-05-25,13:46,1,5,6
12,2025-05-25T05:50:00+02:00,2025-05-25,13:50,8,4,12
12,2025-05-25T05:53:00+02:00,2025-05-25,13:53,6,3,9
12,2025-05-25T05:54:00+02:00,2025-05-25,13:54,3,1,4
17,2025-05-25T05:41:00+02:00,2025-05-25,13:41,3,0,3
17,2025-05-25T05:43:00+02:00,2025-05-25,13:43,1,0,1
17,2025-05-25T05:44:00+02:00,2025-05-25,13:44,0,2,2
17,2025-05-25T05:46:00+02:00,2025-05-25,13:46,2,0,2
17,2025-05-25T05:47:00+02:00,2025-05-25,13:47,4,3,7
17,2025-05-25T05:51:00+02:00,2025-05-25,13:51,0,3,3
17,2025-05-25T05:52:00+02:00,2025-05-25,13:52,2,0,2
17,2025-05-25T05:54:00+02:00,2025-05-25,13:54,2,2,4
18,2025-05-25T05:41:00+02:00,2025-05-25,13:41,0,2,2
18,2025-05-25T05:42:00+02:00,2025-05-25,13:42,5,2,7
18,2025-05-25T05:44:00+02:00,2025-05-25,13:44,0,7,7
18,2025-05-25T05:52:00+02:00,2025-05-25,13:52,3,1,4
18,2025-05-25T05:53:00+02:00,2025-05-25,13:53,2,2,4
18,2025-05-25T05:54:00+02:00,2025-05-25,13:54,1,1,2
19,2025-05-25T05:41:00+02:00,2025-05-25,13:41,13,6,19
19,2025-05-25T05:45:00+02:00,2025-05-25,13:45,12,11,23
19,2025-05-25T05:49:00+02:00,2025-05-25,13:49,12,12,24
19,2025-05-25T05:50:00+02:00,2025-05-25,13:50,13,6,19
19,2025-05-25T05:51:00+02:00,2025-05-25,13:51,14,14,28
20,2025-05-25T05:42:00+02:00,2025-05-25,13:42,16,4,20
20,2025-05-25T05:47:00+02:00,2025-05-25,13:47,6,3,9
20,2025-05-25T05:50:00+02:00,2025-05-25,13:50,8,5,13
20,2025-05-25T05:53:00+02:00,2025-05-25,13:53,9,6,15
23,2025-05-25T05:46:00+02:00,2025-05-25,13:46,5,6,11
23,2025-05-25T05:51:00+02:00,2025-05-25,13:51,1,0,1
24,2025-05-25T05:40:00+02:00,2025-05-25,13:40,4,30,34
24,2025-05-25T05:41:00+02:00,2025-05-25,13:41,11,10,21
24,2025-05-25T05:44:00+02:00,2025-05-25,13:44,9,15,24
24,2025-05-25T05:45:00+02:00,2025-05-25,13:45,2,20,22
24,2025-05-25T05:46:00+02:00,2025-05-25,13:46,7,11,18
24,2025-05-25T05:51:00+02:00,2025-05-25,13:51,5,10,15
24,2025-05-25T05:52:00+02:00,2025-05-25,13:52,1,14,15
24,2025-05-25T05:54:00+02:00,2025-05-25,13:54,5,5,10
25,2025-05-25T05:45:00+02:00,2025-05-25,13:45,47,55,102
27,2025-05-25T05:43:00+02:00,2025-05-25,13:43,4,0,4
27,2025-05-25T05:45:00+02:00,2025-05-25,13:45,4,1,5
27,2025-05-25T05:46:00+02:00,2025-05-25,13:46,3,0,3
27,2025-05-25T05:50:00+02:00,2025-05-25,13:50,3,11,14
30,2025-05-25T05:40:00+02:00,2025-05-25,13:40,5,2,7
30,2025-05-25T05:47:00+02:00,2025-05-25,13:47,17,11,28
30,2025-05-25T05:50:00+02:00,2025-05-25,13:50,8,9,17
30,2025-05-25T05:53:00+02:00,2025-05-25,13:53,8,6,14
30,2025-05-25T05:54:00+02:00,2025-05-25,13:54,4,12,16
35,2025-05-25T05:41:00+02:00,2025-05-25,13:41,11,23,34
35,2025-05-25T05:46:00+02:00,2025-05-25,13:46,22,22,44
35,2025-05-25T05:47:00+02:00,2025-05-25,13:47,32,19,51
35,2025-05-25T05:48:00+02:00,2025-05-25,13:48,26,34,60
35,2025-05-25T05:49:00+02:00,2025-05-25,13:49,6,23,29
35,2025-05-25T05:51:00+02:00,2025-05-25,13:51,30,17,47
46,2025-05-25T05:50:00+02:00,2025-05-25,13:50,5,5,10
48,2025-05-25T05:50:00+02:00,2025-05-25,13:50,8,7,15
48,2025-05-25T05:52:00+02:00,2025-05-25,13:52,7,3,10
49,2025-05-25T05:41:00+02:00,2025-05-25,13:41,5,21,26
49,2025-05-25T05:48:00+02:00,2025-05-25,13:48,0,22,22
49,2025-05-25T05:49:00+02:00,2025-05-25,13:49,8,13,21
49,2025-05-25T05:50:00+02:00,2025-05-25,13:50,4,8,12
49,2025-05-25T05:51:00+02:00,2025-05-25,13:51,6,10,16
49,2025-05-25T05:53:00+02:00,2025-05-25,13:53,12,13,25
49,2025-05-25T05:54:00+02:00,2025-05-25,13:54,1,13,14
51,2025-05-25T05:43:00+02:00,2025-05-25,13:43,7,3,10
51,2025-05-25T05:52:00+02:00,2025-05-25,13:52,0,3,3
51,2025-05-25T05:54:00+02:00,2025-05-25,13:54,3,5,8
52,2025-05-25T05:40:00+02:00,2025-05-25,13:40,11,1,12
52,2025-05-25T05:41:00+02:00,2025-05-25,13:41,6,2,8
52,2025-05-25T05:43:00+02:00,2025-05-25,13:43,11,4,15
52,2025-05-25T05:52:00+02:00,2025-05-25,13:52,7,3,10
53,2025-05-25T05:41:00+02:00,2025-05-25,13:41,10,9,19
53,2025-05-25T05:42:00+02:00,2025-05-25,13:42,13,11,24
53,2025-05-25T05:43:00+02:00,2025-05-25,13:43,14,7,21
53,2025-05-25T05:47:00+02:00,2025-05-25,13:47,14,9,23
53,2025-05-25T05:51:00+02:00,2025-05-25,13:51,12,8,20
56,2025-05-25T05:40:00+02:00,2025-05-25,13:40,6,6,12
56,2025-05-25T05:46:00+02:00,2025-05-25,13:46,12,7,19
56,2025-05-25T05:50:00+02:00,2025-05-25,13:50,9,8,17
56,2025-05-25T05:52:00+02:00,2025-05-25,13:52,14,3,17
56,2025-05-25T05:54:00+02:00,2025-05-25,13:54,12,11,23
58,2025-05-25T05:40:00+02:00,2025-05-25,13:40,12,9,21
58,2025-05-25T05:43:00+02:00,2025-05-25,13:43,18,7,25
58,2025-05-25T05:45:00+02:00,2025-05-25,13:45,10,3,13
58,2025-05-25T05:49:00+02:00,2025-05-25,13:49,10,15,25
58,2025-05-25T05:51:00+02:00,2025-05-25,13:51,10,3,13
62,2025-05-25T05:50:00+02:00,2025-05-25,13:50,2,2,4
62,2025-05-25T05:51:00+02:00,2025-05-25,13:51,7,4,11
63,2025-05-25T05:40:00+02:00,2025-05-25,13:40,4,8,12
63,2025-05-25T05:44:00+02:00,2025-05-25,13:44,7,5,12
63,2025-05-25T05:45:00+02:00,2025-05-25,13:45,4,4,8
63,2025-05-25T05:51:00+02:00,2025-05-25,13:51,7,5,12
63,2025-05-25T05:52:00+02:00,2025-05-25,13:52,6,4,10
67,2025-05-25T05:40:00+02:00,2025-05-25,13:40,10,7,17
67,2025-05-25T05:47:00+02:00,2025-05-25,13:47,3,2,5
67,2025-05-25T05:50:00+02:00,2025-05-25,13:50,3,23,26
67,2025-05-25T05:53:00+02:00,2025-05-25,13:53,8,13,21
68,2025-05-25T05:41:00+02:00,2025-05-25,13:41,5,6,11
68,2025-05-25T05:45:00+02:00,2025-05-25,13:45,3,6,9
68,2025-05-25T05:49:00+02:00,2025-05-25,13:49,7,5,12
72,2025-05-25T05:40:00+02:00,2025-05-25,13:40,2,8,10
72,2025-05-25T05:42:00+02:00,2025-05-25,13:42,1,10,11
72,2025-05-25T05:43:00+02:00,2025-05-25,13:43,7,12,19
72,2025-05-25T05:46:00+02:00,2025-05-25,13:46,11,17,28
76,2025-05-25T05:40:00+02:00,2025-05-25,13:40,1,1,2
76,2025-05-25T05:44:00+02:00,2025-05-25,13:44,1,0,1
76,2025-05-25T05:51:00+02:00,2025-05-25,13:51,0,6,6
76,2025-05-25T05:52:00+02:00,2025-05-25,13:52,1,2,3
79,2025-05-25T05:42:00+02:00,2025-05-25,13:42,12,8,20
79,2025-05-25T05:47:00+02:00,2025-05-25,13:47,11,9,20
79,2025-05-25T05:48:00+02:00,2025-05-25,13:48,27,6,33
79,2025-05-25T05:49:00+02:00,2025-05-25,13:49,9,13,22
79,2025-05-25T05:50:00+02:00,2025-05-25,13:50,15,13,28
79,2025-05-25T05:54:00+02:00,2025-05-25,13:54,16,2,18
85,2025-05-25T05:44:00+02:00,2025-05-25,13:44,5,2,7
85,2025-05-25T05:45:00+02:00,2025-05-25,13:45,1,1,2
85,2025-05-25T05:46:00+02:00,2025-05-25,13:46,2,2,4
85,2025-05-25T05:47:00+02:00,2025-05-25,13:47,1,8,9
85,2025-05-25T05:54:00+02:00,2025-05-25,13:54,2,0,2
86,2025-05-25T05:41:00+02:00,2025-05-25,13:41,1,1,2
86,2025-05-25T05:47:00+02:00,2025-05-25,13:47,1,3,4
109,2025-05-25T05:45:00+02:00,2025-05-25,13:45,10,7,17
117,2025-05-25T05:40:00+02:00,2025-05-25,13:40,23,36,59
117,2025-05-25T05:45:00+02:00,2025-05-25,13:45,18,9,27
117,2025-05-25T05:50:00+02:00,2025-05-25,13:50,11,31,42
123,2025-05-25T05:40:00+02:00,2025-05-25,13:40,3,0,3
123,2025-05-25T05:50:00+02:00,2025-05-25,13:50,0,1,1
136,2025-05-25T05:40:00+02:00,2025-05-25,13:40,52,6,58
136,2025-05-25T05:50:00+02:00,2025-05-25,13:50,63,2,65
137,2025-05-25T05:40:00+02:00,2025-05-25,13:40,0,2,2
137,2025-05-25T05:50:00+02:00,2025-05-25,13:50,1,0,1
138,2025-05-25T05:40:00+02:00,2025-05-25,13:40,2,0,2
164,2025-05-25T05:40:00+02:00,2025-05-25,13:40,12,7,19
164,2025-05-25T05:45:00+02:00,2025-05-25,13:45,10,5,15
181,2025-05-25T05:55:00+02:00,2025-05-25,13:55,2,20,22
181,2025-05-25T05:57:00+02:00,2025-05-25,13:57,12,20,32
181,2025-05-25T06:00:00+02:00,2025-05-25,14:00,6,32,38
181,2025-05-25T06:02:00+02:00,2025-05-25,14:02,12,19,31
181,2025-05-25T06:06:00+02:00,2025-05-25,14:06,6,11,17
181,2025-05-25T06:09:00+02:00,2025-05-25,14:09,5,27,32
180,2025-05-25T05:56:00+02:00,2025-05-25,13:56,1,0,1
180,2025-05-25T06:07:00+02:00,2025-05-25,14:07,0,1,1
3,2025-05-25T07:43:00+02:00,2025-05-25,15:43,18,18,36
3,2025-05-25T07:46:00+02:00,2025-05-25,15:46,14,14,28
3,2025-05-25T07:47:00+02:00,2025-05-25,15:47,20,20,40
3,2025-05-25T07:52:00+02:00,2025-05-25,15:52,11,13,24
4,2025-05-25T07:43:00+02:00,2025-05-25,15:43,33,21,54
4,2025-05-25T07:46:00+02:00,2025-05-25,15:46,53,38,91
4,2025-05-25T07:47:00+02:00,2025-05-25,15:47,33,42,75
4,2025-05-25T07:51:00+02:00,2025-05-25,15:51,35,18,53
4,2025-05-25T07:53:00+02:00,2025-05-25,15:53,33,11,44
6,2025-05-25T07:40:00+02:00,2025-05-25,15:40,17,15,32
6,2025-05-25T07:41:00+02:00,2025-05-25,15:41,9,27,36
6,2025-05-25T07:42:00+02:00,2025-05-25,15:42,17,10,27
6,2025-05-25T07:44:00+02:00,2025-05-25,15:44,15,9,24
6,2025-05-25T07:46:00+02:00,2025-05-25,15:46,29,18,47
6,2025-05-25T07:51:00+02:00,2025-05-25,15:51,14,13,27
6,2025-05-25T07:54:00+02:00,2025-05-25,15:54,16,15,31
8,2025-05-25T07:40:00+02:00,2025-05-25,15:40,3,2,5
8,2025-05-25T07:42:00+02:00,2025-05-25,15:42,0,11,11
8,2025-05-25T07:45:00+02:00,2025-05-25,15:45,2,4,6
8,2025-05-25T07:47:00+02:00,2025-05-25,15:47,2,2,4
8,2025-05-25T07:50:00+02:00,2025-05-25,15:50,0,3,3
8,2025-05-25T07:52:00+02:00,2025-05-25,15:52,7,4,11
8,2025-05-25T07:54:00+02:00,2025-05-25,15:54,5,3,8
28,2025-05-25T07:40:00+02:00,2025-05-25,15:40,16,12,28
28,2025-05-25T07:42:00+02:00,2025-05-25,15:42,14,12,26
28,2025-05-25T07:45:00+02:00,2025-05-25,15:45,7,17,24
28,2025-05-25T07:46:00+02:00,2025-05-25,15:46,11,4,15
28,2025-05-25T07:51:00+02:00,2025-05-25,15:51,11,7,18
29,2025-05-25T07:44:00+02:00,2025-05-25,15:44,8,9,17
29,2025-05-25T07:46:00+02:00,2025-05-25,15:46,21,12,33
29,2025-05-25T07:47:00+02:00,2025-05-25,15:47,10,18,28
29,2025-05-25T07:48:00+02:00,2025-05-25,15:48,9,14,23
29,2025-05-25T07:49:00+02:00,2025-05-25,15:49,13,11,24
29,2025-05-25T07:51:00+02:00,2025-05-25,15:51,23,10,33
29,2025-05-25T07:52:00+02:00,2025-05-25,15:52,20,12,32
31,2025-05-25T07:40:00+02:00,2025-05-25,15:40,0,16,16
31,2025-05-25T07:43:00+02:00,2025-05-25,15:43,6,5,11
31,2025-05-25T07:47:00+02:00,2025-05-25,15:47,0,2,2
36,2025-05-25T07:42:00+02:00,2025-05-25,15:42,5,2,7
36,2025-05-25T07:51:00+02:00,2025-05-25,15:51,0,2,2
39,2025-05-25T07:42:00+02:00,2025-05-25,15:42,0,1,1
39,2025-05-25T07:50:00+02:00,2025-05-25,15:50,1,3,4
39,2025-05-25T07:51:00+02:00,2025-05-25,15:51,0,1,1
40,2025-05-25T07:46:00+02:00,2025-05-25,15:46,1,2,3
40,2025-05-25T07:50:00+02:00,2025-05-25,15:50,3,0,3
40,2025-05-25T07:51:00+02:00,2025-05-25,15:51,2,4,6
40,2025-05-25T07:52:00+02:00,2025-05-25,15:52,1,6,7
40,2025-05-25T07:53:00+02:00,2025-05-25,15:53,1,0,1
41,2025-05-25T07:41:00+02:00,2025-05-25,15:41,14,20,34
41,2025-05-25T07:54:00+02:00,2025-05-25,15:54,12,10,22
43,2025-05-25T07:45:00+02:00,2025-05-25,15:45,6,0,6
45,2025-05-25T07:41:00+02:00,2025-05-25,15:41,22,16,38
45,2025-05-25T07:42:00+02:00,2025-05-25,15:42,27,20,47
45,2025-05-25T07:47:00+02:00,2025-05-25,15:47,32,18,50
45,2025-05-25T07:52:00+02:00,2025-05-25,15:52,13,25,38
45,2025-05-25T07:53:00+02:00,2025-05-25,15:53,37,18,55
47,2025-05-25T07:41:00+02:00,2025-05-25,15:41,4,14,18
47,2025-05-25T07:46:00+02:00,2025-05-25,15:46,23,28,51
47,2025-05-25T07:53:00+02:00,2025-05-25,15:53,20,6,26
47,2025-05-25T07:54:00+02:00,2025-05-25,15:54,25,24,49
50,2025-05-25T07:40:00+02:00,2025-05-25,15:40,7,3,10
50,2025-05-25T07:41:00+02:00,2025-05-25,15:41,6,5,11
50,2025-05-25T07:43:00+02:00,2025-05-25,15:43,5,2,7
50,2025-05-25T07:46:00+02:00,2025-05-25,15:46,6,2,8
50,2025-05-25T07:47:00+02:00,2025-05-25,15:47,0,8,8
50,2025-05-25T07:50:00+02:00,2025-05-25,15:50,3,6,9
54,2025-05-25T07:40:00+02:00,2025-05-25,15:40,4,4,8
54,2025-05-25T07:42:00+02:00,2025-05-25,15:42,2,1,3
54,2025-05-25T07:43:00+02:00,2025-05-25,15:43,2,4,6
54,2025-05-25T07:45:00+02:00,2025-05-25,15:45,4,3,7
54,2025-05-25T07:47:00+02:00,2025-05-25,15:47,2,1,3
54,2025-05-25T07:50:00+02:00,2025-05-25,15:50,5,0,5
54,2025-05-25T07:54:00+02:00,2025-05-25,15:54,5,1,6
59,2025-05-25T07:45:00+02:00,2025-05-25,15:45,24,27,51
61,2025-05-25T07:43:00+02:00,2025-05-25,15:43,8,5,13
61,2025-05-25T07:44:00+02:00,2025-05-25,15:44,16,11,27
61,2025-05-25T07:48:00+02:00,2025-05-25,15:48,8,2,10
66,2025-05-25T07:40:00+02:00,2025-05-25,15:40,20,16,36
66,2025-05-25T07:42:00+02:00,2025-05-25,15:42,20,34,54
66,2025-05-25T07:43:00+02:00,2025-05-25,15:43,24,18,42
66,2025-05-25T07:47:00+02:00,2025-05-25,15:47,26,32,58
66,2025-05-25T07:49:00+02:00,2025-05-25,15:49,27,17,44
66,2025-05-25T07:52:00+02:00,2025-05-25,15:52,22,16,38
66,2025-05-25T07:53:00+02:00,2025-05-25,15:53,27,31,58
69,2025-05-25T07:44:00+02:00,2025-05-25,15:44,0,2,2
69,2025-05-25T07:50:00+02:00,2025-05-25,15:50,7,4,11
69,2025-05-25T07:52:00+02:00,2025-05-25,15:52,5,6,11
69,2025-05-25T07:53:00+02:00,2025-05-25,15:53,4,8,12
70,2025-05-25T07:40:00+02:00,2025-05-25,15:40,2,2,4
70,2025-05-25T07:49:00+02:00,2025-05-25,15:49,5,0,5
71,2025-05-25T07:44:00+02:00,2025-05-25,15:44,0,2,2
71,2025-05-25T07:53:00+02:00,2025-05-25,15:53,1,0,1
75,2025-05-25T07:40:00+02:00,2025-05-25,15:40,1,1,2
75,2025-05-25T07:45:00+02:00,2025-05-25,15:45,1,0,1
75,2025-05-25T07:47:00+02:00,2025-05-25,15:47,5,0,5
75,2025-05-25T07:52:00+02:00,2025-05-25,15:52,0,1,1
77,2025-05-25T07:40:00+02:00,2025-05-25,15:40,17,17,34
77,2025-05-25T07:45:00+02:00,2025-05-25,15:45,10,9,19
78,2025-05-25T07:40:00+02:00,2025-05-25,15:40,1,2,3
78,2025-05-25T07:44:00+02:00,2025-05-25,15:44,0,2,2
78,2025-05-25T07:50:00+02:00,2025-05-25,15:50,0,1,1
78,2025-05-25T07:54:00+02:00,2025-05-25,15:54,1,0,1
87,2025-05-25T07:43:00+02:00,2025-05-25,15:43,3,1,4
87,2025-05-25T07:52:00+02:00,2025-05-25,15:52,0,1,1
107,2025-05-25T07:40:00+02:00,2025-05-25,15:40,8,7,15
108,2025-05-25T07:41:00+02:00,2025-05-25,15:41,1,3,4
108,2025-05-25T07:43:00+02:00,2025-05-25,15:43,1,1,2
108,2025-05-25T07:49:00+02:00,2025-05-25,15:49,1,4,5
108,2025-05-25T07:51:00+02:00,2025-05-25,15:51,1,4,5
108,2025-05-25T07:52:00+02:00,2025-05-25,15:52,4,0,4
108,2025-05-25T07:54:00+02:00,2025-05-25,15:54,2,1,3
118,2025-05-25T07:50:00+02:00,2025-05-25,15:50,0,1,1
133,2025-05-25T07:40:00+02:00,2025-05-25,15:40,38,33,71
133,2025-05-25T07:50:00+02:00,2025-05-25,15:50,33,40,73
135,2025-05-25T07:40:00+02:00,2025-05-25,15:40,49,28,77
135,2025-05-25T07:45:00+02:00,2025-05-25,15:45,67,26,93
140,2025-05-25T07:40:00+02:00,2025-05-25,15:40,7,10,17
140,2025-05-25T07:45:00+02:00,2025-05-25,15:45,5,12,17
166,2025-05-25T07:40:00+02:00,2025-05-25,15:40,3,6,9
167,2025-05-25T07:45:00+02:00,2025-05-25,15:45,6,5,11
1,2025-05-25T07:40:00+02:00,2025-05-25,15:40,12,6,18
1,2025-05-25T07:45:00+02:00,2025-05-25,15:45,36,14,50
1,2025-05-25T07:46:00+02:00,2025-05-25,15:46,24,11,35
1,2025-05-25T07:47:00+02:00,2025-05-25,15:47,21,31,52
1,2025-05-25T07:48:00+02:00,2025-05-25,15:48,26,28,54
1,2025-05-25T07:51:00+02:00,2025-05-25,15:51,27,30,57
1,2025-05-25T07:53:00+02:00,2025-05-25,15:53,31,13,44
2,2025-05-25T07:41:00+02:00,2025-05-25,15:41,2,14,16
2,2025-05-25T07:42:00+02:00,2025-05-25,15:42,13,12,25
2,2025-05-25T07:43:00+02:00,2025-05-25,15:43,15,10,25
2,2025-05-25T07:44:00+02:00,2025-05-25,15:44,16,12,28
2,2025-05-25T07:46:00+02:00,2025-05-25,15:46,4,11,15
2,2025-05-25T07:48:00+02:00,2025-05-25,15:48,12,18,30
2,2025-05-25T07:51:00+02:00,2025-05-25,15:51,8,8,16
2,2025-05-25T07:53:00+02:00,2025-05-25,15:53,2,12,14
9,2025-05-25T07:40:00+02:00,2025-05-25,15:40,1,2,3
9,2025-05-25T07:43:00+02:00,2025-05-25,15:43,2,8,10
9,2025-05-25T07:44:00+02:00,2025-05-25,15:44,0,1,1
9,2025-05-25T07:45:00+02:00,2025-05-25,15:45,0,1,1
9,2025-05-25T07:46:00+02:00,2025-05-25,15:46,2,0,2
9,2025-05-25T07:48:00+02:00,2025-05-25,15:48,1,0,1
9,2025-05-25T07:51:00+02:00,2025-05-25,15:51,1,0,1
10,2025-05-25T07:44:00+02:00,2025-05-25,15:44,1,0,1
10,2025-05-25T07:45:00+02:00,2025-05-25,15:45,2,0,2
10,2025-05-25T07:46:00+02:00,2025-05-25,15:46,4,1,5
10,2025-05-25T07:53:00+02:00,2025-05-25,15:53,1,0,1
11,2025-05-25T07:40:00+02:00,2025-05-25,15:40,2,3,5
11,2025-05-25T07:45:00+02:00,2025-05-25,15:45,9,7,16
11,2025-05-25T07:46:00+02:00,2025-05-25,15:46,1,0,1
11,2025-05-25T07:53:00+02:00,2025-05-25,15:53,0,1,1
12,2025-05-25T07:41:00+02:00,2025-05-25,15:41,4,4,8
12,2025-05-25T07:44:00+02:00,2025-05-25,15:44,6,3,9
12,2025-05-25T07:45:00+02:00,2025-05-25,15:45,3,4,7
12,2025-05-25T07:49:00+02:00,2025-05-25,15:49,8,2,10
12,2025-05-25T07:50:00+02:00,2025-05-25,15:50,8,6,14
17,2025-05-25T07:40:00+02:00,2025-05-25,15:40,1,0,1
17,2025-05-25T07:41:00+02:00,2025-05-25,15:41,3,4,7
17,2025-05-25T07:42:00+02:00,2025-05-25,15:42,2,12,14
17,2025-05-25T07:43:00+02:00,2025-05-25,15:43,0,7,7
17,2025-05-25T07:47:00+02:00,2025-05-25,15:47,0,12,12
17,2025-05-25T07:49:00+02:00,2025-05-25,15:49,1,1,2
17,2025-05-25T07:54:00+02:00,2025-05-25,15:54,0,15,15
18,2025-05-25T07:43:00+02:00,2025-05-25,15:43,2,0,2
18,2025-05-25T07:44:00+02:00,2025-05-25,15:44,1,2,3
19,2025-05-25T07:46:00+02:00,2025-05-25,15:46,9,10,19
19,2025-05-25T07:51:00+02:00,2025-05-25,15:51,18,5,23
19,2025-05-25T07:52:00+02:00,2025-05-25,15:52,12,12,24
20,2025-05-25T07:47:00+02:00,2025-05-25,15:47,3,8,11
20,2025-05-25T07:52:00+02:00,2025-05-25,15:52,2,10,12
20,2025-05-25T07:54:00+02:00,2025-05-25,15:54,4,4,8
23,2025-05-25T07:42:00+02:00,2025-05-25,15:42,4,5,9
23,2025-05-25T07:46:00+02:00,2025-05-25,15:46,0,8,8
23,2025-05-25T07:47:00+02:00,2025-05-25,15:47,2,22,24
23,2025-05-25T07:52:00+02:00,2025-05-25,15:52,3,18,21
23,2025-05-25T07:53:00+02:00,2025-05-25,15:53,3,0,3
24,2025-05-25T07:41:00+02:00,2025-05-25,15:41,5,9,14
24,2025-05-25T07:43:00+02:00,2025-05-25,15:43,7,6,13
24,2025-05-25T07:44:00+02:00,2025-05-25,15:44,7,13,20
24,2025-05-25T07:46:00+02:00,2025-05-25,15:46,10,10,20
24,2025-05-25T07:47:00+02:00,2025-05-25,15:47,8,54,62
24,2025-05-25T07:49:00+02:00,2025-05-25,15:49,6,22,28
27,2025-05-25T07:40:00+02:00,2025-05-25,15:40,1,8,9
27,2025-05-25T07:41:00+02:00,2025-05-25,15:41,5,4,9
27,2025-05-25T07:42:00+02:00,2025-05-25,15:42,4,0,4
27,2025-05-25T07:52:00+02:00,2025-05-25,15:52,5,4,9
27,2025-05-25T07:54:00+02:00,2025-05-25,15:54,3,4,7
30,2025-05-25T07:40:00+02:00,2025-05-25,15:40,4,3,7
30,2025-05-25T07:41:00+02:00,2025-05-25,15:41,1,12,13
30,2025-05-25T07:42:00+02:00,2025-05-25,15:42,3,5,8
30,2025-05-25T07:46:00+02:00,2025-05-25,15:46,7,9,16
30,2025-05-25T07:50:00+02:00,2025-05-25,15:50,5,0,5
30,2025-05-25T07:52:00+02:00,2025-05-25,15:52,1,13,14
30,2025-05-25T07:53:00+02:00,2025-05-25,15:53,7,2,9
35,2025-05-25T07:43:00+02:00,2025-05-25,15:43,19,35,54
35,2025-05-25T07:44:00+02:00,2025-05-25,15:44,21,18,39
35,2025-05-25T07:45:00+02:00,2025-05-25,15:45,23,35,58
35,2025-05-25T07:48:00+02:00,2025-05-25,15:48,20,34,54
35,2025-05-25T07:51:00+02:00,2025-05-25,15:51,15,35,50
35,2025-05-25T07:54:00+02:00,2025-05-25,15:54,24,30,54
46,2025-05-25T07:45:00+02:00,2025-05-25,15:45,9,3,12
46,2025-05-25T07:50:00+02:00,2025-05-25,15:50,4,0,4
48,2025-05-25T07:40:00+02:00,2025-05-25,15:40,15,4,19
48,2025-05-25T07:44:00+02:00,2025-05-25,15:44,14,2,16
48,2025-05-25T07:46:00+02:00,2025-05-25,15:46,9,3,12
48,2025-05-25T07:48:00+02:00,2025-05-25,15:48,1,1,2
48,2025-05-25T07:51:00+02:00,2025-05-25,15:51,14,2,16
49,2025-05-25T07:40:00+02:00,2025-05-25,15:40,2,7,9
49,2025-05-25T07:45:00+02:00,2025-05-25,15:45,3,14,17
49,2025-05-25T07:46:00+02:00,2025-05-25,15:46,5,13,18
49,2025-05-25T07:47:00+02:00,2025-05-25,15:47,0,12,12
49,2025-05-25T07:50:00+02:00,2025-05-25,15:50,0,5,5
49,2025-05-25T07:54:00+02:00,2025-05-25,15:54,4,12,16
51,2025-05-25T07:40:00+02:00,2025-05-25,15:40,3,2,5
51,2025-05-25T07:41:00+02:00,2025-05-25,15:41,3,1,4
51,2025-05-25T07:42:00+02:00,2025-05-25,15:42,4,4,8
51,2025-05-25T07:52:00+02:00,2025-05-25,15:52,1,2,3
52,2025-05-25T07:40:00+02:00,2025-05-25,15:40,8,4,12
52,2025-05-25T07:41:00+02:00,2025-05-25,15:41,12,2,14
52,2025-05-25T07:42:00+02:00,2025-05-25,15:42,12,3,15
52,2025-05-25T07:44:00+02:00,2025-05-25,15:44,3,6,9
52,2025-05-25T07:47:00+02:00,2025-05-25,15:47,8,10,18
52,2025-05-25T07:48:00+02:00,2025-05-25,15:48,6,2,8
52,2025-05-25T07:50:00+02:00,2025-05-25,15:50,7,6,13
53,2025-05-25T07:46:00+02:00,2025-05-25,15:46,11,7,18
53,2025-05-25T07:49:00+02:00,2025-05-25,15:49,7,14,21
53,2025-05-25T07:50:00+02:00,2025-05-25,15:50,15,13,28
56,2025-05-25T07:41:00+02:00,2025-05-25,15:41,2,5,7
56,2025-05-25T07:45:00+02:00,2025-05-25,15:45,10,9,19
56,2025-05-25T07:53:00+02:00,2025-05-25,15:53,0,1,1
58,2025-05-25T07:44:00+02:00,2025-05-25,15:44,19,5,24
58,2025-05-25T07:49:00+02:00,2025-05-25,15:49,0,14,14
58,2025-05-25T07:50:00+02:00,2025-05-25,15:50,4,12,16
58,2025-05-25T07:51:00+02:00,2025-05-25,15:51,9,4,13
58,2025-05-25T07:53:00+02:00,2025-05-25,15:53,9,10,19
62,2025-05-25T07:42:00+02:00,2025-05-25,15:42,4,3,7
62,2025-05-25T07:43:00+02:00,2025-05-25,15:43,2,6,8
62,2025-05-25T07:44:00+02:00,2025-05-25,15:44,2,5,7
62,2025-05-25T07:46:00+02:00,2025-05-25,15:46,11,4,15
63,2025-05-25T07:41:00+02:00,2025-05-25,15:41,13,7,20
63,2025-05-25T07:43:00+02:00,2025-05-25,15:43,0,2,2
63,2025-05-25T07:48:00+02:00,2025-05-25,15:48,11,5,16
63,2025-05-25T07:54:00+02:00,2025-05-25,15:54,4,20,24
67,2025-05-25T07:41:00+02:00,2025-05-25,15:41,4,15,19
67,2025-05-25T07:44:00+02:00,2025-05-25,15:44,0,6,6
67,2025-05-25T07:52:00+02:00,2025-05-25,15:52,4,13,17
67,2025-05-25T07:53:00+02:00,2025-05-25,15:53,0,9,9
68,2025-05-25T07:40:00+02:00,2025-05-25,15:40,4,4,8
68,2025-05-25T07:41:00+02:00,2025-05-25,15:41,6,8,14
68,2025-05-25T07:43:00+02:00,2025-05-25,15:43,7,1,8
68,2025-05-25T07:45:00+02:00,2025-05-25,15:45,4,5,9
68,2025-05-25T07:47:00+02:00,2025-05-25,15:47,6,3,9
68,2025-05-25T07:49:00+02:00,2025-05-25,15:49,2,7,9
68,2025-05-25T07:50:00+02:00,2025-05-25,15:50,5,9,14
68,2025-05-25T07:51:00+02:00,2025-05-25,15:51,8,13,21
72,2025-05-25T07:41:00+02:00,2025-05-25,15:41,4,15,19
72,2025-05-25T07:42:00+02:00,2025-05-25,15:42,11,13,24
72,2025-05-25T07:43:00+02:00,2025-05-25,15:43,4,11,15
72,2025-05-25T07:47:00+02:00,2025-05-25,15:47,9,10,19
72,2025-05-25T07:48:00+02:00,2025-05-25,15:48,0,27,27
72,2025-05-25T07:53:00+02:00,2025-05-25,15:53,7,3,10
72,2025-05-25T07:54:00+02:00,2025-05-25,15:54,7,19,26
76,2025-05-25T07:43:00+02:00,2025-05-25,15:43,1,0,1
76,2025-05-25T07:46:00+02:00,2025-05-25,15:46,0,2,2
76,2025-05-25T07:47:00+02:00,2025-05-25,15:47,1,0,1
76,2025-05-25T07:50:00+02:00,2025-05-25,15:50,1,0,1
76,2025-05-25T07:51:00+02:00,2025-05-25,15:51,0,6,6
79,2025-05-25T07:41:00+02:00,2025-05-25,15:41,5,6,11
79,2025-05-25T07:42:00+02:00,2025-05-25,15:42,17,25,42
79,2025-05-25T07:45:00+02:00,2025-05-25,15:45,17,6,23
79,2025-05-25T07:49:00+02:00,2025-05-25,15:49,19,9,28
79,2025-05-25T07:51:00+02:00,2025-05-25,15:51,11,10,21
85,2025-05-25T07:42:00+02:00,2025-05-25,15:42,0,1,1
85,2025-05-25T07:47:00+02:00,2025-05-25,15:47,1,1,2
85,2025-05-25T07:49:00+02:00,2025-05-25,15:49,1,0,1
85,2025-05-25T07:53:00+02:00,2025-05-25,15:53,1,1,2
86,2025-05-25T07:40:00+02:00,2025-05-25,15:40,1,1,2
86,2025-05-25T07:41:00+02:00,2025-05-25,15:41,2,0,2
86,2025-05-25T07:43:00+02:00,2025-05-25,15:43,1,0,1
86,2025-05-25T07:45:00+02:00,2025-05-25,15:45,0,2,2
86,2025-05-25T07:46:00+02:00,2025-05-25,15:46,1,2,3
86,2025-05-25T07:54:00+02:00,2025-05-25,15:54,0,1,1
109,2025-05-25T07:45:00+02:00,2025-05-25,15:45,2,22,24
109,2025-05-25T07:50:00+02:00,2025-05-25,15:50,8,9,17
117,2025-05-25T07:40:00+02:00,2025-05-25,15:40,14,17,31
136,2025-05-25T07:40:00+02:00,2025-05-25,15:40,16,5,21
136,2025-05-25T07:45:00+02:00,2025-05-25,15:45,17,10,27
138,2025-05-25T07:50:00+02:00,2025-05-25,15:50,2,3,5
139,2025-05-25T07:40:00+02:00,2025-05-25,15:40,6,3,9
139,2025-05-25T07:45:00+02:00,2025-05-25,15:45,3,3,6
161,2025-05-25T07:40:00+02:00,2025-05-25,15:40,43,19,62
161,2025-05-25T07:45:00+02:00,2025-05-25,15:45,15,14,29
164,2025-05-25T07:40:00+02:00,2025-05-25,15:40,4,1,5
164,2025-05-25T07:45:00+02:00,2025-05-25,15:45,8,11,19
181,2025-05-25T07:46:00+02:00,2025-05-25,15:46,14,19,33
181,2025-05-25T07:47:00+02:00,2025-05-25,15:47,16,15,31
181,2025-05-25T07:50:00+02:00,2025-05-25,15:50,21,23,44
181,2025-05-25T07:51:00+02:00,2025-05-25,15:51,11,18,29
182,2025-05-25T07:45:00+02:00,2025-05-25,15:45,11,12,23
180,2025-05-25T07:43:00+02:00,2025-05-25,15:43,0,1,1
180,2025-05-25T07:45:00+02:00,2025-05-25,15:45,0,3,3
180,2025-05-25T07:46:00+02:00,2025-05-25,15:46,0,1,1
180,2025-05-25T07:49:00+02:00,2025-05-25,15:49,2,0,2
180,2025-05-25T07:54:00+02:00,2025-05-25,15:54,4,0,4
3,2025-05-25T08:42:00+02:00,2025-05-25,16:42,9,13,22
3,2025-05-25T08:44:00+02:00,2025-05-25,16:44,14,31,45
3,2025-05-25T08:46:00+02:00,2025-05-25,16:46,11,23,34
3,2025-05-25T08:47:00+02:00,2025-05-25,16:47,22,24,46
3,2025-05-25T08:51:00+02:00,2025-05-25,16:51,11,7,18
3,2025-05-25T08:54:00+02:00,2025-05-25,16:54,14,7,21
4,2025-05-25T08:47:00+02:00,2025-05-25,16:47,39,14,53
4,2025-05-25T08:48:00+02:00,2025-05-25,16:48,18,15,33
4,2025-05-25T08:49:00+02:00,2025-05-25,16:49,37,25,62
4,2025-05-25T08:50:00+02:00,2025-05-25,16:50,29,34,63
4,2025-05-25T08:54:00+02:00,2025-05-25,16:54,26,48,74
6,2025-05-25T08:45:00+02:00,2025-05-25,16:45,18,25,43
6,2025-05-25T08:47:00+02:00,2025-05-25,16:47,6,7,13
6,2025-05-25T08:49:00+02:00,2025-05-25,16:49,17,26,43
8,2025-05-25T08:40:00+02:00,2025-05-25,16:40,4,1,5
8,2025-05-25T08:42:00+02:00,2025-05-25,16:42,8,5,13
8,2025-05-25T08:49:00+02:00,2025-05-25,16:49,3,0,3
8,2025-05-25T08:50:00+02:00,2025-05-25,16:50,6,1,7
8,2025-05-25T08:51:00+02:00,2025-05-25,16:51,1,5,6
8,2025-05-25T08:53:00+02:00,2025-05-25,16:53,7,3,10
28,2025-05-25T08:43:00+02:00,2025-05-25,16:43,9,17,26
28,2025-05-25T08:53:00+02:00,2025-05-25,16:53,9,12,21
29,2025-05-25T08:48:00+02:00,2025-05-25,16:48,14,16,30
29,2025-05-25T08:52:00+02:00,2025-05-25,16:52,10,8,18
29,2025-05-25T08:54:00+02:00,2025-05-25,16:54,14,12,26
31,2025-05-25T08:44:00+02:00,2025-05-25,16:44,6,0,6
31,2025-05-25T08:49:00+02:00,2025-05-25,16:49,5,5,10
31,2025-05-25T08:53:00+02:00,2025-05-25,16:53,4,6,10
31,2025-05-25T08:54:00+02:00,2025-05-25,16:54,0,1,1
36,2025-05-25T08:44:00+02:00,2025-05-25,16:44,0,2,2
36,2025-05-25T08:45:00+02:00,2025-05-25,16:45,1,2,3
36,2025-05-25T08:49:00+02:00,2025-05-25,16:49,0,1,1
36,2025-05-25T08:54:00+02:00,2025-05-25,16:54,2,0,2
39,2025-05-25T08:52:00+02:00,2025-05-25,16:52,1,0,1
39,2025-05-25T08:53:00+02:00,2025-05-25,16:53,1,0,1
40,2025-05-25T08:40:00+02:00,2025-05-25,16:40,3,0,3
40,2025-05-25T08:45:00+02:00,2025-05-25,16:45,0,1,1
40,2025-05-25T08:46:00+02:00,2025-05-25,16:46,0,1,1
40,2025-05-25T08:51:00+02:00,2025-05-25,16:51,1,2,3
41,2025-05-25T08:40:00+02:00,2025-05-25,16:40,5,0,5
41,2025-05-25T08:43:00+02:00,2025-05-25,16:43,17,5,22
41,2025-05-25T08:44:00+02:00,2025-05-25,16:44,14,27,41
43,2025-05-25T08:40:00+02:00,2025-05-25,16:40,4,8,12
43,2025-05-25T08:50:00+02:00,2025-05-25,16:50,12,6,18
44,2025-05-25T08:45:00+02:00,2025-05-25,16:45,6,5,11
45,2025-05-25T08:40:00+02:00,2025-05-25,16:40,16,15,31
45,2025-05-25T08:45:00+02:00,2025-05-25,16:45,15,18,33
45,2025-05-25T08:46:00+02:00,2025-05-25,16:46,23,19,42
45,2025-05-25T08:53:00+02:00,2025-05-25,16:53,14,9,23
45,2025-05-25T08:54:00+02:00,2025-05-25,16:54,24,22,46
47,2025-05-25T08:47:00+02:00,2025-05-25,16:47,16,23,39
47,2025-05-25T08:49:00+02:00,2025-05-25,16:49,19,22,41
47,2025-05-25T08:52:00+02:00,2025-05-25,16:52,19,27,46
50,2025-05-25T08:41:00+02:00,2025-05-25,16:41,1,3,4
50,2025-05-25T08:42:00+02:00,2025-05-25,16:42,3,8,11
50,2025-05-25T08:48:00+02:00,2025-05-25,16:48,4,3,7
50,2025-05-25T08:52:00+02:00,2025-05-25,16:52,1,0,1
50,2025-05-25T08:53:00+02:00,2025-05-25,16:53,8,3,11
54,2025-05-25T08:41:00+02:00,2025-05-25,16:41,1,3,4
54,2025-05-25T08:44:00+02:00,2025-05-25,16:44,6,0,6
54,2025-05-25T08:49:00+02:00,2025-05-25,16:49,1,4,5
54,2025-05-25T08:50:00+02:00,2025-05-25,16:50,1,2,3
54,2025-05-25T08:52:00+02:00,2025-05-25,16:52,3,5,8
59,2025-05-25T08:50:00+02:00,2025-05-25,16:50,20,35,55
61,2025-05-25T08:40:00+02:00,2025-05-25,16:40,7,6,13
61,2025-05-25T08:41:00+02:00,2025-05-25,16:41,7,6,13
61,2025-05-25T08:50:00+02:00,2025-05-25,16:50,10,1,11
61,2025-05-25T08:52:00+02:00,2025-05-25,16:52,8,6,14
61,2025-05-25T08:53:00+02:00,2025-05-25,16:53,12,8,20
61,2025-05-25T08:54:00+02:00,2025-05-25,16:54,9,3,12
66,2025-05-25T08:41:00+02:00,2025-05-25,16:41,23,13,36
66,2025-05-25T08:42:00+02:00,2025-05-25,16:42,32,21,53
66,2025-05-25T08:49:00+02:00,2025-05-25,16:49,36,29,65
66,2025-05-25T08:53:00+02:00,2025-05-25,16:53,19,9,28
66,2025-05-25T08:54:00+02:00,2025-05-25,16:54,18,37,55
69,2025-05-25T08:40:00+02:00,2025-05-25,16:40,0,3,3
69,2025-05-25T08:43:00+02:00,2025-05-25,16:43,3,1,4
69,2025-05-25T08:46:00+02:00,2025-05-25,16:46,8,2,10
69,2025-05-25T08:48:00+02:00,2025-05-25,16:48,1,1,2
69,2025-05-25T08:54:00+02:00,2025-05-25,16:54,4,1,5
70,2025-05-25T08:41:00+02:00,2025-05-25,16:41,0,1,1
70,2025-05-25T08:42:00+02:00,2025-05-25,16:42,0,1,1
70,2025-05-25T08:44:00+02:00,2025-05-25,16:44,2,6,8
70,2025-05-25T08:46:00+02:00,2025-05-25,16:46,2,3,5
70,2025-05-25T08:51:00+02:00,2025-05-25,16:51,0,3,3
70,2025-05-25T08:53:00+02:00,2025-05-25,16:53,4,5,9
75,2025-05-25T08:42:00+02:00,2025-05-25,16:42,0,2,2
75,2025-05-25T08:44:00+02:00,2025-05-25,16:44,0,1,1
75,2025-05-25T08:45:00+02:00,2025-05-25,16:45,1,0,1
75,2025-05-25T08:51:00+02:00,2025-05-25,16:51,1,0,1
77,2025-05-25T08:40:00+02:00,2025-05-25,16:40,23,45,68
77,2025-05-25T08:45:00+02:00,2025-05-25,16:45,18,25,43
78,2025-05-25T08:45:00+02:00,2025-05-25,16:45,0,4,4
78,2025-05-25T08:49:00+02:00,2025-05-25,16:49,0,1,1
78,2025-05-25T08:52:00+02:00,2025-05-25,16:52,0,3,3
78,2025-05-25T08:53:00+02:00,2025-05-25,16:53,0,1,1
84,2025-05-25T08:40:00+02:00,2025-05-25,16:40,101,113,214
84,2025-05-25T08:50:00+02:00,2025-05-25,16:50,79,108,187
87,2025-05-25T08:40:00+02:00,2025-05-25,16:40,0,3,3
87,2025-05-25T08:43:00+02:00,2025-05-25,16:43,0,3,3
87,2025-05-25T08:44:00+02:00,2025-05-25,16:44,1,1,2
87,2025-05-25T08:45:00+02:00,2025-05-25,16:45,5,1,6
87,2025-05-25T08:46:00+02:00,2025-05-25,16:46,1,1,2
87,2025-05-25T08:51:00+02:00,2025-05-25,16:51,3,0,3
107,2025-05-25T08:40:00+02:00,2025-05-25,16:40,6,6,12
108,2025-05-25T08:42:00+02:00,2025-05-25,16:42,9,4,13
108,2025-05-25T08:46:00+02:00,2025-05-25,16:46,7,2,9
108,2025-05-25T08:50:00+02:00,2025-05-25,16:50,4,2,6
108,2025-05-25T08:51:00+02:00,2025-05-25,16:51,1,4,5
108,2025-05-25T08:53:00+02:00,2025-05-25,16:53,3,0,3
108,2025-05-25T08:54:00+02:00,2025-05-25,16:54,1,6,7
118,2025-05-25T08:45:00+02:00,2025-05-25,16:45,0,2,2
131,2025-05-25T08:50:00+02:00,2025-05-25,16:50,4,6,10
132,2025-05-25T08:40:00+02:00,2025-05-25,16:40,14,6,20
133,2025-05-25T08:40:00+02:00,2025-05-25,16:40,57,36,93
134,2025-05-25T08:45:00+02:00,2025-05-25,16:45,37,32,69
134,2025-05-25T08:50:00+02:00,2025-05-25,16:50,41,16,57
135,2025-05-25T08:40:00+02:00,2025-05-25,16:40,39,28,67
135,2025-05-25T08:45:00+02:00,2025-05-25,16:45,32,31,63
162,2025-05-25T08:40:00+02:00,2025-05-25,16:40,12,38,50
162,2025-05-25T08:45:00+02:00,2025-05-25,16:45,27,34,61
162,2025-05-25T08:50:00+02:00,2025-05-25,16:50,34,28,62
166,2025-05-25T08:40:00+02:00,2025-05-25,16:40,7,9,16
166,2025-05-25T08:50:00+02:00,2025-05-25,16:50,12,6,18
167,2025-05-25T08:40:00+02:00,2025-05-25,16:40,5,5,10
167,2025-05-25T08:50:00+02:00,2025-05-25,16:50,5,11,16
179,2025-05-25T08:45:00+02:00,2025-05-25,16:45,2,5,7
179,2025-05-25T08:50:00+02:00,2025-05-25,16:50,6,5,11
1,2025-05-25T08:40:00+02:00,2025-05-25,16:40,21,20,41
1,2025-05-25T08:43:00+02:00,2025-05-25,16:43,25,19,44
1,2025-05-25T08:46:00+02:00,2025-05-25,16:46,25,14,39
1,2025-05-25T08:49:00+02:00,2025-05-25,16:49,16,15,31
1,2025-05-25T08:52:00+02:00,2025-05-25,16:52,13,26,39
2,2025-05-25T08:40:00+02:00,2025-05-25,16:40,9,11,20
2,2025-05-25T08:44:00+02:00,2025-05-25,16:44,13,8,21
2,2025-05-25T08:48:00+02:00,2025-05-25,16:48,18,11,29
2,2025-05-25T08:50:00+02:00,2025-05-25,16:50,17,3,20
2,2025-05-25T08:51:00+02:00,2025-05-25,16:51,15,11,26
2,2025-05-25T08:54:00+02:00,2025-05-25,16:54,13,9,22
9,2025-05-25T08:47:00+02:00,2025-05-25,16:47,3,0,3
9,2025-05-25T08:54:00+02:00,2025-05-25,16:54,0,2,2
10,2025-05-25T08:40:00+02:00,2025-05-25,16:40,2,0,2
10,2025-05-25T08:47:00+02:00,2025-05-25,16:47,3,0,3
10,2025-05-25T08:52:00+02:00,2025-05-25,16:52,0,1,1
11,2025-05-25T08:41:00+02:00,2025-05-25,16:41,1,6,7
11,2025-05-25T08:42:00+02:00,2025-05-25,16:42,2,1,3
11,2025-05-25T08:44:00+02:00,2025-05-25,16:44,1,0,1
11,2025-05-25T08:46:00+02:00,2025-05-25,16:46,1,3,4
11,2025-05-25T08:49:00+02:00,2025-05-25,16:49,1,1,2
12,2025-05-25T08:41:00+02:00,2025-05-25,16:41,4,2,6
12,2025-05-25T08:42:00+02:00,2025-05-25,16:42,20,8,28
12,2025-05-25T08:43:00+02:00,2025-05-25,16:43,3,6,9
12,2025-05-25T08:44:00+02:00,2025-05-25,16:44,17,7,24
12,2025-05-25T08:51:00+02:00,2025-05-25,16:51,14,5,19
17,2025-05-25T08:40:00+02:00,2025-05-25,16:40,3,0,3
17,2025-05-25T08:43:00+02:00,2025-05-25,16:43,1,2,3
17,2025-05-25T08:46:00+02:00,2025-05-25,16:46,5,0,5
17,2025-05-25T08:48:00+02:00,2025-05-25,16:48,0,1,1
17,2025-05-25T08:53:00+02:00,2025-05-25,16:53,5,1,6
18,2025-05-25T08:42:00+02:00,2025-05-25,16:42,1,1,2
18,2025-05-25T08:43:00+02:00,2025-05-25,16:43,1,4,5
18,2025-05-25T08:44:00+02:00,2025-05-25,16:44,2,1,3
18,2025-05-25T08:45:00+02:00,2025-05-25,16:45,0,3,3
18,2025-05-25T08:48:00+02:00,2025-05-25,16:48,2,2,4
18,2025-05-25T08:49:00+02:00,2025-05-25,16:49,0,2,2
18,2025-05-25T08:50:00+02:00,2025-05-25,16:50,2,0,2
18,2025-05-25T08:52:00+02:00,2025-05-25,16:52,2,0,2
19,2025-05-25T08:40:00+02:00,2025-05-25,16:40,4,11,15
19,2025-05-25T08:42:00+02:00,2025-05-25,16:42,10,9,19
19,2025-05-25T08:43:00+02:00,2025-05-25,16:43,10,6,16
19,2025-05-25T08:46:00+02:00,2025-05-25,16:46,13,8,21
19,2025-05-25T08:51:00+02:00,2025-05-25,16:51,15,6,21
20,2025-05-25T08:41:00+02:00,2025-05-25,16:41,10,3,13
20,2025-05-25T08:44:00+02:00,2025-05-25,16:44,0,3,3
20,2025-05-25T08:47:00+02:00,2025-05-25,16:47,1,4,5
20,2025-05-25T08:49:00+02:00,2025-05-25,16:49,4,5,9
20,2025-05-25T08:50:00+02:00,2025-05-25,16:50,1,6,7
23,2025-05-25T08:42:00+02:00,2025-05-25,16:42,0,1,1
23,2025-05-25T08:44:00+02:00,2025-05-25,16:44,1,5,6
23,2025-05-25T08:47:00+02:00,2025-05-25,16:47,0,9,9
23,2025-05-25T08:52:00+02:00,2025-05-25,16:52,1,3,4
24,2025-05-25T08:42:00+02:00,2025-05-25,16:42,7,24,31
24,2025-05-25T08:43:00+02:00,2025-05-25,16:43,9,12,21
24,2025-05-25T08:45:00+02:00,2025-05-25,16:45,0,18,18
24,2025-05-25T08:50:00+02:00,2025-05-25,16:50,2,17,19
24,2025-05-25T08:53:00+02:00,2025-05-25,16:53,6,2,8
24,2025-05-25T08:54:00+02:00,2025-05-25,16:54,17,4,21
25,2025-05-25T08:50:00+02:00,2025-05-25,16:50,100,66,166
27,2025-05-25T08:40:00+02:00,2025-05-25,16:40,7,2,9
27,2025-05-25T08:42:00+02:00,2025-05-25,16:42,0,1,1
27,2025-05-25T08:43:00+02:00,2025-05-25,16:43,3,1,4
27,2025-05-25T08:46:00+02:00,2025-05-25,16:46,1,0,1
27,2025-05-25T08:52:00+02:00,2025-05-25,16:52,3,0,3
27,2025-05-25T08:54:00+02:00,2025-05-25,16:54,2,2,4
30,2025-05-25T08:44:00+02:00,2025-05-25,16:44,6,5,11
30,2025-05-25T08:45:00+02:00,2025-05-25,16:45,2,8,10
30,2025-05-25T08:46:00+02:00,2025-05-25,16:46,1,7,8
30,2025-05-25T08:49:00+02:00,2025-05-25,16:49,9,5,14
30,2025-05-25T08:51:00+02:00,2025-05-25,16:51,5,2,7
30,2025-05-25T08:52:00+02:00,2025-05-25,16:52,1,5,6
30,2025-05-25T08:54:00+02:00,2025-05-25,16:54,6,9,15
35,2025-05-25T08:41:00+02:00,2025-05-25,16:41,21,23,44
35,2025-05-25T08:45:00+02:00,2025-05-25,16:45,16,16,32
35,2025-05-25T08:47:00+02:00,2025-05-25,16:47,22,34,56
35,2025-05-25T08:50:00+02:00,2025-05-25,16:50,28,22,50
35,2025-05-25T08:51:00+02:00,2025-05-25,16:51,24,25,49
35,2025-05-25T08:53:00+02:00,2025-05-25,16:53,17,30,47
46,2025-05-25T08:40:00+02:00,2025-05-25,16:40,0,8,8
46,2025-05-25T08:45:00+02:00,2025-05-25,16:45,5,7,12
46,2025-05-25T08:50:00+02:00,2025-05-25,16:50,2,4,6
48,2025-05-25T08:42:00+02:00,2025-05-25,16:42,4,2,6
48,2025-05-25T08:43:00+02:00,2025-05-25,16:43,9,0,9
48,2025-05-25T08:45:00+02:00,2025-05-25,16:45,0,3,3
48,2025-05-25T08:52:00+02:00,2025-05-25,16:52,5,3,8
48,2025-05-25T08:53:00+02:00,2025-05-25,16:53,13,1,14
49,2025-05-25T08:40:00+02:00,2025-05-25,16:40,5,0,5
49,2025-05-25T08:45:00+02:00,2025-05-25,16:45,4,2,6
49,2025-05-25T08:46:00+02:00,2025-05-25,16:46,2,1,3
51,2025-05-25T08:41:00+02:00,2025-05-25,16:41,0,1,1
51,2025-05-25T08:46:00+02:00,2025-05-25,16:46,5,3,8
51,2025-05-25T08:49:00+02:00,2025-05-25,16:49,1,3,4
51,2025-05-25T08:50:00+02:00,2025-05-25,16:50,2,1,3
52,2025-05-25T08:40:00+02:00,2025-05-25,16:40,4,3,7
52,2025-05-25T08:43:00+02:00,2025-05-25,16:43,0,6,6
52,2025-05-25T08:44:00+02:00,2025-05-25,16:44,9,2,11
52,2025-05-25T08:45:00+02:00,2025-05-25,16:45,7,14,21
52,2025-05-25T08:46:00+02:00,2025-05-25,16:46,2,11,13
52,2025-05-25T08:47:00+02:00,2025-05-25,16:47,4,12,16
52,2025-05-25T08:51:00+02:00,2025-05-25,16:51,9,9,18
52,2025-05-25T08:52:00+02:00,2025-05-25,16:52,4,9,13
53,2025-05-25T08:40:00+02:00,2025-05-25,16:40,6,4,10
53,2025-05-25T08:42:00+02:00,2025-05-25,16:42,2,7,9
53,2025-05-25T08:44:00+02:00,2025-05-25,16:44,7,0,7
53,2025-05-25T08:45:00+02:00,2025-05-25,16:45,8,5,13
53,2025-05-25T08:46:00+02:00,2025-05-25,16:46,14,5,19
53,2025-05-25T08:48:00+02:00,2025-05-25,16:48,10,2,12
53,2025-05-25T08:50:00+02:00,2025-05-25,16:50,6,3,9
53,2025-05-25T08:53:00+02:00,2025-05-25,16:53,14,2,16
56,2025-05-25T08:46:00+02:00,2025-05-25,16:46,4,8,12
56,2025-05-25T08:47:00+02:00,2025-05-25,16:47,3,4,7
56,2025-05-25T08:48:00+02:00,2025-05-25,16:48,12,9,21
56,2025-05-25T08:52:00+02:00,2025-05-25,16:52,10,6,16
56,2025-05-25T08:53:00+02:00,2025-05-25,16:53,4,15,19
58,2025-05-25T08:44:00+02:00,2025-05-25,16:44,10,7,17
58,2025-05-25T08:48:00+02:00,2025-05-25,16:48,7,12,19
58,2025-05-25T08:51:00+02:00,2025-05-25,16:51,12,3,15
58,2025-05-25T08:52:00+02:00,2025-05-25,16:52,3,3,6
58,2025-05-25T08:53:00+02:00,2025-05-25,16:53,6,8,14
62,2025-05-25T08:40:00+02:00,2025-05-25,16:40,4,0,4
62,2025-05-25T08:42:00+02:00,2025-05-25,16:42,7,2,9
62,2025-05-25T08:45:00+02:00,2025-05-25,16:45,8,0,8
62,2025-05-25T08:48:00+02:00,2025-05-25,16:48,3,3,6
62,2025-05-25T08:50:00+02:00,2025-05-25,16:50,3,4,7
62,2025-05-25T08:52:00+02:00,2025-05-25,16:52,1,1,2
62,2025-05-25T08:53:00+02:00,2025-05-25,16:53,2,7,9
63,2025-05-25T08:41:00+02:00,2025-05-25,16:41,5,7,12
63,2025-05-25T08:44:00+02:00,2025-05-25,16:44,5,2,7
63,2025-05-25T08:46:00+02:00,2025-05-25,16:46,9,6,15
63,2025-05-25T08:49:00+02:00,2025-05-25,16:49,2,10,12
63,2025-05-25T08:51:00+02:00,2025-05-25,16:51,12,1,13
63,2025-05-25T08:52:00+02:00,2025-05-25,16:52,6,7,13
67,2025-05-25T08:40:00+02:00,2025-05-25,16:40,2,11,13
67,2025-05-25T08:42:00+02:00,2025-05-25,16:42,1,5,6
67,2025-05-25T08:44:00+02:00,2025-05-25,16:44,2,11,13
67,2025-05-25T08:47:00+02:00,2025-05-25,16:47,8,3,11
67,2025-05-25T08:52:00+02:00,2025-05-25,16:52,4,11,15
68,2025-05-25T08:41:00+02:00,2025-05-25,16:41,6,3,9
68,2025-05-25T08:43:00+02:00,2025-05-25,16:43,4,0,4
68,2025-05-25T08:46:00+02:00,2025-05-25,16:46,3,5,8
68,2025-05-25T08:54:00+02:00,2025-05-25,16:54,2,6,8
72,2025-05-25T08:40:00+02:00,2025-05-25,16:40,16,11,27
72,2025-05-25T08:42:00+02:00,2025-05-25,16:42,2,6,8
72,2025-05-25T08:47:00+02:00,2025-05-25,16:47,11,6,17
72,2025-05-25T08:48:00+02:00,2025-05-25,16:48,4,6,10
76,2025-05-25T08:53:00+02:00,2025-05-25,16:53,0,4,4
79,2025-05-25T08:40:00+02:00,2025-05-25,16:40,16,10,26
79,2025-05-25T08:43:00+02:00,2025-05-25,16:43,10,8,18
79,2025-05-25T08:46:00+02:00,2025-05-25,16:46,6,6,12
79,2025-05-25T08:49:00+02:00,2025-05-25,16:49,20,7,27
79,2025-05-25T08:54:00+02:00,2025-05-25,16:54,26,7,33
85,2025-05-25T08:44:00+02:00,2025-05-25,16:44,0,4,4
85,2025-05-25T08:48:00+02:00,2025-05-25,16:48,1,2,3
85,2025-05-25T08:49:00+02:00,2025-05-25,16:49,0,1,1
85,2025-05-25T08:51:00+02:00,2025-05-25,16:51,1,1,2
85,2025-05-25T08:53:00+02:00,2025-05-25,16:53,1,9,10
86,2025-05-25T08:42:00+02:00,2025-05-25,16:42,0,1,1
86,2025-05-25T08:48:00+02:00,2025-05-25,16:48,1,1,2
86,2025-05-25T08:52:00+02:00,2025-05-25,16:52,2,1,3
86,2025-05-25T08:53:00+02:00,2025-05-25,16:53,0,3,3
117,2025-05-25T08:45:00+02:00,2025-05-25,16:45,9,13,22
123,2025-05-25T08:40:00+02:00,2025-05-25,16:40,8,4,12
123,2025-05-25T08:50:00+02:00,2025-05-25,16:50,2,4,6
130,2025-05-25T08:45:00+02:00,2025-05-25,16:45,2,3,5
137,2025-05-25T08:40:00+02:00,2025-05-25,16:40,0,2,2
138,2025-05-25T08:45:00+02:00,2025-05-25,16:45,2,2,4
139,2025-05-25T08:45:00+02:00,2025-05-25,16:45,14,5,19
141,2025-05-25T08:50:00+02:00,2025-05-25,16:50,16,5,21
142,2025-05-25T08:40:00+02:00,2025-05-25,16:40,46,57,103
161,2025-05-25T08:40:00+02:00,2025-05-25,16:40,31,27,58
161,2025-05-25T08:50:00+02:00,2025-05-25,16:50,34,17,51
3,2025-05-25T08:58:00+02:00,2025-05-25,16:58,38,17,55
3,2025-05-25T08:59:00+02:00,2025-05-25,16:59,17,20,37
3,2025-05-25T09:00:00+02:00,2025-05-25,17:00,8,15,23
3,2025-05-25T09:02:00+02:00,2025-05-25,17:02,26,21,47
3,2025-05-25T09:04:00+02:00,2025-05-25,17:04,32,32,64
4,2025-05-25T08:55:00+02:00,2025-05-25,16:55,28,30,58
4,2025-05-25T08:57:00+02:00,2025-05-25,16:57,38,27,65
4,2025-05-25T09:00:00+02:00,2025-05-25,17:00,29,34,63
4,2025-05-25T09:01:00+02:00,2025-05-25,17:01,23,38,61
4,2025-05-25T09:08:00+02:00,2025-05-25,17:08,27,16,43
4,2025-05-25T09:09:00+02:00,2025-05-25,17:09,34,34,68
5,2025-05-25T08:55:00+02:00,2025-05-25,16:55,102,65,167
6,2025-05-25T09:01:00+02:00,2025-05-25,17:01,13,16,29
6,2025-05-25T09:04:00+02:00,2025-05-25,17:04,9,11,20
6,2025-05-25T09:07:00+02:00,2025-05-25,17:07,18,7,25
8,2025-05-25T08:56:00+02:00,2025-05-25,16:56,0,6,6
8,2025-05-25T09:01:00+02:00,2025-05-25,17:01,4,0,4
8,2025-05-25T09:03:00+02:00,2025-05-25,17:03,4,6,10
8,2025-05-25T09:07:00+02:00,2025-05-25,17:07,6,2,8
8,2025-05-25T09:09:00+02:00,2025-05-25,17:09,10,3,13
28,2025-05-25T08:59:00+02:00,2025-05-25,16:59,9,24,33
28,2025-05-25T09:01:00+02:00,2025-05-25,17:01,6,16,22
28,2025-05-25T09:09:00+02:00,2025-05-25,17:09,14,4,18
29,2025-05-25T08:58:00+02:00,2025-05-25,16:58,9,12,21
29,2025-05-25T09:00:00+02:00,2025-05-25,17:00,21,11,32
29,2025-05-25T09:03:00+02:00,2025-05-25,17:03,12,9,21
29,2025-05-25T09:07:00+02:00,2025-05-25,17:07,2,15,17
31,2025-05-25T08:56:00+02:00,2025-05-25,16:56,0,4,4
31,2025-05-25T08:57:00+02:00,2025-05-25,16:57,10,8,18
31,2025-05-25T09:00:00+02:00,2025-05-25,17:00,2,6,8
31,2025-05-25T09:07:00+02:00,2025-05-25,17:07,5,2,7
31,2025-05-25T09:08:00+02:00,2025-05-25,17:08,1,3,4
31,2025-05-25T09:09:00+02:00,2025-05-25,17:09,3,3,6
36,2025-05-25T08:55:00+02:00,2025-05-25,16:55,1,2,3
36,2025-05-25T08:58:00+02:00,2025-05-25,16:58,3,1,4
36,2025-05-25T09:02:00+02:00,2025-05-25,17:02,5,0,5
39,2025-05-25T08:55:00+02:00,2025-05-25,16:55,1,0,1
40,2025-05-25T08:57:00+02:00,2025-05-25,16:57,1,2,3
40,2025-05-25T08:59:00+02:00,2025-05-25,16:59,1,4,5
40,2025-05-25T09:01:00+02:00,2025-05-25,17:01,1,2,3
40,2025-05-25T09:02:00+02:00,2025-05-25,17:02,4,3,7
41,2025-05-25T09:03:00+02:00,2025-05-25,17:03,4,2,6
41,2025-05-25T09:05:00+02:00,2025-05-25,17:05,15,1,16
41,2025-05-25T09:07:00+02:00,2025-05-25,17:07,13,2,15
41,2025-05-25T09:09:00+02:00,2025-05-25,17:09,2,1,3
43,2025-05-25T09:05:00+02:00,2025-05-25,17:05,11,19,30
44,2025-05-25T09:05:00+02:00,2025-05-25,17:05,8,20,28
45,2025-05-25T08:55:00+02:00,2025-05-25,16:55,14,28,42
45,2025-05-25T09:01:00+02:00,2025-05-25,17:01,26,17,43
45,2025-05-25T09:08:00+02:00,2025-05-25,17:08,22,27,49
47,2025-05-25T08:55:00+02:00,2025-05-25,16:55,11,24,35
47,2025-05-25T08:58:00+02:00,2025-05-25,16:58,6,22,28
47,2025-05-25T09:00:00+02:00,2025-05-25,17:00,11,9,20
47,2025-05-25T09:03:00+02:00,2025-05-25,17:03,15,5,20
47,2025-05-25T09:04:00+02:00,2025-05-25,17:04,12,12,24
47,2025-05-25T09:06:00+02:00,2025-05-25,17:06,9,9,18
47,2025-05-25T09:08:00+02:00,2025-05-25,17:08,19,17,36
50,2025-05-25T08:57:00+02:00,2025-05-25,16:57,4,1,5
50,2025-05-25T09:01:00+02:00,2025-05-25,17:01,5,2,7
50,2025-05-25T09:08:00+02:00,2025-05-25,17:08,1,3,4
50,2025-05-25T09:09:00+02:00,2025-05-25,17:09,7,3,10
54,2025-05-25T08:56:00+02:00,2025-05-25,16:56,1,3,4
54,2025-05-25T08:57:00+02:00,2025-05-25,16:57,0,6,6
54,2025-05-25T08:58:00+02:00,2025-05-25,16:58,6,8,14
54,2025-05-25T09:02:00+02:00,2025-05-25,17:02,3,4,7
54,2025-05-25T09:04:00+02:00,2025-05-25,17:04,1,5,6
54,2025-05-25T09:07:00+02:00,2025-05-25,17:07,1,2,3
54,2025-05-25T09:08:00+02:00,2025-05-25,17:08,3,0,3
54,2025-05-25T09:09:00+02:00,2025-05-25,17:09,2,1,3
61,2025-05-25T08:55:00+02:00,2025-05-25,16:55,1,8,9
61,2025-05-25T09:03:00+02:00,2025-05-25,17:03,6,12,18
61,2025-05-25T09:08:00+02:00,2025-05-25,17:08,6,7,13
66,2025-05-25T08:59:00+02:00,2025-05-25,16:59,25,18,43
66,2025-05-25T09:00:00+02:00,2025-05-25,17:00,38,26,64
66,2025-05-25T09:04:00+02:00,2025-05-25,17:04,28,23,51
66,2025-05-25T09:06:00+02:00,2025-05-25,17:06,25,48,73
66,2025-05-25T09:09:00+02:00,2025-05-25,17:09,20,47,67
69,2025-05-25T09:03:00+02:00,2025-05-25,17:03,0,1,1
69,2025-05-25T09:06:00+02:00,2025-05-25,17:06,1,0,1
70,2025-05-25T08:56:00+02:00,2025-05-25,16:56,3,4,7
70,2025-05-25T08:58:00+02:00,2025-05-25,16:58,2,1,3
70,2025-05-25T09:00:00+02:00,2025-05-25,17:00,3,1,4
70,2025-05-25T09:04:00+02:00,2025-05-25,17:04,0,2,2
75,2025-05-25T09:00:00+02:00,2025-05-25,17:00,2,1,3
75,2025-05-25T09:01:00+02:00,2025-05-25,17:01,1,1,2
75,2025-05-25T09:05:00+02:00,2025-05-25,17:05,0,2,2
75,2025-05-25T09:07:00+02:00,2025-05-25,17:07,2,0,2
75,2025-05-25T09:08:00+02:00,2025-05-25,17:08,0,2,2
77,2025-05-25T09:00:00+02:00,2025-05-25,17:00,12,14,26
77,2025-05-25T09:05:00+02:00,2025-05-25,17:05,14,15,29
78,2025-05-25T08:59:00+02:00,2025-05-25,16:59,0,3,3
78,2025-05-25T09:01:00+02:00,2025-05-25,17:01,0,1,1
78,2025-05-25T09:04:00+02:00,2025-05-25,17:04,0,2,2
84,2025-05-25T09:00:00+02:00,2025-05-25,17:00,75,85,160
84,2025-05-25T09:05:00+02:00,2025-05-25,17:05,101,95,196
87,2025-05-25T08:55:00+02:00,2025-05-25,16:55,2,0,2
87,2025-05-25T08:56:00+02:00,2025-05-25,16:56,2,1,3
87,2025-05-25T09:02:00+02:00,2025-05-25,17:02,1,1,2
87,2025-05-25T09:08:00+02:00,2025-05-25,17:08,3,0,3
107,2025-05-25T08:55:00+02:00,2025-05-25,16:55,7,10,17
108,2025-05-25T08:57:00+02:00,2025-05-25,16:57,3,3,6
108,2025-05-25T09:03:00+02:00,2025-05-25,17:03,2,4,6
108,2025-05-25T09:07:00+02:00,2025-05-25,17:07,1,1,2
131,2025-05-25T08:55:00+02:00,2025-05-25,16:55,27,5,32
131,2025-05-25T09:00:00+02:00,2025-05-25,17:00,15,3,18
131,2025-05-25T09:05:00+02:00,2025-05-25,17:05,5,3,8
132,2025-05-25T08:55:00+02:00,2025-05-25,16:55,10,14,24
133,2025-05-25T08:55:00+02:00,2025-05-25,16:55,49,49,98
133,2025-05-25T09:00:00+02:00,2025-05-25,17:00,47,32,79
135,2025-05-25T08:55:00+02:00,2025-05-25,16:55,27,18,45
162,2025-05-25T09:00:00+02:00,2025-05-25,17:00,24,20,44
162,2025-05-25T09:05:00+02:00,2025-05-25,17:05,13,14,27
167,2025-05-25T09:05:00+02:00,2025-05-25,17:05,7,7,14
179,2025-05-25T08:55:00+02:00,2025-05-25,16:55,6,1,7
179,2025-05-25T09:00:00+02:00,2025-05-25,17:00,3,8,11
1,2025-05-25T08:59:00+02:00,2025-05-25,16:59,20,15,35
1,2025-05-25T09:00:00+02:00,2025-05-25,17:00,22,18,40
1,2025-05-25T09:01:00+02:00,2025-05-25,17:01,35,20,55
1,2025-05-25T09:02:00+02:00,2025-05-25,17:02,26,10,36
1,2025-05-25T09:03:00+02:00,2025-05-25,17:03,30,17,47
2,2025-05-25T09:03:00+02:00,2025-05-25,17:03,12,10,22
2,2025-05-25T09:06:00+02:00,2025-05-25,17:06,17,16,33
2,2025-05-25T09:08:00+02:00,2025-05-25,17:08,7,4,11
9,2025-05-25T08:55:00+02:00,2025-05-25,16:55,1,1,2
9,2025-05-25T08:59:00+02:00,2025-05-25,16:59,0,2,2
9,2025-05-25T09:02:00+02:00,2025-05-25,17:02,3,10,13
9,2025-05-25T09:05:00+02:00,2025-05-25,17:05,0,4,4
9,2025-05-25T09:07:00+02:00,2025-05-25,17:07,1,0,1
9,2025-05-25T09:09:00+02:00,2025-05-25,17:09,0,2,2
10,2025-05-25T08:58:00+02:00,2025-05-25,16:58,3,0,3
10,2025-05-25T09:01:00+02:00,2025-05-25,17:01,2,0,2
10,2025-05-25T09:03:00+02:00,2025-05-25,17:03,4,0,4
10,2025-05-25T09:05:00+02:00,2025-05-25,17:05,7,1,8
10,2025-05-25T09:07:00+02:00,2025-05-25,17:07,0,1,1
10,2025-05-25T09:08:00+02:00,2025-05-25,17:08,3,1,4
10,2025-05-25T09:09:00+02:00,2025-05-25,17:09,1,0,1
11,2025-05-25T08:56:00+02:00,2025-05-25,16:56,2,1,3
11,2025-05-25T09:00:00+02:00,2025-05-25,17:00,8,4,12
12,2025-05-25T08:59:00+02:00,2025-05-25,16:59,5,1,6
12,2025-05-25T09:00:00+02:00,2025-05-25,17:00,3,8,11
12,2025-05-25T09:04:00+02:00,2025-05-25,17:04,7,2,9
12,2025-05-25T09:05:00+02:00,2025-05-25,17:05,7,5,12
12,2025-05-25T09:08:00+02:00,2025-05-25,17:08,4,2,6
17,2025-05-25T09:01:00+02:00,2025-05-25,17:01,0,1,1
17,2025-05-25T09:07:00+02:00,2025-05-25,17:07,1,1,2
17,2025-05-25T09:09:00+02:00,2025-05-25,17:09,4,0,4
18,2025-05-25T08:57:00+02:00,2025-05-25,16:57,0,1,1
18,2025-05-25T09:05:00+02:00,2025-05-25,17:05,2,0,2
18,2025-05-25T09:06:00+02:00,2025-05-25,17:06,1,0,1
18,2025-05-25T09:09:00+02:00,2025-05-25,17:09,1,0,1
19,2025-05-25T08:59:00+02:00,2025-05-25,16:59,4,9,13
19,2025-05-25T09:00:00+02:00,2025-05-25,17:00,25,5,30
19,2025-05-25T09:01:00+02:00,2025-05-25,17:01,10,8,18
19,2025-05-25T09:05:00+02:00,2025-05-25,17:05,17,2,19
19,2025-05-25T09:09:00+02:00,2025-05-25,17:09,14,4,18
20,2025-05-25T08:55:00+02:00,2025-05-25,16:55,7,3,10
20,2025-05-25T08:56:00+02:00,2025-05-25,16:56,0,1,1
20,2025-05-25T08:58:00+02:00,2025-05-25,16:58,3,9,12
20,2025-05-25T08:59:00+02:00,2025-05-25,16:59,2,2,4
20,2025-05-25T09:00:00+02:00,2025-05-25,17:00,6,3,9
20,2025-05-25T09:03:00+02:00,2025-05-25,17:03,8,4,12
23,2025-05-25T08:55:00+02:00,2025-05-25,16:55,0,4,4
23,2025-05-25T08:59:00+02:00,2025-05-25,16:59,0,5,5
23,2025-05-25T09:01:00+02:00,2025-05-25,17:01,6,0,6
23,2025-05-25T09:03:00+02:00,2025-05-25,17:03,0,4,4
23,2025-05-25T09:05:00+02:00,2025-05-25,17:05,2,7,9
23,2025-05-25T09:07:00+02:00,2025-05-25,17:07,2,12,14
23,2025-05-25T09:09:00+02:00,2025-05-25,17:09,1,3,4
24,2025-05-25T08:56:00+02:00,2025-05-25,16:56,5,17,22
24,2025-05-25T08:58:00+02:00,2025-05-25,16:58,0,9,9
24,2025-05-25T09:06:00+02:00,2025-05-25,17:06,4,13,17
24,2025-05-25T09:07:00+02:00,2025-05-25,17:07,4,8,12
25,2025-05-25T08:55:00+02:00,2025-05-25,16:55,73,40,113
25,2025-05-25T09:00:00+02:00,2025-05-25,17:00,76,36,112
27,2025-05-25T08:55:00+02:00,2025-05-25,16:55,3,1,4
27,2025-05-25T09:00:00+02:00,2025-05-25,17:00,2,0,2
27,2025-05-25T09:02:00+02:00,2025-05-25,17:02,7,2,9
27,2025-05-25T09:03:00+02:00,2025-05-25,17:03,0,1,1
27,2025-05-25T09:08:00+02:00,2025-05-25,17:08,0,5,5
30,2025-05-25T09:01:00+02:00,2025-05-25,17:01,0,8,8
30,2025-05-25T09:03:00+02:00,2025-05-25,17:03,14,7,21
30,2025-05-25T09:05:00+02:00,2025-05-25,17:05,4,2,6
30,2025-05-25T09:07:00+02:00,2025-05-25,17:07,4,5,9
35,2025-05-25T08:55:00+02:00,2025-05-25,16:55,16,24,40
35,2025-05-25T08:58:00+02:00,2025-05-25,16:58,11,26,37
35,2025-05-25T09:01:00+02:00,2025-05-25,17:01,18,31,49
35,2025-05-25T09:03:00+02:00,2025-05-25,17:03,23,14,37
46,2025-05-25T08:55:00+02:00,2025-05-25,16:55,3,2,5
48,2025-05-25T08:58:00+02:00,2025-05-25,16:58,2,6,8
48,2025-05-25T08:59:00+02:00,2025-05-25,16:59,6,1,7
48,2025-05-25T09:00:00+02:00,2025-05-25,17:00,1,1,2
48,2025-05-25T09:01:00+02:00,2025-05-25,17:01,1,4,5
48,2025-05-25T09:02:00+02:00,2025-05-25,17:02,4,1,5
48,2025-05-25T09:03:00+02:00,2025-05-25,17:03,1,0,1
48,2025-05-25T09:04:00+02:00,2025-05-25,17:04,0,2,2
48,2025-05-25T09:08:00+02:00,2025-05-25,17:08,11,0,11
49,2025-05-25T08:55:00+02:00,2025-05-25,16:55,5,6,11
51,2025-05-25T08:55:00+02:00,2025-05-25,16:55,3,0,3
51,2025-05-25T08:56:00+02:00,2025-05-25,16:56,0,1,1
51,2025-05-25T08:58:00+02:00,2025-05-25,16:58,1,5,6
51,2025-05-25T09:00:00+02:00,2025-05-25,17:00,2,3,5
51,2025-05-25T09:01:00+02:00,2025-05-25,17:01,5,0,5
51,2025-05-25T09:02:00+02:00,2025-05-25,17:02,3,0,3
51,2025-05-25T09:05:00+02:00,2025-05-25,17:05,1,1,2
52,2025-05-25T08:55:00+02:00,2025-05-25,16:55,3,11,14
52,2025-05-25T08:57:00+02:00,2025-05-25,16:57,2,9,11
52,2025-05-25T08:58:00+02:00,2025-05-25,16:58,3,4,7
52,2025-05-25T09:01:00+02:00,2025-05-25,17:01,4,6,10
52,2025-05-25T09:03:00+02:00,2025-05-25,17:03,3,7,10
52,2025-05-25T09:04:00+02:00,2025-05-25,17:04,11,5,16
52,2025-05-25T09:07:00+02:00,2025-05-25,17:07,7,11,18
52,2025-05-25T09:09:00+02:00,2025-05-25,17:09,11,6,17
53,2025-05-25T08:55:00+02:00,2025-05-25,16:55,4,6,10
56,2025-05-25T08:55:00+02:00,2025-05-25,16:55,5,8,13
56,2025-05-25T09:05:00+02:00,2025-05-25,17:05,2,12,14
56,2025-05-25T09:08:00+02:00,2025-05-25,17:08,3,7,10
58,2025-05-25T08:55:00+02:00,2025-05-25,16:55,9,13,22
58,2025-05-25T08:56:00+02:00,2025-05-25,16:56,9,8,17
58,2025-05-25T08:58:00+02:00,2025-05-25,16:58,2,2,4
58,2025-05-25T09:00:00+02:00,2025-05-25,17:00,6,11,17
58,2025-05-25T09:06:00+02:00,2025-05-25,17:06,14,1,15
58,2025-05-25T09:07:00+02:00,2025-05-25,17:07,5,17,22
58,2025-05-25T09:09:00+02:00,2025-05-25,17:09,12,17,29
62,2025-05-25T08:58:00+02:00,2025-05-25,16:58,3,6,9
62,2025-05-25T09:00:00+02:00,2025-05-25,17:00,7,3,10
62,2025-05-25T09:02:00+02:00,2025-05-25,17:02,3,7,10
62,2025-05-25T09:04:00+02:00,2025-05-25,17:04,1,7,8
62,2025-05-25T09:08:00+02:00,2025-05-25,17:08,2,3,5
63,2025-05-25T08:55:00+02:00,2025-05-25,16:55,11,5,16
63,2025-05-25T08:58:00+02:00,2025-05-25,16:58,7,6,13
63,2025-05-25T09:00:00+02:00,2025-05-25,17:00,6,1,7
63,2025-05-25T09:01:00+02:00,2025-05-25,17:01,9,7,16
63,2025-05-25T09:05:00+02:00,2025-05-25,17:05,0,3,3
63,2025-05-25T09:09:00+02:00,2025-05-25,17:09,5,6,11
67,2025-05-25T08:55:00+02:00,2025-05-25,16:55,2,8,10
67,2025-05-25T08:57:00+02:00,2025-05-25,16:57,6,9,15
67,2025-05-25T09:00:00+02:00,2025-05-25,17:00,8,7,15
67,2025-05-25T09:03:00+02:00,2025-05-25,17:03,6,6,12
67,2025-05-25T09:07:00+02:00,2025-05-25,17:07,0,8,8
67,2025-05-25T09:08:00+02:00,2025-05-25,17:08,4,7,11
68,2025-05-25T08:55:00+02:00,2025-05-25,16:55,8,3,11
68,2025-05-25T08:56:00+02:00,2025-05-25,16:56,3,7,10
68,2025-05-25T09:00:00+02:00,2025-05-25,17:00,5,7,12
68,2025-05-25T09:05:00+02:00,2025-05-25,17:05,5,3,8
72,2025-05-25T08:56:00+02:00,2025-05-25,16:56,2,10,12
72,2025-05-25T08:57:00+02:00,2025-05-25,16:57,2,16,18
72,2025-05-25T08:58:00+02:00,2025-05-25,16:58,5,6,11
72,2025-05-25T09:02:00+02:00,2025-05-25,17:02,6,14,20
72,2025-05-25T09:04:00+02:00,2025-05-25,17:04,7,38,45
72,2025-05-25T09:07:00+02:00,2025-05-25,17:07,1,12,13
76,2025-05-25T09:04:00+02:00,2025-05-25,17:04,0,1,1
76,2025-05-25T09:06:00+02:00,2025-05-25,17:06,1,0,1
79,2025-05-25T08:55:00+02:00,2025-05-25,16:55,9,15,24
79,2025-05-25T08:57:00+02:00,2025-05-25,16:57,21,8,29
79,2025-05-25T08:58:00+02:00,2025-05-25,16:58,8,1,9
79,2025-05-25T08:59:00+02:00,2025-05-25,16:59,11,9,20
79,2025-05-25T09:01:00+02:00,2025-05-25,17:01,19,8,27
79,2025-05-25T09:02:00+02:00,2025-05-25,17:02,10,17,27
79,2025-05-25T09:03:00+02:00,2025-05-25,17:03,13,13,26
79,2025-05-25T09:05:00+02:00,2025-05-25,17:05,3,6,9
85,2025-05-25T08:57:00+02:00,2025-05-25,16:57,1,6,7
85,2025-05-25T09:06:00+02:00,2025-05-25,17:06,2,0,2
86,2025-05-25T08:58:00+02:00,2025-05-25,16:58,1,1,2
86,2025-05-25T09:01:00+02:00,2025-05-25,17:01,1,0,1
86,2025-05-25T09:05:00+02:00,2025-05-25,17:05,0,1,1
86,2025-05-25T09:07:00+02:00,2025-05-25,17:07,0,3,3
86,2025-05-25T09:09:00+02:00,2025-05-25,17:09,2,0,2
109,2025-05-25T08:55:00+02:00,2025-05-25,16:55,3,18,21
117,2025-05-25T09:00:00+02:00,2025-05-25,17:00,7,8,15
117,2025-05-25T09:05:00+02:00,2025-05-25,17:05,29,18,47
123,2025-05-25T09:00:00+02:00,2025-05-25,17:00,5,3,8
123,2025-05-25T09:05:00+02:00,2025-05-25,17:05,7,1,8
130,2025-05-25T08:55:00+02:00,2025-05-25,16:55,6,2,8
136,2025-05-25T08:55:00+02:00,2025-05-25,16:55,23,11,34
136,2025-05-25T09:00:00+02:00,2025-05-25,17:00,7,6,13
141,2025-05-25T08:55:00+02:00,2025-05-25,16:55,13,23,36
141,2025-05-25T09:05:00+02:00,2025-05-25,17:05,2,3,5
142,2025-05-25T09:00:00+02:00,2025-05-25,17:00,44,51,95
142,2025-05-25T09:05:00+02:00,2025-05-25,17:05,65,40,105
161,2025-05-25T09:00:00+02:00,2025-05-25,17:00,23,13,36
164,2025-05-25T08:55:00+02:00,2025-05-25,16:55,15,3,18
181,2025-05-25T09:11:00+02:00,2025-05-25,17:11,21,13,34
181,2025-05-25T09:12:00+02:00,2025-05-25,17:12,20,25,45
181,2025-05-25T09:16:00+02:00,2025-05-25,17:16,17,4,21
181,2025-05-25T09:18:00+02:00,2025-05-25,17:18,9,23,32
181,2025-05-25T09:19:00+02:00,2025-05-25,17:19,11,19,30
181,2025-05-25T09:21:00+02:00,2025-05-25,17:21,17,19,36
181,2025-05-25T09:23:00+02:00,2025-05-25,17:23,9,13,22
182,2025-05-25T09:10:00+02:00,2025-05-25,17:10,14,11,25
180,2025-05-25T09:10:00+02:00,2025-05-25,17:10,0,2,2
180,2025-05-25T09:24:00+02:00,2025-05-25,17:24,0,6,6
181,2025-05-25T09:03:00+02:00,2025-05-25,17:03,11,11,22
181,2025-05-25T09:04:00+02:00,2025-05-25,17:04,11,9,20
181,2025-05-25T09:05:00+02:00,2025-05-25,17:05,5,10,15
181,2025-05-25T09:07:00+02:00,2025-05-25,17:07,21,11,32
181,2025-05-25T09:09:00+02:00,2025-05-25,17:09,2,16,18
182,2025-05-25T09:00:00+02:00,2025-05-25,17:00,18,5,23
180,2025-05-25T08:59:00+02:00,2025-05-25,16:59,2,0,2
180,2025-05-25T09:08:00+02:00,2025-05-25,17:08,2,3,5
180,2025-05-25T09:09:00+02:00,2025-05-25,17:09,2,0,2
3,2025-05-25T09:29:00+02:00,2025-05-25,17:29,14,17,31
3,2025-05-25T09:32:00+02:00,2025-05-25,17:32,16,15,31
3,2025-05-25T09:33:00+02:00,2025-05-25,17:33,4,12,16
3,2025-05-25T09:36:00+02:00,2025-05-25,17:36,6,12,18
3,2025-05-25T09:38:00+02:00,2025-05-25,17:38,10,19,29
4,2025-05-25T09:36:00+02:00,2025-05-25,17:36,18,23,41
5,2025-05-25T09:25:00+02:00,2025-05-25,17:25,76,76,152
5,2025-05-25T09:30:00+02:00,2025-05-25,17:30,91,53,144
6,2025-05-25T09:28:00+02:00,2025-05-25,17:28,11,9,20
6,2025-05-25T09:37:00+02:00,2025-05-25,17:37,13,9,22
8,2025-05-25T09:25:00+02:00,2025-05-25,17:25,6,1,7
8,2025-05-25T09:30:00+02:00,2025-05-25,17:30,6,1,7
8,2025-05-25T09:32:00+02:00,2025-05-25,17:32,3,1,4
8,2025-05-25T09:33:00+02:00,2025-05-25,17:33,2,5,7
8,2025-05-25T09:34:00+02:00,2025-05-25,17:34,0,1,1
8,2025-05-25T09:35:00+02:00,2025-05-25,17:35,3,1,4
28,2025-05-25T09:28:00+02:00,2025-05-25,17:28,4,1,5
28,2025-05-25T09:30:00+02:00,2025-05-25,17:30,4,16,20
28,2025-05-25T09:32:00+02:00,2025-05-25,17:32,5,7,12
28,2025-05-25T09:35:00+02:00,2025-05-25,17:35,3,11,14
29,2025-05-25T09:25:00+02:00,2025-05-25,17:25,9,20,29
29,2025-05-25T09:26:00+02:00,2025-05-25,17:26,9,9,18
29,2025-05-25T09:27:00+02:00,2025-05-25,17:27,11,4,15
29,2025-05-25T09:28:00+02:00,2025-05-25,17:28,6,2,8
29,2025-05-25T09:31:00+02:00,2025-05-25,17:31,3,8,11
29,2025-05-25T09:32:00+02:00,2025-05-25,17:32,2,5,7
29,2025-05-25T09:36:00+02:00,2025-05-25,17:36,4,4,8
29,2025-05-25T09:38:00+02:00,2025-05-25,17:38,2,7,9
31,2025-05-25T09:27:00+02:00,2025-05-25,17:27,5,5,10
31,2025-05-25T09:33:00+02:00,2025-05-25,17:33,6,2,8
31,2025-05-25T09:35:00+02:00,2025-05-25,17:35,7,7,14
36,2025-05-25T09:29:00+02:00,2025-05-25,17:29,0,3,3
36,2025-05-25T09:31:00+02:00,2025-05-25,17:31,2,1,3
36,2025-05-25T09:33:00+02:00,2025-05-25,17:33,1,3,4
36,2025-05-25T09:37:00+02:00,2025-05-25,17:37,0,6,6
36,2025-05-25T09:39:00+02:00,2025-05-25,17:39,1,2,3
39,2025-05-25T09:32:00+02:00,2025-05-25,17:32,1,0,1
40,2025-05-25T09:26:00+02:00,2025-05-25,17:26,0,7,7
40,2025-05-25T09:30:00+02:00,2025-05-25,17:30,1,2,3
41,2025-05-25T09:28:00+02:00,2025-05-25,17:28,6,7,13
41,2025-05-25T09:31:00+02:00,2025-05-25,17:31,1,8,9
41,2025-05-25T09:32:00+02:00,2025-05-25,17:32,5,10,15
41,2025-05-25T09:34:00+02:00,2025-05-25,17:34,7,6,13
41,2025-05-25T09:36:00+02:00,2025-05-25,17:36,2,0,2
41,2025-05-25T09:38:00+02:00,2025-05-25,17:38,6,3,9
43,2025-05-25T09:25:00+02:00,2025-05-25,17:25,5,2,7
43,2025-05-25T09:30:00+02:00,2025-05-25,17:30,4,3,7
45,2025-05-25T09:25:00+02:00,2025-05-25,17:25,19,22,41
45,2025-05-25T09:27:00+02:00,2025-05-25,17:27,19,34,53
45,2025-05-25T09:36:00+02:00,2025-05-25,17:36,7,21,28
45,2025-05-25T09:38:00+02:00,2025-05-25,17:38,24,7,31
47,2025-05-25T09:30:00+02:00,2025-05-25,17:30,16,12,28
47,2025-05-25T09:31:00+02:00,2025-05-25,17:31,26,19,45
47,2025-05-25T09:32:00+02:00,2025-05-25,17:32,16,20,36
47,2025-05-25T09:34:00+02:00,2025-05-25,17:34,19,15,34
47,2025-05-25T09:35:00+02:00,2025-05-25,17:35,13,25,38
50,2025-05-25T09:28:00+02:00,2025-05-25,17:28,13,4,17
50,2025-05-25T09:32:00+02:00,2025-05-25,17:32,2,2,4
50,2025-05-25T09:33:00+02:00,2025-05-25,17:33,3,1,4
54,2025-05-25T09:25:00+02:00,2025-05-25,17:25,2,2,4
54,2025-05-25T09:27:00+02:00,2025-05-25,17:27,2,0,2
54,2025-05-25T09:28:00+02:00,2025-05-25,17:28,0,5,5
54,2025-05-25T09:30:00+02:00,2025-05-25,17:30,3,0,3
61,2025-05-25T09:26:00+02:00,2025-05-25,17:26,4,2,6
61,2025-05-25T09:29:00+02:00,2025-05-25,17:29,4,6,10
61,2025-05-25T09:30:00+02:00,2025-05-25,17:30,2,0,2
61,2025-05-25T09:31:00+02:00,2025-05-25,17:31,8,11,19
61,2025-05-25T09:32:00+02:00,2025-05-25,17:32,11,5,16
61,2025-05-25T09:33:00+02:00,2025-05-25,17:33,3,4,7
61,2025-05-25T09:35:00+02:00,2025-05-25,17:35,5,2,7
61,2025-05-25T09:37:00+02:00,2025-05-25,17:37,4,3,7
61,2025-05-25T09:39:00+02:00,2025-05-25,17:39,3,0,3
66,2025-05-25T09:25:00+02:00,2025-05-25,17:25,19,32,51
66,2025-05-25T09:26:00+02:00,2025-05-25,17:26,19,19,38
66,2025-05-25T09:30:00+02:00,2025-05-25,17:30,20,21,41
66,2025-05-25T09:34:00+02:00,2025-05-25,17:34,13,25,38
66,2025-05-25T09:37:00+02:00,2025-05-25,17:37,10,39,49
66,2025-05-25T09:39:00+02:00,2025-05-25,17:39,33,34,67
69,2025-05-25T09:30:00+02:00,2025-05-25,17:30,1,0,1
69,2025-05-25T09:31:00+02:00,2025-05-25,17:31,1,1,2
69,2025-05-25T09:36:00+02:00,2025-05-25,17:36,4,0,4
70,2025-05-25T09:25:00+02:00,2025-05-25,17:25,2,3,5
70,2025-05-25T09:31:00+02:00,2025-05-25,17:31,1,7,8
70,2025-05-25T09:35:00+02:00,2025-05-25,17:35,5,6,11
70,2025-05-25T09:39:00+02:00,2025-05-25,17:39,1,1,2
75,2025-05-25T09:32:00+02:00,2025-05-25,17:32,0,1,1
75,2025-05-25T09:34:00+02:00,2025-05-25,17:34,1,0,1
87,2025-05-25T09:25:00+02:00,2025-05-25,17:25,3,0,3
87,2025-05-25T09:30:00+02:00,2025-05-25,17:30,2,0,2
87,2025-05-25T09:32:00+02:00,2025-05-25,17:32,4,2,6
87,2025-05-25T09:38:00+02:00,2025-05-25,17:38,3,3,6
108,2025-05-25T09:25:00+02:00,2025-05-25,17:25,5,2,7
108,2025-05-25T09:29:00+02:00,2025-05-25,17:29,1,7,8
108,2025-05-25T09:30:00+02:00,2025-05-25,17:30,5,2,7
108,2025-05-25T09:32:00+02:00,2025-05-25,17:32,0,3,3
108,2025-05-25T09:33:00+02:00,2025-05-25,17:33,2,3,5
108,2025-05-25T09:39:00+02:00,2025-05-25,17:39,3,2,5
118,2025-05-25T09:30:00+02:00,2025-05-25,17:30,1,0,1
131,2025-05-25T09:25:00+02:00,2025-05-25,17:25,2,5,7
132,2025-05-25T09:35:00+02:00,2025-05-25,17:35,15,10,25
133,2025-05-25T09:35:00+02:00,2025-05-25,17:35,45,28,73
135,2025-05-25T09:35:00+02:00,2025-05-25,17:35,11,20,31
162,2025-05-25T09:35:00+02:00,2025-05-25,17:35,22,16,38
166,2025-05-25T09:30:00+02:00,2025-05-25,17:30,4,1,5
1,2025-05-25T09:26:00+02:00,2025-05-25,17:26,35,16,51
1,2025-05-25T09:28:00+02:00,2025-05-25,17:28,17,19,36
1,2025-05-25T09:31:00+02:00,2025-05-25,17:31,16,20,36
1,2025-05-25T09:33:00+02:00,2025-05-25,17:33,20,8,28
2,2025-05-25T09:25:00+02:00,2025-05-25,17:25,6,9,15
2,2025-05-25T09:26:00+02:00,2025-05-25,17:26,12,6,18
2,2025-05-25T09:27:00+02:00,2025-05-25,17:27,9,7,16
2,2025-05-25T09:30:00+02:00,2025-05-25,17:30,9,2,11
2,2025-05-25T09:33:00+02:00,2025-05-25,17:33,12,2,14
2,2025-05-25T09:35:00+02:00,2025-05-25,17:35,4,11,15
9,2025-05-25T09:25:00+02:00,2025-05-25,17:25,0,1,1
9,2025-05-25T09:28:00+02:00,2025-05-25,17:28,0,3,3
9,2025-05-25T09:30:00+02:00,2025-05-25,17:30,1,2,3
9,2025-05-25T09:31:00+02:00,2025-05-25,17:31,1,2,3
9,2025-05-25T09:32:00+02:00,2025-05-25,17:32,3,0,3
9,2025-05-25T09:34:00+02:00,2025-05-25,17:34,0,2,2
10,2025-05-25T09:26:00+02:00,2025-05-25,17:26,1,1,2
10,2025-05-25T09:30:00+02:00,2025-05-25,17:30,1,1,2
10,2025-05-25T09:31:00+02:00,2025-05-25,17:31,1,0,1
10,2025-05-25T09:35:00+02:00,2025-05-25,17:35,3,0,3
10,2025-05-25T09:38:00+02:00,2025-05-25,17:38,4,0,4
12,2025-05-25T09:25:00+02:00,2025-05-25,17:25,1,8,9
12,2025-05-25T09:27:00+02:00,2025-05-25,17:27,3,9,12
12,2025-05-25T09:29:00+02:00,2025-05-25,17:29,3,2,5
12,2025-05-25T09:35:00+02:00,2025-05-25,17:35,0,2,2
12,2025-05-25T09:36:00+02:00,2025-05-25,17:36,9,2,11
12,2025-05-25T09:39:00+02:00,2025-05-25,17:39,2,2,4
17,2025-05-25T09:29:00+02:00,2025-05-25,17:29,1,2,3
17,2025-05-25T09:35:00+02:00,2025-05-25,17:35,1,0,1
17,2025-05-25T09:37:00+02:00,2025-05-25,17:37,1,2,3
18,2025-05-25T09:25:00+02:00,2025-05-25,17:25,1,0,1
18,2025-05-25T09:37:00+02:00,2025-05-25,17:37,0,1,1
19,2025-05-25T09:26:00+02:00,2025-05-25,17:26,22,2,24
19,2025-05-25T09:29:00+02:00,2025-05-25,17:29,13,10,23
19,2025-05-25T09:32:00+02:00,2025-05-25,17:32,13,17,30
20,2025-05-25T09:25:00+02:00,2025-05-25,17:25,8,4,12
20,2025-05-25T09:30:00+02:00,2025-05-25,17:30,11,0,11
20,2025-05-25T09:31:00+02:00,2025-05-25,17:31,10,3,13
20,2025-05-25T09:32:00+02:00,2025-05-25,17:32,1,2,3
20,2025-05-25T09:36:00+02:00,2025-05-25,17:36,2,7,9
20,2025-05-25T09:38:00+02:00,2025-05-25,17:38,2,12,14
23,2025-05-25T09:26:00+02:00,2025-05-25,17:26,5,3,8
23,2025-05-25T09:28:00+02:00,2025-05-25,17:28,2,2,4
23,2025-05-25T09:30:00+02:00,2025-05-25,17:30,5,5,10
23,2025-05-25T09:32:00+02:00,2025-05-25,17:32,2,0,2
23,2025-05-25T09:38:00+02:00,2025-05-25,17:38,5,4,9
24,2025-05-25T09:25:00+02:00,2025-05-25,17:25,8,3,11
24,2025-05-25T09:28:00+02:00,2025-05-25,17:28,9,2,11
24,2025-05-25T09:29:00+02:00,2025-05-25,17:29,4,6,10
24,2025-05-25T09:31:00+02:00,2025-05-25,17:31,11,7,18
24,2025-05-25T09:32:00+02:00,2025-05-25,17:32,3,5,8
24,2025-05-25T09:34:00+02:00,2025-05-25,17:34,8,22,30
24,2025-05-25T09:35:00+02:00,2025-05-25,17:35,15,15,30
24,2025-05-25T09:38:00+02:00,2025-05-25,17:38,17,22,39
27,2025-05-25T09:27:00+02:00,2025-05-25,17:27,0,2,2
27,2025-05-25T09:29:00+02:00,2025-05-25,17:29,5,1,6
27,2025-05-25T09:32:00+02:00,2025-05-25,17:32,2,0,2
27,2025-05-25T09:33:00+02:00,2025-05-25,17:33,3,0,3
30,2025-05-25T09:27:00+02:00,2025-05-25,17:27,3,3,6
30,2025-05-25T09:32:00+02:00,2025-05-25,17:32,14,2,16
30,2025-05-25T09:33:00+02:00,2025-05-25,17:33,5,4,9
30,2025-05-25T09:34:00+02:00,2025-05-25,17:34,5,4,9
35,2025-05-25T09:26:00+02:00,2025-05-25,17:26,13,25,38
35,2025-05-25T09:30:00+02:00,2025-05-25,17:30,15,9,24
35,2025-05-25T09:31:00+02:00,2025-05-25,17:31,15,25,40
35,2025-05-25T09:34:00+02:00,2025-05-25,17:34,7,13,20
46,2025-05-25T09:30:00+02:00,2025-05-25,17:30,7,5,12
46,2025-05-25T09:35:00+02:00,2025-05-25,17:35,2,2,4
48,2025-05-25T09:26:00+02:00,2025-05-25,17:26,3,0,3
48,2025-05-25T09:31:00+02:00,2025-05-25,17:31,1,3,4
48,2025-05-25T09:34:00+02:00,2025-05-25,17:34,6,1,7
49,2025-05-25T09:25:00+02:00,2025-05-25,17:25,5,8,13
49,2025-05-25T09:27:00+02:00,2025-05-25,17:27,5,4,9
49,2025-05-25T09:29:00+02:00,2025-05-25,17:29,11,2,13
49,2025-05-25T09:31:00+02:00,2025-05-25,17:31,10,2,12
49,2025-05-25T09:32:00+02:00,2025-05-25,17:32,7,4,11
49,2025-05-25T09:33:00+02:00,2025-05-25,17:33,6,5,11
49,2025-05-25T09:37:00+02:00,2025-05-25,17:37,3,3,6
49,2025-05-25T09:39:00+02:00,2025-05-25,17:39,2,5,7
51,2025-05-25T09:26:00+02:00,2025-05-25,17:26,4,2,6
51,2025-05-25T09:27:00+02:00,2025-05-25,17:27,0,3,3
51,2025-05-25T09:28:00+02:00,2025-05-25,17:28,1,6,7
51,2025-05-25T09:30:00+02:00,2025-05-25,17:30,0,1,1
51,2025-05-25T09:37:00+02:00,2025-05-25,17:37,1,0,1
51,2025-05-25T09:39:00+02:00,2025-05-25,17:39,1,1,2
52,2025-05-25T09:28:00+02:00,2025-05-25,17:28,10,6,16
52,2025-05-25T09:33:00+02:00,2025-05-25,17:33,13,14,27
52,2025-05-25T09:35:00+02:00,2025-05-25,17:35,2,2,4
52,2025-05-25T09:36:00+02:00,2025-05-25,17:36,13,4,17
52,2025-05-25T09:39:00+02:00,2025-05-25,17:39,7,9,16
53,2025-05-25T09:26:00+02:00,2025-05-25,17:26,6,4,10
53,2025-05-25T09:27:00+02:00,2025-05-25,17:27,4,0,4
53,2025-05-25T09:34:00+02:00,2025-05-25,17:34,3,2,5
53,2025-05-25T09:35:00+02:00,2025-05-25,17:35,4,0,4
53,2025-05-25T09:36:00+02:00,2025-05-25,17:36,10,4,14
53,2025-05-25T09:38:00+02:00,2025-05-25,17:38,6,1,7
53,2025-05-25T09:39:00+02:00,2025-05-25,17:39,8,0,8
56,2025-05-25T09:25:00+02:00,2025-05-25,17:25,5,7,12
56,2025-05-25T09:26:00+02:00,2025-05-25,17:26,14,9,23
56,2025-05-25T09:28:00+02:00,2025-05-25,17:28,11,5,16
56,2025-05-25T09:33:00+02:00,2025-05-25,17:33,6,4,10
56,2025-05-25T09:37:00+02:00,2025-05-25,17:37,7,6,13
56,2025-05-25T09:38:00+02:00,2025-05-25,17:38,2,9,11
58,2025-05-25T09:27:00+02:00,2025-05-25,17:27,15,3,18
58,2025-05-25T09:28:00+02:00,2025-05-25,17:28,8,8,16
58,2025-05-25T09:30:00+02:00,2025-05-25,17:30,10,25,35
58,2025-05-25T09:34:00+02:00,2025-05-25,17:34,3,5,8
58,2025-05-25T09:35:00+02:00,2025-05-25,17:35,6,5,11
58,2025-05-25T09:39:00+02:00,2025-05-25,17:39,3,9,12
62,2025-05-25T09:26:00+02:00,2025-05-25,17:26,1,1,2
62,2025-05-25T09:29:00+02:00,2025-05-25,17:29,4,1,5
62,2025-05-25T09:31:00+02:00,2025-05-25,17:31,0,1,1
62,2025-05-25T09:32:00+02:00,2025-05-25,17:32,3,1,4
62,2025-05-25T09:33:00+02:00,2025-05-25,17:33,6,2,8
62,2025-05-25T09:35:00+02:00,2025-05-25,17:35,2,3,5
62,2025-05-25T09:37:00+02:00,2025-05-25,17:37,3,3,6
62,2025-05-25T09:38:00+02:00,2025-05-25,17:38,0,4,4
62,2025-05-25T09:39:00+02:00,2025-05-25,17:39,1,5,6
63,2025-05-25T09:29:00+02:00,2025-05-25,17:29,9,1,10
63,2025-05-25T09:33:00+02:00,2025-05-25,17:33,5,3,8
63,2025-05-25T09:34:00+02:00,2025-05-25,17:34,1,2,3
63,2025-05-25T09:37:00+02:00,2025-05-25,17:37,6,7,13
67,2025-05-25T09:25:00+02:00,2025-05-25,17:25,3,5,8
67,2025-05-25T09:28:00+02:00,2025-05-25,17:28,1,2,3
67,2025-05-25T09:32:00+02:00,2025-05-25,17:32,0,5,5
67,2025-05-25T09:33:00+02:00,2025-05-25,17:33,11,3,14
67,2025-05-25T09:34:00+02:00,2025-05-25,17:34,4,2,6
67,2025-05-25T09:36:00+02:00,2025-05-25,17:36,1,16,17
68,2025-05-25T09:29:00+02:00,2025-05-25,17:29,3,0,3
68,2025-05-25T09:30:00+02:00,2025-05-25,17:30,7,0,7
68,2025-05-25T09:31:00+02:00,2025-05-25,17:31,4,2,6
68,2025-05-25T09:35:00+02:00,2025-05-25,17:35,7,1,8
68,2025-05-25T09:38:00+02:00,2025-05-25,17:38,3,2,5
72,2025-05-25T09:25:00+02:00,2025-05-25,17:25,4,3,7
72,2025-05-25T09:29:00+02:00,2025-05-25,17:29,7,12,19
72,2025-05-25T09:37:00+02:00,2025-05-25,17:37,6,11,17
72,2025-05-25T09:38:00+02:00,2025-05-25,17:38,2,3,5
76,2025-05-25T09:25:00+02:00,2025-05-25,17:25,1,2,3
76,2025-05-25T09:27:00+02:00,2025-05-25,17:27,1,2,3
76,2025-05-25T09:29:00+02:00,2025-05-25,17:29,3,0,3
76,2025-05-25T09:34:00+02:00,2025-05-25,17:34,3,1,4
76,2025-05-25T09:38:00+02:00,2025-05-25,17:38,1,0,1
79,2025-05-25T09:31:00+02:00,2025-05-25,17:31,12,4,16
79,2025-05-25T09:32:00+02:00,2025-05-25,17:32,12,12,24
79,2025-05-25T09:34:00+02:00,2025-05-25,17:34,6,4,10
79,2025-05-25T09:38:00+02:00,2025-05-25,17:38,17,6,23
79,2025-05-25T09:39:00+02:00,2025-05-25,17:39,3,9,12
85,2025-05-25T09:25:00+02:00,2025-05-25,17:25,1,0,1
85,2025-05-25T09:27:00+02:00,2025-05-25,17:27,1,2,3
85,2025-05-25T09:33:00+02:00,2025-05-25,17:33,0,1,1
85,2025-05-25T09:34:00+02:00,2025-05-25,17:34,3,0,3
85,2025-05-25T09:39:00+02:00,2025-05-25,17:39,0,4,4
86,2025-05-25T09:32:00+02:00,2025-05-25,17:32,1,1,2
86,2025-05-25T09:33:00+02:00,2025-05-25,17:33,1,0,1
86,2025-05-25T09:38:00+02:00,2025-05-25,17:38,2,0,2
109,2025-05-25T09:25:00+02:00,2025-05-25,17:25,3,8,11
117,2025-05-25T09:25:00+02:00,2025-05-25,17:25,19,10,29
117,2025-05-25T09:35:00+02:00,2025-05-25,17:35,22,12,34
123,2025-05-25T09:25:00+02:00,2025-05-25,17:25,10,8,18
123,2025-05-25T09:35:00+02:00,2025-05-25,17:35,4,0,4
130,2025-05-25T09:35:00+02:00,2025-05-25,17:35,0,3,3
136,2025-05-25T09:30:00+02:00,2025-05-25,17:30,8,8,16
139,2025-05-25T09:30:00+02:00,2025-05-25,17:30,2,6,8
141,2025-05-25T09:25:00+02:00,2025-05-25,17:25,8,14,22
141,2025-05-25T09:35:00+02:00,2025-05-25,17:35,12,10,22
142,2025-05-25T09:25:00+02:00,2025-05-25,17:25,41,32,73
142,2025-05-25T09:35:00+02:00,2025-05-25,17:35,21,15,36
164,2025-05-25T09:35:00+02:00,2025-05-25,17:35,7,15,22
181,2025-05-25T09:40:00+02:00,2025-05-25,17:40,8,25,33
181,2025-05-25T09:48:00+02:00,2025-05-25,17:48,5,14,19
181,2025-05-25T09:49:00+02:00,2025-05-25,17:49,24,23,47
181,2025-05-25T09:51:00+02:00,2025-05-25,17:51,17,5,22
181,2025-05-25T09:52:00+02:00,2025-05-25,17:52,6,28,34
181,2025-05-25T09:54:00+02:00,2025-05-25,17:54,12,12,24
182,2025-05-25T09:40:00+02:00,2025-05-25,17:40,14,15,29
182,2025-05-25T09:45:00+02:00,2025-05-25,17:45,16,12,28
182,2025-05-25T09:50:00+02:00,2025-05-25,17:50,12,23,35
3,2025-05-25T11:38:00+02:00,2025-05-25,19:38,21,20,41
3,2025-05-25T11:39:00+02:00,2025-05-25,19:39,17,19,36
4,2025-05-25T11:36:00+02:00,2025-05-25,19:36,12,25,37
4,2025-05-25T11:38:00+02:00,2025-05-25,19:38,17,23,40
4,2025-05-25T11:39:00+02:00,2025-05-25,19:39,11,12,23
6,2025-05-25T11:29:00+02:00,2025-05-25,19:29,12,13,25
6,2025-05-25T11:31:00+02:00,2025-05-25,19:31,1,12,13
6,2025-05-25T11:36:00+02:00,2025-05-25,19:36,22,9,31
6,2025-05-25T11:38:00+02:00,2025-05-25,19:38,5,15,20
6,2025-05-25T11:39:00+02:00,2025-05-25,19:39,3,10,13
8,2025-05-25T11:25:00+02:00,2025-05-25,19:25,1,2,3
21,2025-05-25T11:25:00+02:00,2025-05-25,19:25,33,46,79
28,2025-05-25T11:25:00+02:00,2025-05-25,19:25,2,2,4
28,2025-05-25T11:26:00+02:00,2025-05-25,19:26,2,2,4
28,2025-05-25T11:29:00+02:00,2025-05-25,19:29,2,1,3
28,2025-05-25T11:30:00+02:00,2025-05-25,19:30,4,5,9
28,2025-05-25T11:38:00+02:00,2025-05-25,19:38,3,1,4
28,2025-05-25T11:39:00+02:00,2025-05-25,19:39,3,3,6
29,2025-05-25T11:25:00+02:00,2025-05-25,19:25,1,4,5
29,2025-05-25T11:30:00+02:00,2025-05-25,19:30,2,9,11
29,2025-05-25T11:32:00+02:00,2025-05-25,19:32,4,9,13
29,2025-05-25T11:39:00+02:00,2025-05-25,19:39,4,2,6
31,2025-05-25T11:30:00+02:00,2025-05-25,19:30,5,1,6
31,2025-05-25T11:31:00+02:00,2025-05-25,19:31,1,5,6
31,2025-05-25T11:34:00+02:00,2025-05-25,19:34,1,3,4
31,2025-05-25T11:37:00+02:00,2025-05-25,19:37,0,4,4
36,2025-05-25T11:28:00+02:00,2025-05-25,19:28,4,0,4
36,2025-05-25T11:33:00+02:00,2025-05-25,19:33,2,0,2
36,2025-05-25T11:35:00+02:00,2025-05-25,19:35,2,3,5
36,2025-05-25T11:36:00+02:00,2025-05-25,19:36,0,3,3
39,2025-05-25T11:33:00+02:00,2025-05-25,19:33,1,0,1
40,2025-05-25T11:27:00+02:00,2025-05-25,19:27,2,0,2
40,2025-05-25T11:30:00+02:00,2025-05-25,19:30,1,0,1
40,2025-05-25T11:36:00+02:00,2025-05-25,19:36,4,1,5
40,2025-05-25T11:37:00+02:00,2025-05-25,19:37,4,2,6
40,2025-05-25T11:38:00+02:00,2025-05-25,19:38,1,0,1
40,2025-05-25T11:39:00+02:00,2025-05-25,19:39,2,3,5
41,2025-05-25T11:26:00+02:00,2025-05-25,19:26,3,0,3
41,2025-05-25T11:30:00+02:00,2025-05-25,19:30,4,1,5
41,2025-05-25T11:32:00+02:00,2025-05-25,19:32,0,6,6
41,2025-05-25T11:33:00+02:00,2025-05-25,19:33,0,1,1
41,2025-05-25T11:35:00+02:00,2025-05-25,19:35,5,0,5
41,2025-05-25T11:36:00+02:00,2025-05-25,19:36,2,5,7
41,2025-05-25T11:37:00+02:00,2025-05-25,19:37,14,0,14
43,2025-05-25T11:25:00+02:00,2025-05-25,19:25,0,4,4
44,2025-05-25T11:30:00+02:00,2025-05-25,19:30,4,2,6
44,2025-05-25T11:35:00+02:00,2025-05-25,19:35,2,0,2
45,2025-05-25T11:25:00+02:00,2025-05-25,19:25,16,8,24
45,2025-05-25T11:28:00+02:00,2025-05-25,19:28,10,13,23
45,2025-05-25T11:30:00+02:00,2025-05-25,19:30,2,2,4
45,2025-05-25T11:33:00+02:00,2025-05-25,19:33,10,4,14
47,2025-05-25T11:26:00+02:00,2025-05-25,19:26,5,16,21
47,2025-05-25T11:32:00+02:00,2025-05-25,19:32,9,9,18
47,2025-05-25T11:37:00+02:00,2025-05-25,19:37,6,0,6
50,2025-05-25T11:26:00+02:00,2025-05-25,19:26,2,4,6
50,2025-05-25T11:33:00+02:00,2025-05-25,19:33,4,1,5
50,2025-05-25T11:34:00+02:00,2025-05-25,19:34,2,6,8
50,2025-05-25T11:36:00+02:00,2025-05-25,19:36,4,4,8
50,2025-05-25T11:37:00+02:00,2025-05-25,19:37,7,0,7
54,2025-05-25T11:25:00+02:00,2025-05-25,19:25,5,2,7
54,2025-05-25T11:29:00+02:00,2025-05-25,19:29,1,3,4
54,2025-05-25T11:31:00+02:00,2025-05-25,19:31,0,1,1
54,2025-05-25T11:32:00+02:00,2025-05-25,19:32,4,5,9
54,2025-05-25T11:35:00+02:00,2025-05-25,19:35,3,4,7
54,2025-05-25T11:39:00+02:00,2025-05-25,19:39,3,1,4
59,2025-05-25T11:25:00+02:00,2025-05-25,19:25,16,27,43
61,2025-05-25T11:25:00+02:00,2025-05-25,19:25,7,4,11
61,2025-05-25T11:32:00+02:00,2025-05-25,19:32,5,1,6
61,2025-05-25T11:33:00+02:00,2025-05-25,19:33,5,6,11
61,2025-05-25T11:34:00+02:00,2025-05-25,19:34,6,3,9
61,2025-05-25T11:38:00+02:00,2025-05-25,19:38,6,1,7
66,2025-05-25T11:25:00+02:00,2025-05-25,19:25,20,23,43
66,2025-05-25T11:26:00+02:00,2025-05-25,19:26,9,14,23
66,2025-05-25T11:29:00+02:00,2025-05-25,19:29,17,12,29
66,2025-05-25T11:35:00+02:00,2025-05-25,19:35,16,15,31
66,2025-05-25T11:37:00+02:00,2025-05-25,19:37,17,21,38
69,2025-05-25T11:31:00+02:00,2025-05-25,19:31,1,0,1
69,2025-05-25T11:33:00+02:00,2025-05-25,19:33,0,1,1
69,2025-05-25T11:37:00+02:00,2025-05-25,19:37,0,1,1
69,2025-05-25T11:39:00+02:00,2025-05-25,19:39,0,2,2
70,2025-05-25T11:27:00+02:00,2025-05-25,19:27,1,4,5
70,2025-05-25T11:29:00+02:00,2025-05-25,19:29,1,4,5
70,2025-05-25T11:32:00+02:00,2025-05-25,19:32,2,0,2
71,2025-05-25T11:25:00+02:00,2025-05-25,19:25,2,0,2
71,2025-05-25T11:35:00+02:00,2025-05-25,19:35,2,0,2
77,2025-05-25T11:30:00+02:00,2025-05-25,19:30,29,8,37
84,2025-05-25T11:30:00+02:00,2025-05-25,19:30,38,73,111
87,2025-05-25T11:37:00+02:00,2025-05-25,19:37,0,2,2
87,2025-05-25T11:38:00+02:00,2025-05-25,19:38,3,0,3
107,2025-05-25T11:30:00+02:00,2025-05-25,19:30,6,0,6
108,2025-05-25T11:25:00+02:00,2025-05-25,19:25,4,0,4
108,2025-05-25T11:26:00+02:00,2025-05-25,19:26,2,1,3
108,2025-05-25T11:27:00+02:00,2025-05-25,19:27,4,1,5
108,2025-05-25T11:34:00+02:00,2025-05-25,19:34,0,1,1
108,2025-05-25T11:37:00+02:00,2025-05-25,19:37,0,2,2
131,2025-05-25T11:25:00+02:00,2025-05-25,19:25,5,3,8
132,2025-05-25T11:25:00+02:00,2025-05-25,19:25,8,9,17
132,2025-05-25T11:30:00+02:00,2025-05-25,19:30,11,10,21
133,2025-05-25T11:25:00+02:00,2025-05-25,19:25,60,39,99
133,2025-05-25T11:30:00+02:00,2025-05-25,19:30,49,35,84
135,2025-05-25T11:25:00+02:00,2025-05-25,19:25,16,111,127
162,2025-05-25T11:30:00+02:00,2025-05-25,19:30,24,26,50
167,2025-05-25T11:25:00+02:00,2025-05-25,19:25,2,0,2
179,2025-05-25T11:30:00+02:00,2025-05-25,19:30,5,9,14
1,2025-05-25T11:27:00+02:00,2025-05-25,19:27,9,5,14
1,2025-05-25T11:29:00+02:00,2025-05-25,19:29,6,2,8
1,2025-05-25T11:31:00+02:00,2025-05-25,19:31,17,7,24
1,2025-05-25T11:32:00+02:00,2025-05-25,19:32,7,3,10
1,2025-05-25T11:34:00+02:00,2025-05-25,19:34,8,9,17
1,2025-05-25T11:35:00+02:00,2025-05-25,19:35,11,6,17
1,2025-05-25T11:36:00+02:00,2025-05-25,19:36,9,4,13
1,2025-05-25T11:38:00+02:00,2025-05-25,19:38,2,8,10
1,2025-05-25T11:39:00+02:00,2025-05-25,19:39,6,3,9
2,2025-05-25T11:25:00+02:00,2025-05-25,19:25,3,1,4
2,2025-05-25T11:26:00+02:00,2025-05-25,19:26,1,2,3
2,2025-05-25T11:37:00+02:00,2025-05-25,19:37,0,1,1
2,2025-05-25T11:38:00+02:00,2025-05-25,19:38,0,1,1
9,2025-05-25T11:30:00+02:00,2025-05-25,19:30,4,3,7
9,2025-05-25T11:35:00+02:00,2025-05-25,19:35,1,0,1
9,2025-05-25T11:37:00+02:00,2025-05-25,19:37,5,0,5
10,2025-05-25T11:25:00+02:00,2025-05-25,19:25,0,2,2
10,2025-05-25T11:27:00+02:00,2025-05-25,19:27,0,4,4
10,2025-05-25T11:30:00+02:00,2025-05-25,19:30,3,2,5
10,2025-05-25T11:38:00+02:00,2025-05-25,19:38,0,2,2
11,2025-05-25T11:30:00+02:00,2025-05-25,19:30,3,1,4
12,2025-05-25T11:30:00+02:00,2025-05-25,19:30,2,10,12
12,2025-05-25T11:38:00+02:00,2025-05-25,19:38,1,5,6
17,2025-05-25T11:25:00+02:00,2025-05-25,19:25,5,3,8
17,2025-05-25T11:28:00+02:00,2025-05-25,19:28,0,5,5
17,2025-05-25T11:29:00+02:00,2025-05-25,19:29,2,3,5
17,2025-05-25T11:30:00+02:00,2025-05-25,19:30,0,2,2
17,2025-05-25T11:32:00+02:00,2025-05-25,19:32,0,3,3
17,2025-05-25T11:33:00+02:00,2025-05-25,19:33,0,1,1
17,2025-05-25T11:34:00+02:00,2025-05-25,19:34,3,0,3
17,2025-05-25T11:37:00+02:00,2025-05-25,19:37,0,3,3
19,2025-05-25T11:26:00+02:00,2025-05-25,19:26,10,14,24
19,2025-05-25T11:27:00+02:00,2025-05-25,19:27,7,6,13
19,2025-05-25T11:32:00+02:00,2025-05-25,19:32,10,7,17
19,2025-05-25T11:36:00+02:00,2025-05-25,19:36,4,17,21
19,2025-05-25T11:37:00+02:00,2025-05-25,19:37,5,8,13
20,2025-05-25T11:30:00+02:00,2025-05-25,19:30,6,7,13
20,2025-05-25T11:32:00+02:00,2025-05-25,19:32,0,6,6
20,2025-05-25T11:35:00+02:00,2025-05-25,19:35,0,2,2
20,2025-05-25T11:36:00+02:00,2025-05-25,19:36,9,4,13
20,2025-05-25T11:39:00+02:00,2025-05-25,19:39,5,5,10
23,2025-05-25T11:25:00+02:00,2025-05-25,19:25,3,0,3
23,2025-05-25T11:26:00+02:00,2025-05-25,19:26,4,1,5
23,2025-05-25T11:32:00+02:00,2025-05-25,19:32,1,1,2
23,2025-05-25T11:35:00+02:00,2025-05-25,19:35,1,0,1
23,2025-05-25T11:38:00+02:00,2025-05-25,19:38,1,4,5
24,2025-05-25T11:26:00+02:00,2025-05-25,19:26,6,4,10
24,2025-05-25T11:27:00+02:00,2025-05-25,19:27,3,11,14
24,2025-05-25T11:34:00+02:00,2025-05-25,19:34,4,10,14
24,2025-05-25T11:36:00+02:00,2025-05-25,19:36,13,1,14
24,2025-05-25T11:39:00+02:00,2025-05-25,19:39,7,3,10
25,2025-05-25T11:25:00+02:00,2025-05-25,19:25,22,15,37
25,2025-05-25T11:30:00+02:00,2025-05-25,19:30,11,13,24
25,2025-05-25T11:35:00+02:00,2025-05-25,19:35,26,27,53
27,2025-05-25T11:29:00+02:00,2025-05-25,19:29,0,6,6
27,2025-05-25T11:30:00+02:00,2025-05-25,19:30,7,0,7
27,2025-05-25T11:31:00+02:00,2025-05-25,19:31,2,1,3
27,2025-05-25T11:34:00+02:00,2025-05-25,19:34,3,3,6
27,2025-05-25T11:37:00+02:00,2025-05-25,19:37,6,2,8
27,2025-05-25T11:38:00+02:00,2025-05-25,19:38,2,0,2
30,2025-05-25T11:25:00+02:00,2025-05-25,19:25,3,12,15
30,2025-05-25T11:26:00+02:00,2025-05-25,19:26,1,14,15
30,2025-05-25T11:30:00+02:00,2025-05-25,19:30,2,6,8
30,2025-05-25T11:31:00+02:00,2025-05-25,19:31,3,10,13
30,2025-05-25T11:32:00+02:00,2025-05-25,19:32,8,1,9
30,2025-05-25T11:33:00+02:00,2025-05-25,19:33,10,4,14
35,2025-05-25T11:26:00+02:00,2025-05-25,19:26,11,3,14
35,2025-05-25T11:27:00+02:00,2025-05-25,19:27,4,15,19
35,2025-05-25T11:29:00+02:00,2025-05-25,19:29,1,18,19
35,2025-05-25T11:32:00+02:00,2025-05-25,19:32,7,6,13
35,2025-05-25T11:33:00+02:00,2025-05-25,19:33,10,9,19
46,2025-05-25T11:35:00+02:00,2025-05-25,19:35,1,0,1
48,2025-05-25T11:32:00+02:00,2025-05-25,19:32,3,1,4
48,2025-05-25T11:38:00+02:00,2025-05-25,19:38,1,2,3
48,2025-05-25T11:39:00+02:00,2025-05-25,19:39,0,3,3
49,2025-05-25T11:25:00+02:00,2025-05-25,19:25,1,3,4
49,2025-05-25T11:28:00+02:00,2025-05-25,19:28,0,6,6
49,2025-05-25T11:29:00+02:00,2025-05-25,19:29,4,5,9
49,2025-05-25T11:30:00+02:00,2025-05-25,19:30,4,5,9
49,2025-05-25T11:33:00+02:00,2025-05-25,19:33,5,1,6
49,2025-05-25T11:35:00+02:00,2025-05-25,19:35,4,2,6
49,2025-05-25T11:37:00+02:00,2025-05-25,19:37,9,3,12
51,2025-05-25T11:26:00+02:00,2025-05-25,19:26,0,4,4
51,2025-05-25T11:35:00+02:00,2025-05-25,19:35,2,3,5
51,2025-05-25T11:39:00+02:00,2025-05-25,19:39,1,1,2
52,2025-05-25T11:29:00+02:00,2025-05-25,19:29,0,1,1
53,2025-05-25T11:26:00+02:00,2025-05-25,19:26,0,3,3
53,2025-05-25T11:28:00+02:00,2025-05-25,19:28,1,5,6
53,2025-05-25T11:29:00+02:00,2025-05-25,19:29,8,1,9
53,2025-05-25T11:30:00+02:00,2025-05-25,19:30,2,1,3
53,2025-05-25T11:36:00+02:00,2025-05-25,19:36,6,5,11
53,2025-05-25T11:37:00+02:00,2025-05-25,19:37,5,5,10
53,2025-05-25T11:39:00+02:00,2025-05-25,19:39,2,3,5
56,2025-05-25T11:25:00+02:00,2025-05-25,19:25,7,3,10
56,2025-05-25T11:26:00+02:00,2025-05-25,19:26,8,4,12
56,2025-05-25T11:30:00+02:00,2025-05-25,19:30,6,7,13
56,2025-05-25T11:34:00+02:00,2025-05-25,19:34,8,10,18
56,2025-05-25T11:35:00+02:00,2025-05-25,19:35,7,8,15
56,2025-05-25T11:38:00+02:00,2025-05-25,19:38,11,11,22
56,2025-05-25T11:39:00+02:00,2025-05-25,19:39,3,8,11
58,2025-05-25T11:27:00+02:00,2025-05-25,19:27,32,6,38
58,2025-05-25T11:29:00+02:00,2025-05-25,19:29,4,6,10
58,2025-05-25T11:30:00+02:00,2025-05-25,19:30,48,1,49
58,2025-05-25T11:31:00+02:00,2025-05-25,19:31,11,7,18
58,2025-05-25T11:33:00+02:00,2025-05-25,19:33,27,4,31
58,2025-05-25T11:34:00+02:00,2025-05-25,19:34,4,1,5
58,2025-05-25T11:36:00+02:00,2025-05-25,19:36,13,6,19
58,2025-05-25T11:37:00+02:00,2025-05-25,19:37,14,3,17
58,2025-05-25T11:39:00+02:00,2025-05-25,19:39,2,3,5
62,2025-05-25T11:25:00+02:00,2025-05-25,19:25,1,4,5
62,2025-05-25T11:26:00+02:00,2025-05-25,19:26,7,2,9
62,2025-05-25T11:27:00+02:00,2025-05-25,19:27,4,4,8
62,2025-05-25T11:34:00+02:00,2025-05-25,19:34,1,0,1
62,2025-05-25T11:36:00+02:00,2025-05-25,19:36,3,3,6
62,2025-05-25T11:38:00+02:00,2025-05-25,19:38,3,6,9
63,2025-05-25T11:31:00+02:00,2025-05-25,19:31,0,1,1
63,2025-05-25T11:34:00+02:00,2025-05-25,19:34,0,1,1
63,2025-05-25T11:37:00+02:00,2025-05-25,19:37,0,1,1
67,2025-05-25T11:28:00+02:00,2025-05-25,19:28,1,1,2
67,2025-05-25T11:32:00+02:00,2025-05-25,19:32,4,3,7
67,2025-05-25T11:33:00+02:00,2025-05-25,19:33,1,1,2
67,2025-05-25T11:34:00+02:00,2025-05-25,19:34,3,1,4
67,2025-05-25T11:36:00+02:00,2025-05-25,19:36,0,5,5
68,2025-05-25T11:25:00+02:00,2025-05-25,19:25,9,1,10
68,2025-05-25T11:27:00+02:00,2025-05-25,19:27,3,3,6
68,2025-05-25T11:28:00+02:00,2025-05-25,19:28,2,4,6
68,2025-05-25T11:31:00+02:00,2025-05-25,19:31,0,1,1
68,2025-05-25T11:34:00+02:00,2025-05-25,19:34,1,2,3
68,2025-05-25T11:36:00+02:00,2025-05-25,19:36,7,3,10
72,2025-05-25T11:27:00+02:00,2025-05-25,19:27,4,10,14
72,2025-05-25T11:29:00+02:00,2025-05-25,19:29,2,11,13
72,2025-05-25T11:34:00+02:00,2025-05-25,19:34,2,10,12
72,2025-05-25T11:35:00+02:00,2025-05-25,19:35,4,14,18
72,2025-05-25T11:36:00+02:00,2025-05-25,19:36,6,4,10
72,2025-05-25T11:37:00+02:00,2025-05-25,19:37,2,5,7
72,2025-05-25T11:38:00+02:00,2025-05-25,19:38,5,4,9
72,2025-05-25T11:39:00+02:00,2025-05-25,19:39,9,0,9
76,2025-05-25T11:25:00+02:00,2025-05-25,19:25,0,1,1
79,2025-05-25T11:25:00+02:00,2025-05-25,19:25,1,8,9
79,2025-05-25T11:26:00+02:00,2025-05-25,19:26,4,5,9
79,2025-05-25T11:29:00+02:00,2025-05-25,19:29,5,7,12
79,2025-05-25T11:31:00+02:00,2025-05-25,19:31,3,12,15
79,2025-05-25T11:34:00+02:00,2025-05-25,19:34,7,13,20
79,2025-05-25T11:36:00+02:00,2025-05-25,19:36,0,6,6
85,2025-05-25T11:31:00+02:00,2025-05-25,19:31,0,2,2
85,2025-05-25T11:34:00+02:00,2025-05-25,19:34,1,0,1
86,2025-05-25T11:28:00+02:00,2025-05-25,19:28,0,1,1
86,2025-05-25T11:34:00+02:00,2025-05-25,19:34,2,0,2
109,2025-05-25T11:25:00+02:00,2025-05-25,19:25,5,4,9
109,2025-05-25T11:35:00+02:00,2025-05-25,19:35,8,7,15
117,2025-05-25T11:25:00+02:00,2025-05-25,19:25,28,5,33
117,2025-05-25T11:35:00+02:00,2025-05-25,19:35,33,6,39
130,2025-05-25T11:30:00+02:00,2025-05-25,19:30,2,0,2
136,2025-05-25T11:30:00+02:00,2025-05-25,19:30,1,2,3
139,2025-05-25T11:35:00+02:00,2025-05-25,19:35,1,1,2
141,2025-05-25T11:30:00+02:00,2025-05-25,19:30,2,6,8
141,2025-05-25T11:35:00+02:00,2025-05-25,19:35,11,5,16
3,2025-05-25T11:44:00+02:00,2025-05-25,19:44,9,8,17
3,2025-05-25T11:45:00+02:00,2025-05-25,19:45,7,18,25
3,2025-05-25T11:46:00+02:00,2025-05-25,19:46,3,12,15
3,2025-05-25T11:47:00+02:00,2025-05-25,19:47,16,25,41
3,2025-05-25T11:48:00+02:00,2025-05-25,19:48,14,11,25
3,2025-05-25T11:51:00+02:00,2025-05-25,19:51,20,6,26
4,2025-05-25T11:44:00+02:00,2025-05-25,19:44,8,22,30
4,2025-05-25T11:45:00+02:00,2025-05-25,19:45,2,15,17
4,2025-05-25T11:46:00+02:00,2025-05-25,19:46,13,9,22
4,2025-05-25T11:47:00+02:00,2025-05-25,19:47,19,7,26
4,2025-05-25T11:48:00+02:00,2025-05-25,19:48,9,12,21
4,2025-05-25T11:50:00+02:00,2025-05-25,19:50,11,12,23
4,2025-05-25T11:52:00+02:00,2025-05-25,19:52,15,9,24
6,2025-05-25T11:41:00+02:00,2025-05-25,19:41,6,11,17
6,2025-05-25T11:42:00+02:00,2025-05-25,19:42,11,9,20
6,2025-05-25T11:54:00+02:00,2025-05-25,19:54,3,4,7
8,2025-05-25T11:49:00+02:00,2025-05-25,19:49,0,1,1
28,2025-05-25T11:40:00+02:00,2025-05-25,19:40,6,2,8
28,2025-05-25T11:41:00+02:00,2025-05-25,19:41,2,4,6
28,2025-05-25T11:42:00+02:00,2025-05-25,19:42,5,0,5
28,2025-05-25T11:50:00+02:00,2025-05-25,19:50,9,6,15
28,2025-05-25T11:53:00+02:00,2025-05-25,19:53,9,1,10
29,2025-05-25T11:43:00+02:00,2025-05-25,19:43,5,2,7
29,2025-05-25T11:44:00+02:00,2025-05-25,19:44,3,3,6
29,2025-05-25T11:45:00+02:00,2025-05-25,19:45,6,8,14
31,2025-05-25T11:40:00+02:00,2025-05-25,19:40,3,7,10
31,2025-05-25T11:44:00+02:00,2025-05-25,19:44,7,3,10
31,2025-05-25T11:46:00+02:00,2025-05-25,19:46,4,9,13
31,2025-05-25T11:49:00+02:00,2025-05-25,19:49,5,6,11
31,2025-05-25T11:50:00+02:00,2025-05-25,19:50,4,2,6
31,2025-05-25T11:51:00+02:00,2025-05-25,19:51,0,2,2
31,2025-05-25T11:52:00+02:00,2025-05-25,19:52,0,2,2
31,2025-05-25T11:54:00+02:00,2025-05-25,19:54,6,4,10
36,2025-05-25T11:42:00+02:00,2025-05-25,19:42,0,1,1
36,2025-05-25T11:52:00+02:00,2025-05-25,19:52,0,1,1
39,2025-05-25T11:40:00+02:00,2025-05-25,19:40,4,1,5
39,2025-05-25T11:41:00+02:00,2025-05-25,19:41,0,1,1
39,2025-05-25T11:42:00+02:00,2025-05-25,19:42,2,0,2
39,2025-05-25T11:45:00+02:00,2025-05-25,19:45,1,1,2
39,2025-05-25T11:54:00+02:00,2025-05-25,19:54,1,0,1
41,2025-05-25T11:49:00+02:00,2025-05-25,19:49,5,3,8
41,2025-05-25T11:52:00+02:00,2025-05-25,19:52,3,3,6
45,2025-05-25T11:42:00+02:00,2025-05-25,19:42,16,12,28
45,2025-05-25T11:43:00+02:00,2025-05-25,19:43,7,13,20
45,2025-05-25T11:44:00+02:00,2025-05-25,19:44,9,10,19
45,2025-05-25T11:47:00+02:00,2025-05-25,19:47,14,19,33
45,2025-05-25T11:48:00+02:00,2025-05-25,19:48,19,9,28
45,2025-05-25T11:50:00+02:00,2025-05-25,19:50,13,12,25
45,2025-05-25T11:51:00+02:00,2025-05-25,19:51,9,7,16
45,2025-05-25T11:53:00+02:00,2025-05-25,19:53,7,10,17
45,2025-05-25T11:54:00+02:00,2025-05-25,19:54,2,3,5
47,2025-05-25T11:43:00+02:00,2025-05-25,19:43,9,2,11
47,2025-05-25T11:45:00+02:00,2025-05-25,19:45,7,6,13
47,2025-05-25T11:49:00+02:00,2025-05-25,19:49,14,3,17
47,2025-05-25T11:53:00+02:00,2025-05-25,19:53,5,17,22
50,2025-05-25T11:41:00+02:00,2025-05-25,19:41,0,1,1
50,2025-05-25T11:42:00+02:00,2025-05-25,19:42,5,2,7
50,2025-05-25T11:45:00+02:00,2025-05-25,19:45,9,1,10
50,2025-05-25T11:49:00+02:00,2025-05-25,19:49,11,6,17
50,2025-05-25T11:52:00+02:00,2025-05-25,19:52,5,0,5
50,2025-05-25T11:53:00+02:00,2025-05-25,19:53,3,2,5
54,2025-05-25T11:41:00+02:00,2025-05-25,19:41,1,2,3
54,2025-05-25T11:42:00+02:00,2025-05-25,19:42,4,2,6
54,2025-05-25T11:46:00+02:00,2025-05-25,19:46,2,2,4
54,2025-05-25T11:52:00+02:00,2025-05-25,19:52,6,3,9
54,2025-05-25T11:54:00+02:00,2025-05-25,19:54,0,5,5
59,2025-05-25T11:40:00+02:00,2025-05-25,19:40,15,18,33
59,2025-05-25T11:50:00+02:00,2025-05-25,19:50,12,24,36
61,2025-05-25T11:40:00+02:00,2025-05-25,19:40,3,0,3
61,2025-05-25T11:46:00+02:00,2025-05-25,19:46,7,0,7
61,2025-05-25T11:48:00+02:00,2025-05-25,19:48,4,5,9
66,2025-05-25T11:40:00+02:00,2025-05-25,19:40,26,12,38
66,2025-05-25T11:42:00+02:00,2025-05-25,19:42,5,8,13
66,2025-05-25T11:46:00+02:00,2025-05-25,19:46,22,10,32
66,2025-05-25T11:50:00+02:00,2025-05-25,19:50,14,13,27
66,2025-05-25T11:51:00+02:00,2025-05-25,19:51,25,9,34
66,2025-05-25T11:53:00+02:00,2025-05-25,19:53,17,16,33
70,2025-05-25T11:42:00+02:00,2025-05-25,19:42,0,1,1
70,2025-05-25T11:46:00+02:00,2025-05-25,19:46,0,1,1
70,2025-05-25T11:47:00+02:00,2025-05-25,19:47,1,4,5
70,2025-05-25T11:54:00+02:00,2025-05-25,19:54,0,1,1
77,2025-05-25T11:45:00+02:00,2025-05-25,19:45,28,7,35
77,2025-05-25T11:50:00+02:00,2025-05-25,19:50,15,0,15
78,2025-05-25T11:51:00+02:00,2025-05-25,19:51,1,0,1
78,2025-05-25T11:54:00+02:00,2025-05-25,19:54,2,0,2
84,2025-05-25T11:45:00+02:00,2025-05-25,19:45,51,62,113
87,2025-05-25T11:41:00+02:00,2025-05-25,19:41,0,1,1
87,2025-05-25T11:42:00+02:00,2025-05-25,19:42,1,0,1
87,2025-05-25T11:43:00+02:00,2025-05-25,19:43,1,0,1
87,2025-05-25T11:47:00+02:00,2025-05-25,19:47,2,0,2
87,2025-05-25T11:51:00+02:00,2025-05-25,19:51,1,1,2
107,2025-05-25T11:50:00+02:00,2025-05-25,19:50,9,10,19
108,2025-05-25T11:40:00+02:00,2025-05-25,19:40,1,0,1
108,2025-05-25T11:41:00+02:00,2025-05-25,19:41,3,2,5
108,2025-05-25T11:44:00+02:00,2025-05-25,19:44,1,3,4
108,2025-05-25T11:45:00+02:00,2025-05-25,19:45,0,1,1
131,2025-05-25T11:50:00+02:00,2025-05-25,19:50,2,6,8
134,2025-05-25T11:45:00+02:00,2025-05-25,19:45,29,22,51
135,2025-05-25T11:40:00+02:00,2025-05-25,19:40,13,50,63
162,2025-05-25T11:40:00+02:00,2025-05-25,19:40,9,8,17
165,2025-05-25T11:45:00+02:00,2025-05-25,19:45,2,0,2
167,2025-05-25T11:45:00+02:00,2025-05-25,19:45,0,3,3
167,2025-05-25T11:50:00+02:00,2025-05-25,19:50,2,3,5
179,2025-05-25T11:40:00+02:00,2025-05-25,19:40,8,3,11
1,2025-05-25T11:40:00+02:00,2025-05-25,19:40,3,2,5
1,2025-05-25T11:41:00+02:00,2025-05-25,19:41,6,5,11
1,2025-05-25T11:42:00+02:00,2025-05-25,19:42,11,14,25
1,2025-05-25T11:43:00+02:00,2025-05-25,19:43,16,6,22
1,2025-05-25T11:44:00+02:00,2025-05-25,19:44,5,6,11
1,2025-05-25T11:49:00+02:00,2025-05-25,19:49,8,7,15
1,2025-05-25T11:50:00+02:00,2025-05-25,19:50,2,0,2
2,2025-05-25T11:40:00+02:00,2025-05-25,19:40,0,11,11
2,2025-05-25T11:50:00+02:00,2025-05-25,19:50,0,4,4
9,2025-05-25T11:54:00+02:00,2025-05-25,19:54,1,1,2
10,2025-05-25T11:41:00+02:00,2025-05-25,19:41,0,1,1
10,2025-05-25T11:50:00+02:00,2025-05-25,19:50,3,0,3
10,2025-05-25T11:54:00+02:00,2025-05-25,19:54,1,0,1
11,2025-05-25T11:45:00+02:00,2025-05-25,19:45,7,3,10
12,2025-05-25T11:44:00+02:00,2025-05-25,19:44,0,4,4
12,2025-05-25T11:45:00+02:00,2025-05-25,19:45,2,4,6
12,2025-05-25T11:48:00+02:00,2025-05-25,19:48,0,11,11
12,2025-05-25T11:50:00+02:00,2025-05-25,19:50,4,3,7
12,2025-05-25T11:52:00+02:00,2025-05-25,19:52,8,6,14
12,2025-05-25T11:53:00+02:00,2025-05-25,19:53,0,1,1
17,2025-05-25T11:42:00+02:00,2025-05-25,19:42,9,0,9
17,2025-05-25T11:43:00+02:00,2025-05-25,19:43,5,2,7
17,2025-05-25T11:45:00+02:00,2025-05-25,19:45,0,1,1
17,2025-05-25T11:49:00+02:00,2025-05-25,19:49,1,0,1
17,2025-05-25T11:51:00+02:00,2025-05-25,19:51,3,0,3
17,2025-05-25T11:53:00+02:00,2025-05-25,19:53,2,2,4
18,2025-05-25T11:49:00+02:00,2025-05-25,19:49,2,0,2
18,2025-05-25T11:54:00+02:00,2025-05-25,19:54,0,2,2
19,2025-05-25T11:43:00+02:00,2025-05-25,19:43,6,7,13
19,2025-05-25T11:46:00+02:00,2025-05-25,19:46,3,14,17
19,2025-05-25T11:48:00+02:00,2025-05-25,19:48,5,12,17
19,2025-05-25T11:51:00+02:00,2025-05-25,19:51,7,13,20
19,2025-05-25T11:52:00+02:00,2025-05-25,19:52,12,6,18
19,2025-05-25T11:53:00+02:00,2025-05-25,19:53,8,14,22
20,2025-05-25T11:40:00+02:00,2025-05-25,19:40,1,3,4
20,2025-05-25T11:42:00+02:00,2025-05-25,19:42,2,5,7
20,2025-05-25T11:43:00+02:00,2025-05-25,19:43,5,1,6
20,2025-05-25T11:44:00+02:00,2025-05-25,19:44,9,6,15
20,2025-05-25T11:46:00+02:00,2025-05-25,19:46,2,6,8
20,2025-05-25T11:53:00+02:00,2025-05-25,19:53,7,2,9
23,2025-05-25T11:42:00+02:00,2025-05-25,19:42,2,0,2
23,2025-05-25T11:46:00+02:00,2025-05-25,19:46,1,2,3
23,2025-05-25T11:51:00+02:00,2025-05-25,19:51,0,7,7
24,2025-05-25T11:41:00+02:00,2025-05-25,19:41,6,4,10
24,2025-05-25T11:46:00+02:00,2025-05-25,19:46,4,15,19
24,2025-05-25T11:47:00+02:00,2025-05-25,19:47,7,3,10
24,2025-05-25T11:51:00+02:00,2025-05-25,19:51,8,8,16
24,2025-05-25T11:53:00+02:00,2025-05-25,19:53,2,11,13
25,2025-05-25T11:50:00+02:00,2025-05-25,19:50,14,28,42
27,2025-05-25T11:40:00+02:00,2025-05-25,19:40,2,0,2
27,2025-05-25T11:42:00+02:00,2025-05-25,19:42,1,1,2
27,2025-05-25T11:47:00+02:00,2025-05-25,19:47,2,0,2
27,2025-05-25T11:48:00+02:00,2025-05-25,19:48,11,3,14
27,2025-05-25T11:49:00+02:00,2025-05-25,19:49,2,0,2
27,2025-05-25T11:54:00+02:00,2025-05-25,19:54,1,0,1
30,2025-05-25T11:42:00+02:00,2025-05-25,19:42,5,9,14
30,2025-05-25T11:44:00+02:00,2025-05-25,19:44,6,4,10
30,2025-05-25T11:45:00+02:00,2025-05-25,19:45,1,9,10
30,2025-05-25T11:50:00+02:00,2025-05-25,19:50,3,6,9
30,2025-05-25T11:51:00+02:00,2025-05-25,19:51,0,8,8
30,2025-05-25T11:52:00+02:00,2025-05-25,19:52,6,4,10
30,2025-05-25T11:53:00+02:00,2025-05-25,19:53,7,9,16
35,2025-05-25T11:40:00+02:00,2025-05-25,19:40,8,4,12
35,2025-05-25T11:43:00+02:00,2025-05-25,19:43,8,6,14
35,2025-05-25T11:46:00+02:00,2025-05-25,19:46,4,4,8
35,2025-05-25T11:48:00+02:00,2025-05-25,19:48,4,10,14
35,2025-05-25T11:49:00+02:00,2025-05-25,19:49,3,5,8
35,2025-05-25T11:50:00+02:00,2025-05-25,19:50,3,10,13
48,2025-05-25T11:40:00+02:00,2025-05-25,19:40,0,1,1
48,2025-05-25T11:44:00+02:00,2025-05-25,19:44,1,0,1
48,2025-05-25T11:49:00+02:00,2025-05-25,19:49,0,1,1
48,2025-05-25T11:53:00+02:00,2025-05-25,19:53,1,1,2
49,2025-05-25T11:41:00+02:00,2025-05-25,19:41,2,1,3
49,2025-05-25T11:42:00+02:00,2025-05-25,19:42,8,1,9
49,2025-05-25T11:43:00+02:00,2025-05-25,19:43,1,2,3
49,2025-05-25T11:45:00+02:00,2025-05-25,19:45,8,1,9
49,2025-05-25T11:48:00+02:00,2025-05-25,19:48,4,1,5
49,2025-05-25T11:49:00+02:00,2025-05-25,19:49,1,5,6
49,2025-05-25T11:51:00+02:00,2025-05-25,19:51,3,0,3
49,2025-05-25T11:52:00+02:00,2025-05-25,19:52,6,2,8
51,2025-05-25T11:43:00+02:00,2025-05-25,19:43,0,1,1
51,2025-05-25T11:48:00+02:00,2025-05-25,19:48,6,0,6
52,2025-05-25T11:43:00+02:00,2025-05-25,19:43,8,6,14
52,2025-05-25T11:49:00+02:00,2025-05-25,19:49,5,8,13
52,2025-05-25T11:51:00+02:00,2025-05-25,19:51,3,1,4
52,2025-05-25T11:53:00+02:00,2025-05-25,19:53,6,4,10
52,2025-05-25T11:54:00+02:00,2025-05-25,19:54,1,1,2
53,2025-05-25T11:40:00+02:00,2025-05-25,19:40,7,6,13
53,2025-05-25T11:42:00+02:00,2025-05-25,19:42,4,1,5
53,2025-05-25T11:43:00+02:00,2025-05-25,19:43,1,5,6
53,2025-05-25T11:46:00+02:00,2025-05-25,19:46,1,4,5
53,2025-05-25T11:48:00+02:00,2025-05-25,19:48,1,5,6
53,2025-05-25T11:50:00+02:00,2025-05-25,19:50,1,4,5
56,2025-05-25T11:48:00+02:00,2025-05-25,19:48,5,12,17
56,2025-05-25T11:50:00+02:00,2025-05-25,19:50,9,4,13
56,2025-05-25T11:52:00+02:00,2025-05-25,19:52,3,11,14
56,2025-05-25T11:53:00+02:00,2025-05-25,19:53,2,4,6
58,2025-05-25T11:41:00+02:00,2025-05-25,19:41,5,11,16
58,2025-05-25T11:49:00+02:00,2025-05-25,19:49,2,3,5
58,2025-05-25T11:50:00+02:00,2025-05-25,19:50,6,2,8
62,2025-05-25T11:41:00+02:00,2025-05-25,19:41,0,2,2
62,2025-05-25T11:42:00+02:00,2025-05-25,19:42,3,5,8
62,2025-05-25T11:46:00+02:00,2025-05-25,19:46,5,0,5
63,2025-05-25T11:41:00+02:00,2025-05-25,19:41,0,1,1
63,2025-05-25T11:45:00+02:00,2025-05-25,19:45,0,1,1
63,2025-05-25T11:49:00+02:00,2025-05-25,19:49,1,6,7
63,2025-05-25T11:50:00+02:00,2025-05-25,19:50,0,6,6
63,2025-05-25T11:53:00+02:00,2025-05-25,19:53,0,5,5
67,2025-05-25T11:47:00+02:00,2025-05-25,19:47,2,2,4
67,2025-05-25T11:51:00+02:00,2025-05-25,19:51,2,3,5
67,2025-05-25T11:54:00+02:00,2025-05-25,19:54,0,8,8
68,2025-05-25T11:43:00+02:00,2025-05-25,19:43,1,2,3
68,2025-05-25T11:46:00+02:00,2025-05-25,19:46,0,1,1
68,2025-05-25T11:53:00+02:00,2025-05-25,19:53,3,2,5
72,2025-05-25T11:43:00+02:00,2025-05-25,19:43,5,9,14
72,2025-05-25T11:44:00+02:00,2025-05-25,19:44,0,4,4
72,2025-05-25T11:46:00+02:00,2025-05-25,19:46,1,2,3
72,2025-05-25T11:50:00+02:00,2025-05-25,19:50,2,4,6
72,2025-05-25T11:53:00+02:00,2025-05-25,19:53,12,4,16
76,2025-05-25T11:41:00+02:00,2025-05-25,19:41,0,1,1
76,2025-05-25T11:42:00+02:00,2025-05-25,19:42,0,1,1
76,2025-05-25T11:47:00+02:00,2025-05-25,19:47,0,2,2
79,2025-05-25T11:46:00+02:00,2025-05-25,19:46,3,6,9
79,2025-05-25T11:49:00+02:00,2025-05-25,19:49,5,4,9
79,2025-05-25T11:52:00+02:00,2025-05-25,19:52,9,5,14
85,2025-05-25T11:51:00+02:00,2025-05-25,19:51,0,1,1
85,2025-05-25T11:54:00+02:00,2025-05-25,19:54,0,2,2
86,2025-05-25T11:44:00+02:00,2025-05-25,19:44,0,3,3
86,2025-05-25T11:51:00+02:00,2025-05-25,19:51,3,0,3
86,2025-05-25T11:53:00+02:00,2025-05-25,19:53,13,2,15
109,2025-05-25T11:40:00+02:00,2025-05-25,19:40,3,8,11
109,2025-05-25T11:45:00+02:00,2025-05-25,19:45,2,2,4
117,2025-05-25T11:40:00+02:00,2025-05-25,19:40,9,11,20
136,2025-05-25T11:40:00+02:00,2025-05-25,19:40,1,3,4
136,2025-05-25T11:45:00+02:00,2025-05-25,19:45,3,0,3
139,2025-05-25T11:40:00+02:00,2025-05-25,19:40,0,2,2
141,2025-05-25T11:45:00+02:00,2025-05-25,19:45,2,5,7
141,2025-05-25T11:50:00+02:00,2025-05-25,19:50,14,5,19
142,2025-05-25T11:40:00+02:00,2025-05-25,19:40,4,2,6
142,2025-05-25T11:50:00+02:00,2025-05-25,19:50,3,2,5
161,2025-05-25T11:40:00+02:00,2025-05-25,19:40,1,0,1
161,2025-05-25T11:45:00+02:00,2025-05-25,19:45,0,1,1
164,2025-05-25T11:50:00+02:00,2025-05-25,19:50,4,5,9
181,2025-05-25T11:43:00+02:00,2025-05-25,19:43,16,7,23
181,2025-05-25T11:44:00+02:00,2025-05-25,19:44,4,17,21
181,2025-05-25T11:45:00+02:00,2025-05-25,19:45,18,3,21
181,2025-05-25T11:49:00+02:00,2025-05-25,19:49,14,15,29
181,2025-05-25T11:53:00+02:00,2025-05-25,19:53,17,11,28
182,2025-05-25T11:50:00+02:00,2025-05-25,19:50,31,13,44
3,2025-05-25T11:55:00+02:00,2025-05-25,19:55,4,22,26
3,2025-05-25T11:58:00+02:00,2025-05-25,19:58,4,20,24
3,2025-05-25T11:59:00+02:00,2025-05-25,19:59,28,14,42
3,2025-05-25T12:00:00+02:00,2025-05-25,20:00,5,21,26
3,2025-05-25T12:03:00+02:00,2025-05-25,20:03,15,16,31
3,2025-05-25T12:07:00+02:00,2025-05-25,20:07,8,7,15
3,2025-05-25T12:09:00+02:00,2025-05-25,20:09,15,14,29
4,2025-05-25T11:55:00+02:00,2025-05-25,19:55,3,7,10
4,2025-05-25T11:57:00+02:00,2025-05-25,19:57,7,15,22
4,2025-05-25T12:01:00+02:00,2025-05-25,20:01,11,9,20
4,2025-05-25T12:05:00+02:00,2025-05-25,20:05,16,11,27
4,2025-05-25T12:07:00+02:00,2025-05-25,20:07,6,14,20
4,2025-05-25T12:09:00+02:00,2025-05-25,20:09,10,11,21
5,2025-05-25T12:00:00+02:00,2025-05-25,20:00,10,24,34
5,2025-05-25T12:05:00+02:00,2025-05-25,20:05,33,61,94
6,2025-05-25T11:55:00+02:00,2025-05-25,19:55,3,1,4
6,2025-05-25T11:57:00+02:00,2025-05-25,19:57,6,6,12
6,2025-05-25T11:58:00+02:00,2025-05-25,19:58,5,10,15
6,2025-05-25T12:00:00+02:00,2025-05-25,20:00,7,2,9
8,2025-05-25T12:00:00+02:00,2025-05-25,20:00,3,0,3
21,2025-05-25T12:05:00+02:00,2025-05-25,20:05,16,34,50
28,2025-05-25T11:56:00+02:00,2025-05-25,19:56,0,1,1
28,2025-05-25T11:58:00+02:00,2025-05-25,19:58,1,4,5
28,2025-05-25T12:00:00+02:00,2025-05-25,20:00,3,1,4
28,2025-05-25T12:01:00+02:00,2025-05-25,20:01,5,0,5
29,2025-05-25T11:57:00+02:00,2025-05-25,19:57,2,8,10
29,2025-05-25T11:58:00+02:00,2025-05-25,19:58,2,0,2
29,2025-05-25T12:07:00+02:00,2025-05-25,20:07,2,0,2
29,2025-05-25T12:08:00+02:00,2025-05-25,20:08,0,5,5
31,2025-05-25T11:56:00+02:00,2025-05-25,19:56,1,5,6
31,2025-05-25T12:00:00+02:00,2025-05-25,20:00,0,4,4
31,2025-05-25T12:04:00+02:00,2025-05-25,20:04,3,0,3
31,2025-05-25T12:08:00+02:00,2025-05-25,20:08,4,6,10
36,2025-05-25T11:58:00+02:00,2025-05-25,19:58,0,2,2
36,2025-05-25T11:59:00+02:00,2025-05-25,19:59,2,0,2
36,2025-05-25T12:09:00+02:00,2025-05-25,20:09,0,3,3
39,2025-05-25T12:05:00+02:00,2025-05-25,20:05,0,1,1
40,2025-05-25T11:56:00+02:00,2025-05-25,19:56,0,2,2
40,2025-05-25T12:00:00+02:00,2025-05-25,20:00,0,1,1
40,2025-05-25T12:04:00+02:00,2025-05-25,20:04,10,1,11
40,2025-05-25T12:07:00+02:00,2025-05-25,20:07,2,0,2
41,2025-05-25T11:55:00+02:00,2025-05-25,19:55,5,2,7
41,2025-05-25T11:56:00+02:00,2025-05-25,19:56,1,2,3
41,2025-05-25T11:57:00+02:00,2025-05-25,19:57,4,3,7
41,2025-05-25T12:00:00+02:00,2025-05-25,20:00,1,2,3
41,2025-05-25T12:04:00+02:00,2025-05-25,20:04,0,2,2
41,2025-05-25T12:05:00+02:00,2025-05-25,20:05,1,2,3
43,2025-05-25T11:55:00+02:00,2025-05-25,19:55,7,0,7
45,2025-05-25T11:58:00+02:00,2025-05-25,19:58,13,10,23
45,2025-05-25T11:59:00+02:00,2025-05-25,19:59,4,13,17
45,2025-05-25T12:04:00+02:00,2025-05-25,20:04,8,5,13
45,2025-05-25T12:06:00+02:00,2025-05-25,20:06,6,10,16
45,2025-05-25T12:07:00+02:00,2025-05-25,20:07,3,13,16
45,2025-05-25T12:08:00+02:00,2025-05-25,20:08,5,13,18
45,2025-05-25T12:09:00+02:00,2025-05-25,20:09,2,13,15
47,2025-05-25T11:56:00+02:00,2025-05-25,19:56,13,8,21
47,2025-05-25T11:58:00+02:00,2025-05-25,19:58,5,1,6
47,2025-05-25T11:59:00+02:00,2025-05-25,19:59,3,14,17
47,2025-05-25T12:00:00+02:00,2025-05-25,20:00,4,19,23
47,2025-05-25T12:04:00+02:00,2025-05-25,20:04,4,3,7
47,2025-05-25T12:06:00+02:00,2025-05-25,20:06,15,7,22
47,2025-05-25T12:07:00+02:00,2025-05-25,20:07,9,7,16
47,2025-05-25T12:09:00+02:00,2025-05-25,20:09,2,8,10
50,2025-05-25T11:56:00+02:00,2025-05-25,19:56,6,2,8
50,2025-05-25T11:57:00+02:00,2025-05-25,19:57,6,3,9
50,2025-05-25T11:58:00+02:00,2025-05-25,19:58,3,1,4
50,2025-05-25T12:03:00+02:00,2025-05-25,20:03,8,0,8
50,2025-05-25T12:04:00+02:00,2025-05-25,20:04,0,1,1
50,2025-05-25T12:05:00+02:00,2025-05-25,20:05,0,1,1
50,2025-05-25T12:07:00+02:00,2025-05-25,20:07,5,2,7
54,2025-05-25T12:00:00+02:00,2025-05-25,20:00,9,5,14
54,2025-05-25T12:01:00+02:00,2025-05-25,20:01,1,1,2
54,2025-05-25T12:04:00+02:00,2025-05-25,20:04,0,2,2
54,2025-05-25T12:05:00+02:00,2025-05-25,20:05,1,2,3
54,2025-05-25T12:07:00+02:00,2025-05-25,20:07,2,2,4
61,2025-05-25T11:58:00+02:00,2025-05-25,19:58,9,1,10
61,2025-05-25T12:03:00+02:00,2025-05-25,20:03,6,3,9
66,2025-05-25T11:56:00+02:00,2025-05-25,19:56,17,13,30
66,2025-05-25T11:58:00+02:00,2025-05-25,19:58,16,11,27
66,2025-05-25T11:59:00+02:00,2025-05-25,19:59,13,28,41
66,2025-05-25T12:00:00+02:00,2025-05-25,20:00,14,11,25
66,2025-05-25T12:02:00+02:00,2025-05-25,20:02,15,12,27
66,2025-05-25T12:04:00+02:00,2025-05-25,20:04,21,22,43
66,2025-05-25T12:07:00+02:00,2025-05-25,20:07,14,5,19
66,2025-05-25T12:08:00+02:00,2025-05-25,20:08,14,18,32
69,2025-05-25T11:59:00+02:00,2025-05-25,19:59,3,1,4
69,2025-05-25T12:06:00+02:00,2025-05-25,20:06,0,1,1
70,2025-05-25T11:55:00+02:00,2025-05-25,19:55,0,2,2
70,2025-05-25T11:56:00+02:00,2025-05-25,19:56,5,1,6
70,2025-05-25T11:58:00+02:00,2025-05-25,19:58,2,4,6
70,2025-05-25T12:02:00+02:00,2025-05-25,20:02,2,3,5
70,2025-05-25T12:03:00+02:00,2025-05-25,20:03,2,4,6
70,2025-05-25T12:04:00+02:00,2025-05-25,20:04,4,2,6
70,2025-05-25T12:06:00+02:00,2025-05-25,20:06,0,5,5
70,2025-05-25T12:08:00+02:00,2025-05-25,20:08,2,0,2
70,2025-05-25T12:09:00+02:00,2025-05-25,20:09,0,1,1
71,2025-05-25T11:57:00+02:00,2025-05-25,19:57,0,1,1
71,2025-05-25T12:04:00+02:00,2025-05-25,20:04,1,1,2
71,2025-05-25T12:07:00+02:00,2025-05-25,20:07,1,1,2
75,2025-05-25T11:58:00+02:00,2025-05-25,19:58,0,2,2
77,2025-05-25T11:55:00+02:00,2025-05-25,19:55,13,1,14
78,2025-05-25T12:01:00+02:00,2025-05-25,20:01,0,2,2
84,2025-05-25T12:05:00+02:00,2025-05-25,20:05,34,31,65
87,2025-05-25T12:03:00+02:00,2025-05-25,20:03,1,0,1
87,2025-05-25T12:04:00+02:00,2025-05-25,20:04,2,0,2
87,2025-05-25T12:05:00+02:00,2025-05-25,20:05,0,1,1
107,2025-05-25T11:55:00+02:00,2025-05-25,19:55,2,2,4
107,2025-05-25T12:00:00+02:00,2025-05-25,20:00,4,3,7
108,2025-05-25T11:58:00+02:00,2025-05-25,19:58,2,0,2
108,2025-05-25T11:59:00+02:00,2025-05-25,19:59,8,2,10
108,2025-05-25T12:02:00+02:00,2025-05-25,20:02,0,2,2
108,2025-05-25T12:05:00+02:00,2025-05-25,20:05,4,0,4
108,2025-05-25T12:06:00+02:00,2025-05-25,20:06,0,1,1
118,2025-05-25T12:05:00+02:00,2025-05-25,20:05,0,3,3
133,2025-05-25T12:00:00+02:00,2025-05-25,20:00,40,21,61
135,2025-05-25T12:05:00+02:00,2025-05-25,20:05,13,18,31
165,2025-05-25T12:00:00+02:00,2025-05-25,20:00,8,0,8
165,2025-05-25T12:05:00+02:00,2025-05-25,20:05,1,0,1
167,2025-05-25T12:00:00+02:00,2025-05-25,20:00,1,0,1
1,2025-05-25T11:57:00+02:00,2025-05-25,19:57,10,2,12
1,2025-05-25T12:00:00+02:00,2025-05-25,20:00,2,3,5
1,2025-05-25T12:02:00+02:00,2025-05-25,20:02,6,4,10
1,2025-05-25T12:05:00+02:00,2025-05-25,20:05,7,5,12
1,2025-05-25T12:08:00+02:00,2025-05-25,20:08,4,5,9
1,2025-05-25T12:09:00+02:00,2025-05-25,20:09,8,1,9
2,2025-05-25T11:55:00+02:00,2025-05-25,19:55,0,1,1
2,2025-05-25T11:57:00+02:00,2025-05-25,19:57,0,3,3
2,2025-05-25T12:00:00+02:00,2025-05-25,20:00,7,1,8
2,2025-05-25T12:03:00+02:00,2025-05-25,20:03,2,2,4
2,2025-05-25T12:05:00+02:00,2025-05-25,20:05,0,6,6
9,2025-05-25T12:02:00+02:00,2025-05-25,20:02,0,1,1
9,2025-05-25T12:07:00+02:00,2025-05-25,20:07,1,0,1
9,2025-05-25T12:09:00+02:00,2025-05-25,20:09,2,0,2
10,2025-05-25T11:56:00+02:00,2025-05-25,19:56,2,0,2
10,2025-05-25T11:58:00+02:00,2025-05-25,19:58,0,1,1
10,2025-05-25T12:05:00+02:00,2025-05-25,20:05,0,1,1
11,2025-05-25T11:55:00+02:00,2025-05-25,19:55,2,3,5
12,2025-05-25T11:55:00+02:00,2025-05-25,19:55,2,1,3
12,2025-05-25T11:57:00+02:00,2025-05-25,19:57,3,0,3
12,2025-05-25T11:59:00+02:00,2025-05-25,19:59,2,1,3
12,2025-05-25T12:01:00+02:00,2025-05-25,20:01,0,3,3
12,2025-05-25T12:08:00+02:00,2025-05-25,20:08,5,1,6
17,2025-05-25T11:56:00+02:00,2025-05-25,19:56,0,2,2
19,2025-05-25T11:55:00+02:00,2025-05-25,19:55,9,17,26
19,2025-05-25T11:56:00+02:00,2025-05-25,19:56,15,3,18
19,2025-05-25T11:57:00+02:00,2025-05-25,19:57,4,13,17
19,2025-05-25T12:01:00+02:00,2025-05-25,20:01,5,6,11
19,2025-05-25T12:03:00+02:00,2025-05-25,20:03,9,10,19
19,2025-05-25T12:04:00+02:00,2025-05-25,20:04,14,8,22
20,2025-05-25T11:56:00+02:00,2025-05-25,19:56,4,9,13
20,2025-05-25T11:57:00+02:00,2025-05-25,19:57,1,6,7
20,2025-05-25T12:00:00+02:00,2025-05-25,20:00,1,6,7
20,2025-05-25T12:03:00+02:00,2025-05-25,20:03,1,18,19
20,2025-05-25T12:08:00+02:00,2025-05-25,20:08,3,5,8
20,2025-05-25T12:09:00+02:00,2025-05-25,20:09,3,4,7
23,2025-05-25T11:55:00+02:00,2025-05-25,19:55,1,4,5
23,2025-05-25T11:59:00+02:00,2025-05-25,19:59,0,1,1
23,2025-05-25T12:01:00+02:00,2025-05-25,20:01,3,1,4
23,2025-05-25T12:02:00+02:00,2025-05-25,20:02,2,4,6
23,2025-05-25T12:04:00+02:00,2025-05-25,20:04,1,4,5
23,2025-05-25T12:09:00+02:00,2025-05-25,20:09,1,2,3
24,2025-05-25T11:58:00+02:00,2025-05-25,19:58,0,1,1
24,2025-05-25T11:59:00+02:00,2025-05-25,19:59,2,0,2
24,2025-05-25T12:00:00+02:00,2025-05-25,20:00,5,1,6
24,2025-05-25T12:06:00+02:00,2025-05-25,20:06,10,13,23
27,2025-05-25T11:57:00+02:00,2025-05-25,19:57,3,4,7
30,2025-05-25T11:57:00+02:00,2025-05-25,19:57,5,6,11
30,2025-05-25T12:01:00+02:00,2025-05-25,20:01,6,5,11
30,2025-05-25T12:03:00+02:00,2025-05-25,20:03,0,11,11
30,2025-05-25T12:08:00+02:00,2025-05-25,20:08,2,8,10
35,2025-05-25T11:55:00+02:00,2025-05-25,19:55,0,2,2
35,2025-05-25T12:00:00+02:00,2025-05-25,20:00,8,16,24
35,2025-05-25T12:02:00+02:00,2025-05-25,20:02,8,9,17
35,2025-05-25T12:06:00+02:00,2025-05-25,20:06,10,3,13
35,2025-05-25T12:07:00+02:00,2025-05-25,20:07,4,8,12
35,2025-05-25T12:08:00+02:00,2025-05-25,20:08,8,12,20
48,2025-05-25T11:55:00+02:00,2025-05-25,19:55,0,11,11
48,2025-05-25T12:01:00+02:00,2025-05-25,20:01,1,2,3
48,2025-05-25T12:02:00+02:00,2025-05-25,20:02,1,0,1
48,2025-05-25T12:05:00+02:00,2025-05-25,20:05,2,0,2
49,2025-05-25T11:56:00+02:00,2025-05-25,19:56,1,1,2
49,2025-05-25T11:57:00+02:00,2025-05-25,19:57,3,0,3
49,2025-05-25T11:59:00+02:00,2025-05-25,19:59,1,4,5
49,2025-05-25T12:03:00+02:00,2025-05-25,20:03,4,1,5
49,2025-05-25T12:04:00+02:00,2025-05-25,20:04,0,6,6
49,2025-05-25T12:08:00+02:00,2025-05-25,20:08,0,3,3
51,2025-05-25T11:56:00+02:00,2025-05-25,19:56,0,1,1
52,2025-05-25T12:02:00+02:00,2025-05-25,20:02,6,6,12
52,2025-05-25T12:03:00+02:00,2025-05-25,20:03,1,1,2
52,2025-05-25T12:04:00+02:00,2025-05-25,20:04,3,2,5
52,2025-05-25T12:06:00+02:00,2025-05-25,20:06,5,0,5
53,2025-05-25T11:56:00+02:00,2025-05-25,19:56,2,1,3
53,2025-05-25T11:58:00+02:00,2025-05-25,19:58,1,1,2
53,2025-05-25T11:59:00+02:00,2025-05-25,19:59,2,1,3
53,2025-05-25T12:03:00+02:00,2025-05-25,20:03,4,3,7
53,2025-05-25T12:04:00+02:00,2025-05-25,20:04,1,6,7
53,2025-05-25T12:05:00+02:00,2025-05-25,20:05,1,3,4
53,2025-05-25T12:06:00+02:00,2025-05-25,20:06,0,1,1
56,2025-05-25T11:57:00+02:00,2025-05-25,19:57,7,6,13
56,2025-05-25T12:06:00+02:00,2025-05-25,20:06,11,12,23
56,2025-05-25T12:07:00+02:00,2025-05-25,20:07,5,6,11
58,2025-05-25T11:56:00+02:00,2025-05-25,19:56,7,7,14
58,2025-05-25T11:58:00+02:00,2025-05-25,19:58,7,5,12
58,2025-05-25T12:04:00+02:00,2025-05-25,20:04,14,9,23
58,2025-05-25T12:05:00+02:00,2025-05-25,20:05,6,2,8
58,2025-05-25T12:06:00+02:00,2025-05-25,20:06,4,4,8
62,2025-05-25T11:58:00+02:00,2025-05-25,19:58,3,0,3
62,2025-05-25T11:59:00+02:00,2025-05-25,19:59,2,5,7
62,2025-05-25T12:02:00+02:00,2025-05-25,20:02,7,2,9
62,2025-05-25T12:09:00+02:00,2025-05-25,20:09,0,2,2
63,2025-05-25T11:57:00+02:00,2025-05-25,19:57,0,4,4
63,2025-05-25T11:58:00+02:00,2025-05-25,19:58,2,1,3
63,2025-05-25T12:00:00+02:00,2025-05-25,20:00,0,9,9
67,2025-05-25T11:55:00+02:00,2025-05-25,19:55,3,6,9
67,2025-05-25T11:56:00+02:00,2025-05-25,19:56,7,0,7
67,2025-05-25T12:00:00+02:00,2025-05-25,20:00,0,4,4
67,2025-05-25T12:02:00+02:00,2025-05-25,20:02,0,5,5
67,2025-05-25T12:07:00+02:00,2025-05-25,20:07,3,2,5
67,2025-05-25T12:08:00+02:00,2025-05-25,20:08,4,6,10
68,2025-05-25T11:55:00+02:00,2025-05-25,19:55,7,0,7
68,2025-05-25T11:56:00+02:00,2025-05-25,19:56,4,0,4
68,2025-05-25T11:57:00+02:00,2025-05-25,19:57,2,3,5
68,2025-05-25T12:04:00+02:00,2025-05-25,20:04,3,4,7
72,2025-05-25T11:58:00+02:00,2025-05-25,19:58,2,3,5
72,2025-05-25T12:04:00+02:00,2025-05-25,20:04,5,3,8
72,2025-05-25T12:05:00+02:00,2025-05-25,20:05,18,4,22
72,2025-05-25T12:06:00+02:00,2025-05-25,20:06,5,1,6
72,2025-05-25T12:08:00+02:00,2025-05-25,20:08,2,10,12
76,2025-05-25T11:57:00+02:00,2025-05-25,19:57,0,1,1
79,2025-05-25T12:01:00+02:00,2025-05-25,20:01,10,7,17
79,2025-05-25T12:04:00+02:00,2025-05-25,20:04,2,4,6
79,2025-05-25T12:08:00+02:00,2025-05-25,20:08,3,4,7
85,2025-05-25T12:01:00+02:00,2025-05-25,20:01,2,1,3
85,2025-05-25T12:08:00+02:00,2025-05-25,20:08,1,0,1
86,2025-05-25T11:55:00+02:00,2025-05-25,19:55,0,5,5
86,2025-05-25T12:02:00+02:00,2025-05-25,20:02,1,0,1
109,2025-05-25T12:05:00+02:00,2025-05-25,20:05,6,11,17
117,2025-05-25T11:55:00+02:00,2025-05-25,19:55,9,5,14
130,2025-05-25T12:05:00+02:00,2025-05-25,20:05,2,0,2
138,2025-05-25T12:05:00+02:00,2025-05-25,20:05,1,0,1
139,2025-05-25T12:00:00+02:00,2025-05-25,20:00,0,1,1
141,2025-05-25T12:05:00+02:00,2025-05-25,20:05,12,10,22
164,2025-05-25T11:55:00+02:00,2025-05-25,19:55,6,3,9
164,2025-05-25T12:00:00+02:00,2025-05-25,20:00,11,5,16
164,2025-05-25T12:05:00+02:00,2025-05-25,20:05,4,1,5
181,2025-05-25T11:57:00+02:00,2025-05-25,19:57,11,11,22
181,2025-05-25T11:58:00+02:00,2025-05-25,19:58,12,11,23
181,2025-05-25T12:01:00+02:00,2025-05-25,20:01,9,11,20
181,2025-05-25T12:04:00+02:00,2025-05-25,20:04,9,9,18
182,2025-05-25T12:05:00+02:00,2025-05-25,20:05,21,27,48
180,2025-05-25T12:07:00+02:00,2025-05-25,20:07,0,1,1
3,2025-05-25T09:10:00+02:00,2025-05-25,17:10,31,16,47
3,2025-05-25T09:11:00+02:00,2025-05-25,17:11,37,7,44
3,2025-05-25T09:13:00+02:00,2025-05-25,17:13,20,23,43
3,2025-05-25T09:16:00+02:00,2025-05-25,17:16,18,13,31
3,2025-05-25T09:17:00+02:00,2025-05-25,17:17,25,6,31
3,2025-05-25T09:18:00+02:00,2025-05-25,17:18,8,15,23
3,2025-05-25T09:22:00+02:00,2025-05-25,17:22,27,26,53
4,2025-05-25T09:10:00+02:00,2025-05-25,17:10,35,23,58
4,2025-05-25T09:11:00+02:00,2025-05-25,17:11,19,30,49
4,2025-05-25T09:12:00+02:00,2025-05-25,17:12,35,24,59
4,2025-05-25T09:14:00+02:00,2025-05-25,17:14,24,27,51
4,2025-05-25T09:17:00+02:00,2025-05-25,17:17,35,21,56
5,2025-05-25T09:20:00+02:00,2025-05-25,17:20,66,83,149
6,2025-05-25T09:11:00+02:00,2025-05-25,17:11,10,7,17
6,2025-05-25T09:12:00+02:00,2025-05-25,17:12,12,11,23
6,2025-05-25T09:18:00+02:00,2025-05-25,17:18,16,20,36
6,2025-05-25T09:19:00+02:00,2025-05-25,17:19,15,23,38
8,2025-05-25T09:16:00+02:00,2025-05-25,17:16,2,6,8
8,2025-05-25T09:18:00+02:00,2025-05-25,17:18,8,2,10
8,2025-05-25T09:19:00+02:00,2025-05-25,17:19,2,0,2
8,2025-05-25T09:22:00+02:00,2025-05-25,17:22,5,2,7
8,2025-05-25T09:23:00+02:00,2025-05-25,17:23,2,0,2
28,2025-05-25T09:10:00+02:00,2025-05-25,17:10,3,9,12
28,2025-05-25T09:12:00+02:00,2025-05-25,17:12,12,8,20
28,2025-05-25T09:17:00+02:00,2025-05-25,17:17,5,6,11
28,2025-05-25T09:19:00+02:00,2025-05-25,17:19,9,9,18
28,2025-05-25T09:22:00+02:00,2025-05-25,17:22,5,14,19
29,2025-05-25T09:10:00+02:00,2025-05-25,17:10,9,13,22
29,2025-05-25T09:13:00+02:00,2025-05-25,17:13,11,8,19
29,2025-05-25T09:19:00+02:00,2025-05-25,17:19,3,11,14
29,2025-05-25T09:24:00+02:00,2025-05-25,17:24,13,8,21
31,2025-05-25T09:11:00+02:00,2025-05-25,17:11,11,0,11
31,2025-05-25T09:15:00+02:00,2025-05-25,17:15,5,0,5
31,2025-05-25T09:24:00+02:00,2025-05-25,17:24,11,10,21
36,2025-05-25T09:10:00+02:00,2025-05-25,17:10,4,1,5
36,2025-05-25T09:11:00+02:00,2025-05-25,17:11,2,2,4
36,2025-05-25T09:14:00+02:00,2025-05-25,17:14,4,2,6
36,2025-05-25T09:16:00+02:00,2025-05-25,17:16,1,2,3
36,2025-05-25T09:18:00+02:00,2025-05-25,17:18,2,0,2
36,2025-05-25T09:20:00+02:00,2025-05-25,17:20,0,4,4
39,2025-05-25T09:20:00+02:00,2025-05-25,17:20,1,0,1
40,2025-05-25T09:14:00+02:00,2025-05-25,17:14,2,3,5
40,2025-05-25T09:18:00+02:00,2025-05-25,17:18,2,1,3
40,2025-05-25T09:22:00+02:00,2025-05-25,17:22,0,3,3
41,2025-05-25T09:10:00+02:00,2025-05-25,17:10,8,6,14
41,2025-05-25T09:11:00+02:00,2025-05-25,17:11,9,8,17
41,2025-05-25T09:13:00+02:00,2025-05-25,17:13,6,21,27
41,2025-05-25T09:17:00+02:00,2025-05-25,17:17,8,10,18
41,2025-05-25T09:18:00+02:00,2025-05-25,17:18,11,10,21
41,2025-05-25T09:24:00+02:00,2025-05-25,17:24,19,12,31
43,2025-05-25T09:20:00+02:00,2025-05-25,17:20,1,9,10
44,2025-05-25T09:20:00+02:00,2025-05-25,17:20,3,1,4
45,2025-05-25T09:14:00+02:00,2025-05-25,17:14,12,11,23
45,2025-05-25T09:15:00+02:00,2025-05-25,17:15,26,9,35
45,2025-05-25T09:22:00+02:00,2025-05-25,17:22,9,13,22
47,2025-05-25T09:15:00+02:00,2025-05-25,17:15,17,5,22
47,2025-05-25T09:16:00+02:00,2025-05-25,17:16,16,11,27
47,2025-05-25T09:18:00+02:00,2025-05-25,17:18,11,9,20
47,2025-05-25T09:20:00+02:00,2025-05-25,17:20,18,26,44
47,2025-05-25T09:21:00+02:00,2025-05-25,17:21,16,19,35
47,2025-05-25T09:23:00+02:00,2025-05-25,17:23,13,24,37
50,2025-05-25T09:11:00+02:00,2025-05-25,17:11,6,3,9
50,2025-05-25T09:20:00+02:00,2025-05-25,17:20,12,3,15
50,2025-05-25T09:22:00+02:00,2025-05-25,17:22,3,3,6
50,2025-05-25T09:24:00+02:00,2025-05-25,17:24,4,2,6
54,2025-05-25T09:11:00+02:00,2025-05-25,17:11,0,3,3
54,2025-05-25T09:14:00+02:00,2025-05-25,17:14,1,6,7
54,2025-05-25T09:21:00+02:00,2025-05-25,17:21,0,1,1
54,2025-05-25T09:24:00+02:00,2025-05-25,17:24,1,1,2
61,2025-05-25T09:10:00+02:00,2025-05-25,17:10,8,10,18
61,2025-05-25T09:11:00+02:00,2025-05-25,17:11,3,1,4
61,2025-05-25T09:13:00+02:00,2025-05-25,17:13,4,7,11
61,2025-05-25T09:17:00+02:00,2025-05-25,17:17,4,3,7
61,2025-05-25T09:18:00+02:00,2025-05-25,17:18,7,2,9
61,2025-05-25T09:23:00+02:00,2025-05-25,17:23,8,9,17
66,2025-05-25T09:12:00+02:00,2025-05-25,17:12,28,21,49
66,2025-05-25T09:13:00+02:00,2025-05-25,17:13,15,32,47
66,2025-05-25T09:14:00+02:00,2025-05-25,17:14,28,19,47
66,2025-05-25T09:18:00+02:00,2025-05-25,17:18,29,42,71
66,2025-05-25T09:19:00+02:00,2025-05-25,17:19,47,34,81
66,2025-05-25T09:22:00+02:00,2025-05-25,17:22,21,42,63
69,2025-05-25T09:20:00+02:00,2025-05-25,17:20,2,2,4
70,2025-05-25T09:10:00+02:00,2025-05-25,17:10,3,1,4
70,2025-05-25T09:16:00+02:00,2025-05-25,17:16,0,3,3
70,2025-05-25T09:17:00+02:00,2025-05-25,17:17,0,7,7
70,2025-05-25T09:24:00+02:00,2025-05-25,17:24,1,3,4
71,2025-05-25T09:12:00+02:00,2025-05-25,17:12,1,0,1
75,2025-05-25T09:15:00+02:00,2025-05-25,17:15,0,2,2
75,2025-05-25T09:16:00+02:00,2025-05-25,17:16,0,3,3
75,2025-05-25T09:23:00+02:00,2025-05-25,17:23,3,2,5
75,2025-05-25T09:24:00+02:00,2025-05-25,17:24,0,1,1
77,2025-05-25T09:15:00+02:00,2025-05-25,17:15,16,12,28
78,2025-05-25T09:12:00+02:00,2025-05-25,17:12,0,1,1
78,2025-05-25T09:13:00+02:00,2025-05-25,17:13,0,3,3
78,2025-05-25T09:19:00+02:00,2025-05-25,17:19,0,1,1
78,2025-05-25T09:21:00+02:00,2025-05-25,17:21,1,1,2
84,2025-05-25T09:10:00+02:00,2025-05-25,17:10,65,106,171
84,2025-05-25T09:20:00+02:00,2025-05-25,17:20,92,150,242
87,2025-05-25T09:10:00+02:00,2025-05-25,17:10,1,2,3
87,2025-05-25T09:13:00+02:00,2025-05-25,17:13,2,1,3
87,2025-05-25T09:15:00+02:00,2025-05-25,17:15,2,3,5
87,2025-05-25T09:16:00+02:00,2025-05-25,17:16,1,0,1
87,2025-05-25T09:20:00+02:00,2025-05-25,17:20,0,2,2
87,2025-05-25T09:21:00+02:00,2025-05-25,17:21,2,2,4
87,2025-05-25T09:23:00+02:00,2025-05-25,17:23,2,3,5
108,2025-05-25T09:14:00+02:00,2025-05-25,17:14,2,0,2
108,2025-05-25T09:16:00+02:00,2025-05-25,17:16,7,3,10
108,2025-05-25T09:18:00+02:00,2025-05-25,17:18,1,3,4
108,2025-05-25T09:24:00+02:00,2025-05-25,17:24,3,0,3
132,2025-05-25T09:20:00+02:00,2025-05-25,17:20,14,2,16
133,2025-05-25T09:15:00+02:00,2025-05-25,17:15,34,37,71
133,2025-05-25T09:20:00+02:00,2025-05-25,17:20,25,33,58
134,2025-05-25T09:10:00+02:00,2025-05-25,17:10,39,27,66
140,2025-05-25T09:20:00+02:00,2025-05-25,17:20,8,5,13
166,2025-05-25T09:20:00+02:00,2025-05-25,17:20,2,5,7
167,2025-05-25T09:10:00+02:00,2025-05-25,17:10,7,7,14
167,2025-05-25T09:15:00+02:00,2025-05-25,17:15,3,3,6
167,2025-05-25T09:20:00+02:00,2025-05-25,17:20,2,7,9
179,2025-05-25T09:15:00+02:00,2025-05-25,17:15,3,3,6
179,2025-05-25T09:20:00+02:00,2025-05-25,17:20,2,7,9
1,2025-05-25T09:11:00+02:00,2025-05-25,17:11,17,21,38
1,2025-05-25T09:12:00+02:00,2025-05-25,17:12,19,14,33
1,2025-05-25T09:13:00+02:00,2025-05-25,17:13,26,9,35
1,2025-05-25T09:17:00+02:00,2025-05-25,17:17,23,12,35
1,2025-05-25T09:19:00+02:00,2025-05-25,17:19,16,22,38
2,2025-05-25T09:15:00+02:00,2025-05-25,17:15,7,3,10
2,2025-05-25T09:17:00+02:00,2025-05-25,17:17,11,1,12
2,2025-05-25T09:23:00+02:00,2025-05-25,17:23,6,15,21
9,2025-05-25T09:12:00+02:00,2025-05-25,17:12,2,0,2
9,2025-05-25T09:15:00+02:00,2025-05-25,17:15,2,0,2
9,2025-05-25T09:22:00+02:00,2025-05-25,17:22,1,1,2
10,2025-05-25T09:19:00+02:00,2025-05-25,17:19,3,1,4
10,2025-05-25T09:20:00+02:00,2025-05-25,17:20,0,1,1
10,2025-05-25T09:21:00+02:00,2025-05-25,17:21,1,0,1
10,2025-05-25T09:22:00+02:00,2025-05-25,17:22,4,1,5
11,2025-05-25T09:10:00+02:00,2025-05-25,17:10,1,5,6
11,2025-05-25T09:20:00+02:00,2025-05-25,17:20,6,1,7
12,2025-05-25T09:14:00+02:00,2025-05-25,17:14,0,18,18
12,2025-05-25T09:15:00+02:00,2025-05-25,17:15,2,3,5
12,2025-05-25T09:20:00+02:00,2025-05-25,17:20,4,0,4
17,2025-05-25T09:12:00+02:00,2025-05-25,17:12,0,1,1
17,2025-05-25T09:13:00+02:00,2025-05-25,17:13,2,0,2
17,2025-05-25T09:17:00+02:00,2025-05-25,17:17,2,3,5
17,2025-05-25T09:20:00+02:00,2025-05-25,17:20,1,5,6
17,2025-05-25T09:21:00+02:00,2025-05-25,17:21,0,3,3
17,2025-05-25T09:23:00+02:00,2025-05-25,17:23,2,7,9
18,2025-05-25T09:20:00+02:00,2025-05-25,17:20,2,0,2
19,2025-05-25T09:11:00+02:00,2025-05-25,17:11,24,5,29
19,2025-05-25T09:17:00+02:00,2025-05-25,17:17,12,7,19
19,2025-05-25T09:18:00+02:00,2025-05-25,17:18,8,4,12
19,2025-05-25T09:23:00+02:00,2025-05-25,17:23,8,14,22
20,2025-05-25T09:14:00+02:00,2025-05-25,17:14,8,6,14
20,2025-05-25T09:16:00+02:00,2025-05-25,17:16,3,1,4
20,2025-05-25T09:18:00+02:00,2025-05-25,17:18,11,4,15
20,2025-05-25T09:19:00+02:00,2025-05-25,17:19,3,6,9
20,2025-05-25T09:24:00+02:00,2025-05-25,17:24,4,3,7
23,2025-05-25T09:10:00+02:00,2025-05-25,17:10,0,5,5
23,2025-05-25T09:12:00+02:00,2025-05-25,17:12,2,5,7
23,2025-05-25T09:16:00+02:00,2025-05-25,17:16,9,0,9
23,2025-05-25T09:19:00+02:00,2025-05-25,17:19,2,6,8
23,2025-05-25T09:22:00+02:00,2025-05-25,17:22,0,8,8
23,2025-05-25T09:23:00+02:00,2025-05-25,17:23,3,6,9
23,2025-05-25T09:24:00+02:00,2025-05-25,17:24,4,8,12
24,2025-05-25T09:10:00+02:00,2025-05-25,17:10,2,19,21
24,2025-05-25T09:22:00+02:00,2025-05-25,17:22,2,16,18
24,2025-05-25T09:24:00+02:00,2025-05-25,17:24,2,17,19
27,2025-05-25T09:10:00+02:00,2025-05-25,17:10,0,3,3
27,2025-05-25T09:12:00+02:00,2025-05-25,17:12,0,2,2
27,2025-05-25T09:13:00+02:00,2025-05-25,17:13,1,0,1
27,2025-05-25T09:16:00+02:00,2025-05-25,17:16,4,1,5
30,2025-05-25T09:12:00+02:00,2025-05-25,17:12,10,8,18
30,2025-05-25T09:13:00+02:00,2025-05-25,17:13,10,4,14
30,2025-05-25T09:17:00+02:00,2025-05-25,17:17,4,6,10
30,2025-05-25T09:20:00+02:00,2025-05-25,17:20,1,8,9
35,2025-05-25T09:12:00+02:00,2025-05-25,17:12,25,12,37
35,2025-05-25T09:14:00+02:00,2025-05-25,17:14,10,15,25
35,2025-05-25T09:15:00+02:00,2025-05-25,17:15,20,20,40
35,2025-05-25T09:17:00+02:00,2025-05-25,17:17,23,26,49
35,2025-05-25T09:18:00+02:00,2025-05-25,17:18,21,12,33
35,2025-05-25T09:19:00+02:00,2025-05-25,17:19,14,22,36
35,2025-05-25T09:21:00+02:00,2025-05-25,17:21,14,13,27
48,2025-05-25T09:10:00+02:00,2025-05-25,17:10,3,0,3
48,2025-05-25T09:12:00+02:00,2025-05-25,17:12,4,4,8
48,2025-05-25T09:13:00+02:00,2025-05-25,17:13,5,0,5
48,2025-05-25T09:16:00+02:00,2025-05-25,17:16,1,0,1
48,2025-05-25T09:19:00+02:00,2025-05-25,17:19,3,0,3
48,2025-05-25T09:21:00+02:00,2025-05-25,17:21,1,0,1
48,2025-05-25T09:22:00+02:00,2025-05-25,17:22,3,3,6
49,2025-05-25T09:10:00+02:00,2025-05-25,17:10,3,10,13
49,2025-05-25T09:14:00+02:00,2025-05-25,17:14,3,0,3
49,2025-05-25T09:16:00+02:00,2025-05-25,17:16,1,1,2
49,2025-05-25T09:17:00+02:00,2025-05-25,17:17,0,3,3
49,2025-05-25T09:18:00+02:00,2025-05-25,17:18,2,3,5
49,2025-05-25T09:19:00+02:00,2025-05-25,17:19,14,2,16
49,2025-05-25T09:23:00+02:00,2025-05-25,17:23,5,5,10
51,2025-05-25T09:12:00+02:00,2025-05-25,17:12,3,6,9
51,2025-05-25T09:14:00+02:00,2025-05-25,17:14,1,0,1
51,2025-05-25T09:15:00+02:00,2025-05-25,17:15,3,3,6
51,2025-05-25T09:22:00+02:00,2025-05-25,17:22,1,1,2
51,2025-05-25T09:23:00+02:00,2025-05-25,17:23,1,1,2
52,2025-05-25T09:20:00+02:00,2025-05-25,17:20,6,3,9
53,2025-05-25T09:17:00+02:00,2025-05-25,17:17,4,3,7
53,2025-05-25T09:22:00+02:00,2025-05-25,17:22,3,6,9
53,2025-05-25T09:23:00+02:00,2025-05-25,17:23,5,2,7
56,2025-05-25T09:14:00+02:00,2025-05-25,17:14,10,11,21
56,2025-05-25T09:21:00+02:00,2025-05-25,17:21,4,10,14
58,2025-05-25T09:11:00+02:00,2025-05-25,17:11,5,4,9
58,2025-05-25T09:16:00+02:00,2025-05-25,17:16,9,16,25
58,2025-05-25T09:20:00+02:00,2025-05-25,17:20,6,2,8
58,2025-05-25T09:24:00+02:00,2025-05-25,17:24,8,5,13
62,2025-05-25T09:11:00+02:00,2025-05-25,17:11,6,2,8
62,2025-05-25T09:13:00+02:00,2025-05-25,17:13,6,3,9
62,2025-05-25T09:14:00+02:00,2025-05-25,17:14,5,5,10
62,2025-05-25T09:15:00+02:00,2025-05-25,17:15,4,3,7
62,2025-05-25T09:16:00+02:00,2025-05-25,17:16,1,2,3
62,2025-05-25T09:18:00+02:00,2025-05-25,17:18,2,5,7
62,2025-05-25T09:19:00+02:00,2025-05-25,17:19,1,9,10
62,2025-05-25T09:22:00+02:00,2025-05-25,17:22,4,2,6
62,2025-05-25T09:23:00+02:00,2025-05-25,17:23,2,2,4
63,2025-05-25T09:19:00+02:00,2025-05-25,17:19,4,8,12
67,2025-05-25T09:12:00+02:00,2025-05-25,17:12,0,9,9
67,2025-05-25T09:15:00+02:00,2025-05-25,17:15,2,8,10
67,2025-05-25T09:20:00+02:00,2025-05-25,17:20,7,2,9
67,2025-05-25T09:24:00+02:00,2025-05-25,17:24,8,7,15
68,2025-05-25T09:14:00+02:00,2025-05-25,17:14,0,2,2
68,2025-05-25T09:16:00+02:00,2025-05-25,17:16,1,0,1
68,2025-05-25T09:24:00+02:00,2025-05-25,17:24,4,2,6
72,2025-05-25T09:10:00+02:00,2025-05-25,17:10,11,14,25
72,2025-05-25T09:12:00+02:00,2025-05-25,17:12,6,6,12
72,2025-05-25T09:15:00+02:00,2025-05-25,17:15,5,13,18
72,2025-05-25T09:20:00+02:00,2025-05-25,17:20,0,10,10
72,2025-05-25T09:21:00+02:00,2025-05-25,17:21,0,4,4
72,2025-05-25T09:22:00+02:00,2025-05-25,17:22,2,11,13
76,2025-05-25T09:10:00+02:00,2025-05-25,17:10,1,0,1
76,2025-05-25T09:12:00+02:00,2025-05-25,17:12,4,0,4
76,2025-05-25T09:13:00+02:00,2025-05-25,17:13,0,1,1
76,2025-05-25T09:18:00+02:00,2025-05-25,17:18,1,0,1
76,2025-05-25T09:22:00+02:00,2025-05-25,17:22,0,1,1
79,2025-05-25T09:13:00+02:00,2025-05-25,17:13,7,4,11
79,2025-05-25T09:14:00+02:00,2025-05-25,17:14,8,13,21
79,2025-05-25T09:22:00+02:00,2025-05-25,17:22,9,14,23
79,2025-05-25T09:23:00+02:00,2025-05-25,17:23,6,6,12
79,2025-05-25T09:24:00+02:00,2025-05-25,17:24,26,14,40
85,2025-05-25T09:10:00+02:00,2025-05-25,17:10,0,2,2
85,2025-05-25T09:16:00+02:00,2025-05-25,17:16,3,0,3
86,2025-05-25T09:10:00+02:00,2025-05-25,17:10,2,2,4
86,2025-05-25T09:14:00+02:00,2025-05-25,17:14,1,0,1
86,2025-05-25T09:15:00+02:00,2025-05-25,17:15,3,3,6
86,2025-05-25T09:16:00+02:00,2025-05-25,17:16,2,1,3
109,2025-05-25T09:15:00+02:00,2025-05-25,17:15,5,14,19
123,2025-05-25T09:20:00+02:00,2025-05-25,17:20,15,3,18
136,2025-05-25T09:10:00+02:00,2025-05-25,17:10,14,6,20
136,2025-05-25T09:20:00+02:00,2025-05-25,17:20,15,5,20
137,2025-05-25T09:20:00+02:00,2025-05-25,17:20,0,1,1
138,2025-05-25T09:10:00+02:00,2025-05-25,17:10,0,3,3
139,2025-05-25T09:15:00+02:00,2025-05-25,17:15,9,5,14
142,2025-05-25T09:10:00+02:00,2025-05-25,17:10,51,48,99
142,2025-05-25T09:20:00+02:00,2025-05-25,17:20,67,57,124
161,2025-05-25T09:10:00+02:00,2025-05-25,17:10,26,18,44
161,2025-05-25T09:15:00+02:00,2025-05-25,17:15,30,13,43
161,2025-05-25T09:20:00+02:00,2025-05-25,17:20,42,10,52
164,2025-05-25T09:15:00+02:00,2025-05-25,17:15,9,1,10
164,2025-05-25T09:20:00+02:00,2025-05-25,17:20,10,3,13
181,2025-05-25T09:25:00+02:00,2025-05-25,17:25,21,7,28
181,2025-05-25T09:26:00+02:00,2025-05-25,17:26,17,13,30
181,2025-05-25T09:27:00+02:00,2025-05-25,17:27,12,16,28
181,2025-05-25T09:28:00+02:00,2025-05-25,17:28,8,20,28
181,2025-05-25T09:35:00+02:00,2025-05-25,17:35,35,20,55
181,2025-05-25T09:36:00+02:00,2025-05-25,17:36,18,19,37
181,2025-05-25T09:38:00+02:00,2025-05-25,17:38,4,8,12
182,2025-05-25T09:25:00+02:00,2025-05-25,17:25,21,12,33
180,2025-05-25T09:25:00+02:00,2025-05-25,17:25,0,3,3
180,2025-05-25T09:35:00+02:00,2025-05-25,17:35,0,1,1
3,2025-05-25T08:26:00+02:00,2025-05-25,16:26,16,20,36
3,2025-05-25T08:28:00+02:00,2025-05-25,16:28,24,19,43
3,2025-05-25T08:31:00+02:00,2025-05-25,16:31,27,18,45
3,2025-05-25T08:32:00+02:00,2025-05-25,16:32,11,16,27
3,2025-05-25T08:37:00+02:00,2025-05-25,16:37,19,17,36
3,2025-05-25T08:38:00+02:00,2025-05-25,16:38,19,21,40
4,2025-05-25T08:27:00+02:00,2025-05-25,16:27,42,16,58
4,2025-05-25T08:31:00+02:00,2025-05-25,16:31,27,34,61
4,2025-05-25T08:32:00+02:00,2025-05-25,16:32,33,21,54
4,2025-05-25T08:33:00+02:00,2025-05-25,16:33,35,25,60
4,2025-05-25T08:36:00+02:00,2025-05-25,16:36,34,21,55
4,2025-05-25T08:37:00+02:00,2025-05-25,16:37,29,55,84
4,2025-05-25T08:39:00+02:00,2025-05-25,16:39,20,29,49
5,2025-05-25T08:25:00+02:00,2025-05-25,16:25,140,95,235
5,2025-05-25T08:30:00+02:00,2025-05-25,16:30,63,104,167
5,2025-05-25T08:35:00+02:00,2025-05-25,16:35,101,76,177
6,2025-05-25T08:35:00+02:00,2025-05-25,16:35,21,5,26
6,2025-05-25T08:36:00+02:00,2025-05-25,16:36,15,22,37
6,2025-05-25T08:37:00+02:00,2025-05-25,16:37,24,10,34
6,2025-05-25T08:38:00+02:00,2025-05-25,16:38,11,7,18
8,2025-05-25T08:29:00+02:00,2025-05-25,16:29,5,4,9
8,2025-05-25T08:35:00+02:00,2025-05-25,16:35,3,0,3
8,2025-05-25T08:36:00+02:00,2025-05-25,16:36,1,4,5
8,2025-05-25T08:37:00+02:00,2025-05-25,16:37,9,3,12
28,2025-05-25T08:25:00+02:00,2025-05-25,16:25,10,13,23
28,2025-05-25T08:27:00+02:00,2025-05-25,16:27,4,9,13
29,2025-05-25T08:25:00+02:00,2025-05-25,16:25,11,21,32
29,2025-05-25T08:26:00+02:00,2025-05-25,16:26,14,13,27
29,2025-05-25T08:32:00+02:00,2025-05-25,16:32,7,10,17
31,2025-05-25T08:25:00+02:00,2025-05-25,16:25,6,2,8
31,2025-05-25T08:27:00+02:00,2025-05-25,16:27,4,8,12
31,2025-05-25T08:30:00+02:00,2025-05-25,16:30,2,0,2
31,2025-05-25T08:33:00+02:00,2025-05-25,16:33,5,5,10
31,2025-05-25T08:35:00+02:00,2025-05-25,16:35,2,2,4
36,2025-05-25T08:25:00+02:00,2025-05-25,16:25,2,1,3
36,2025-05-25T08:30:00+02:00,2025-05-25,16:30,0,2,2
36,2025-05-25T08:37:00+02:00,2025-05-25,16:37,2,2,4
39,2025-05-25T08:30:00+02:00,2025-05-25,16:30,2,2,4
39,2025-05-25T08:39:00+02:00,2025-05-25,16:39,0,1,1
40,2025-05-25T08:25:00+02:00,2025-05-25,16:25,0,5,5
40,2025-05-25T08:29:00+02:00,2025-05-25,16:29,2,0,2
40,2025-05-25T08:30:00+02:00,2025-05-25,16:30,2,0,2
40,2025-05-25T08:33:00+02:00,2025-05-25,16:33,3,2,5
40,2025-05-25T08:35:00+02:00,2025-05-25,16:35,5,1,6
40,2025-05-25T08:36:00+02:00,2025-05-25,16:36,1,2,3
40,2025-05-25T08:37:00+02:00,2025-05-25,16:37,1,4,5
40,2025-05-25T08:38:00+02:00,2025-05-25,16:38,0,2,2
41,2025-05-25T08:31:00+02:00,2025-05-25,16:31,4,6,10
41,2025-05-25T08:34:00+02:00,2025-05-25,16:34,6,3,9
41,2025-05-25T08:35:00+02:00,2025-05-25,16:35,13,4,17
41,2025-05-25T08:37:00+02:00,2025-05-25,16:37,4,13,17
43,2025-05-25T08:30:00+02:00,2025-05-25,16:30,2,9,11
43,2025-05-25T08:35:00+02:00,2025-05-25,16:35,9,9,18
44,2025-05-25T08:30:00+02:00,2025-05-25,16:30,5,10,15
45,2025-05-25T08:26:00+02:00,2025-05-25,16:26,12,30,42
45,2025-05-25T08:27:00+02:00,2025-05-25,16:27,20,25,45
45,2025-05-25T08:28:00+02:00,2025-05-25,16:28,26,15,41
45,2025-05-25T08:31:00+02:00,2025-05-25,16:31,11,23,34
47,2025-05-25T08:29:00+02:00,2025-05-25,16:29,12,28,40
47,2025-05-25T08:35:00+02:00,2025-05-25,16:35,20,26,46
47,2025-05-25T08:39:00+02:00,2025-05-25,16:39,23,9,32
50,2025-05-25T08:28:00+02:00,2025-05-25,16:28,3,5,8
50,2025-05-25T08:30:00+02:00,2025-05-25,16:30,3,3,6
50,2025-05-25T08:32:00+02:00,2025-05-25,16:32,4,2,6
50,2025-05-25T08:38:00+02:00,2025-05-25,16:38,3,1,4
54,2025-05-25T08:25:00+02:00,2025-05-25,16:25,1,2,3
54,2025-05-25T08:28:00+02:00,2025-05-25,16:28,1,4,5
54,2025-05-25T08:31:00+02:00,2025-05-25,16:31,3,0,3
54,2025-05-25T08:32:00+02:00,2025-05-25,16:32,8,1,9
54,2025-05-25T08:35:00+02:00,2025-05-25,16:35,2,0,2
59,2025-05-25T08:35:00+02:00,2025-05-25,16:35,26,21,47
61,2025-05-25T08:28:00+02:00,2025-05-25,16:28,14,7,21
61,2025-05-25T08:32:00+02:00,2025-05-25,16:32,3,7,10
66,2025-05-25T08:25:00+02:00,2025-05-25,16:25,14,21,35
66,2025-05-25T08:27:00+02:00,2025-05-25,16:27,34,37,71
66,2025-05-25T08:29:00+02:00,2025-05-25,16:29,27,22,49
66,2025-05-25T08:31:00+02:00,2025-05-25,16:31,29,35,64
66,2025-05-25T08:33:00+02:00,2025-05-25,16:33,26,25,51
66,2025-05-25T08:35:00+02:00,2025-05-25,16:35,23,29,52
66,2025-05-25T08:38:00+02:00,2025-05-25,16:38,18,25,43
66,2025-05-25T08:39:00+02:00,2025-05-25,16:39,8,27,35
69,2025-05-25T08:30:00+02:00,2025-05-25,16:30,2,2,4
69,2025-05-25T08:33:00+02:00,2025-05-25,16:33,2,3,5
69,2025-05-25T08:37:00+02:00,2025-05-25,16:37,0,1,1
69,2025-05-25T08:39:00+02:00,2025-05-25,16:39,2,2,4
70,2025-05-25T08:28:00+02:00,2025-05-25,16:28,4,0,4
70,2025-05-25T08:29:00+02:00,2025-05-25,16:29,2,5,7
70,2025-05-25T08:31:00+02:00,2025-05-25,16:31,1,1,2
70,2025-05-25T08:32:00+02:00,2025-05-25,16:32,0,7,7
70,2025-05-25T08:36:00+02:00,2025-05-25,16:36,3,1,4
71,2025-05-25T08:33:00+02:00,2025-05-25,16:33,1,0,1
75,2025-05-25T08:26:00+02:00,2025-05-25,16:26,2,1,3
75,2025-05-25T08:27:00+02:00,2025-05-25,16:27,0,3,3
75,2025-05-25T08:32:00+02:00,2025-05-25,16:32,1,0,1
75,2025-05-25T08:37:00+02:00,2025-05-25,16:37,1,0,1
77,2025-05-25T08:25:00+02:00,2025-05-25,16:25,10,23,33
77,2025-05-25T08:30:00+02:00,2025-05-25,16:30,7,22,29
78,2025-05-25T08:28:00+02:00,2025-05-25,16:28,0,1,1
78,2025-05-25T08:33:00+02:00,2025-05-25,16:33,0,4,4
87,2025-05-25T08:27:00+02:00,2025-05-25,16:27,2,3,5
87,2025-05-25T08:29:00+02:00,2025-05-25,16:29,5,0,5
107,2025-05-25T08:25:00+02:00,2025-05-25,16:25,16,14,30
108,2025-05-25T08:26:00+02:00,2025-05-25,16:26,2,1,3
108,2025-05-25T08:27:00+02:00,2025-05-25,16:27,1,1,2
108,2025-05-25T08:28:00+02:00,2025-05-25,16:28,2,2,4
108,2025-05-25T08:34:00+02:00,2025-05-25,16:34,3,7,10
108,2025-05-25T08:35:00+02:00,2025-05-25,16:35,0,2,2
131,2025-05-25T08:35:00+02:00,2025-05-25,16:35,17,4,21
132,2025-05-25T08:25:00+02:00,2025-05-25,16:25,11,15,26
133,2025-05-25T08:25:00+02:00,2025-05-25,16:25,39,45,84
134,2025-05-25T08:35:00+02:00,2025-05-25,16:35,54,42,96
135,2025-05-25T08:30:00+02:00,2025-05-25,16:30,79,25,104
140,2025-05-25T08:30:00+02:00,2025-05-25,16:30,13,9,22
140,2025-05-25T08:35:00+02:00,2025-05-25,16:35,2,4,6
162,2025-05-25T08:35:00+02:00,2025-05-25,16:35,20,34,54
165,2025-05-25T08:30:00+02:00,2025-05-25,16:30,4,2,6
166,2025-05-25T08:35:00+02:00,2025-05-25,16:35,10,5,15
167,2025-05-25T08:25:00+02:00,2025-05-25,16:25,6,10,16
179,2025-05-25T08:30:00+02:00,2025-05-25,16:30,4,12,16
179,2025-05-25T08:35:00+02:00,2025-05-25,16:35,7,3,10
1,2025-05-25T08:25:00+02:00,2025-05-25,16:25,10,12,22
1,2025-05-25T08:33:00+02:00,2025-05-25,16:33,19,10,29
1,2025-05-25T08:34:00+02:00,2025-05-25,16:34,37,31,68
1,2025-05-25T08:37:00+02:00,2025-05-25,16:37,22,24,46
2,2025-05-25T08:28:00+02:00,2025-05-25,16:28,8,3,11
2,2025-05-25T08:36:00+02:00,2025-05-25,16:36,7,5,12
2,2025-05-25T08:39:00+02:00,2025-05-25,16:39,11,9,20
9,2025-05-25T08:39:00+02:00,2025-05-25,16:39,3,0,3
10,2025-05-25T08:26:00+02:00,2025-05-25,16:26,2,0,2
10,2025-05-25T08:28:00+02:00,2025-05-25,16:28,0,1,1
10,2025-05-25T08:36:00+02:00,2025-05-25,16:36,0,2,2
11,2025-05-25T08:26:00+02:00,2025-05-25,16:26,0,3,3
11,2025-05-25T08:30:00+02:00,2025-05-25,16:30,41,6,47
11,2025-05-25T08:33:00+02:00,2025-05-25,16:33,12,2,14
11,2025-05-25T08:38:00+02:00,2025-05-25,16:38,11,0,11
12,2025-05-25T08:25:00+02:00,2025-05-25,16:25,5,4,9
12,2025-05-25T08:31:00+02:00,2025-05-25,16:31,2,1,3
12,2025-05-25T08:32:00+02:00,2025-05-25,16:32,4,7,11
12,2025-05-25T08:36:00+02:00,2025-05-25,16:36,5,8,13
12,2025-05-25T08:38:00+02:00,2025-05-25,16:38,13,8,21
12,2025-05-25T08:39:00+02:00,2025-05-25,16:39,9,5,14
17,2025-05-25T08:25:00+02:00,2025-05-25,16:25,0,1,1
17,2025-05-25T08:26:00+02:00,2025-05-25,16:26,5,4,9
17,2025-05-25T08:27:00+02:00,2025-05-25,16:27,4,4,8
17,2025-05-25T08:28:00+02:00,2025-05-25,16:28,3,4,7
17,2025-05-25T08:29:00+02:00,2025-05-25,16:29,0,5,5
17,2025-05-25T08:32:00+02:00,2025-05-25,16:32,1,0,1
17,2025-05-25T08:34:00+02:00,2025-05-25,16:34,0,4,4
17,2025-05-25T08:36:00+02:00,2025-05-25,16:36,1,4,5
18,2025-05-25T08:25:00+02:00,2025-05-25,16:25,1,2,3
18,2025-05-25T08:31:00+02:00,2025-05-25,16:31,1,0,1
18,2025-05-25T08:33:00+02:00,2025-05-25,16:33,5,1,6
18,2025-05-25T08:36:00+02:00,2025-05-25,16:36,2,0,2
18,2025-05-25T08:37:00+02:00,2025-05-25,16:37,2,0,2
19,2025-05-25T08:25:00+02:00,2025-05-25,16:25,9,0,9
19,2025-05-25T08:28:00+02:00,2025-05-25,16:28,21,11,32
19,2025-05-25T08:29:00+02:00,2025-05-25,16:29,15,10,25
19,2025-05-25T08:33:00+02:00,2025-05-25,16:33,13,8,21
20,2025-05-25T08:25:00+02:00,2025-05-25,16:25,9,2,11
20,2025-05-25T08:27:00+02:00,2025-05-25,16:27,5,7,12
20,2025-05-25T08:28:00+02:00,2025-05-25,16:28,4,1,5
20,2025-05-25T08:29:00+02:00,2025-05-25,16:29,1,2,3
20,2025-05-25T08:30:00+02:00,2025-05-25,16:30,9,4,13
20,2025-05-25T08:32:00+02:00,2025-05-25,16:32,5,3,8
20,2025-05-25T08:35:00+02:00,2025-05-25,16:35,9,1,10
20,2025-05-25T08:38:00+02:00,2025-05-25,16:38,8,5,13
20,2025-05-25T08:39:00+02:00,2025-05-25,16:39,5,1,6
23,2025-05-25T08:25:00+02:00,2025-05-25,16:25,3,3,6
23,2025-05-25T08:27:00+02:00,2025-05-25,16:27,4,4,8
23,2025-05-25T08:29:00+02:00,2025-05-25,16:29,2,1,3
23,2025-05-25T08:33:00+02:00,2025-05-25,16:33,1,4,5
23,2025-05-25T08:34:00+02:00,2025-05-25,16:34,6,2,8
23,2025-05-25T08:39:00+02:00,2025-05-25,16:39,5,5,10
24,2025-05-25T08:33:00+02:00,2025-05-25,16:33,4,11,15
24,2025-05-25T08:35:00+02:00,2025-05-25,16:35,2,18,20
24,2025-05-25T08:37:00+02:00,2025-05-25,16:37,2,28,30
25,2025-05-25T08:30:00+02:00,2025-05-25,16:30,70,51,121
27,2025-05-25T08:25:00+02:00,2025-05-25,16:25,4,0,4
27,2025-05-25T08:26:00+02:00,2025-05-25,16:26,1,5,6
27,2025-05-25T08:27:00+02:00,2025-05-25,16:27,2,0,2
27,2025-05-25T08:28:00+02:00,2025-05-25,16:28,0,4,4
27,2025-05-25T08:32:00+02:00,2025-05-25,16:32,3,1,4
27,2025-05-25T08:33:00+02:00,2025-05-25,16:33,5,1,6
27,2025-05-25T08:35:00+02:00,2025-05-25,16:35,4,0,4
30,2025-05-25T08:28:00+02:00,2025-05-25,16:28,8,7,15
30,2025-05-25T08:32:00+02:00,2025-05-25,16:32,9,7,16
30,2025-05-25T08:35:00+02:00,2025-05-25,16:35,4,9,13
30,2025-05-25T08:36:00+02:00,2025-05-25,16:36,2,9,11
30,2025-05-25T08:39:00+02:00,2025-05-25,16:39,5,2,7
35,2025-05-25T08:27:00+02:00,2025-05-25,16:27,13,40,53
35,2025-05-25T08:30:00+02:00,2025-05-25,16:30,19,34,53
35,2025-05-25T08:36:00+02:00,2025-05-25,16:36,40,27,67
35,2025-05-25T08:37:00+02:00,2025-05-25,16:37,12,27,39
46,2025-05-25T08:25:00+02:00,2025-05-25,16:25,7,6,13
48,2025-05-25T08:25:00+02:00,2025-05-25,16:25,5,2,7
48,2025-05-25T08:26:00+02:00,2025-05-25,16:26,10,0,10
48,2025-05-25T08:29:00+02:00,2025-05-25,16:29,6,8,14
48,2025-05-25T08:34:00+02:00,2025-05-25,16:34,12,1,13
48,2025-05-25T08:35:00+02:00,2025-05-25,16:35,9,0,9
48,2025-05-25T08:36:00+02:00,2025-05-25,16:36,1,6,7
48,2025-05-25T08:37:00+02:00,2025-05-25,16:37,7,7,14
48,2025-05-25T08:38:00+02:00,2025-05-25,16:38,7,3,10
48,2025-05-25T08:39:00+02:00,2025-05-25,16:39,3,2,5
49,2025-05-25T08:25:00+02:00,2025-05-25,16:25,8,13,21
49,2025-05-25T08:26:00+02:00,2025-05-25,16:26,1,7,8
49,2025-05-25T08:35:00+02:00,2025-05-25,16:35,0,8,8
49,2025-05-25T08:38:00+02:00,2025-05-25,16:38,8,2,10
51,2025-05-25T08:28:00+02:00,2025-05-25,16:28,2,2,4
51,2025-05-25T08:35:00+02:00,2025-05-25,16:35,2,4,6
53,2025-05-25T08:34:00+02:00,2025-05-25,16:34,5,6,11
56,2025-05-25T08:28:00+02:00,2025-05-25,16:28,1,5,6
56,2025-05-25T08:30:00+02:00,2025-05-25,16:30,9,10,19
56,2025-05-25T08:35:00+02:00,2025-05-25,16:35,10,9,19
56,2025-05-25T08:36:00+02:00,2025-05-25,16:36,12,9,21
58,2025-05-25T08:26:00+02:00,2025-05-25,16:26,7,14,21
58,2025-05-25T08:32:00+02:00,2025-05-25,16:32,10,3,13
58,2025-05-25T08:34:00+02:00,2025-05-25,16:34,13,4,17
58,2025-05-25T08:37:00+02:00,2025-05-25,16:37,14,4,18
58,2025-05-25T08:39:00+02:00,2025-05-25,16:39,10,11,21
62,2025-05-25T08:25:00+02:00,2025-05-25,16:25,2,2,4
62,2025-05-25T08:26:00+02:00,2025-05-25,16:26,4,4,8
62,2025-05-25T08:27:00+02:00,2025-05-25,16:27,6,3,9
62,2025-05-25T08:31:00+02:00,2025-05-25,16:31,2,5,7
62,2025-05-25T08:32:00+02:00,2025-05-25,16:32,5,5,10
62,2025-05-25T08:34:00+02:00,2025-05-25,16:34,4,1,5
62,2025-05-25T08:38:00+02:00,2025-05-25,16:38,1,3,4
63,2025-05-25T08:26:00+02:00,2025-05-25,16:26,3,6,9
63,2025-05-25T08:28:00+02:00,2025-05-25,16:28,7,13,20
63,2025-05-25T08:29:00+02:00,2025-05-25,16:29,4,5,9
63,2025-05-25T08:31:00+02:00,2025-05-25,16:31,13,5,18
63,2025-05-25T08:32:00+02:00,2025-05-25,16:32,7,6,13
63,2025-05-25T08:33:00+02:00,2025-05-25,16:33,8,1,9
63,2025-05-25T08:37:00+02:00,2025-05-25,16:37,11,3,14
63,2025-05-25T08:38:00+02:00,2025-05-25,16:38,7,2,9
63,2025-05-25T08:39:00+02:00,2025-05-25,16:39,4,1,5
67,2025-05-25T08:27:00+02:00,2025-05-25,16:27,7,16,23
67,2025-05-25T08:32:00+02:00,2025-05-25,16:32,15,11,26
67,2025-05-25T08:35:00+02:00,2025-05-25,16:35,4,8,12
67,2025-05-25T08:38:00+02:00,2025-05-25,16:38,4,5,9
67,2025-05-25T08:39:00+02:00,2025-05-25,16:39,11,2,13
68,2025-05-25T08:30:00+02:00,2025-05-25,16:30,4,3,7
68,2025-05-25T08:31:00+02:00,2025-05-25,16:31,4,6,10
68,2025-05-25T08:35:00+02:00,2025-05-25,16:35,2,2,4
72,2025-05-25T08:27:00+02:00,2025-05-25,16:27,14,13,27
72,2025-05-25T08:28:00+02:00,2025-05-25,16:28,16,3,19
72,2025-05-25T08:31:00+02:00,2025-05-25,16:31,5,12,17
72,2025-05-25T08:33:00+02:00,2025-05-25,16:33,2,14,16
72,2025-05-25T08:36:00+02:00,2025-05-25,16:36,5,13,18
72,2025-05-25T08:37:00+02:00,2025-05-25,16:37,8,23,31
72,2025-05-25T08:39:00+02:00,2025-05-25,16:39,6,5,11
76,2025-05-25T08:26:00+02:00,2025-05-25,16:26,1,0,1
76,2025-05-25T08:30:00+02:00,2025-05-25,16:30,1,0,1
76,2025-05-25T08:39:00+02:00,2025-05-25,16:39,1,5,6
79,2025-05-25T08:26:00+02:00,2025-05-25,16:26,7,22,29
79,2025-05-25T08:29:00+02:00,2025-05-25,16:29,13,9,22
79,2025-05-25T08:30:00+02:00,2025-05-25,16:30,26,11,37
79,2025-05-25T08:31:00+02:00,2025-05-25,16:31,12,5,17
79,2025-05-25T08:36:00+02:00,2025-05-25,16:36,13,9,22
79,2025-05-25T08:38:00+02:00,2025-05-25,16:38,13,8,21
85,2025-05-25T08:29:00+02:00,2025-05-25,16:29,2,1,3
85,2025-05-25T08:30:00+02:00,2025-05-25,16:30,1,0,1
86,2025-05-25T08:25:00+02:00,2025-05-25,16:25,1,0,1
86,2025-05-25T08:29:00+02:00,2025-05-25,16:29,0,6,6
86,2025-05-25T08:33:00+02:00,2025-05-25,16:33,0,3,3
86,2025-05-25T08:35:00+02:00,2025-05-25,16:35,0,1,1
86,2025-05-25T08:37:00+02:00,2025-05-25,16:37,2,0,2
86,2025-05-25T08:38:00+02:00,2025-05-25,16:38,0,2,2
109,2025-05-25T08:25:00+02:00,2025-05-25,16:25,10,6,16
117,2025-05-25T08:25:00+02:00,2025-05-25,16:25,27,19,46
130,2025-05-25T08:25:00+02:00,2025-05-25,16:25,1,6,7
130,2025-05-25T08:35:00+02:00,2025-05-25,16:35,4,0,4
136,2025-05-25T08:30:00+02:00,2025-05-25,16:30,14,7,21
136,2025-05-25T08:35:00+02:00,2025-05-25,16:35,16,7,23
137,2025-05-25T08:35:00+02:00,2025-05-25,16:35,0,3,3
139,2025-05-25T08:30:00+02:00,2025-05-25,16:30,2,4,6
141,2025-05-25T08:30:00+02:00,2025-05-25,16:30,20,14,34
142,2025-05-25T08:25:00+02:00,2025-05-25,16:25,35,42,77
142,2025-05-25T08:35:00+02:00,2025-05-25,16:35,54,41,95
164,2025-05-25T08:25:00+02:00,2025-05-25,16:25,6,20,26
181,2025-05-25T08:40:00+02:00,2025-05-25,16:40,16,7,23
181,2025-05-25T08:42:00+02:00,2025-05-25,16:42,11,17,28
181,2025-05-25T08:49:00+02:00,2025-05-25,16:49,14,21,35
181,2025-05-25T08:50:00+02:00,2025-05-25,16:50,8,25,33
181,2025-05-25T08:51:00+02:00,2025-05-25,16:51,9,19,28
181,2025-05-25T08:53:00+02:00,2025-05-25,16:53,21,20,41
182,2025-05-25T08:40:00+02:00,2025-05-25,16:40,13,5,18
182,2025-05-25T08:50:00+02:00,2025-05-25,16:50,18,17,35
180,2025-05-25T08:50:00+02:00,2025-05-25,16:50,0,1,1
180,2025-05-25T08:51:00+02:00,2025-05-25,16:51,1,0,1
180,2025-05-25T08:52:00+02:00,2025-05-25,16:52,2,0,2
3,2025-05-25T12:31:00+02:00,2025-05-25,20:31,13,9,22
3,2025-05-25T12:34:00+02:00,2025-05-25,20:34,8,7,15
3,2025-05-25T12:35:00+02:00,2025-05-25,20:35,3,20,23
3,2025-05-25T12:38:00+02:00,2025-05-25,20:38,5,8,13
4,2025-05-25T12:27:00+02:00,2025-05-25,20:27,19,15,34
4,2025-05-25T12:29:00+02:00,2025-05-25,20:29,11,4,15
4,2025-05-25T12:33:00+02:00,2025-05-25,20:33,3,19,22
4,2025-05-25T12:34:00+02:00,2025-05-25,20:34,5,9,14
4,2025-05-25T12:35:00+02:00,2025-05-25,20:35,11,13,24
4,2025-05-25T12:36:00+02:00,2025-05-25,20:36,9,18,27
4,2025-05-25T12:38:00+02:00,2025-05-25,20:38,4,6,10
5,2025-05-25T12:30:00+02:00,2025-05-25,20:30,10,30,40
6,2025-05-25T12:28:00+02:00,2025-05-25,20:28,10,5,15
6,2025-05-25T12:30:00+02:00,2025-05-25,20:30,4,12,16
6,2025-05-25T12:34:00+02:00,2025-05-25,20:34,10,4,14
8,2025-05-25T12:36:00+02:00,2025-05-25,20:36,0,1,1
21,2025-05-25T12:30:00+02:00,2025-05-25,20:30,18,34,52
28,2025-05-25T12:28:00+02:00,2025-05-25,20:28,3,2,5
28,2025-05-25T12:31:00+02:00,2025-05-25,20:31,1,0,1
28,2025-05-25T12:38:00+02:00,2025-05-25,20:38,2,3,5
29,2025-05-25T12:26:00+02:00,2025-05-25,20:26,0,1,1
29,2025-05-25T12:29:00+02:00,2025-05-25,20:29,5,2,7
29,2025-05-25T12:31:00+02:00,2025-05-25,20:31,0,2,2
29,2025-05-25T12:32:00+02:00,2025-05-25,20:32,9,5,14
29,2025-05-25T12:33:00+02:00,2025-05-25,20:33,2,1,3
31,2025-05-25T12:27:00+02:00,2025-05-25,20:27,14,3,17
31,2025-05-25T12:38:00+02:00,2025-05-25,20:38,4,2,6
31,2025-05-25T12:39:00+02:00,2025-05-25,20:39,3,11,14
36,2025-05-25T12:25:00+02:00,2025-05-25,20:25,2,1,3
36,2025-05-25T12:26:00+02:00,2025-05-25,20:26,0,3,3
36,2025-05-25T12:27:00+02:00,2025-05-25,20:27,1,1,2
36,2025-05-25T12:33:00+02:00,2025-05-25,20:33,0,2,2
36,2025-05-25T12:36:00+02:00,2025-05-25,20:36,3,3,6
39,2025-05-25T12:26:00+02:00,2025-05-25,20:26,0,1,1
39,2025-05-25T12:28:00+02:00,2025-05-25,20:28,1,0,1
40,2025-05-25T12:25:00+02:00,2025-05-25,20:25,7,5,12
40,2025-05-25T12:29:00+02:00,2025-05-25,20:29,4,0,4
40,2025-05-25T12:30:00+02:00,2025-05-25,20:30,1,2,3
40,2025-05-25T12:36:00+02:00,2025-05-25,20:36,0,2,2
40,2025-05-25T12:37:00+02:00,2025-05-25,20:37,10,0,10
41,2025-05-25T12:26:00+02:00,2025-05-25,20:26,10,3,13
41,2025-05-25T12:32:00+02:00,2025-05-25,20:32,2,6,8
41,2025-05-25T12:37:00+02:00,2025-05-25,20:37,3,0,3
44,2025-05-25T12:25:00+02:00,2025-05-25,20:25,4,2,6
44,2025-05-25T12:35:00+02:00,2025-05-25,20:35,3,3,6
45,2025-05-25T12:27:00+02:00,2025-05-25,20:27,3,8,11
45,2025-05-25T12:28:00+02:00,2025-05-25,20:28,7,17,24
45,2025-05-25T12:30:00+02:00,2025-05-25,20:30,4,13,17
45,2025-05-25T12:31:00+02:00,2025-05-25,20:31,4,22,26
45,2025-05-25T12:33:00+02:00,2025-05-25,20:33,7,7,14
45,2025-05-25T12:34:00+02:00,2025-05-25,20:34,3,16,19
45,2025-05-25T12:35:00+02:00,2025-05-25,20:35,6,9,15
45,2025-05-25T12:38:00+02:00,2025-05-25,20:38,3,9,12
47,2025-05-25T12:26:00+02:00,2025-05-25,20:26,4,14,18
47,2025-05-25T12:27:00+02:00,2025-05-25,20:27,7,2,9
47,2025-05-25T12:29:00+02:00,2025-05-25,20:29,7,3,10
47,2025-05-25T12:31:00+02:00,2025-05-25,20:31,8,8,16
47,2025-05-25T12:32:00+02:00,2025-05-25,20:32,4,3,7
47,2025-05-25T12:34:00+02:00,2025-05-25,20:34,10,0,10
50,2025-05-25T12:25:00+02:00,2025-05-25,20:25,1,0,1
50,2025-05-25T12:31:00+02:00,2025-05-25,20:31,1,5,6
50,2025-05-25T12:34:00+02:00,2025-05-25,20:34,4,0,4
50,2025-05-25T12:39:00+02:00,2025-05-25,20:39,3,0,3
54,2025-05-25T12:32:00+02:00,2025-05-25,20:32,1,0,1
54,2025-05-25T12:33:00+02:00,2025-05-25,20:33,0,8,8
54,2025-05-25T12:36:00+02:00,2025-05-25,20:36,3,0,3
54,2025-05-25T12:37:00+02:00,2025-05-25,20:37,1,1,2
54,2025-05-25T12:38:00+02:00,2025-05-25,20:38,3,4,7
59,2025-05-25T12:25:00+02:00,2025-05-25,20:25,6,6,12
61,2025-05-25T12:31:00+02:00,2025-05-25,20:31,2,0,2
61,2025-05-25T12:32:00+02:00,2025-05-25,20:32,10,6,16
61,2025-05-25T12:35:00+02:00,2025-05-25,20:35,2,6,8
66,2025-05-25T12:26:00+02:00,2025-05-25,20:26,23,20,43
66,2025-05-25T12:27:00+02:00,2025-05-25,20:27,25,22,47
66,2025-05-25T12:33:00+02:00,2025-05-25,20:33,22,22,44
66,2025-05-25T12:36:00+02:00,2025-05-25,20:36,9,22,31
69,2025-05-25T12:26:00+02:00,2025-05-25,20:26,0,1,1
69,2025-05-25T12:28:00+02:00,2025-05-25,20:28,2,0,2
70,2025-05-25T12:27:00+02:00,2025-05-25,20:27,1,0,1
70,2025-05-25T12:30:00+02:00,2025-05-25,20:30,2,4,6
70,2025-05-25T12:31:00+02:00,2025-05-25,20:31,0,1,1
70,2025-05-25T12:38:00+02:00,2025-05-25,20:38,2,1,3
70,2025-05-25T12:39:00+02:00,2025-05-25,20:39,1,7,8
75,2025-05-25T12:36:00+02:00,2025-05-25,20:36,0,2,2
87,2025-05-25T12:31:00+02:00,2025-05-25,20:31,0,2,2
107,2025-05-25T12:25:00+02:00,2025-05-25,20:25,9,4,13
108,2025-05-25T12:26:00+02:00,2025-05-25,20:26,1,0,1
108,2025-05-25T12:27:00+02:00,2025-05-25,20:27,2,0,2
108,2025-05-25T12:30:00+02:00,2025-05-25,20:30,0,3,3
108,2025-05-25T12:36:00+02:00,2025-05-25,20:36,4,1,5
108,2025-05-25T12:38:00+02:00,2025-05-25,20:38,2,1,3
131,2025-05-25T12:35:00+02:00,2025-05-25,20:35,5,2,7
132,2025-05-25T12:30:00+02:00,2025-05-25,20:30,5,15,20
132,2025-05-25T12:35:00+02:00,2025-05-25,20:35,11,6,17
133,2025-05-25T12:30:00+02:00,2025-05-25,20:30,24,30,54
134,2025-05-25T12:25:00+02:00,2025-05-25,20:25,5,13,18
134,2025-05-25T12:35:00+02:00,2025-05-25,20:35,21,12,33
162,2025-05-25T12:30:00+02:00,2025-05-25,20:30,4,2,6
162,2025-05-25T12:35:00+02:00,2025-05-25,20:35,3,2,5
166,2025-05-25T12:35:00+02:00,2025-05-25,20:35,0,1,1
167,2025-05-25T12:25:00+02:00,2025-05-25,20:25,1,2,3
167,2025-05-25T12:30:00+02:00,2025-05-25,20:30,0,2,2
179,2025-05-25T12:25:00+02:00,2025-05-25,20:25,4,4,8
179,2025-05-25T12:30:00+02:00,2025-05-25,20:30,1,0,1
1,2025-05-25T12:27:00+02:00,2025-05-25,20:27,6,5,11
1,2025-05-25T12:29:00+02:00,2025-05-25,20:29,0,12,12
1,2025-05-25T12:30:00+02:00,2025-05-25,20:30,1,10,11
1,2025-05-25T12:36:00+02:00,2025-05-25,20:36,2,4,6
1,2025-05-25T12:39:00+02:00,2025-05-25,20:39,5,2,7
2,2025-05-25T12:25:00+02:00,2025-05-25,20:25,0,2,2
2,2025-05-25T12:29:00+02:00,2025-05-25,20:29,2,6,8
2,2025-05-25T12:33:00+02:00,2025-05-25,20:33,2,6,8
2,2025-05-25T12:37:00+02:00,2025-05-25,20:37,0,1,1
9,2025-05-25T12:27:00+02:00,2025-05-25,20:27,0,1,1
9,2025-05-25T12:37:00+02:00,2025-05-25,20:37,0,3,3
10,2025-05-25T12:32:00+02:00,2025-05-25,20:32,0,3,3
12,2025-05-25T12:25:00+02:00,2025-05-25,20:25,3,0,3
12,2025-05-25T12:27:00+02:00,2025-05-25,20:27,4,4,8
12,2025-05-25T12:29:00+02:00,2025-05-25,20:29,1,3,4
12,2025-05-25T12:33:00+02:00,2025-05-25,20:33,2,1,3
12,2025-05-25T12:37:00+02:00,2025-05-25,20:37,4,2,6
12,2025-05-25T12:39:00+02:00,2025-05-25,20:39,0,1,1
17,2025-05-25T12:26:00+02:00,2025-05-25,20:26,1,0,1
17,2025-05-25T12:27:00+02:00,2025-05-25,20:27,2,2,4
17,2025-05-25T12:30:00+02:00,2025-05-25,20:30,0,1,1
17,2025-05-25T12:33:00+02:00,2025-05-25,20:33,2,9,11
18,2025-05-25T12:34:00+02:00,2025-05-25,20:34,0,2,2
18,2025-05-25T12:35:00+02:00,2025-05-25,20:35,1,0,1
19,2025-05-25T12:27:00+02:00,2025-05-25,20:27,14,11,25
19,2025-05-25T12:28:00+02:00,2025-05-25,20:28,19,2,21
19,2025-05-25T12:29:00+02:00,2025-05-25,20:29,8,4,12
19,2025-05-25T12:34:00+02:00,2025-05-25,20:34,19,1,20
20,2025-05-25T12:25:00+02:00,2025-05-25,20:25,4,3,7
20,2025-05-25T12:28:00+02:00,2025-05-25,20:28,4,18,22
20,2025-05-25T12:34:00+02:00,2025-05-25,20:34,2,10,12
20,2025-05-25T12:37:00+02:00,2025-05-25,20:37,4,8,12
23,2025-05-25T12:26:00+02:00,2025-05-25,20:26,0,4,4
23,2025-05-25T12:27:00+02:00,2025-05-25,20:27,0,2,2
23,2025-05-25T12:28:00+02:00,2025-05-25,20:28,3,1,4
23,2025-05-25T12:32:00+02:00,2025-05-25,20:32,0,1,1
23,2025-05-25T12:33:00+02:00,2025-05-25,20:33,0,2,2
23,2025-05-25T12:37:00+02:00,2025-05-25,20:37,7,11,18
23,2025-05-25T12:38:00+02:00,2025-05-25,20:38,1,1,2
24,2025-05-25T12:27:00+02:00,2025-05-25,20:27,4,9,13
24,2025-05-25T12:32:00+02:00,2025-05-25,20:32,4,3,7
24,2025-05-25T12:33:00+02:00,2025-05-25,20:33,5,4,9
24,2025-05-25T12:38:00+02:00,2025-05-25,20:38,7,3,10
25,2025-05-25T12:25:00+02:00,2025-05-25,20:25,12,23,35
25,2025-05-25T12:35:00+02:00,2025-05-25,20:35,25,12,37
27,2025-05-25T12:25:00+02:00,2025-05-25,20:25,3,0,3
27,2025-05-25T12:27:00+02:00,2025-05-25,20:27,0,1,1
27,2025-05-25T12:37:00+02:00,2025-05-25,20:37,2,0,2
30,2025-05-25T12:26:00+02:00,2025-05-25,20:26,8,5,13
30,2025-05-25T12:30:00+02:00,2025-05-25,20:30,5,10,15
30,2025-05-25T12:36:00+02:00,2025-05-25,20:36,3,1,4
30,2025-05-25T12:37:00+02:00,2025-05-25,20:37,1,5,6
30,2025-05-25T12:38:00+02:00,2025-05-25,20:38,1,3,4
35,2025-05-25T12:25:00+02:00,2025-05-25,20:25,12,7,19
35,2025-05-25T12:27:00+02:00,2025-05-25,20:27,10,2,12
35,2025-05-25T12:31:00+02:00,2025-05-25,20:31,8,7,15
35,2025-05-25T12:33:00+02:00,2025-05-25,20:33,1,12,13
35,2025-05-25T12:36:00+02:00,2025-05-25,20:36,1,8,9
35,2025-05-25T12:37:00+02:00,2025-05-25,20:37,2,2,4
48,2025-05-25T12:26:00+02:00,2025-05-25,20:26,0,1,1
48,2025-05-25T12:30:00+02:00,2025-05-25,20:30,4,3,7
48,2025-05-25T12:38:00+02:00,2025-05-25,20:38,1,0,1
48,2025-05-25T12:39:00+02:00,2025-05-25,20:39,2,1,3
49,2025-05-25T12:31:00+02:00,2025-05-25,20:31,3,4,7
51,2025-05-25T12:27:00+02:00,2025-05-25,20:27,2,0,2
51,2025-05-25T12:32:00+02:00,2025-05-25,20:32,0,5,5
52,2025-05-25T12:25:00+02:00,2025-05-25,20:25,1,4,5
52,2025-05-25T12:28:00+02:00,2025-05-25,20:28,6,1,7
52,2025-05-25T12:34:00+02:00,2025-05-25,20:34,3,3,6
52,2025-05-25T12:39:00+02:00,2025-05-25,20:39,2,10,12
53,2025-05-25T12:27:00+02:00,2025-05-25,20:27,1,2,3
53,2025-05-25T12:31:00+02:00,2025-05-25,20:31,4,2,6
53,2025-05-25T12:32:00+02:00,2025-05-25,20:32,1,9,10
53,2025-05-25T12:34:00+02:00,2025-05-25,20:34,3,5,8
53,2025-05-25T12:36:00+02:00,2025-05-25,20:36,1,0,1
56,2025-05-25T12:25:00+02:00,2025-05-25,20:25,9,5,14
56,2025-05-25T12:32:00+02:00,2025-05-25,20:32,0,10,10
56,2025-05-25T12:33:00+02:00,2025-05-25,20:33,5,2,7
56,2025-05-25T12:34:00+02:00,2025-05-25,20:34,10,4,14
58,2025-05-25T12:26:00+02:00,2025-05-25,20:26,1,3,4
58,2025-05-25T12:29:00+02:00,2025-05-25,20:29,2,2,4
58,2025-05-25T12:31:00+02:00,2025-05-25,20:31,11,15,26
58,2025-05-25T12:36:00+02:00,2025-05-25,20:36,3,3,6
58,2025-05-25T12:38:00+02:00,2025-05-25,20:38,1,6,7
62,2025-05-25T12:26:00+02:00,2025-05-25,20:26,1,6,7
62,2025-05-25T12:30:00+02:00,2025-05-25,20:30,2,0,2
62,2025-05-25T12:31:00+02:00,2025-05-25,20:31,2,1,3
62,2025-05-25T12:32:00+02:00,2025-05-25,20:32,1,1,2
62,2025-05-25T12:36:00+02:00,2025-05-25,20:36,0,1,1
62,2025-05-25T12:37:00+02:00,2025-05-25,20:37,8,0,8
62,2025-05-25T12:38:00+02:00,2025-05-25,20:38,3,2,5
63,2025-05-25T12:25:00+02:00,2025-05-25,20:25,0,3,3
63,2025-05-25T12:35:00+02:00,2025-05-25,20:35,0,1,1
63,2025-05-25T12:37:00+02:00,2025-05-25,20:37,1,5,6
63,2025-05-25T12:38:00+02:00,2025-05-25,20:38,0,1,1
63,2025-05-25T12:39:00+02:00,2025-05-25,20:39,1,1,2
67,2025-05-25T12:28:00+02:00,2025-05-25,20:28,0,8,8
67,2025-05-25T12:29:00+02:00,2025-05-25,20:29,4,4,8
67,2025-05-25T12:30:00+02:00,2025-05-25,20:30,5,3,8
67,2025-05-25T12:33:00+02:00,2025-05-25,20:33,3,3,6
67,2025-05-25T12:34:00+02:00,2025-05-25,20:34,4,1,5
67,2025-05-25T12:35:00+02:00,2025-05-25,20:35,0,2,2
67,2025-05-25T12:36:00+02:00,2025-05-25,20:36,4,3,7
67,2025-05-25T12:38:00+02:00,2025-05-25,20:38,6,3,9
68,2025-05-25T12:28:00+02:00,2025-05-25,20:28,3,1,4
68,2025-05-25T12:31:00+02:00,2025-05-25,20:31,1,1,2
68,2025-05-25T12:35:00+02:00,2025-05-25,20:35,0,1,1
68,2025-05-25T12:37:00+02:00,2025-05-25,20:37,7,2,9
72,2025-05-25T12:28:00+02:00,2025-05-25,20:28,0,1,1
72,2025-05-25T12:30:00+02:00,2025-05-25,20:30,0,7,7
72,2025-05-25T12:33:00+02:00,2025-05-25,20:33,0,6,6
72,2025-05-25T12:36:00+02:00,2025-05-25,20:36,0,6,6
72,2025-05-25T12:39:00+02:00,2025-05-25,20:39,0,1,1
76,2025-05-25T12:29:00+02:00,2025-05-25,20:29,0,2,2
79,2025-05-25T12:27:00+02:00,2025-05-25,20:27,1,10,11
79,2025-05-25T12:28:00+02:00,2025-05-25,20:28,8,5,13
79,2025-05-25T12:34:00+02:00,2025-05-25,20:34,1,2,3
85,2025-05-25T12:26:00+02:00,2025-05-25,20:26,0,2,2
85,2025-05-25T12:27:00+02:00,2025-05-25,20:27,1,1,2
86,2025-05-25T12:26:00+02:00,2025-05-25,20:26,0,1,1
86,2025-05-25T12:31:00+02:00,2025-05-25,20:31,0,1,1
109,2025-05-25T12:30:00+02:00,2025-05-25,20:30,3,10,13
130,2025-05-25T12:25:00+02:00,2025-05-25,20:25,6,1,7
137,2025-05-25T12:25:00+02:00,2025-05-25,20:25,2,1,3
139,2025-05-25T12:35:00+02:00,2025-05-25,20:35,3,1,4
141,2025-05-25T12:25:00+02:00,2025-05-25,20:25,8,5,13
141,2025-05-25T12:30:00+02:00,2025-05-25,20:30,7,7,14
141,2025-05-25T12:35:00+02:00,2025-05-25,20:35,5,4,9
164,2025-05-25T12:25:00+02:00,2025-05-25,20:25,5,1,6
164,2025-05-25T12:35:00+02:00,2025-05-25,20:35,0,2,2
3,2025-05-25T12:11:00+02:00,2025-05-25,20:11,19,8,27
3,2025-05-25T12:12:00+02:00,2025-05-25,20:12,17,9,26
3,2025-05-25T12:20:00+02:00,2025-05-25,20:20,17,12,29
3,2025-05-25T12:22:00+02:00,2025-05-25,20:22,8,9,17
4,2025-05-25T12:18:00+02:00,2025-05-25,20:18,6,23,29
4,2025-05-25T12:19:00+02:00,2025-05-25,20:19,17,12,29
5,2025-05-25T12:15:00+02:00,2025-05-25,20:15,27,34,61
6,2025-05-25T12:10:00+02:00,2025-05-25,20:10,2,8,10
6,2025-05-25T12:11:00+02:00,2025-05-25,20:11,8,3,11
6,2025-05-25T12:12:00+02:00,2025-05-25,20:12,9,3,12
6,2025-05-25T12:13:00+02:00,2025-05-25,20:13,6,9,15
6,2025-05-25T12:16:00+02:00,2025-05-25,20:16,11,11,22
6,2025-05-25T12:17:00+02:00,2025-05-25,20:17,8,7,15
6,2025-05-25T12:19:00+02:00,2025-05-25,20:19,3,6,9
21,2025-05-25T12:10:00+02:00,2025-05-25,20:10,18,33,51
28,2025-05-25T12:13:00+02:00,2025-05-25,20:13,2,0,2
28,2025-05-25T12:18:00+02:00,2025-05-25,20:18,1,5,6
28,2025-05-25T12:20:00+02:00,2025-05-25,20:20,2,2,4
29,2025-05-25T12:10:00+02:00,2025-05-25,20:10,0,3,3
29,2025-05-25T12:15:00+02:00,2025-05-25,20:15,0,1,1
29,2025-05-25T12:21:00+02:00,2025-05-25,20:21,0,8,8
31,2025-05-25T12:20:00+02:00,2025-05-25,20:20,0,3,3
31,2025-05-25T12:21:00+02:00,2025-05-25,20:21,8,0,8
31,2025-05-25T12:24:00+02:00,2025-05-25,20:24,0,7,7
36,2025-05-25T12:23:00+02:00,2025-05-25,20:23,7,0,7
39,2025-05-25T12:14:00+02:00,2025-05-25,20:14,1,2,3
39,2025-05-25T12:15:00+02:00,2025-05-25,20:15,0,1,1
40,2025-05-25T12:10:00+02:00,2025-05-25,20:10,7,1,8
40,2025-05-25T12:12:00+02:00,2025-05-25,20:12,6,0,6
40,2025-05-25T12:15:00+02:00,2025-05-25,20:15,9,0,9
40,2025-05-25T12:17:00+02:00,2025-05-25,20:17,4,1,5
40,2025-05-25T12:21:00+02:00,2025-05-25,20:21,2,1,3
40,2025-05-25T12:23:00+02:00,2025-05-25,20:23,1,0,1
40,2025-05-25T12:24:00+02:00,2025-05-25,20:24,1,0,1
41,2025-05-25T12:13:00+02:00,2025-05-25,20:13,0,1,1
41,2025-05-25T12:14:00+02:00,2025-05-25,20:14,1,1,2
41,2025-05-25T12:15:00+02:00,2025-05-25,20:15,0,1,1
41,2025-05-25T12:18:00+02:00,2025-05-25,20:18,0,2,2
41,2025-05-25T12:19:00+02:00,2025-05-25,20:19,3,1,4
43,2025-05-25T12:20:00+02:00,2025-05-25,20:20,6,4,10
44,2025-05-25T12:20:00+02:00,2025-05-25,20:20,1,1,2
45,2025-05-25T12:10:00+02:00,2025-05-25,20:10,22,18,40
45,2025-05-25T12:13:00+02:00,2025-05-25,20:13,6,2,8
45,2025-05-25T12:14:00+02:00,2025-05-25,20:14,2,13,15
45,2025-05-25T12:18:00+02:00,2025-05-25,20:18,12,11,23
45,2025-05-25T12:19:00+02:00,2025-05-25,20:19,4,14,18
47,2025-05-25T12:10:00+02:00,2025-05-25,20:10,8,2,10
47,2025-05-25T12:17:00+02:00,2025-05-25,20:17,8,13,21
47,2025-05-25T12:22:00+02:00,2025-05-25,20:22,9,8,17
47,2025-05-25T12:23:00+02:00,2025-05-25,20:23,11,9,20
50,2025-05-25T12:10:00+02:00,2025-05-25,20:10,2,2,4
50,2025-05-25T12:11:00+02:00,2025-05-25,20:11,1,3,4
50,2025-05-25T12:14:00+02:00,2025-05-25,20:14,0,8,8
50,2025-05-25T12:22:00+02:00,2025-05-25,20:22,5,1,6
54,2025-05-25T12:15:00+02:00,2025-05-25,20:15,2,1,3
54,2025-05-25T12:16:00+02:00,2025-05-25,20:16,1,2,3
54,2025-05-25T12:20:00+02:00,2025-05-25,20:20,1,0,1
54,2025-05-25T12:23:00+02:00,2025-05-25,20:23,10,3,13
59,2025-05-25T12:15:00+02:00,2025-05-25,20:15,11,16,27
61,2025-05-25T12:10:00+02:00,2025-05-25,20:10,6,0,6
61,2025-05-25T12:12:00+02:00,2025-05-25,20:12,5,1,6
61,2025-05-25T12:13:00+02:00,2025-05-25,20:13,2,1,3
61,2025-05-25T12:15:00+02:00,2025-05-25,20:15,7,8,15
61,2025-05-25T12:21:00+02:00,2025-05-25,20:21,6,0,6
61,2025-05-25T12:22:00+02:00,2025-05-25,20:22,3,3,6
61,2025-05-25T12:24:00+02:00,2025-05-25,20:24,1,0,1
66,2025-05-25T12:12:00+02:00,2025-05-25,20:12,17,10,27
66,2025-05-25T12:14:00+02:00,2025-05-25,20:14,14,10,24
66,2025-05-25T12:15:00+02:00,2025-05-25,20:15,9,19,28
66,2025-05-25T12:18:00+02:00,2025-05-25,20:18,17,9,26
66,2025-05-25T12:19:00+02:00,2025-05-25,20:19,24,22,46
66,2025-05-25T12:20:00+02:00,2025-05-25,20:20,33,6,39
66,2025-05-25T12:23:00+02:00,2025-05-25,20:23,16,8,24
69,2025-05-25T12:14:00+02:00,2025-05-25,20:14,1,0,1
69,2025-05-25T12:21:00+02:00,2025-05-25,20:21,2,1,3
70,2025-05-25T12:11:00+02:00,2025-05-25,20:11,0,2,2
70,2025-05-25T12:13:00+02:00,2025-05-25,20:13,2,3,5
70,2025-05-25T12:15:00+02:00,2025-05-25,20:15,5,2,7
70,2025-05-25T12:16:00+02:00,2025-05-25,20:16,6,3,9
70,2025-05-25T12:18:00+02:00,2025-05-25,20:18,0,5,5
70,2025-05-25T12:21:00+02:00,2025-05-25,20:21,2,0,2
71,2025-05-25T12:13:00+02:00,2025-05-25,20:13,1,0,1
78,2025-05-25T12:19:00+02:00,2025-05-25,20:19,1,0,1
78,2025-05-25T12:23:00+02:00,2025-05-25,20:23,0,1,1
84,2025-05-25T12:20:00+02:00,2025-05-25,20:20,43,59,102
87,2025-05-25T12:10:00+02:00,2025-05-25,20:10,1,0,1
87,2025-05-25T12:19:00+02:00,2025-05-25,20:19,2,2,4
107,2025-05-25T12:15:00+02:00,2025-05-25,20:15,8,2,10
108,2025-05-25T12:10:00+02:00,2025-05-25,20:10,1,1,2
108,2025-05-25T12:16:00+02:00,2025-05-25,20:16,0,3,3
108,2025-05-25T12:20:00+02:00,2025-05-25,20:20,0,1,1
108,2025-05-25T12:22:00+02:00,2025-05-25,20:22,1,1,2
108,2025-05-25T12:24:00+02:00,2025-05-25,20:24,0,1,1
131,2025-05-25T12:10:00+02:00,2025-05-25,20:10,10,0,10
133,2025-05-25T12:20:00+02:00,2025-05-25,20:20,24,30,54
134,2025-05-25T12:20:00+02:00,2025-05-25,20:20,15,25,40
135,2025-05-25T12:20:00+02:00,2025-05-25,20:20,15,14,29
162,2025-05-25T12:20:00+02:00,2025-05-25,20:20,16,5,21
165,2025-05-25T12:15:00+02:00,2025-05-25,20:15,1,0,1
167,2025-05-25T12:10:00+02:00,2025-05-25,20:10,0,1,1
179,2025-05-25T12:20:00+02:00,2025-05-25,20:20,12,6,18
1,2025-05-25T12:15:00+02:00,2025-05-25,20:15,0,5,5
1,2025-05-25T12:17:00+02:00,2025-05-25,20:17,7,5,12
1,2025-05-25T12:18:00+02:00,2025-05-25,20:18,6,5,11
1,2025-05-25T12:19:00+02:00,2025-05-25,20:19,8,5,13
1,2025-05-25T12:21:00+02:00,2025-05-25,20:21,0,1,1
2,2025-05-25T12:12:00+02:00,2025-05-25,20:12,3,0,3
2,2025-05-25T12:16:00+02:00,2025-05-25,20:16,0,1,1
2,2025-05-25T12:17:00+02:00,2025-05-25,20:17,0,4,4
2,2025-05-25T12:20:00+02:00,2025-05-25,20:20,2,9,11
2,2025-05-25T12:22:00+02:00,2025-05-25,20:22,0,13,13
2,2025-05-25T12:23:00+02:00,2025-05-25,20:23,1,3,4
9,2025-05-25T12:21:00+02:00,2025-05-25,20:21,2,1,3
10,2025-05-25T12:11:00+02:00,2025-05-25,20:11,0,1,1
10,2025-05-25T12:20:00+02:00,2025-05-25,20:20,1,0,1
11,2025-05-25T12:10:00+02:00,2025-05-25,20:10,3,0,3
12,2025-05-25T12:12:00+02:00,2025-05-25,20:12,0,5,5
12,2025-05-25T12:23:00+02:00,2025-05-25,20:23,4,0,4
12,2025-05-25T12:24:00+02:00,2025-05-25,20:24,2,5,7
17,2025-05-25T12:18:00+02:00,2025-05-25,20:18,2,0,2
17,2025-05-25T12:19:00+02:00,2025-05-25,20:19,0,3,3
17,2025-05-25T12:20:00+02:00,2025-05-25,20:20,2,1,3
17,2025-05-25T12:24:00+02:00,2025-05-25,20:24,2,0,2
18,2025-05-25T12:10:00+02:00,2025-05-25,20:10,0,1,1
19,2025-05-25T12:14:00+02:00,2025-05-25,20:14,6,9,15
19,2025-05-25T12:15:00+02:00,2025-05-25,20:15,4,8,12
19,2025-05-25T12:16:00+02:00,2025-05-25,20:16,4,4,8
19,2025-05-25T12:17:00+02:00,2025-05-25,20:17,10,4,14
19,2025-05-25T12:18:00+02:00,2025-05-25,20:18,4,3,7
19,2025-05-25T12:22:00+02:00,2025-05-25,20:22,8,13,21
20,2025-05-25T12:11:00+02:00,2025-05-25,20:11,2,4,6
20,2025-05-25T12:17:00+02:00,2025-05-25,20:17,11,20,31
20,2025-05-25T12:18:00+02:00,2025-05-25,20:18,5,10,15
20,2025-05-25T12:19:00+02:00,2025-05-25,20:19,4,0,4
20,2025-05-25T12:20:00+02:00,2025-05-25,20:20,4,13,17
20,2025-05-25T12:21:00+02:00,2025-05-25,20:21,9,5,14
20,2025-05-25T12:23:00+02:00,2025-05-25,20:23,1,3,4
23,2025-05-25T12:17:00+02:00,2025-05-25,20:17,0,13,13
23,2025-05-25T12:19:00+02:00,2025-05-25,20:19,0,1,1
23,2025-05-25T12:22:00+02:00,2025-05-25,20:22,2,3,5
23,2025-05-25T12:23:00+02:00,2025-05-25,20:23,2,0,2
24,2025-05-25T12:17:00+02:00,2025-05-25,20:17,1,17,18
24,2025-05-25T12:18:00+02:00,2025-05-25,20:18,0,21,21
27,2025-05-25T12:11:00+02:00,2025-05-25,20:11,4,2,6
27,2025-05-25T12:12:00+02:00,2025-05-25,20:12,1,0,1
27,2025-05-25T12:13:00+02:00,2025-05-25,20:13,0,1,1
27,2025-05-25T12:16:00+02:00,2025-05-25,20:16,3,0,3
27,2025-05-25T12:20:00+02:00,2025-05-25,20:20,2,0,2
30,2025-05-25T12:13:00+02:00,2025-05-25,20:13,3,15,18
30,2025-05-25T12:23:00+02:00,2025-05-25,20:23,1,5,6
30,2025-05-25T12:24:00+02:00,2025-05-25,20:24,6,4,10
35,2025-05-25T12:11:00+02:00,2025-05-25,20:11,2,4,6
35,2025-05-25T12:14:00+02:00,2025-05-25,20:14,7,1,8
35,2025-05-25T12:19:00+02:00,2025-05-25,20:19,9,6,15
35,2025-05-25T12:22:00+02:00,2025-05-25,20:22,4,8,12
48,2025-05-25T12:21:00+02:00,2025-05-25,20:21,1,6,7
48,2025-05-25T12:23:00+02:00,2025-05-25,20:23,3,0,3
48,2025-05-25T12:24:00+02:00,2025-05-25,20:24,5,0,5
49,2025-05-25T12:12:00+02:00,2025-05-25,20:12,7,4,11
49,2025-05-25T12:18:00+02:00,2025-05-25,20:18,2,1,3
49,2025-05-25T12:22:00+02:00,2025-05-25,20:22,4,2,6
49,2025-05-25T12:23:00+02:00,2025-05-25,20:23,2,4,6
49,2025-05-25T12:24:00+02:00,2025-05-25,20:24,9,1,10
51,2025-05-25T12:11:00+02:00,2025-05-25,20:11,0,1,1
51,2025-05-25T12:18:00+02:00,2025-05-25,20:18,2,0,2
51,2025-05-25T12:19:00+02:00,2025-05-25,20:19,1,0,1
51,2025-05-25T12:22:00+02:00,2025-05-25,20:22,1,1,2
52,2025-05-25T12:11:00+02:00,2025-05-25,20:11,4,1,5
52,2025-05-25T12:13:00+02:00,2025-05-25,20:13,1,11,12
52,2025-05-25T12:16:00+02:00,2025-05-25,20:16,4,2,6
52,2025-05-25T12:17:00+02:00,2025-05-25,20:17,3,2,5
52,2025-05-25T12:19:00+02:00,2025-05-25,20:19,2,6,8
52,2025-05-25T12:22:00+02:00,2025-05-25,20:22,12,4,16
53,2025-05-25T12:14:00+02:00,2025-05-25,20:14,2,12,14
53,2025-05-25T12:16:00+02:00,2025-05-25,20:16,0,2,2
53,2025-05-25T12:21:00+02:00,2025-05-25,20:21,0,4,4
56,2025-05-25T12:13:00+02:00,2025-05-25,20:13,3,4,7
56,2025-05-25T12:18:00+02:00,2025-05-25,20:18,8,11,19
56,2025-05-25T12:20:00+02:00,2025-05-25,20:20,2,8,10
56,2025-05-25T12:21:00+02:00,2025-05-25,20:21,7,11,18
56,2025-05-25T12:22:00+02:00,2025-05-25,20:22,10,4,14
58,2025-05-25T12:11:00+02:00,2025-05-25,20:11,2,0,2
58,2025-05-25T12:22:00+02:00,2025-05-25,20:22,2,6,8
58,2025-05-25T12:23:00+02:00,2025-05-25,20:23,0,1,1
58,2025-05-25T12:24:00+02:00,2025-05-25,20:24,5,4,9
62,2025-05-25T12:11:00+02:00,2025-05-25,20:11,3,0,3
62,2025-05-25T12:12:00+02:00,2025-05-25,20:12,3,1,4
62,2025-05-25T12:13:00+02:00,2025-05-25,20:13,12,0,12
62,2025-05-25T12:16:00+02:00,2025-05-25,20:16,4,7,11
62,2025-05-25T12:20:00+02:00,2025-05-25,20:20,4,0,4
62,2025-05-25T12:24:00+02:00,2025-05-25,20:24,3,1,4
63,2025-05-25T12:11:00+02:00,2025-05-25,20:11,0,3,3
63,2025-05-25T12:15:00+02:00,2025-05-25,20:15,1,5,6
63,2025-05-25T12:17:00+02:00,2025-05-25,20:17,0,2,2
63,2025-05-25T12:21:00+02:00,2025-05-25,20:21,0,1,1
63,2025-05-25T12:22:00+02:00,2025-05-25,20:22,0,4,4
67,2025-05-25T12:19:00+02:00,2025-05-25,20:19,0,3,3
67,2025-05-25T12:20:00+02:00,2025-05-25,20:20,1,13,14
68,2025-05-25T12:12:00+02:00,2025-05-25,20:12,0,1,1
68,2025-05-25T12:17:00+02:00,2025-05-25,20:17,3,0,3
68,2025-05-25T12:23:00+02:00,2025-05-25,20:23,1,0,1
72,2025-05-25T12:13:00+02:00,2025-05-25,20:13,5,2,7
72,2025-05-25T12:15:00+02:00,2025-05-25,20:15,5,7,12
72,2025-05-25T12:18:00+02:00,2025-05-25,20:18,3,9,12
72,2025-05-25T12:24:00+02:00,2025-05-25,20:24,0,2,2
76,2025-05-25T12:12:00+02:00,2025-05-25,20:12,0,1,1
76,2025-05-25T12:21:00+02:00,2025-05-25,20:21,0,1,1
79,2025-05-25T12:10:00+02:00,2025-05-25,20:10,7,10,17
79,2025-05-25T12:13:00+02:00,2025-05-25,20:13,4,8,12
79,2025-05-25T12:15:00+02:00,2025-05-25,20:15,2,3,5
79,2025-05-25T12:16:00+02:00,2025-05-25,20:16,8,4,12
79,2025-05-25T12:18:00+02:00,2025-05-25,20:18,4,4,8
79,2025-05-25T12:19:00+02:00,2025-05-25,20:19,1,1,2
79,2025-05-25T12:23:00+02:00,2025-05-25,20:23,0,6,6
85,2025-05-25T12:11:00+02:00,2025-05-25,20:11,0,1,1
85,2025-05-25T12:15:00+02:00,2025-05-25,20:15,0,1,1
85,2025-05-25T12:19:00+02:00,2025-05-25,20:19,0,1,1
85,2025-05-25T12:22:00+02:00,2025-05-25,20:22,1,0,1
86,2025-05-25T12:11:00+02:00,2025-05-25,20:11,1,0,1
86,2025-05-25T12:18:00+02:00,2025-05-25,20:18,2,0,2
86,2025-05-25T12:20:00+02:00,2025-05-25,20:20,1,0,1
117,2025-05-25T12:10:00+02:00,2025-05-25,20:10,17,1,18
117,2025-05-25T12:15:00+02:00,2025-05-25,20:15,11,4,15
141,2025-05-25T12:10:00+02:00,2025-05-25,20:10,4,12,16
142,2025-05-25T12:10:00+02:00,2025-05-25,20:10,1,2,3
164,2025-05-25T12:20:00+02:00,2025-05-25,20:20,3,8,11
181,2025-05-25T12:15:00+02:00,2025-05-25,20:15,8,6,14
181,2025-05-25T12:18:00+02:00,2025-05-25,20:18,24,8,32
181,2025-05-25T12:22:00+02:00,2025-05-25,20:22,18,13,31
181,2025-05-25T12:24:00+02:00,2025-05-25,20:24,5,6,11
181,2025-05-25T12:28:00+02:00,2025-05-25,20:28,15,11,26
181,2025-05-25T12:29:00+02:00,2025-05-25,20:29,7,10,17
181,2025-05-25T12:31:00+02:00,2025-05-25,20:31,14,14,28
181,2025-05-25T12:32:00+02:00,2025-05-25,20:32,7,13,20
181,2025-05-25T12:35:00+02:00,2025-05-25,20:35,7,10,17
181,2025-05-25T12:36:00+02:00,2025-05-25,20:36,7,8,15
181,2025-05-25T12:39:00+02:00,2025-05-25,20:39,6,3,9
182,2025-05-25T12:35:00+02:00,2025-05-25,20:35,3,24,27
180,2025-05-25T12:35:00+02:00,2025-05-25,20:35,1,0,1
3,2025-05-25T10:55:00+02:00,2025-05-25,18:55,14,13,27
3,2025-05-25T11:00:00+02:00,2025-05-25,19:00,16,19,35
3,2025-05-25T11:04:00+02:00,2025-05-25,19:04,6,29,35
4,2025-05-25T10:55:00+02:00,2025-05-25,18:55,19,27,46
4,2025-05-25T10:57:00+02:00,2025-05-25,18:57,16,8,24
4,2025-05-25T10:58:00+02:00,2025-05-25,18:58,14,14,28
4,2025-05-25T10:59:00+02:00,2025-05-25,18:59,16,11,27
4,2025-05-25T11:00:00+02:00,2025-05-25,19:00,25,35,60
4,2025-05-25T11:03:00+02:00,2025-05-25,19:03,14,25,39
4,2025-05-25T11:09:00+02:00,2025-05-25,19:09,19,27,46
5,2025-05-25T10:55:00+02:00,2025-05-25,18:55,41,71,112
6,2025-05-25T10:58:00+02:00,2025-05-25,18:58,2,4,6
6,2025-05-25T10:59:00+02:00,2025-05-25,18:59,2,8,10
6,2025-05-25T11:02:00+02:00,2025-05-25,19:02,17,6,23
6,2025-05-25T11:03:00+02:00,2025-05-25,19:03,9,1,10
6,2025-05-25T11:04:00+02:00,2025-05-25,19:04,11,12,23
6,2025-05-25T11:05:00+02:00,2025-05-25,19:05,6,17,23
6,2025-05-25T11:06:00+02:00,2025-05-25,19:06,7,3,10
8,2025-05-25T10:56:00+02:00,2025-05-25,18:56,0,1,1
8,2025-05-25T11:07:00+02:00,2025-05-25,19:07,0,1,1
21,2025-05-25T11:05:00+02:00,2025-05-25,19:05,48,53,101
28,2025-05-25T10:59:00+02:00,2025-05-25,18:59,3,14,17
28,2025-05-25T11:00:00+02:00,2025-05-25,19:00,0,13,13
28,2025-05-25T11:03:00+02:00,2025-05-25,19:03,0,10,10
28,2025-05-25T11:06:00+02:00,2025-05-25,19:06,9,22,31
29,2025-05-25T11:00:00+02:00,2025-05-25,19:00,14,7,21
29,2025-05-25T11:02:00+02:00,2025-05-25,19:02,4,6,10
29,2025-05-25T11:05:00+02:00,2025-05-25,19:05,2,0,2
29,2025-05-25T11:06:00+02:00,2025-05-25,19:06,0,6,6
29,2025-05-25T11:08:00+02:00,2025-05-25,19:08,5,10,15
31,2025-05-25T10:56:00+02:00,2025-05-25,18:56,3,7,10
31,2025-05-25T10:58:00+02:00,2025-05-25,18:58,6,11,17
31,2025-05-25T11:07:00+02:00,2025-05-25,19:07,2,0,2
31,2025-05-25T11:09:00+02:00,2025-05-25,19:09,3,1,4
36,2025-05-25T10:56:00+02:00,2025-05-25,18:56,1,0,1
36,2025-05-25T10:57:00+02:00,2025-05-25,18:57,2,4,6
36,2025-05-25T11:03:00+02:00,2025-05-25,19:03,0,2,2
39,2025-05-25T10:58:00+02:00,2025-05-25,18:58,0,1,1
40,2025-05-25T10:56:00+02:00,2025-05-25,18:56,3,0,3
40,2025-05-25T11:04:00+02:00,2025-05-25,19:04,0,1,1
40,2025-05-25T11:09:00+02:00,2025-05-25,19:09,1,0,1
41,2025-05-25T10:55:00+02:00,2025-05-25,18:55,1,0,1
41,2025-05-25T11:00:00+02:00,2025-05-25,19:00,1,0,1
41,2025-05-25T11:03:00+02:00,2025-05-25,19:03,1,0,1
41,2025-05-25T11:04:00+02:00,2025-05-25,19:04,0,1,1
41,2025-05-25T11:08:00+02:00,2025-05-25,19:08,3,4,7
45,2025-05-25T10:55:00+02:00,2025-05-25,18:55,13,13,26
45,2025-05-25T10:56:00+02:00,2025-05-25,18:56,14,9,23
45,2025-05-25T10:58:00+02:00,2025-05-25,18:58,4,16,20
45,2025-05-25T10:59:00+02:00,2025-05-25,18:59,22,12,34
45,2025-05-25T11:00:00+02:00,2025-05-25,19:00,11,11,22
45,2025-05-25T11:03:00+02:00,2025-05-25,19:03,8,11,19
45,2025-05-25T11:06:00+02:00,2025-05-25,19:06,20,22,42
45,2025-05-25T11:07:00+02:00,2025-05-25,19:07,15,6,21
47,2025-05-25T10:55:00+02:00,2025-05-25,18:55,13,11,24
47,2025-05-25T10:58:00+02:00,2025-05-25,18:58,15,12,27
47,2025-05-25T10:59:00+02:00,2025-05-25,18:59,17,9,26
47,2025-05-25T11:04:00+02:00,2025-05-25,19:04,8,7,15
47,2025-05-25T11:06:00+02:00,2025-05-25,19:06,11,12,23
47,2025-05-25T11:07:00+02:00,2025-05-25,19:07,13,12,25
47,2025-05-25T11:09:00+02:00,2025-05-25,19:09,12,16,28
50,2025-05-25T10:57:00+02:00,2025-05-25,18:57,0,4,4
50,2025-05-25T11:04:00+02:00,2025-05-25,19:04,5,3,8
50,2025-05-25T11:08:00+02:00,2025-05-25,19:08,6,2,8
50,2025-05-25T11:09:00+02:00,2025-05-25,19:09,3,9,12
54,2025-05-25T10:55:00+02:00,2025-05-25,18:55,1,0,1
54,2025-05-25T10:56:00+02:00,2025-05-25,18:56,0,1,1
54,2025-05-25T10:59:00+02:00,2025-05-25,18:59,3,4,7
54,2025-05-25T11:01:00+02:00,2025-05-25,19:01,0,10,10
54,2025-05-25T11:02:00+02:00,2025-05-25,19:02,1,6,7
54,2025-05-25T11:03:00+02:00,2025-05-25,19:03,1,3,4
54,2025-05-25T11:06:00+02:00,2025-05-25,19:06,4,2,6
61,2025-05-25T10:57:00+02:00,2025-05-25,18:57,3,2,5
61,2025-05-25T11:00:00+02:00,2025-05-25,19:00,5,10,15
61,2025-05-25T11:04:00+02:00,2025-05-25,19:04,1,2,3
61,2025-05-25T11:09:00+02:00,2025-05-25,19:09,9,2,11
66,2025-05-25T10:55:00+02:00,2025-05-25,18:55,13,30,43
66,2025-05-25T11:01:00+02:00,2025-05-25,19:01,11,17,28
69,2025-05-25T11:02:00+02:00,2025-05-25,19:02,2,1,3
69,2025-05-25T11:08:00+02:00,2025-05-25,19:08,0,1,1
70,2025-05-25T10:58:00+02:00,2025-05-25,18:58,2,1,3
70,2025-05-25T11:00:00+02:00,2025-05-25,19:00,2,3,5
70,2025-05-25T11:05:00+02:00,2025-05-25,19:05,1,3,4
70,2025-05-25T11:06:00+02:00,2025-05-25,19:06,7,2,9
70,2025-05-25T11:09:00+02:00,2025-05-25,19:09,4,0,4
75,2025-05-25T11:00:00+02:00,2025-05-25,19:00,1,1,2
75,2025-05-25T11:01:00+02:00,2025-05-25,19:01,1,0,1
75,2025-05-25T11:08:00+02:00,2025-05-25,19:08,1,0,1
77,2025-05-25T11:05:00+02:00,2025-05-25,19:05,13,7,20
87,2025-05-25T10:55:00+02:00,2025-05-25,18:55,3,0,3
87,2025-05-25T10:59:00+02:00,2025-05-25,18:59,3,0,3
87,2025-05-25T11:01:00+02:00,2025-05-25,19:01,3,0,3
87,2025-05-25T11:03:00+02:00,2025-05-25,19:03,0,3,3
87,2025-05-25T11:07:00+02:00,2025-05-25,19:07,2,1,3
87,2025-05-25T11:08:00+02:00,2025-05-25,19:08,0,1,1
87,2025-05-25T11:09:00+02:00,2025-05-25,19:09,3,2,5
107,2025-05-25T11:00:00+02:00,2025-05-25,19:00,9,7,16
108,2025-05-25T10:59:00+02:00,2025-05-25,18:59,2,4,6
108,2025-05-25T11:03:00+02:00,2025-05-25,19:03,0,1,1
108,2025-05-25T11:09:00+02:00,2025-05-25,19:09,2,6,8
131,2025-05-25T10:55:00+02:00,2025-05-25,18:55,18,5,23
133,2025-05-25T11:05:00+02:00,2025-05-25,19:05,30,35,65
134,2025-05-25T10:55:00+02:00,2025-05-25,18:55,36,21,57
162,2025-05-25T10:55:00+02:00,2025-05-25,18:55,14,27,41
162,2025-05-25T11:05:00+02:00,2025-05-25,19:05,21,20,41
165,2025-05-25T11:05:00+02:00,2025-05-25,19:05,0,3,3
166,2025-05-25T10:55:00+02:00,2025-05-25,18:55,1,4,5
166,2025-05-25T11:05:00+02:00,2025-05-25,19:05,2,0,2
167,2025-05-25T11:00:00+02:00,2025-05-25,19:00,0,1,1
179,2025-05-25T10:55:00+02:00,2025-05-25,18:55,8,1,9
179,2025-05-25T11:00:00+02:00,2025-05-25,19:00,5,5,10
1,2025-05-25T10:56:00+02:00,2025-05-25,18:56,12,12,24
1,2025-05-25T10:57:00+02:00,2025-05-25,18:57,17,4,21
1,2025-05-25T10:58:00+02:00,2025-05-25,18:58,12,6,18
1,2025-05-25T11:02:00+02:00,2025-05-25,19:02,12,15,27
1,2025-05-25T11:03:00+02:00,2025-05-25,19:03,30,3,33
1,2025-05-25T11:07:00+02:00,2025-05-25,19:07,23,4,27
1,2025-05-25T11:08:00+02:00,2025-05-25,19:08,8,3,11
1,2025-05-25T11:09:00+02:00,2025-05-25,19:09,18,7,25
2,2025-05-25T10:55:00+02:00,2025-05-25,18:55,3,1,4
2,2025-05-25T10:57:00+02:00,2025-05-25,18:57,2,1,3
2,2025-05-25T10:59:00+02:00,2025-05-25,18:59,5,0,5
2,2025-05-25T11:02:00+02:00,2025-05-25,19:02,6,2,8
2,2025-05-25T11:03:00+02:00,2025-05-25,19:03,11,5,16
2,2025-05-25T11:04:00+02:00,2025-05-25,19:04,2,0,2
2,2025-05-25T11:06:00+02:00,2025-05-25,19:06,5,3,8
2,2025-05-25T11:09:00+02:00,2025-05-25,19:09,1,6,7
9,2025-05-25T10:59:00+02:00,2025-05-25,18:59,0,2,2
9,2025-05-25T11:08:00+02:00,2025-05-25,19:08,2,0,2
10,2025-05-25T11:01:00+02:00,2025-05-25,19:01,1,3,4
10,2025-05-25T11:02:00+02:00,2025-05-25,19:02,0,1,1
11,2025-05-25T11:00:00+02:00,2025-05-25,19:00,8,0,8
12,2025-05-25T10:55:00+02:00,2025-05-25,18:55,2,5,7
12,2025-05-25T10:59:00+02:00,2025-05-25,18:59,4,2,6
12,2025-05-25T11:01:00+02:00,2025-05-25,19:01,2,4,6
17,2025-05-25T10:55:00+02:00,2025-05-25,18:55,0,4,4
17,2025-05-25T10:58:00+02:00,2025-05-25,18:58,2,0,2
17,2025-05-25T11:00:00+02:00,2025-05-25,19:00,4,2,6
17,2025-05-25T11:06:00+02:00,2025-05-25,19:06,0,2,2
17,2025-05-25T11:07:00+02:00,2025-05-25,19:07,4,1,5
17,2025-05-25T11:08:00+02:00,2025-05-25,19:08,1,3,4
18,2025-05-25T11:04:00+02:00,2025-05-25,19:04,0,1,1
18,2025-05-25T11:08:00+02:00,2025-05-25,19:08,0,8,8
18,2025-05-25T11:09:00+02:00,2025-05-25,19:09,1,1,2
19,2025-05-25T10:55:00+02:00,2025-05-25,18:55,11,5,16
19,2025-05-25T10:56:00+02:00,2025-05-25,18:56,11,10,21
19,2025-05-25T10:59:00+02:00,2025-05-25,18:59,10,7,17
19,2025-05-25T11:01:00+02:00,2025-05-25,19:01,9,8,17
19,2025-05-25T11:06:00+02:00,2025-05-25,19:06,23,2,25
19,2025-05-25T11:07:00+02:00,2025-05-25,19:07,9,3,12
19,2025-05-25T11:08:00+02:00,2025-05-25,19:08,19,4,23
20,2025-05-25T10:58:00+02:00,2025-05-25,18:58,14,24,38
20,2025-05-25T10:59:00+02:00,2025-05-25,18:59,12,3,15
20,2025-05-25T11:05:00+02:00,2025-05-25,19:05,7,9,16
20,2025-05-25T11:07:00+02:00,2025-05-25,19:07,7,21,28
20,2025-05-25T11:09:00+02:00,2025-05-25,19:09,8,10,18
23,2025-05-25T10:55:00+02:00,2025-05-25,18:55,0,7,7
23,2025-05-25T11:01:00+02:00,2025-05-25,19:01,3,6,9
23,2025-05-25T11:04:00+02:00,2025-05-25,19:04,1,2,3
23,2025-05-25T11:06:00+02:00,2025-05-25,19:06,3,4,7
23,2025-05-25T11:09:00+02:00,2025-05-25,19:09,0,8,8
24,2025-05-25T10:55:00+02:00,2025-05-25,18:55,9,0,9
24,2025-05-25T10:56:00+02:00,2025-05-25,18:56,8,6,14
24,2025-05-25T10:59:00+02:00,2025-05-25,18:59,3,13,16
24,2025-05-25T11:00:00+02:00,2025-05-25,19:00,5,12,17
24,2025-05-25T11:02:00+02:00,2025-05-25,19:02,3,6,9
24,2025-05-25T11:06:00+02:00,2025-05-25,19:06,2,15,17
24,2025-05-25T11:07:00+02:00,2025-05-25,19:07,4,24,28
24,2025-05-25T11:08:00+02:00,2025-05-25,19:08,10,7,17
24,2025-05-25T11:09:00+02:00,2025-05-25,19:09,10,1,11
25,2025-05-25T11:05:00+02:00,2025-05-25,19:05,19,24,43
27,2025-05-25T10:56:00+02:00,2025-05-25,18:56,1,0,1
27,2025-05-25T11:03:00+02:00,2025-05-25,19:03,0,1,1
27,2025-05-25T11:05:00+02:00,2025-05-25,19:05,0,3,3
27,2025-05-25T11:08:00+02:00,2025-05-25,19:08,4,0,4
30,2025-05-25T10:59:00+02:00,2025-05-25,18:59,1,8,9
30,2025-05-25T11:06:00+02:00,2025-05-25,19:06,2,8,10
30,2025-05-25T11:07:00+02:00,2025-05-25,19:07,9,10,19
30,2025-05-25T11:08:00+02:00,2025-05-25,19:08,5,17,22
35,2025-05-25T10:56:00+02:00,2025-05-25,18:56,15,9,24
35,2025-05-25T10:57:00+02:00,2025-05-25,18:57,4,10,14
35,2025-05-25T10:58:00+02:00,2025-05-25,18:58,13,21,34
35,2025-05-25T11:01:00+02:00,2025-05-25,19:01,7,9,16
35,2025-05-25T11:02:00+02:00,2025-05-25,19:02,14,15,29
48,2025-05-25T10:57:00+02:00,2025-05-25,18:57,2,5,7
48,2025-05-25T11:00:00+02:00,2025-05-25,19:00,1,4,5
48,2025-05-25T11:02:00+02:00,2025-05-25,19:02,3,0,3
48,2025-05-25T11:03:00+02:00,2025-05-25,19:03,2,6,8
48,2025-05-25T11:04:00+02:00,2025-05-25,19:04,5,2,7
48,2025-05-25T11:05:00+02:00,2025-05-25,19:05,1,7,8
49,2025-05-25T10:55:00+02:00,2025-05-25,18:55,5,14,19
49,2025-05-25T10:59:00+02:00,2025-05-25,18:59,7,4,11
49,2025-05-25T11:03:00+02:00,2025-05-25,19:03,2,6,8
51,2025-05-25T10:55:00+02:00,2025-05-25,18:55,2,1,3
51,2025-05-25T11:01:00+02:00,2025-05-25,19:01,5,0,5
51,2025-05-25T11:02:00+02:00,2025-05-25,19:02,1,10,11
51,2025-05-25T11:03:00+02:00,2025-05-25,19:03,7,1,8
51,2025-05-25T11:05:00+02:00,2025-05-25,19:05,7,1,8
51,2025-05-25T11:08:00+02:00,2025-05-25,19:08,2,0,2
52,2025-05-25T10:55:00+02:00,2025-05-25,18:55,4,12,16
52,2025-05-25T11:03:00+02:00,2025-05-25,19:03,2,13,15
53,2025-05-25T10:56:00+02:00,2025-05-25,18:56,3,1,4
53,2025-05-25T10:59:00+02:00,2025-05-25,18:59,0,2,2
53,2025-05-25T11:01:00+02:00,2025-05-25,19:01,5,3,8
56,2025-05-25T10:55:00+02:00,2025-05-25,18:55,16,12,28
56,2025-05-25T10:58:00+02:00,2025-05-25,18:58,8,5,13
56,2025-05-25T11:05:00+02:00,2025-05-25,19:05,9,11,20
56,2025-05-25T11:07:00+02:00,2025-05-25,19:07,7,12,19
56,2025-05-25T11:08:00+02:00,2025-05-25,19:08,9,1,10
58,2025-05-25T10:55:00+02:00,2025-05-25,18:55,8,18,26
58,2025-05-25T10:58:00+02:00,2025-05-25,18:58,5,1,6
58,2025-05-25T11:00:00+02:00,2025-05-25,19:00,15,5,20
58,2025-05-25T11:04:00+02:00,2025-05-25,19:04,11,2,13
58,2025-05-25T11:06:00+02:00,2025-05-25,19:06,3,5,8
62,2025-05-25T10:55:00+02:00,2025-05-25,18:55,4,0,4
62,2025-05-25T10:56:00+02:00,2025-05-25,18:56,13,3,16
62,2025-05-25T10:59:00+02:00,2025-05-25,18:59,6,3,9
62,2025-05-25T11:00:00+02:00,2025-05-25,19:00,3,4,7
62,2025-05-25T11:03:00+02:00,2025-05-25,19:03,1,0,1
63,2025-05-25T11:04:00+02:00,2025-05-25,19:04,0,2,2
63,2025-05-25T11:05:00+02:00,2025-05-25,19:05,0,3,3
63,2025-05-25T11:07:00+02:00,2025-05-25,19:07,1,4,5
67,2025-05-25T10:56:00+02:00,2025-05-25,18:56,5,2,7
67,2025-05-25T10:59:00+02:00,2025-05-25,18:59,4,2,6
67,2025-05-25T11:01:00+02:00,2025-05-25,19:01,2,6,8
67,2025-05-25T11:06:00+02:00,2025-05-25,19:06,4,2,6
67,2025-05-25T11:07:00+02:00,2025-05-25,19:07,4,11,15
67,2025-05-25T11:08:00+02:00,2025-05-25,19:08,1,9,10
68,2025-05-25T10:59:00+02:00,2025-05-25,18:59,2,2,4
68,2025-05-25T11:02:00+02:00,2025-05-25,19:02,0,1,1
68,2025-05-25T11:09:00+02:00,2025-05-25,19:09,1,0,1
72,2025-05-25T11:00:00+02:00,2025-05-25,19:00,1,6,7
72,2025-05-25T11:01:00+02:00,2025-05-25,19:01,0,3,3
72,2025-05-25T11:04:00+02:00,2025-05-25,19:04,11,0,11
72,2025-05-25T11:07:00+02:00,2025-05-25,19:07,3,4,7
72,2025-05-25T11:08:00+02:00,2025-05-25,19:08,4,8,12
72,2025-05-25T11:09:00+02:00,2025-05-25,19:09,4,6,10
76,2025-05-25T10:55:00+02:00,2025-05-25,18:55,0,3,3
76,2025-05-25T11:05:00+02:00,2025-05-25,19:05,1,1,2
76,2025-05-25T11:09:00+02:00,2025-05-25,19:09,0,1,1
79,2025-05-25T10:55:00+02:00,2025-05-25,18:55,7,8,15
79,2025-05-25T10:58:00+02:00,2025-05-25,18:58,25,2,27
79,2025-05-25T11:01:00+02:00,2025-05-25,19:01,7,5,12
79,2025-05-25T11:03:00+02:00,2025-05-25,19:03,5,10,15
79,2025-05-25T11:05:00+02:00,2025-05-25,19:05,10,17,27
85,2025-05-25T10:59:00+02:00,2025-05-25,18:59,0,1,1
85,2025-05-25T11:01:00+02:00,2025-05-25,19:01,0,1,1
85,2025-05-25T11:03:00+02:00,2025-05-25,19:03,0,3,3
85,2025-05-25T11:08:00+02:00,2025-05-25,19:08,1,3,4
86,2025-05-25T10:56:00+02:00,2025-05-25,18:56,0,1,1
86,2025-05-25T11:09:00+02:00,2025-05-25,19:09,4,0,4
109,2025-05-25T11:05:00+02:00,2025-05-25,19:05,2,16,18
117,2025-05-25T10:55:00+02:00,2025-05-25,18:55,7,16,23
130,2025-05-25T10:55:00+02:00,2025-05-25,18:55,1,0,1
130,2025-05-25T11:05:00+02:00,2025-05-25,19:05,1,0,1
136,2025-05-25T11:00:00+02:00,2025-05-25,19:00,3,5,8
139,2025-05-25T11:00:00+02:00,2025-05-25,19:00,4,0,4
141,2025-05-25T10:55:00+02:00,2025-05-25,18:55,19,12,31
142,2025-05-25T11:00:00+02:00,2025-05-25,19:00,10,1,11
142,2025-05-25T11:05:00+02:00,2025-05-25,19:05,13,0,13
181,2025-05-25T11:21:00+02:00,2025-05-25,19:21,20,13,33
181,2025-05-25T11:23:00+02:00,2025-05-25,19:23,4,12,16
180,2025-05-25T11:16:00+02:00,2025-05-25,19:16,2,0,2
180,2025-05-25T11:18:00+02:00,2025-05-25,19:18,0,1,1
181,2025-05-25T11:26:00+02:00,2025-05-25,19:26,20,7,27
181,2025-05-25T11:27:00+02:00,2025-05-25,19:27,6,9,15
181,2025-05-25T11:29:00+02:00,2025-05-25,19:29,21,16,37
181,2025-05-25T11:32:00+02:00,2025-05-25,19:32,12,6,18
181,2025-05-25T11:35:00+02:00,2025-05-25,19:35,10,22,32
181,2025-05-25T11:36:00+02:00,2025-05-25,19:36,11,7,18
181,2025-05-25T11:38:00+02:00,2025-05-25,19:38,17,14,31
182,2025-05-25T11:30:00+02:00,2025-05-25,19:30,36,16,52
3,2025-05-25T11:10:00+02:00,2025-05-25,19:10,11,14,25
3,2025-05-25T11:12:00+02:00,2025-05-25,19:12,11,22,33
3,2025-05-25T11:13:00+02:00,2025-05-25,19:13,7,15,22
3,2025-05-25T11:16:00+02:00,2025-05-25,19:16,3,9,12
3,2025-05-25T11:17:00+02:00,2025-05-25,19:17,20,12,32
3,2025-05-25T11:19:00+02:00,2025-05-25,19:19,11,6,17
3,2025-05-25T11:21:00+02:00,2025-05-25,19:21,24,4,28
4,2025-05-25T11:11:00+02:00,2025-05-25,19:11,43,30,73
4,2025-05-25T11:13:00+02:00,2025-05-25,19:13,33,17,50
4,2025-05-25T11:15:00+02:00,2025-05-25,19:15,28,19,47
4,2025-05-25T11:18:00+02:00,2025-05-25,19:18,22,21,43
4,2025-05-25T11:19:00+02:00,2025-05-25,19:19,27,16,43
4,2025-05-25T11:23:00+02:00,2025-05-25,19:23,11,14,25
4,2025-05-25T11:24:00+02:00,2025-05-25,19:24,31,34,65
5,2025-05-25T11:15:00+02:00,2025-05-25,19:15,33,86,119
5,2025-05-25T11:20:00+02:00,2025-05-25,19:20,26,52,78
6,2025-05-25T11:15:00+02:00,2025-05-25,19:15,9,8,17
6,2025-05-25T11:17:00+02:00,2025-05-25,19:17,12,13,25
6,2025-05-25T11:19:00+02:00,2025-05-25,19:19,11,11,22
6,2025-05-25T11:21:00+02:00,2025-05-25,19:21,8,5,13
6,2025-05-25T11:24:00+02:00,2025-05-25,19:24,9,3,12
28,2025-05-25T11:13:00+02:00,2025-05-25,19:13,2,12,14
28,2025-05-25T11:14:00+02:00,2025-05-25,19:14,3,6,9
28,2025-05-25T11:15:00+02:00,2025-05-25,19:15,2,4,6
28,2025-05-25T11:17:00+02:00,2025-05-25,19:17,2,9,11
28,2025-05-25T11:21:00+02:00,2025-05-25,19:21,1,2,3
28,2025-05-25T11:22:00+02:00,2025-05-25,19:22,5,2,7
28,2025-05-25T11:23:00+02:00,2025-05-25,19:23,6,9,15
29,2025-05-25T11:12:00+02:00,2025-05-25,19:12,4,3,7
29,2025-05-25T11:15:00+02:00,2025-05-25,19:15,9,13,22
29,2025-05-25T11:16:00+02:00,2025-05-25,19:16,5,11,16
29,2025-05-25T11:17:00+02:00,2025-05-25,19:17,1,14,15
29,2025-05-25T11:20:00+02:00,2025-05-25,19:20,2,16,18
29,2025-05-25T11:23:00+02:00,2025-05-25,19:23,3,7,10
31,2025-05-25T11:14:00+02:00,2025-05-25,19:14,2,6,8
31,2025-05-25T11:21:00+02:00,2025-05-25,19:21,9,0,9
31,2025-05-25T11:22:00+02:00,2025-05-25,19:22,0,4,4
31,2025-05-25T11:23:00+02:00,2025-05-25,19:23,4,8,12
31,2025-05-25T11:24:00+02:00,2025-05-25,19:24,8,5,13
36,2025-05-25T11:11:00+02:00,2025-05-25,19:11,9,2,11
36,2025-05-25T11:13:00+02:00,2025-05-25,19:13,0,2,2
36,2025-05-25T11:16:00+02:00,2025-05-25,19:16,0,1,1
36,2025-05-25T11:17:00+02:00,2025-05-25,19:17,2,3,5
36,2025-05-25T11:20:00+02:00,2025-05-25,19:20,2,1,3
40,2025-05-25T11:10:00+02:00,2025-05-25,19:10,2,0,2
40,2025-05-25T11:13:00+02:00,2025-05-25,19:13,3,3,6
40,2025-05-25T11:17:00+02:00,2025-05-25,19:17,1,1,2
40,2025-05-25T11:18:00+02:00,2025-05-25,19:18,0,2,2
40,2025-05-25T11:23:00+02:00,2025-05-25,19:23,3,0,3
41,2025-05-25T11:11:00+02:00,2025-05-25,19:11,2,0,2
41,2025-05-25T11:19:00+02:00,2025-05-25,19:19,4,5,9
41,2025-05-25T11:21:00+02:00,2025-05-25,19:21,4,1,5
43,2025-05-25T11:10:00+02:00,2025-05-25,19:10,3,3,6
44,2025-05-25T11:10:00+02:00,2025-05-25,19:10,1,2,3
44,2025-05-25T11:15:00+02:00,2025-05-25,19:15,3,5,8
45,2025-05-25T11:10:00+02:00,2025-05-25,19:10,12,10,22
45,2025-05-25T11:12:00+02:00,2025-05-25,19:12,13,13,26
45,2025-05-25T11:15:00+02:00,2025-05-25,19:15,6,5,11
45,2025-05-25T11:19:00+02:00,2025-05-25,19:19,16,4,20
47,2025-05-25T11:10:00+02:00,2025-05-25,19:10,16,8,24
47,2025-05-25T11:13:00+02:00,2025-05-25,19:13,9,1,10
47,2025-05-25T11:16:00+02:00,2025-05-25,19:16,19,10,29
47,2025-05-25T11:17:00+02:00,2025-05-25,19:17,7,12,19
47,2025-05-25T11:18:00+02:00,2025-05-25,19:18,11,7,18
47,2025-05-25T11:21:00+02:00,2025-05-25,19:21,13,6,19
47,2025-05-25T11:22:00+02:00,2025-05-25,19:22,4,4,8
47,2025-05-25T11:24:00+02:00,2025-05-25,19:24,17,15,32
50,2025-05-25T11:10:00+02:00,2025-05-25,19:10,1,3,4
50,2025-05-25T11:11:00+02:00,2025-05-25,19:11,1,2,3
50,2025-05-25T11:16:00+02:00,2025-05-25,19:16,4,6,10
50,2025-05-25T11:17:00+02:00,2025-05-25,19:17,0,3,3
50,2025-05-25T11:19:00+02:00,2025-05-25,19:19,5,6,11
50,2025-05-25T11:21:00+02:00,2025-05-25,19:21,0,4,4
54,2025-05-25T11:10:00+02:00,2025-05-25,19:10,0,3,3
54,2025-05-25T11:11:00+02:00,2025-05-25,19:11,1,2,3
54,2025-05-25T11:12:00+02:00,2025-05-25,19:12,0,1,1
54,2025-05-25T11:14:00+02:00,2025-05-25,19:14,0,4,4
54,2025-05-25T11:19:00+02:00,2025-05-25,19:19,2,1,3
54,2025-05-25T11:20:00+02:00,2025-05-25,19:20,4,1,5
54,2025-05-25T11:21:00+02:00,2025-05-25,19:21,3,6,9
54,2025-05-25T11:22:00+02:00,2025-05-25,19:22,3,6,9
54,2025-05-25T11:23:00+02:00,2025-05-25,19:23,0,3,3
54,2025-05-25T11:24:00+02:00,2025-05-25,19:24,4,1,5
61,2025-05-25T11:11:00+02:00,2025-05-25,19:11,8,4,12
61,2025-05-25T11:14:00+02:00,2025-05-25,19:14,6,3,9
61,2025-05-25T11:18:00+02:00,2025-05-25,19:18,2,4,6
61,2025-05-25T11:22:00+02:00,2025-05-25,19:22,3,0,3
61,2025-05-25T11:23:00+02:00,2025-05-25,19:23,7,3,10
66,2025-05-25T11:12:00+02:00,2025-05-25,19:12,14,10,24
66,2025-05-25T11:13:00+02:00,2025-05-25,19:13,15,16,31
66,2025-05-25T11:17:00+02:00,2025-05-25,19:17,22,19,41
66,2025-05-25T11:18:00+02:00,2025-05-25,19:18,21,19,40
66,2025-05-25T11:19:00+02:00,2025-05-25,19:19,14,18,32
66,2025-05-25T11:22:00+02:00,2025-05-25,19:22,26,18,44
69,2025-05-25T11:15:00+02:00,2025-05-25,19:15,0,1,1
69,2025-05-25T11:17:00+02:00,2025-05-25,19:17,0,1,1
70,2025-05-25T11:11:00+02:00,2025-05-25,19:11,1,2,3
70,2025-05-25T11:14:00+02:00,2025-05-25,19:14,9,3,12
70,2025-05-25T11:16:00+02:00,2025-05-25,19:16,3,3,6
70,2025-05-25T11:17:00+02:00,2025-05-25,19:17,0,4,4
75,2025-05-25T11:18:00+02:00,2025-05-25,19:18,0,1,1
75,2025-05-25T11:22:00+02:00,2025-05-25,19:22,1,0,1
77,2025-05-25T11:15:00+02:00,2025-05-25,19:15,28,8,36
78,2025-05-25T11:20:00+02:00,2025-05-25,19:20,0,2,2
78,2025-05-25T11:21:00+02:00,2025-05-25,19:21,2,2,4
84,2025-05-25T11:15:00+02:00,2025-05-25,19:15,60,89,149
84,2025-05-25T11:20:00+02:00,2025-05-25,19:20,60,63,123
87,2025-05-25T11:10:00+02:00,2025-05-25,19:10,4,0,4
87,2025-05-25T11:19:00+02:00,2025-05-25,19:19,4,0,4
87,2025-05-25T11:24:00+02:00,2025-05-25,19:24,1,0,1
107,2025-05-25T11:10:00+02:00,2025-05-25,19:10,7,6,13
108,2025-05-25T11:10:00+02:00,2025-05-25,19:10,4,3,7
108,2025-05-25T11:21:00+02:00,2025-05-25,19:21,1,1,2
108,2025-05-25T11:22:00+02:00,2025-05-25,19:22,2,1,3
108,2025-05-25T11:23:00+02:00,2025-05-25,19:23,3,0,3
118,2025-05-25T11:10:00+02:00,2025-05-25,19:10,1,0,1
118,2025-05-25T11:20:00+02:00,2025-05-25,19:20,2,0,2
131,2025-05-25T11:15:00+02:00,2025-05-25,19:15,3,8,11
132,2025-05-25T11:20:00+02:00,2025-05-25,19:20,8,24,32
133,2025-05-25T11:15:00+02:00,2025-05-25,19:15,33,40,73
134,2025-05-25T11:20:00+02:00,2025-05-25,19:20,40,35,75
135,2025-05-25T11:10:00+02:00,2025-05-25,19:10,12,38,50
135,2025-05-25T11:15:00+02:00,2025-05-25,19:15,13,29,42
162,2025-05-25T11:20:00+02:00,2025-05-25,19:20,34,15,49
167,2025-05-25T11:15:00+02:00,2025-05-25,19:15,0,3,3
1,2025-05-25T11:10:00+02:00,2025-05-25,19:10,14,6,20
1,2025-05-25T11:12:00+02:00,2025-05-25,19:12,10,9,19
1,2025-05-25T11:13:00+02:00,2025-05-25,19:13,12,4,16
1,2025-05-25T11:16:00+02:00,2025-05-25,19:16,3,0,3
1,2025-05-25T11:18:00+02:00,2025-05-25,19:18,5,7,12
1,2025-05-25T11:19:00+02:00,2025-05-25,19:19,6,5,11
1,2025-05-25T11:21:00+02:00,2025-05-25,19:21,3,9,12
2,2025-05-25T11:10:00+02:00,2025-05-25,19:10,7,4,11
2,2025-05-25T11:11:00+02:00,2025-05-25,19:11,0,1,1
2,2025-05-25T11:12:00+02:00,2025-05-25,19:12,0,7,7
2,2025-05-25T11:13:00+02:00,2025-05-25,19:13,2,5,7
2,2025-05-25T11:16:00+02:00,2025-05-25,19:16,2,7,9
9,2025-05-25T11:13:00+02:00,2025-05-25,19:13,5,0,5
9,2025-05-25T11:16:00+02:00,2025-05-25,19:16,1,0,1
9,2025-05-25T11:22:00+02:00,2025-05-25,19:22,2,2,4
10,2025-05-25T11:12:00+02:00,2025-05-25,19:12,0,3,3
10,2025-05-25T11:17:00+02:00,2025-05-25,19:17,5,0,5
10,2025-05-25T11:22:00+02:00,2025-05-25,19:22,6,3,9
11,2025-05-25T11:10:00+02:00,2025-05-25,19:10,6,0,6
11,2025-05-25T11:20:00+02:00,2025-05-25,19:20,0,8,8
12,2025-05-25T11:11:00+02:00,2025-05-25,19:11,4,3,7
12,2025-05-25T11:21:00+02:00,2025-05-25,19:21,2,4,6
12,2025-05-25T11:22:00+02:00,2025-05-25,19:22,1,18,19
12,2025-05-25T11:23:00+02:00,2025-05-25,19:23,0,6,6
17,2025-05-25T11:13:00+02:00,2025-05-25,19:13,5,0,5
17,2025-05-25T11:19:00+02:00,2025-05-25,19:19,1,0,1
17,2025-05-25T11:24:00+02:00,2025-05-25,19:24,4,1,5
18,2025-05-25T11:16:00+02:00,2025-05-25,19:16,1,0,1
19,2025-05-25T11:11:00+02:00,2025-05-25,19:11,9,5,14
19,2025-05-25T11:13:00+02:00,2025-05-25,19:13,11,9,20
19,2025-05-25T11:21:00+02:00,2025-05-25,19:21,17,6,23
19,2025-05-25T11:24:00+02:00,2025-05-25,19:24,6,15,21
20,2025-05-25T11:12:00+02:00,2025-05-25,19:12,6,19,25
20,2025-05-25T11:22:00+02:00,2025-05-25,19:22,13,14,27
20,2025-05-25T11:23:00+02:00,2025-05-25,19:23,10,11,21
20,2025-05-25T11:24:00+02:00,2025-05-25,19:24,4,15,19
23,2025-05-25T11:11:00+02:00,2025-05-25,19:11,1,7,8
23,2025-05-25T11:12:00+02:00,2025-05-25,19:12,0,3,3
23,2025-05-25T11:17:00+02:00,2025-05-25,19:17,0,1,1
24,2025-05-25T11:12:00+02:00,2025-05-25,19:12,9,3,12
24,2025-05-25T11:14:00+02:00,2025-05-25,19:14,10,6,16
24,2025-05-25T11:17:00+02:00,2025-05-25,19:17,4,19,23
24,2025-05-25T11:18:00+02:00,2025-05-25,19:18,8,14,22
24,2025-05-25T11:19:00+02:00,2025-05-25,19:19,8,5,13
24,2025-05-25T11:21:00+02:00,2025-05-25,19:21,5,4,9
25,2025-05-25T11:20:00+02:00,2025-05-25,19:20,17,11,28
27,2025-05-25T11:15:00+02:00,2025-05-25,19:15,2,2,4
27,2025-05-25T11:17:00+02:00,2025-05-25,19:17,3,0,3
27,2025-05-25T11:20:00+02:00,2025-05-25,19:20,2,1,3
27,2025-05-25T11:22:00+02:00,2025-05-25,19:22,2,0,2
30,2025-05-25T11:10:00+02:00,2025-05-25,19:10,3,7,10
30,2025-05-25T11:15:00+02:00,2025-05-25,19:15,5,10,15
35,2025-05-25T11:15:00+02:00,2025-05-25,19:15,14,8,22
35,2025-05-25T11:17:00+02:00,2025-05-25,19:17,7,14,21
35,2025-05-25T11:19:00+02:00,2025-05-25,19:19,11,12,23
35,2025-05-25T11:24:00+02:00,2025-05-25,19:24,13,11,24
46,2025-05-25T11:15:00+02:00,2025-05-25,19:15,1,0,1
46,2025-05-25T11:20:00+02:00,2025-05-25,19:20,1,0,1
48,2025-05-25T11:12:00+02:00,2025-05-25,19:12,1,0,1
48,2025-05-25T11:13:00+02:00,2025-05-25,19:13,1,1,2
48,2025-05-25T11:14:00+02:00,2025-05-25,19:14,0,1,1
48,2025-05-25T11:15:00+02:00,2025-05-25,19:15,5,1,6
48,2025-05-25T11:18:00+02:00,2025-05-25,19:18,2,5,7
48,2025-05-25T11:20:00+02:00,2025-05-25,19:20,0,1,1
48,2025-05-25T11:22:00+02:00,2025-05-25,19:22,1,3,4
48,2025-05-25T11:24:00+02:00,2025-05-25,19:24,1,2,3
49,2025-05-25T11:13:00+02:00,2025-05-25,19:13,3,1,4
49,2025-05-25T11:14:00+02:00,2025-05-25,19:14,2,5,7
49,2025-05-25T11:15:00+02:00,2025-05-25,19:15,2,3,5
49,2025-05-25T11:16:00+02:00,2025-05-25,19:16,0,7,7
49,2025-05-25T11:18:00+02:00,2025-05-25,19:18,1,9,10
49,2025-05-25T11:20:00+02:00,2025-05-25,19:20,10,1,11
49,2025-05-25T11:24:00+02:00,2025-05-25,19:24,4,0,4
51,2025-05-25T11:12:00+02:00,2025-05-25,19:12,1,3,4
51,2025-05-25T11:19:00+02:00,2025-05-25,19:19,2,1,3
51,2025-05-25T11:20:00+02:00,2025-05-25,19:20,3,1,4
51,2025-05-25T11:21:00+02:00,2025-05-25,19:21,1,4,5
52,2025-05-25T11:10:00+02:00,2025-05-25,19:10,0,9,9
52,2025-05-25T11:17:00+02:00,2025-05-25,19:17,1,3,4
52,2025-05-25T11:18:00+02:00,2025-05-25,19:18,13,14,27
52,2025-05-25T11:21:00+02:00,2025-05-25,19:21,5,5,10
52,2025-05-25T11:22:00+02:00,2025-05-25,19:22,11,4,15
53,2025-05-25T11:10:00+02:00,2025-05-25,19:10,2,2,4
53,2025-05-25T11:13:00+02:00,2025-05-25,19:13,0,8,8
53,2025-05-25T11:18:00+02:00,2025-05-25,19:18,2,3,5
53,2025-05-25T11:22:00+02:00,2025-05-25,19:22,3,1,4
53,2025-05-25T11:23:00+02:00,2025-05-25,19:23,0,3,3
56,2025-05-25T11:10:00+02:00,2025-05-25,19:10,8,10,18
56,2025-05-25T11:11:00+02:00,2025-05-25,19:11,7,11,18
56,2025-05-25T11:16:00+02:00,2025-05-25,19:16,14,3,17
56,2025-05-25T11:18:00+02:00,2025-05-25,19:18,9,7,16
56,2025-05-25T11:23:00+02:00,2025-05-25,19:23,0,2,2
58,2025-05-25T11:12:00+02:00,2025-05-25,19:12,10,8,18
58,2025-05-25T11:15:00+02:00,2025-05-25,19:15,13,3,16
58,2025-05-25T11:16:00+02:00,2025-05-25,19:16,2,3,5
58,2025-05-25T11:22:00+02:00,2025-05-25,19:22,14,7,21
62,2025-05-25T11:11:00+02:00,2025-05-25,19:11,0,2,2
62,2025-05-25T11:16:00+02:00,2025-05-25,19:16,7,0,7
62,2025-05-25T11:17:00+02:00,2025-05-25,19:17,2,2,4
62,2025-05-25T11:18:00+02:00,2025-05-25,19:18,0,5,5
62,2025-05-25T11:19:00+02:00,2025-05-25,19:19,1,1,2
62,2025-05-25T11:20:00+02:00,2025-05-25,19:20,4,4,8
62,2025-05-25T11:24:00+02:00,2025-05-25,19:24,2,3,5
63,2025-05-25T11:10:00+02:00,2025-05-25,19:10,0,1,1
63,2025-05-25T11:15:00+02:00,2025-05-25,19:15,0,3,3
63,2025-05-25T11:21:00+02:00,2025-05-25,19:21,0,2,2
63,2025-05-25T11:22:00+02:00,2025-05-25,19:22,2,3,5
63,2025-05-25T11:23:00+02:00,2025-05-25,19:23,3,2,5
63,2025-05-25T11:24:00+02:00,2025-05-25,19:24,0,2,2
67,2025-05-25T11:11:00+02:00,2025-05-25,19:11,6,4,10
67,2025-05-25T11:19:00+02:00,2025-05-25,19:19,3,5,8
67,2025-05-25T11:21:00+02:00,2025-05-25,19:21,7,8,15
67,2025-05-25T11:23:00+02:00,2025-05-25,19:23,6,8,14
68,2025-05-25T11:16:00+02:00,2025-05-25,19:16,1,3,4
68,2025-05-25T11:18:00+02:00,2025-05-25,19:18,2,4,6
68,2025-05-25T11:19:00+02:00,2025-05-25,19:19,3,1,4
68,2025-05-25T11:22:00+02:00,2025-05-25,19:22,3,0,3
72,2025-05-25T11:10:00+02:00,2025-05-25,19:10,1,3,4
72,2025-05-25T11:12:00+02:00,2025-05-25,19:12,3,2,5
72,2025-05-25T11:14:00+02:00,2025-05-25,19:14,8,3,11
72,2025-05-25T11:15:00+02:00,2025-05-25,19:15,13,6,19
72,2025-05-25T11:20:00+02:00,2025-05-25,19:20,3,5,8
76,2025-05-25T11:18:00+02:00,2025-05-25,19:18,0,1,1
79,2025-05-25T11:13:00+02:00,2025-05-25,19:13,3,6,9
79,2025-05-25T11:14:00+02:00,2025-05-25,19:14,4,3,7
79,2025-05-25T11:18:00+02:00,2025-05-25,19:18,3,4,7
79,2025-05-25T11:21:00+02:00,2025-05-25,19:21,6,4,10
79,2025-05-25T11:22:00+02:00,2025-05-25,19:22,10,7,17
79,2025-05-25T11:24:00+02:00,2025-05-25,19:24,2,7,9
86,2025-05-25T11:19:00+02:00,2025-05-25,19:19,0,1,1
86,2025-05-25T11:23:00+02:00,2025-05-25,19:23,2,1,3
117,2025-05-25T11:20:00+02:00,2025-05-25,19:20,14,21,35
130,2025-05-25T11:15:00+02:00,2025-05-25,19:15,2,0,2
130,2025-05-25T11:20:00+02:00,2025-05-25,19:20,1,1,2
138,2025-05-25T11:15:00+02:00,2025-05-25,19:15,0,1,1
139,2025-05-25T11:20:00+02:00,2025-05-25,19:20,0,3,3
141,2025-05-25T11:20:00+02:00,2025-05-25,19:20,9,4,13
142,2025-05-25T11:15:00+02:00,2025-05-25,19:15,7,0,7
142,2025-05-25T11:20:00+02:00,2025-05-25,19:20,8,3,11
164,2025-05-25T11:10:00+02:00,2025-05-25,19:10,4,10,14
164,2025-05-25T11:20:00+02:00,2025-05-25,19:20,5,19,24
3,2025-05-25T10:25:00+02:00,2025-05-25,18:25,21,26,47
3,2025-05-25T10:26:00+02:00,2025-05-25,18:26,13,22,35
3,2025-05-25T10:27:00+02:00,2025-05-25,18:27,8,19,27
3,2025-05-25T10:28:00+02:00,2025-05-25,18:28,18,18,36
3,2025-05-25T10:33:00+02:00,2025-05-25,18:33,9,12,21
3,2025-05-25T10:38:00+02:00,2025-05-25,18:38,9,28,37
3,2025-05-25T10:39:00+02:00,2025-05-25,18:39,11,23,34
4,2025-05-25T10:27:00+02:00,2025-05-25,18:27,24,13,37
4,2025-05-25T10:29:00+02:00,2025-05-25,18:29,30,23,53
4,2025-05-25T10:34:00+02:00,2025-05-25,18:34,19,9,28
4,2025-05-25T10:35:00+02:00,2025-05-25,18:35,8,25,33
4,2025-05-25T10:38:00+02:00,2025-05-25,18:38,17,14,31
6,2025-05-25T10:28:00+02:00,2025-05-25,18:28,11,14,25
6,2025-05-25T10:34:00+02:00,2025-05-25,18:34,10,4,14
6,2025-05-25T10:35:00+02:00,2025-05-25,18:35,7,4,11
8,2025-05-25T10:25:00+02:00,2025-05-25,18:25,0,2,2
8,2025-05-25T10:27:00+02:00,2025-05-25,18:27,0,1,1
8,2025-05-25T10:37:00+02:00,2025-05-25,18:37,0,1,1
8,2025-05-25T10:39:00+02:00,2025-05-25,18:39,1,1,2
28,2025-05-25T10:25:00+02:00,2025-05-25,18:25,4,8,12
28,2025-05-25T10:26:00+02:00,2025-05-25,18:26,5,5,10
28,2025-05-25T10:27:00+02:00,2025-05-25,18:27,4,9,13
28,2025-05-25T10:28:00+02:00,2025-05-25,18:28,3,5,8
28,2025-05-25T10:29:00+02:00,2025-05-25,18:29,1,7,8
28,2025-05-25T10:30:00+02:00,2025-05-25,18:30,3,10,13
28,2025-05-25T10:32:00+02:00,2025-05-25,18:32,4,5,9
28,2025-05-25T10:35:00+02:00,2025-05-25,18:35,1,10,11
28,2025-05-25T10:36:00+02:00,2025-05-25,18:36,2,7,9
28,2025-05-25T10:37:00+02:00,2025-05-25,18:37,6,6,12
28,2025-05-25T10:39:00+02:00,2025-05-25,18:39,1,4,5
29,2025-05-25T10:25:00+02:00,2025-05-25,18:25,8,3,11
29,2025-05-25T10:26:00+02:00,2025-05-25,18:26,2,2,4
29,2025-05-25T10:27:00+02:00,2025-05-25,18:27,3,6,9
29,2025-05-25T10:29:00+02:00,2025-05-25,18:29,8,9,17
29,2025-05-25T10:30:00+02:00,2025-05-25,18:30,3,8,11
29,2025-05-25T10:33:00+02:00,2025-05-25,18:33,4,5,9
29,2025-05-25T10:35:00+02:00,2025-05-25,18:35,7,14,21
29,2025-05-25T10:37:00+02:00,2025-05-25,18:37,0,7,7
31,2025-05-25T10:26:00+02:00,2025-05-25,18:26,2,1,3
31,2025-05-25T10:28:00+02:00,2025-05-25,18:28,2,0,2
31,2025-05-25T10:35:00+02:00,2025-05-25,18:35,1,7,8
36,2025-05-25T10:25:00+02:00,2025-05-25,18:25,1,0,1
36,2025-05-25T10:27:00+02:00,2025-05-25,18:27,1,1,2
36,2025-05-25T10:28:00+02:00,2025-05-25,18:28,10,0,10
36,2025-05-25T10:36:00+02:00,2025-05-25,18:36,3,0,3
39,2025-05-25T10:31:00+02:00,2025-05-25,18:31,1,0,1
40,2025-05-25T10:28:00+02:00,2025-05-25,18:28,1,0,1
40,2025-05-25T10:29:00+02:00,2025-05-25,18:29,0,2,2
40,2025-05-25T10:33:00+02:00,2025-05-25,18:33,2,1,3
40,2025-05-25T10:36:00+02:00,2025-05-25,18:36,0,3,3
41,2025-05-25T10:26:00+02:00,2025-05-25,18:26,9,4,13
41,2025-05-25T10:27:00+02:00,2025-05-25,18:27,0,7,7
41,2025-05-25T10:34:00+02:00,2025-05-25,18:34,7,0,7
41,2025-05-25T10:35:00+02:00,2025-05-25,18:35,2,8,10
41,2025-05-25T10:39:00+02:00,2025-05-25,18:39,2,10,12
44,2025-05-25T10:30:00+02:00,2025-05-25,18:30,0,2,2
44,2025-05-25T10:35:00+02:00,2025-05-25,18:35,1,0,1
45,2025-05-25T10:29:00+02:00,2025-05-25,18:29,12,15,27
45,2025-05-25T10:33:00+02:00,2025-05-25,18:33,9,6,15
45,2025-05-25T10:38:00+02:00,2025-05-25,18:38,12,23,35
47,2025-05-25T10:30:00+02:00,2025-05-25,18:30,11,4,15
47,2025-05-25T10:31:00+02:00,2025-05-25,18:31,14,20,34
47,2025-05-25T10:33:00+02:00,2025-05-25,18:33,11,10,21
50,2025-05-25T10:30:00+02:00,2025-05-25,18:30,2,2,4
50,2025-05-25T10:31:00+02:00,2025-05-25,18:31,0,3,3
50,2025-05-25T10:32:00+02:00,2025-05-25,18:32,6,6,12
50,2025-05-25T10:34:00+02:00,2025-05-25,18:34,0,6,6
54,2025-05-25T10:26:00+02:00,2025-05-25,18:26,2,1,3
54,2025-05-25T10:29:00+02:00,2025-05-25,18:29,2,7,9
61,2025-05-25T10:25:00+02:00,2025-05-25,18:25,4,8,12
61,2025-05-25T10:26:00+02:00,2025-05-25,18:26,4,1,5
61,2025-05-25T10:33:00+02:00,2025-05-25,18:33,9,4,13
61,2025-05-25T10:38:00+02:00,2025-05-25,18:38,6,1,7
66,2025-05-25T10:25:00+02:00,2025-05-25,18:25,17,25,42
66,2025-05-25T10:30:00+02:00,2025-05-25,18:30,17,7,24
66,2025-05-25T10:31:00+02:00,2025-05-25,18:31,11,21,32
66,2025-05-25T10:33:00+02:00,2025-05-25,18:33,26,38,64
69,2025-05-25T10:27:00+02:00,2025-05-25,18:27,1,1,2
69,2025-05-25T10:28:00+02:00,2025-05-25,18:28,0,1,1
69,2025-05-25T10:34:00+02:00,2025-05-25,18:34,0,1,1
70,2025-05-25T10:25:00+02:00,2025-05-25,18:25,0,8,8
70,2025-05-25T10:26:00+02:00,2025-05-25,18:26,1,4,5
70,2025-05-25T10:28:00+02:00,2025-05-25,18:28,4,16,20
70,2025-05-25T10:33:00+02:00,2025-05-25,18:33,2,1,3
70,2025-05-25T10:35:00+02:00,2025-05-25,18:35,0,8,8
70,2025-05-25T10:38:00+02:00,2025-05-25,18:38,2,8,10
75,2025-05-25T10:28:00+02:00,2025-05-25,18:28,2,0,2
87,2025-05-25T10:38:00+02:00,2025-05-25,18:38,0,1,1
108,2025-05-25T10:25:00+02:00,2025-05-25,18:25,2,2,4
108,2025-05-25T10:27:00+02:00,2025-05-25,18:27,1,0,1
108,2025-05-25T10:29:00+02:00,2025-05-25,18:29,0,2,2
108,2025-05-25T10:31:00+02:00,2025-05-25,18:31,3,3,6
108,2025-05-25T10:36:00+02:00,2025-05-25,18:36,2,0,2
108,2025-05-25T10:39:00+02:00,2025-05-25,18:39,6,5,11
118,2025-05-25T10:25:00+02:00,2025-05-25,18:25,11,0,11
134,2025-05-25T10:30:00+02:00,2025-05-25,18:30,29,34,63
134,2025-05-25T10:35:00+02:00,2025-05-25,18:35,20,24,44
135,2025-05-25T10:35:00+02:00,2025-05-25,18:35,12,15,27
162,2025-05-25T10:30:00+02:00,2025-05-25,18:30,16,26,42
162,2025-05-25T10:35:00+02:00,2025-05-25,18:35,31,18,49
165,2025-05-25T10:35:00+02:00,2025-05-25,18:35,2,1,3
166,2025-05-25T10:35:00+02:00,2025-05-25,18:35,1,3,4
167,2025-05-25T10:35:00+02:00,2025-05-25,18:35,2,3,5
179,2025-05-25T10:25:00+02:00,2025-05-25,18:25,6,10,16
179,2025-05-25T10:30:00+02:00,2025-05-25,18:30,4,1,5
1,2025-05-25T10:28:00+02:00,2025-05-25,18:28,15,7,22
1,2025-05-25T10:32:00+02:00,2025-05-25,18:32,15,4,19
1,2025-05-25T10:38:00+02:00,2025-05-25,18:38,23,2,25
2,2025-05-25T10:29:00+02:00,2025-05-25,18:29,1,3,4
2,2025-05-25T10:30:00+02:00,2025-05-25,18:30,7,0,7
2,2025-05-25T10:32:00+02:00,2025-05-25,18:32,4,1,5
9,2025-05-25T10:30:00+02:00,2025-05-25,18:30,0,3,3
9,2025-05-25T10:32:00+02:00,2025-05-25,18:32,0,1,1
10,2025-05-25T10:34:00+02:00,2025-05-25,18:34,3,0,3
10,2025-05-25T10:35:00+02:00,2025-05-25,18:35,1,0,1
10,2025-05-25T10:39:00+02:00,2025-05-25,18:39,1,0,1
11,2025-05-25T10:30:00+02:00,2025-05-25,18:30,2,0,2
12,2025-05-25T10:25:00+02:00,2025-05-25,18:25,0,3,3
12,2025-05-25T10:30:00+02:00,2025-05-25,18:30,0,2,2
12,2025-05-25T10:31:00+02:00,2025-05-25,18:31,0,1,1
12,2025-05-25T10:37:00+02:00,2025-05-25,18:37,4,3,7
12,2025-05-25T10:38:00+02:00,2025-05-25,18:38,5,5,10
12,2025-05-25T10:39:00+02:00,2025-05-25,18:39,2,4,6
17,2025-05-25T10:25:00+02:00,2025-05-25,18:25,2,3,5
17,2025-05-25T10:26:00+02:00,2025-05-25,18:26,1,2,3
17,2025-05-25T10:27:00+02:00,2025-05-25,18:27,1,3,4
17,2025-05-25T10:29:00+02:00,2025-05-25,18:29,5,4,9
17,2025-05-25T10:30:00+02:00,2025-05-25,18:30,5,0,5
17,2025-05-25T10:32:00+02:00,2025-05-25,18:32,3,0,3
17,2025-05-25T10:35:00+02:00,2025-05-25,18:35,16,1,17
17,2025-05-25T10:37:00+02:00,2025-05-25,18:37,9,2,11
18,2025-05-25T10:31:00+02:00,2025-05-25,18:31,2,0,2
18,2025-05-25T10:33:00+02:00,2025-05-25,18:33,0,1,1
19,2025-05-25T10:25:00+02:00,2025-05-25,18:25,11,11,22
19,2025-05-25T10:27:00+02:00,2025-05-25,18:27,9,14,23
19,2025-05-25T10:28:00+02:00,2025-05-25,18:28,12,12,24
19,2025-05-25T10:30:00+02:00,2025-05-25,18:30,13,8,21
19,2025-05-25T10:32:00+02:00,2025-05-25,18:32,22,4,26
19,2025-05-25T10:35:00+02:00,2025-05-25,18:35,11,10,21
19,2025-05-25T10:36:00+02:00,2025-05-25,18:36,24,4,28
19,2025-05-25T10:38:00+02:00,2025-05-25,18:38,3,15,18
20,2025-05-25T10:26:00+02:00,2025-05-25,18:26,3,8,11
20,2025-05-25T10:31:00+02:00,2025-05-25,18:31,8,13,21
20,2025-05-25T10:35:00+02:00,2025-05-25,18:35,9,6,15
20,2025-05-25T10:36:00+02:00,2025-05-25,18:36,6,3,9
20,2025-05-25T10:38:00+02:00,2025-05-25,18:38,12,1,13
23,2025-05-25T10:26:00+02:00,2025-05-25,18:26,1,0,1
23,2025-05-25T10:27:00+02:00,2025-05-25,18:27,1,2,3
23,2025-05-25T10:33:00+02:00,2025-05-25,18:33,4,2,6
24,2025-05-25T10:29:00+02:00,2025-05-25,18:29,5,22,27
24,2025-05-25T10:32:00+02:00,2025-05-25,18:32,2,11,13
24,2025-05-25T10:33:00+02:00,2025-05-25,18:33,10,5,15
24,2025-05-25T10:35:00+02:00,2025-05-25,18:35,7,4,11
24,2025-05-25T10:37:00+02:00,2025-05-25,18:37,9,9,18
24,2025-05-25T10:38:00+02:00,2025-05-25,18:38,3,6,9
25,2025-05-25T10:30:00+02:00,2025-05-25,18:30,58,28,86
27,2025-05-25T10:28:00+02:00,2025-05-25,18:28,9,0,9
27,2025-05-25T10:29:00+02:00,2025-05-25,18:29,2,0,2
27,2025-05-25T10:33:00+02:00,2025-05-25,18:33,4,1,5
27,2025-05-25T10:34:00+02:00,2025-05-25,18:34,1,0,1
30,2025-05-25T10:25:00+02:00,2025-05-25,18:25,13,8,21
30,2025-05-25T10:26:00+02:00,2025-05-25,18:26,5,7,12
30,2025-05-25T10:31:00+02:00,2025-05-25,18:31,6,8,14
30,2025-05-25T10:37:00+02:00,2025-05-25,18:37,2,6,8
35,2025-05-25T10:28:00+02:00,2025-05-25,18:28,13,16,29
35,2025-05-25T10:33:00+02:00,2025-05-25,18:33,11,11,22
35,2025-05-25T10:35:00+02:00,2025-05-25,18:35,9,9,18
35,2025-05-25T10:36:00+02:00,2025-05-25,18:36,15,7,22
35,2025-05-25T10:37:00+02:00,2025-05-25,18:37,5,5,10
46,2025-05-25T10:35:00+02:00,2025-05-25,18:35,1,0,1
48,2025-05-25T10:30:00+02:00,2025-05-25,18:30,1,1,2
48,2025-05-25T10:31:00+02:00,2025-05-25,18:31,1,0,1
49,2025-05-25T10:27:00+02:00,2025-05-25,18:27,7,1,8
49,2025-05-25T10:39:00+02:00,2025-05-25,18:39,10,2,12
51,2025-05-25T10:30:00+02:00,2025-05-25,18:30,1,0,1
51,2025-05-25T10:33:00+02:00,2025-05-25,18:33,6,1,7
51,2025-05-25T10:35:00+02:00,2025-05-25,18:35,5,2,7
51,2025-05-25T10:39:00+02:00,2025-05-25,18:39,3,1,4
52,2025-05-25T10:25:00+02:00,2025-05-25,18:25,2,9,11
52,2025-05-25T10:26:00+02:00,2025-05-25,18:26,0,12,12
52,2025-05-25T10:27:00+02:00,2025-05-25,18:27,3,0,3
52,2025-05-25T10:32:00+02:00,2025-05-25,18:32,3,2,5
52,2025-05-25T10:38:00+02:00,2025-05-25,18:38,2,10,12
53,2025-05-25T10:30:00+02:00,2025-05-25,18:30,3,0,3
53,2025-05-25T10:31:00+02:00,2025-05-25,18:31,4,5,9
53,2025-05-25T10:32:00+02:00,2025-05-25,18:32,2,2,4
53,2025-05-25T10:34:00+02:00,2025-05-25,18:34,3,4,7
53,2025-05-25T10:38:00+02:00,2025-05-25,18:38,5,1,6
53,2025-05-25T10:39:00+02:00,2025-05-25,18:39,7,2,9
56,2025-05-25T10:27:00+02:00,2025-05-25,18:27,3,18,21
56,2025-05-25T10:31:00+02:00,2025-05-25,18:31,7,4,11
56,2025-05-25T10:34:00+02:00,2025-05-25,18:34,3,8,11
58,2025-05-25T10:26:00+02:00,2025-05-25,18:26,6,11,17
58,2025-05-25T10:27:00+02:00,2025-05-25,18:27,3,1,4
58,2025-05-25T10:28:00+02:00,2025-05-25,18:28,7,5,12
58,2025-05-25T10:30:00+02:00,2025-05-25,18:30,8,1,9
58,2025-05-25T10:32:00+02:00,2025-05-25,18:32,3,3,6
58,2025-05-25T10:34:00+02:00,2025-05-25,18:34,6,0,6
62,2025-05-25T10:25:00+02:00,2025-05-25,18:25,4,1,5
62,2025-05-25T10:26:00+02:00,2025-05-25,18:26,2,7,9
62,2025-05-25T10:27:00+02:00,2025-05-25,18:27,6,2,8
62,2025-05-25T10:28:00+02:00,2025-05-25,18:28,3,1,4
62,2025-05-25T10:29:00+02:00,2025-05-25,18:29,3,7,10
62,2025-05-25T10:32:00+02:00,2025-05-25,18:32,2,1,3
62,2025-05-25T10:34:00+02:00,2025-05-25,18:34,8,1,9
62,2025-05-25T10:36:00+02:00,2025-05-25,18:36,3,3,6
62,2025-05-25T10:37:00+02:00,2025-05-25,18:37,3,2,5
63,2025-05-25T10:26:00+02:00,2025-05-25,18:26,3,8,11
63,2025-05-25T10:29:00+02:00,2025-05-25,18:29,0,3,3
63,2025-05-25T10:32:00+02:00,2025-05-25,18:32,1,5,6
63,2025-05-25T10:34:00+02:00,2025-05-25,18:34,2,5,7
63,2025-05-25T10:36:00+02:00,2025-05-25,18:36,1,6,7
63,2025-05-25T10:38:00+02:00,2025-05-25,18:38,2,8,10
67,2025-05-25T10:25:00+02:00,2025-05-25,18:25,5,3,8
67,2025-05-25T10:27:00+02:00,2025-05-25,18:27,8,11,19
67,2025-05-25T10:28:00+02:00,2025-05-25,18:28,2,12,14
67,2025-05-25T10:36:00+02:00,2025-05-25,18:36,3,5,8
67,2025-05-25T10:37:00+02:00,2025-05-25,18:37,5,4,9
68,2025-05-25T10:29:00+02:00,2025-05-25,18:29,4,6,10
68,2025-05-25T10:30:00+02:00,2025-05-25,18:30,6,0,6
68,2025-05-25T10:32:00+02:00,2025-05-25,18:32,0,1,1
68,2025-05-25T10:39:00+02:00,2025-05-25,18:39,2,2,4
72,2025-05-25T10:25:00+02:00,2025-05-25,18:25,6,2,8
72,2025-05-25T10:27:00+02:00,2025-05-25,18:27,2,10,12
72,2025-05-25T10:29:00+02:00,2025-05-25,18:29,1,7,8
72,2025-05-25T10:31:00+02:00,2025-05-25,18:31,3,8,11
72,2025-05-25T10:33:00+02:00,2025-05-25,18:33,2,5,7
72,2025-05-25T10:37:00+02:00,2025-05-25,18:37,4,12,16
72,2025-05-25T10:38:00+02:00,2025-05-25,18:38,17,9,26
76,2025-05-25T10:28:00+02:00,2025-05-25,18:28,1,1,2
76,2025-05-25T10:31:00+02:00,2025-05-25,18:31,0,3,3
79,2025-05-25T10:31:00+02:00,2025-05-25,18:31,5,10,15
79,2025-05-25T10:32:00+02:00,2025-05-25,18:32,2,16,18
79,2025-05-25T10:35:00+02:00,2025-05-25,18:35,2,6,8
79,2025-05-25T10:38:00+02:00,2025-05-25,18:38,14,11,25
79,2025-05-25T10:39:00+02:00,2025-05-25,18:39,7,5,12
85,2025-05-25T10:29:00+02:00,2025-05-25,18:29,3,2,5
85,2025-05-25T10:32:00+02:00,2025-05-25,18:32,2,1,3
86,2025-05-25T10:38:00+02:00,2025-05-25,18:38,1,0,1
109,2025-05-25T10:35:00+02:00,2025-05-25,18:35,13,14,27
117,2025-05-25T10:30:00+02:00,2025-05-25,18:30,28,49,77
136,2025-05-25T10:30:00+02:00,2025-05-25,18:30,1,105,106
139,2025-05-25T10:25:00+02:00,2025-05-25,18:25,6,5,11
141,2025-05-25T10:30:00+02:00,2025-05-25,18:30,6,2,8
141,2025-05-25T10:35:00+02:00,2025-05-25,18:35,8,16,24
142,2025-05-25T10:25:00+02:00,2025-05-25,18:25,7,1,8
142,2025-05-25T10:35:00+02:00,2025-05-25,18:35,5,4,9
164,2025-05-25T10:35:00+02:00,2025-05-25,18:35,14,4,18
3,2025-05-25T10:40:00+02:00,2025-05-25,18:40,4,11,15
3,2025-05-25T10:48:00+02:00,2025-05-25,18:48,21,30,51
3,2025-05-25T10:50:00+02:00,2025-05-25,18:50,26,6,32
3,2025-05-25T10:51:00+02:00,2025-05-25,18:51,21,14,35
3,2025-05-25T10:53:00+02:00,2025-05-25,18:53,21,15,36
4,2025-05-25T10:40:00+02:00,2025-05-25,18:40,18,11,29
4,2025-05-25T10:41:00+02:00,2025-05-25,18:41,24,16,40
4,2025-05-25T10:42:00+02:00,2025-05-25,18:42,11,10,21
4,2025-05-25T10:45:00+02:00,2025-05-25,18:45,23,14,37
4,2025-05-25T10:49:00+02:00,2025-05-25,18:49,15,14,29
4,2025-05-25T10:50:00+02:00,2025-05-25,18:50,14,16,30
4,2025-05-25T10:51:00+02:00,2025-05-25,18:51,46,12,58
5,2025-05-25T10:45:00+02:00,2025-05-25,18:45,45,96,141
6,2025-05-25T10:41:00+02:00,2025-05-25,18:41,1,3,4
6,2025-05-25T10:48:00+02:00,2025-05-25,18:48,8,4,12
6,2025-05-25T10:49:00+02:00,2025-05-25,18:49,13,13,26
6,2025-05-25T10:52:00+02:00,2025-05-25,18:52,13,18,31
6,2025-05-25T10:53:00+02:00,2025-05-25,18:53,10,6,16
8,2025-05-25T10:40:00+02:00,2025-05-25,18:40,1,0,1
8,2025-05-25T10:50:00+02:00,2025-05-25,18:50,1,0,1
8,2025-05-25T10:51:00+02:00,2025-05-25,18:51,0,1,1
21,2025-05-25T10:45:00+02:00,2025-05-25,18:45,26,38,64
28,2025-05-25T10:48:00+02:00,2025-05-25,18:48,4,8,12
28,2025-05-25T10:49:00+02:00,2025-05-25,18:49,2,29,31
28,2025-05-25T10:52:00+02:00,2025-05-25,18:52,2,14,16
29,2025-05-25T10:43:00+02:00,2025-05-25,18:43,5,12,17
29,2025-05-25T10:45:00+02:00,2025-05-25,18:45,2,7,9
29,2025-05-25T10:47:00+02:00,2025-05-25,18:47,5,6,11
29,2025-05-25T10:50:00+02:00,2025-05-25,18:50,3,7,10
31,2025-05-25T10:44:00+02:00,2025-05-25,18:44,7,3,10
31,2025-05-25T10:45:00+02:00,2025-05-25,18:45,8,0,8
31,2025-05-25T10:46:00+02:00,2025-05-25,18:46,3,4,7
31,2025-05-25T10:48:00+02:00,2025-05-25,18:48,2,0,2
31,2025-05-25T10:49:00+02:00,2025-05-25,18:49,3,0,3
31,2025-05-25T10:50:00+02:00,2025-05-25,18:50,6,0,6
31,2025-05-25T10:53:00+02:00,2025-05-25,18:53,4,0,4
36,2025-05-25T10:40:00+02:00,2025-05-25,18:40,0,1,1
36,2025-05-25T10:45:00+02:00,2025-05-25,18:45,5,0,5
36,2025-05-25T10:49:00+02:00,2025-05-25,18:49,6,2,8
36,2025-05-25T10:51:00+02:00,2025-05-25,18:51,2,1,3
36,2025-05-25T10:53:00+02:00,2025-05-25,18:53,3,0,3
39,2025-05-25T10:44:00+02:00,2025-05-25,18:44,3,0,3
39,2025-05-25T10:48:00+02:00,2025-05-25,18:48,2,0,2
40,2025-05-25T10:43:00+02:00,2025-05-25,18:43,4,0,4
40,2025-05-25T10:48:00+02:00,2025-05-25,18:48,2,4,6
40,2025-05-25T10:52:00+02:00,2025-05-25,18:52,0,1,1
181,2025-05-25T10:40:00+02:00,2025-05-25,18:40,6,18,24
181,2025-05-25T10:41:00+02:00,2025-05-25,18:41,11,12,23
181,2025-05-25T10:45:00+02:00,2025-05-25,18:45,13,13,26
180,2025-05-25T10:40:00+02:00,2025-05-25,18:40,0,1,1
180,2025-05-25T10:44:00+02:00,2025-05-25,18:44,0,1,1
180,2025-05-25T10:54:00+02:00,2025-05-25,18:54,1,0,1
181,2025-05-25T10:57:00+02:00,2025-05-25,18:57,26,21,47
181,2025-05-25T10:59:00+02:00,2025-05-25,18:59,13,22,35
182,2025-05-25T10:55:00+02:00,2025-05-25,18:55,20,27,47
182,2025-05-25T11:00:00+02:00,2025-05-25,19:00,16,16,32
41,2025-05-25T10:46:00+02:00,2025-05-25,18:46,10,3,13
41,2025-05-25T10:48:00+02:00,2025-05-25,18:48,0,1,1
43,2025-05-25T10:45:00+02:00,2025-05-25,18:45,2,3,5
44,2025-05-25T10:50:00+02:00,2025-05-25,18:50,7,1,8
45,2025-05-25T10:44:00+02:00,2025-05-25,18:44,1,12,13
45,2025-05-25T10:45:00+02:00,2025-05-25,18:45,14,18,32
45,2025-05-25T10:51:00+02:00,2025-05-25,18:51,5,30,35
45,2025-05-25T10:52:00+02:00,2025-05-25,18:52,16,17,33
45,2025-05-25T10:54:00+02:00,2025-05-25,18:54,9,13,22
47,2025-05-25T10:44:00+02:00,2025-05-25,18:44,17,5,22
47,2025-05-25T10:45:00+02:00,2025-05-25,18:45,4,14,18
47,2025-05-25T10:49:00+02:00,2025-05-25,18:49,8,4,12
50,2025-05-25T10:42:00+02:00,2025-05-25,18:42,1,0,1
50,2025-05-25T10:43:00+02:00,2025-05-25,18:43,7,10,17
50,2025-05-25T10:45:00+02:00,2025-05-25,18:45,7,9,16
50,2025-05-25T10:48:00+02:00,2025-05-25,18:48,1,2,3
50,2025-05-25T10:49:00+02:00,2025-05-25,18:49,1,3,4
50,2025-05-25T10:51:00+02:00,2025-05-25,18:51,0,4,4
50,2025-05-25T10:53:00+02:00,2025-05-25,18:53,0,6,6
54,2025-05-25T10:41:00+02:00,2025-05-25,18:41,3,1,4
54,2025-05-25T10:50:00+02:00,2025-05-25,18:50,0,2,2
54,2025-05-25T10:51:00+02:00,2025-05-25,18:51,1,0,1
59,2025-05-25T10:40:00+02:00,2025-05-25,18:40,14,27,41
59,2025-05-25T10:45:00+02:00,2025-05-25,18:45,17,20,37
59,2025-05-25T10:50:00+02:00,2025-05-25,18:50,14,19,33
61,2025-05-25T10:40:00+02:00,2025-05-25,18:40,3,0,3
61,2025-05-25T10:46:00+02:00,2025-05-25,18:46,0,2,2
61,2025-05-25T10:47:00+02:00,2025-05-25,18:47,0,1,1
61,2025-05-25T10:48:00+02:00,2025-05-25,18:48,5,4,9
61,2025-05-25T10:54:00+02:00,2025-05-25,18:54,3,13,16
66,2025-05-25T10:40:00+02:00,2025-05-25,18:40,17,21,38
66,2025-05-25T10:42:00+02:00,2025-05-25,18:42,10,4,14
66,2025-05-25T10:51:00+02:00,2025-05-25,18:51,15,10,25
69,2025-05-25T10:43:00+02:00,2025-05-25,18:43,1,0,1
69,2025-05-25T10:47:00+02:00,2025-05-25,18:47,0,1,1
70,2025-05-25T10:44:00+02:00,2025-05-25,18:44,0,11,11
70,2025-05-25T10:45:00+02:00,2025-05-25,18:45,4,14,18
70,2025-05-25T10:53:00+02:00,2025-05-25,18:53,2,4,6
70,2025-05-25T10:54:00+02:00,2025-05-25,18:54,0,10,10
71,2025-05-25T10:44:00+02:00,2025-05-25,18:44,1,0,1
71,2025-05-25T10:52:00+02:00,2025-05-25,18:52,1,1,2
75,2025-05-25T10:44:00+02:00,2025-05-25,18:44,4,0,4
75,2025-05-25T10:47:00+02:00,2025-05-25,18:47,4,0,4
75,2025-05-25T10:50:00+02:00,2025-05-25,18:50,1,0,1
77,2025-05-25T10:50:00+02:00,2025-05-25,18:50,16,5,21
78,2025-05-25T10:52:00+02:00,2025-05-25,18:52,0,1,1
84,2025-05-25T10:40:00+02:00,2025-05-25,18:40,79,92,171
87,2025-05-25T10:40:00+02:00,2025-05-25,18:40,2,2,4
87,2025-05-25T10:41:00+02:00,2025-05-25,18:41,4,2,6
87,2025-05-25T10:42:00+02:00,2025-05-25,18:42,2,0,2
87,2025-05-25T10:44:00+02:00,2025-05-25,18:44,3,2,5
87,2025-05-25T10:47:00+02:00,2025-05-25,18:47,2,1,3
87,2025-05-25T10:52:00+02:00,2025-05-25,18:52,1,0,1
87,2025-05-25T10:53:00+02:00,2025-05-25,18:53,0,2,2
87,2025-05-25T10:54:00+02:00,2025-05-25,18:54,3,3,6
107,2025-05-25T10:45:00+02:00,2025-05-25,18:45,3,4,7
107,2025-05-25T10:50:00+02:00,2025-05-25,18:50,7,12,19
108,2025-05-25T10:48:00+02:00,2025-05-25,18:48,2,4,6
108,2025-05-25T10:54:00+02:00,2025-05-25,18:54,1,0,1
118,2025-05-25T10:40:00+02:00,2025-05-25,18:40,3,0,3
118,2025-05-25T10:45:00+02:00,2025-05-25,18:45,3,0,3
132,2025-05-25T10:40:00+02:00,2025-05-25,18:40,7,12,19
132,2025-05-25T10:45:00+02:00,2025-05-25,18:45,7,11,18
132,2025-05-25T10:50:00+02:00,2025-05-25,18:50,5,17,22
133,2025-05-25T10:45:00+02:00,2025-05-25,18:45,51,40,91
133,2025-05-25T10:50:00+02:00,2025-05-25,18:50,37,27,64
134,2025-05-25T10:40:00+02:00,2025-05-25,18:40,40,32,72
134,2025-05-25T10:50:00+02:00,2025-05-25,18:50,26,25,51
162,2025-05-25T10:40:00+02:00,2025-05-25,18:40,34,17,51
162,2025-05-25T10:50:00+02:00,2025-05-25,18:50,21,21,42
165,2025-05-25T10:40:00+02:00,2025-05-25,18:40,4,8,12
166,2025-05-25T10:45:00+02:00,2025-05-25,18:45,3,5,8
166,2025-05-25T10:50:00+02:00,2025-05-25,18:50,1,3,4
167,2025-05-25T10:45:00+02:00,2025-05-25,18:45,1,2,3
1,2025-05-25T10:52:00+02:00,2025-05-25,18:52,7,5,12
1,2025-05-25T10:53:00+02:00,2025-05-25,18:53,11,5,16
1,2025-05-25T10:54:00+02:00,2025-05-25,18:54,18,7,25
2,2025-05-25T10:40:00+02:00,2025-05-25,18:40,3,7,10
2,2025-05-25T10:47:00+02:00,2025-05-25,18:47,6,2,8
2,2025-05-25T10:49:00+02:00,2025-05-25,18:49,4,10,14
2,2025-05-25T10:50:00+02:00,2025-05-25,18:50,10,9,19
9,2025-05-25T10:41:00+02:00,2025-05-25,18:41,1,1,2
9,2025-05-25T10:42:00+02:00,2025-05-25,18:42,1,1,2
9,2025-05-25T10:43:00+02:00,2025-05-25,18:43,0,6,6
9,2025-05-25T10:44:00+02:00,2025-05-25,18:44,1,0,1
9,2025-05-25T10:47:00+02:00,2025-05-25,18:47,0,3,3
9,2025-05-25T10:51:00+02:00,2025-05-25,18:51,0,1,1
10,2025-05-25T10:41:00+02:00,2025-05-25,18:41,0,1,1
10,2025-05-25T10:44:00+02:00,2025-05-25,18:44,0,2,2
12,2025-05-25T10:41:00+02:00,2025-05-25,18:41,4,1,5
12,2025-05-25T10:42:00+02:00,2025-05-25,18:42,2,0,2
12,2025-05-25T10:44:00+02:00,2025-05-25,18:44,4,6,10
12,2025-05-25T10:46:00+02:00,2025-05-25,18:46,2,4,6
12,2025-05-25T10:52:00+02:00,2025-05-25,18:52,3,6,9
12,2025-05-25T10:53:00+02:00,2025-05-25,18:53,1,0,1
17,2025-05-25T10:42:00+02:00,2025-05-25,18:42,0,1,1
17,2025-05-25T10:43:00+02:00,2025-05-25,18:43,0,4,4
17,2025-05-25T10:48:00+02:00,2025-05-25,18:48,0,2,2
18,2025-05-25T10:41:00+02:00,2025-05-25,18:41,0,2,2
19,2025-05-25T10:41:00+02:00,2025-05-25,18:41,12,6,18
19,2025-05-25T10:46:00+02:00,2025-05-25,18:46,7,12,19
19,2025-05-25T10:51:00+02:00,2025-05-25,18:51,9,12,21
19,2025-05-25T10:54:00+02:00,2025-05-25,18:54,13,3,16
20,2025-05-25T10:40:00+02:00,2025-05-25,18:40,3,7,10
20,2025-05-25T10:41:00+02:00,2025-05-25,18:41,9,12,21
20,2025-05-25T10:43:00+02:00,2025-05-25,18:43,8,3,11
20,2025-05-25T10:45:00+02:00,2025-05-25,18:45,13,2,15
20,2025-05-25T10:47:00+02:00,2025-05-25,18:47,0,5,5
20,2025-05-25T10:48:00+02:00,2025-05-25,18:48,23,1,24
20,2025-05-25T10:50:00+02:00,2025-05-25,18:50,5,1,6
23,2025-05-25T10:42:00+02:00,2025-05-25,18:42,3,1,4
23,2025-05-25T10:43:00+02:00,2025-05-25,18:43,0,4,4
23,2025-05-25T10:45:00+02:00,2025-05-25,18:45,0,3,3
23,2025-05-25T10:47:00+02:00,2025-05-25,18:47,5,5,10
23,2025-05-25T10:49:00+02:00,2025-05-25,18:49,0,2,2
23,2025-05-25T10:52:00+02:00,2025-05-25,18:52,3,2,5
24,2025-05-25T10:40:00+02:00,2025-05-25,18:40,12,8,20
24,2025-05-25T10:54:00+02:00,2025-05-25,18:54,7,26,33
25,2025-05-25T10:40:00+02:00,2025-05-25,18:40,34,9,43
25,2025-05-25T10:45:00+02:00,2025-05-25,18:45,23,14,37
27,2025-05-25T10:40:00+02:00,2025-05-25,18:40,5,0,5
27,2025-05-25T10:42:00+02:00,2025-05-25,18:42,2,0,2
27,2025-05-25T10:47:00+02:00,2025-05-25,18:47,2,0,2
27,2025-05-25T10:48:00+02:00,2025-05-25,18:48,4,0,4
27,2025-05-25T10:52:00+02:00,2025-05-25,18:52,0,3,3
30,2025-05-25T10:43:00+02:00,2025-05-25,18:43,5,9,14
30,2025-05-25T10:45:00+02:00,2025-05-25,18:45,10,7,17
30,2025-05-25T10:48:00+02:00,2025-05-25,18:48,3,5,8
30,2025-05-25T10:49:00+02:00,2025-05-25,18:49,10,10,20
35,2025-05-25T10:40:00+02:00,2025-05-25,18:40,12,22,34
35,2025-05-25T10:44:00+02:00,2025-05-25,18:44,14,17,31
35,2025-05-25T10:48:00+02:00,2025-05-25,18:48,9,15,24
35,2025-05-25T10:50:00+02:00,2025-05-25,18:50,7,19,26
35,2025-05-25T10:53:00+02:00,2025-05-25,18:53,10,4,14
48,2025-05-25T10:41:00+02:00,2025-05-25,18:41,7,4,11
48,2025-05-25T10:42:00+02:00,2025-05-25,18:42,0,5,5
48,2025-05-25T10:43:00+02:00,2025-05-25,18:43,0,5,5
48,2025-05-25T10:45:00+02:00,2025-05-25,18:45,3,4,7
48,2025-05-25T10:53:00+02:00,2025-05-25,18:53,1,1,2
49,2025-05-25T10:42:00+02:00,2025-05-25,18:42,2,0,2
49,2025-05-25T10:46:00+02:00,2025-05-25,18:46,1,7,8
49,2025-05-25T10:50:00+02:00,2025-05-25,18:50,2,2,4
49,2025-05-25T10:53:00+02:00,2025-05-25,18:53,2,2,4
51,2025-05-25T10:40:00+02:00,2025-05-25,18:40,1,2,3
51,2025-05-25T10:41:00+02:00,2025-05-25,18:41,1,0,1
52,2025-05-25T10:40:00+02:00,2025-05-25,18:40,5,5,10
52,2025-05-25T10:45:00+02:00,2025-05-25,18:45,2,13,15
52,2025-05-25T10:47:00+02:00,2025-05-25,18:47,3,6,9
52,2025-05-25T10:49:00+02:00,2025-05-25,18:49,2,13,15
52,2025-05-25T10:52:00+02:00,2025-05-25,18:52,11,1,12
52,2025-05-25T10:53:00+02:00,2025-05-25,18:53,8,2,10
53,2025-05-25T10:42:00+02:00,2025-05-25,18:42,2,0,2
53,2025-05-25T10:43:00+02:00,2025-05-25,18:43,5,3,8
53,2025-05-25T10:44:00+02:00,2025-05-25,18:44,1,1,2
53,2025-05-25T10:47:00+02:00,2025-05-25,18:47,2,7,9
53,2025-05-25T10:48:00+02:00,2025-05-25,18:48,2,3,5
53,2025-05-25T10:50:00+02:00,2025-05-25,18:50,0,4,4
53,2025-05-25T10:53:00+02:00,2025-05-25,18:53,2,8,10
56,2025-05-25T10:48:00+02:00,2025-05-25,18:48,14,5,19
56,2025-05-25T10:51:00+02:00,2025-05-25,18:51,7,12,19
56,2025-05-25T10:54:00+02:00,2025-05-25,18:54,6,9,15
58,2025-05-25T10:40:00+02:00,2025-05-25,18:40,7,1,8
58,2025-05-25T10:45:00+02:00,2025-05-25,18:45,10,2,12
58,2025-05-25T10:48:00+02:00,2025-05-25,18:48,10,0,10
58,2025-05-25T10:49:00+02:00,2025-05-25,18:49,7,3,10
58,2025-05-25T10:52:00+02:00,2025-05-25,18:52,3,3,6
58,2025-05-25T10:53:00+02:00,2025-05-25,18:53,14,7,21
62,2025-05-25T10:42:00+02:00,2025-05-25,18:42,1,7,8
62,2025-05-25T10:48:00+02:00,2025-05-25,18:48,6,0,6
62,2025-05-25T10:50:00+02:00,2025-05-25,18:50,4,3,7
62,2025-05-25T10:53:00+02:00,2025-05-25,18:53,3,1,4
63,2025-05-25T10:41:00+02:00,2025-05-25,18:41,3,1,4
63,2025-05-25T10:53:00+02:00,2025-05-25,18:53,1,0,1
67,2025-05-25T10:41:00+02:00,2025-05-25,18:41,5,8,13
67,2025-05-25T10:42:00+02:00,2025-05-25,18:42,4,5,9
67,2025-05-25T10:45:00+02:00,2025-05-25,18:45,15,0,15
67,2025-05-25T10:47:00+02:00,2025-05-25,18:47,2,3,5
67,2025-05-25T10:48:00+02:00,2025-05-25,18:48,1,2,3
67,2025-05-25T10:50:00+02:00,2025-05-25,18:50,7,8,15
67,2025-05-25T10:52:00+02:00,2025-05-25,18:52,8,14,22
68,2025-05-25T10:42:00+02:00,2025-05-25,18:42,2,2,4
68,2025-05-25T10:43:00+02:00,2025-05-25,18:43,7,1,8
68,2025-05-25T10:44:00+02:00,2025-05-25,18:44,5,2,7
68,2025-05-25T10:47:00+02:00,2025-05-25,18:47,1,4,5
68,2025-05-25T10:48:00+02:00,2025-05-25,18:48,3,1,4
68,2025-05-25T10:51:00+02:00,2025-05-25,18:51,4,2,6
68,2025-05-25T10:52:00+02:00,2025-05-25,18:52,3,1,4
72,2025-05-25T10:41:00+02:00,2025-05-25,18:41,6,13,19
72,2025-05-25T10:48:00+02:00,2025-05-25,18:48,0,7,7
72,2025-05-25T10:53:00+02:00,2025-05-25,18:53,5,16,21
76,2025-05-25T10:44:00+02:00,2025-05-25,18:44,0,3,3
76,2025-05-25T10:47:00+02:00,2025-05-25,18:47,3,0,3
76,2025-05-25T10:51:00+02:00,2025-05-25,18:51,1,1,2
79,2025-05-25T10:42:00+02:00,2025-05-25,18:42,6,11,17
79,2025-05-25T10:46:00+02:00,2025-05-25,18:46,13,1,14
79,2025-05-25T10:51:00+02:00,2025-05-25,18:51,14,9,23
79,2025-05-25T10:52:00+02:00,2025-05-25,18:52,4,14,18
79,2025-05-25T10:54:00+02:00,2025-05-25,18:54,7,5,12
85,2025-05-25T10:42:00+02:00,2025-05-25,18:42,0,5,5
85,2025-05-25T10:43:00+02:00,2025-05-25,18:43,0,1,1
85,2025-05-25T10:46:00+02:00,2025-05-25,18:46,2,0,2
85,2025-05-25T10:48:00+02:00,2025-05-25,18:48,4,0,4
85,2025-05-25T10:52:00+02:00,2025-05-25,18:52,0,1,1
86,2025-05-25T10:43:00+02:00,2025-05-25,18:43,0,2,2
86,2025-05-25T10:44:00+02:00,2025-05-25,18:44,1,1,2
86,2025-05-25T10:50:00+02:00,2025-05-25,18:50,0,3,3
109,2025-05-25T10:40:00+02:00,2025-05-25,18:40,2,11,13
117,2025-05-25T10:45:00+02:00,2025-05-25,18:45,16,34,50
123,2025-05-25T10:50:00+02:00,2025-05-25,18:50,0,1,1
130,2025-05-25T10:50:00+02:00,2025-05-25,18:50,3,2,5
137,2025-05-25T10:40:00+02:00,2025-05-25,18:40,0,1,1
139,2025-05-25T10:40:00+02:00,2025-05-25,18:40,1,3,4
139,2025-05-25T10:45:00+02:00,2025-05-25,18:45,4,4,8
139,2025-05-25T10:50:00+02:00,2025-05-25,18:50,2,1,3
161,2025-05-25T10:40:00+02:00,2025-05-25,18:40,0,9,9
161,2025-05-25T10:45:00+02:00,2025-05-25,18:45,0,2,2
3,2025-05-25T08:11:00+02:00,2025-05-25,16:11,20,28,48
3,2025-05-25T08:14:00+02:00,2025-05-25,16:14,19,12,31
3,2025-05-25T08:18:00+02:00,2025-05-25,16:18,11,36,47
3,2025-05-25T08:24:00+02:00,2025-05-25,16:24,10,19,29
4,2025-05-25T08:10:00+02:00,2025-05-25,16:10,27,25,52
4,2025-05-25T08:11:00+02:00,2025-05-25,16:11,15,38,53
4,2025-05-25T08:12:00+02:00,2025-05-25,16:12,33,20,53
4,2025-05-25T08:15:00+02:00,2025-05-25,16:15,23,20,43
4,2025-05-25T08:17:00+02:00,2025-05-25,16:17,30,25,55
4,2025-05-25T08:18:00+02:00,2025-05-25,16:18,11,37,48
4,2025-05-25T08:22:00+02:00,2025-05-25,16:22,37,17,54
5,2025-05-25T08:10:00+02:00,2025-05-25,16:10,115,95,210
5,2025-05-25T08:15:00+02:00,2025-05-25,16:15,106,112,218
6,2025-05-25T08:10:00+02:00,2025-05-25,16:10,24,18,42
6,2025-05-25T08:15:00+02:00,2025-05-25,16:15,26,10,36
6,2025-05-25T08:17:00+02:00,2025-05-25,16:17,13,6,19
8,2025-05-25T08:10:00+02:00,2025-05-25,16:10,4,4,8
8,2025-05-25T08:15:00+02:00,2025-05-25,16:15,9,3,12
8,2025-05-25T08:16:00+02:00,2025-05-25,16:16,6,5,11
8,2025-05-25T08:20:00+02:00,2025-05-25,16:20,3,2,5
8,2025-05-25T08:24:00+02:00,2025-05-25,16:24,3,0,3
28,2025-05-25T08:11:00+02:00,2025-05-25,16:11,7,5,12
28,2025-05-25T08:14:00+02:00,2025-05-25,16:14,10,12,22
28,2025-05-25T08:15:00+02:00,2025-05-25,16:15,36,20,56
28,2025-05-25T08:18:00+02:00,2025-05-25,16:18,3,19,22
28,2025-05-25T08:22:00+02:00,2025-05-25,16:22,8,13,21
29,2025-05-25T08:10:00+02:00,2025-05-25,16:10,11,16,27
29,2025-05-25T08:13:00+02:00,2025-05-25,16:13,11,12,23
29,2025-05-25T08:14:00+02:00,2025-05-25,16:14,5,9,14
29,2025-05-25T08:16:00+02:00,2025-05-25,16:16,14,7,21
29,2025-05-25T08:21:00+02:00,2025-05-25,16:21,15,11,26
31,2025-05-25T08:10:00+02:00,2025-05-25,16:10,18,7,25
31,2025-05-25T08:11:00+02:00,2025-05-25,16:11,7,0,7
31,2025-05-25T08:13:00+02:00,2025-05-25,16:13,3,1,4
31,2025-05-25T08:14:00+02:00,2025-05-25,16:14,6,1,7
31,2025-05-25T08:21:00+02:00,2025-05-25,16:21,5,11,16
31,2025-05-25T08:22:00+02:00,2025-05-25,16:22,3,2,5
31,2025-05-25T08:23:00+02:00,2025-05-25,16:23,5,5,10
36,2025-05-25T08:10:00+02:00,2025-05-25,16:10,2,7,9
36,2025-05-25T08:12:00+02:00,2025-05-25,16:12,5,1,6
36,2025-05-25T08:14:00+02:00,2025-05-25,16:14,3,2,5
36,2025-05-25T08:15:00+02:00,2025-05-25,16:15,0,3,3
36,2025-05-25T08:22:00+02:00,2025-05-25,16:22,5,2,7
39,2025-05-25T08:11:00+02:00,2025-05-25,16:11,1,0,1
39,2025-05-25T08:12:00+02:00,2025-05-25,16:12,3,2,5
39,2025-05-25T08:20:00+02:00,2025-05-25,16:20,0,1,1
40,2025-05-25T08:10:00+02:00,2025-05-25,16:10,0,4,4
40,2025-05-25T08:14:00+02:00,2025-05-25,16:14,1,6,7
40,2025-05-25T08:15:00+02:00,2025-05-25,16:15,5,1,6
40,2025-05-25T08:17:00+02:00,2025-05-25,16:17,0,2,2
40,2025-05-25T08:18:00+02:00,2025-05-25,16:18,0,4,4
40,2025-05-25T08:19:00+02:00,2025-05-25,16:19,1,1,2
40,2025-05-25T08:24:00+02:00,2025-05-25,16:24,3,4,7
41,2025-05-25T08:12:00+02:00,2025-05-25,16:12,17,6,23
41,2025-05-25T08:16:00+02:00,2025-05-25,16:16,5,0,5
41,2025-05-25T08:17:00+02:00,2025-05-25,16:17,15,6,21
41,2025-05-25T08:21:00+02:00,2025-05-25,16:21,12,3,15
45,2025-05-25T08:12:00+02:00,2025-05-25,16:12,4,10,14
45,2025-05-25T08:13:00+02:00,2025-05-25,16:13,9,13,22
45,2025-05-25T08:14:00+02:00,2025-05-25,16:14,13,12,25
45,2025-05-25T08:16:00+02:00,2025-05-25,16:16,9,24,33
45,2025-05-25T08:17:00+02:00,2025-05-25,16:17,19,29,48
45,2025-05-25T08:18:00+02:00,2025-05-25,16:18,22,20,42
45,2025-05-25T08:21:00+02:00,2025-05-25,16:21,12,16,28
45,2025-05-25T08:22:00+02:00,2025-05-25,16:22,12,11,23
47,2025-05-25T08:10:00+02:00,2025-05-25,16:10,18,21,39
47,2025-05-25T08:11:00+02:00,2025-05-25,16:11,11,14,25
47,2025-05-25T08:15:00+02:00,2025-05-25,16:15,18,21,39
47,2025-05-25T08:18:00+02:00,2025-05-25,16:18,33,18,51
47,2025-05-25T08:23:00+02:00,2025-05-25,16:23,13,29,42
47,2025-05-25T08:24:00+02:00,2025-05-25,16:24,18,9,27
50,2025-05-25T08:12:00+02:00,2025-05-25,16:12,2,9,11
50,2025-05-25T08:14:00+02:00,2025-05-25,16:14,8,4,12
50,2025-05-25T08:17:00+02:00,2025-05-25,16:17,1,3,4
50,2025-05-25T08:19:00+02:00,2025-05-25,16:19,4,4,8
50,2025-05-25T08:21:00+02:00,2025-05-25,16:21,2,2,4
54,2025-05-25T08:20:00+02:00,2025-05-25,16:20,3,0,3
54,2025-05-25T08:23:00+02:00,2025-05-25,16:23,3,6,9
61,2025-05-25T08:10:00+02:00,2025-05-25,16:10,20,5,25
61,2025-05-25T08:11:00+02:00,2025-05-25,16:11,9,4,13
61,2025-05-25T08:12:00+02:00,2025-05-25,16:12,7,15,22
61,2025-05-25T08:20:00+02:00,2025-05-25,16:20,12,7,19
66,2025-05-25T08:12:00+02:00,2025-05-25,16:12,19,43,62
66,2025-05-25T08:13:00+02:00,2025-05-25,16:13,11,25,36
66,2025-05-25T08:16:00+02:00,2025-05-25,16:16,33,24,57
66,2025-05-25T08:17:00+02:00,2025-05-25,16:17,30,13,43
66,2025-05-25T08:19:00+02:00,2025-05-25,16:19,26,25,51
69,2025-05-25T08:10:00+02:00,2025-05-25,16:10,3,0,3
69,2025-05-25T08:11:00+02:00,2025-05-25,16:11,3,5,8
69,2025-05-25T08:13:00+02:00,2025-05-25,16:13,5,2,7
69,2025-05-25T08:15:00+02:00,2025-05-25,16:15,3,5,8
69,2025-05-25T08:16:00+02:00,2025-05-25,16:16,7,3,10
69,2025-05-25T08:21:00+02:00,2025-05-25,16:21,8,2,10
69,2025-05-25T08:22:00+02:00,2025-05-25,16:22,1,3,4
69,2025-05-25T08:24:00+02:00,2025-05-25,16:24,4,3,7
70,2025-05-25T08:11:00+02:00,2025-05-25,16:11,2,1,3
70,2025-05-25T08:12:00+02:00,2025-05-25,16:12,2,4,6
70,2025-05-25T08:17:00+02:00,2025-05-25,16:17,6,2,8
71,2025-05-25T08:10:00+02:00,2025-05-25,16:10,0,1,1
71,2025-05-25T08:19:00+02:00,2025-05-25,16:19,0,2,2
75,2025-05-25T08:10:00+02:00,2025-05-25,16:10,1,1,2
75,2025-05-25T08:11:00+02:00,2025-05-25,16:11,0,1,1
75,2025-05-25T08:15:00+02:00,2025-05-25,16:15,5,0,5
75,2025-05-25T08:17:00+02:00,2025-05-25,16:17,0,2,2
75,2025-05-25T08:18:00+02:00,2025-05-25,16:18,2,4,6
75,2025-05-25T08:23:00+02:00,2025-05-25,16:23,4,2,6
78,2025-05-25T08:14:00+02:00,2025-05-25,16:14,0,1,1
78,2025-05-25T08:18:00+02:00,2025-05-25,16:18,0,4,4
78,2025-05-25T08:20:00+02:00,2025-05-25,16:20,1,0,1
84,2025-05-25T08:10:00+02:00,2025-05-25,16:10,51,82,133
84,2025-05-25T08:20:00+02:00,2025-05-25,16:20,95,120,215
87,2025-05-25T08:13:00+02:00,2025-05-25,16:13,1,0,1
87,2025-05-25T08:19:00+02:00,2025-05-25,16:19,4,0,4
87,2025-05-25T08:21:00+02:00,2025-05-25,16:21,2,0,2
107,2025-05-25T08:10:00+02:00,2025-05-25,16:10,7,16,23
107,2025-05-25T08:15:00+02:00,2025-05-25,16:15,9,9,18
107,2025-05-25T08:20:00+02:00,2025-05-25,16:20,4,11,15
108,2025-05-25T08:11:00+02:00,2025-05-25,16:11,2,0,2
108,2025-05-25T08:17:00+02:00,2025-05-25,16:17,2,6,8
108,2025-05-25T08:18:00+02:00,2025-05-25,16:18,3,1,4
108,2025-05-25T08:19:00+02:00,2025-05-25,16:19,2,3,5
108,2025-05-25T08:21:00+02:00,2025-05-25,16:21,1,2,3
108,2025-05-25T08:24:00+02:00,2025-05-25,16:24,2,2,4
118,2025-05-25T08:20:00+02:00,2025-05-25,16:20,13,4,17
132,2025-05-25T08:10:00+02:00,2025-05-25,16:10,9,13,22
133,2025-05-25T08:10:00+02:00,2025-05-25,16:10,36,52,88
134,2025-05-25T08:15:00+02:00,2025-05-25,16:15,28,42,70
134,2025-05-25T08:20:00+02:00,2025-05-25,16:20,40,20,60
135,2025-05-25T08:10:00+02:00,2025-05-25,16:10,47,30,77
140,2025-05-25T08:15:00+02:00,2025-05-25,16:15,7,1,8
166,2025-05-25T08:10:00+02:00,2025-05-25,16:10,9,6,15
166,2025-05-25T08:20:00+02:00,2025-05-25,16:20,5,5,10
167,2025-05-25T08:10:00+02:00,2025-05-25,16:10,5,9,14
179,2025-05-25T08:10:00+02:00,2025-05-25,16:10,7,3,10
179,2025-05-25T08:20:00+02:00,2025-05-25,16:20,5,6,11
1,2025-05-25T08:11:00+02:00,2025-05-25,16:11,25,5,30
1,2025-05-25T08:13:00+02:00,2025-05-25,16:13,15,15,30
1,2025-05-25T08:14:00+02:00,2025-05-25,16:14,27,14,41
1,2025-05-25T08:15:00+02:00,2025-05-25,16:15,26,19,45
1,2025-05-25T08:17:00+02:00,2025-05-25,16:17,28,22,50
1,2025-05-25T08:18:00+02:00,2025-05-25,16:18,11,19,30
1,2025-05-25T08:20:00+02:00,2025-05-25,16:20,35,23,58
1,2025-05-25T08:21:00+02:00,2025-05-25,16:21,27,30,57
1,2025-05-25T08:23:00+02:00,2025-05-25,16:23,27,11,38
2,2025-05-25T08:11:00+02:00,2025-05-25,16:11,5,12,17
2,2025-05-25T08:12:00+02:00,2025-05-25,16:12,12,2,14
2,2025-05-25T08:15:00+02:00,2025-05-25,16:15,3,14,17
2,2025-05-25T08:16:00+02:00,2025-05-25,16:16,13,7,20
9,2025-05-25T08:13:00+02:00,2025-05-25,16:13,0,5,5
9,2025-05-25T08:14:00+02:00,2025-05-25,16:14,1,0,1
9,2025-05-25T08:16:00+02:00,2025-05-25,16:16,0,4,4
9,2025-05-25T08:19:00+02:00,2025-05-25,16:19,1,0,1
9,2025-05-25T08:21:00+02:00,2025-05-25,16:21,0,3,3
9,2025-05-25T08:22:00+02:00,2025-05-25,16:22,1,2,3
10,2025-05-25T08:10:00+02:00,2025-05-25,16:10,3,3,6
10,2025-05-25T08:15:00+02:00,2025-05-25,16:15,1,0,1
10,2025-05-25T08:19:00+02:00,2025-05-25,16:19,0,1,1
11,2025-05-25T08:22:00+02:00,2025-05-25,16:22,2,2,4
11,2025-05-25T08:23:00+02:00,2025-05-25,16:23,2,3,5
11,2025-05-25T08:24:00+02:00,2025-05-25,16:24,1,2,3
12,2025-05-25T08:11:00+02:00,2025-05-25,16:11,6,2,8
12,2025-05-25T08:14:00+02:00,2025-05-25,16:14,12,14,26
12,2025-05-25T08:17:00+02:00,2025-05-25,16:17,1,3,4
12,2025-05-25T08:18:00+02:00,2025-05-25,16:18,17,0,17
12,2025-05-25T08:19:00+02:00,2025-05-25,16:19,16,4,20
12,2025-05-25T08:20:00+02:00,2025-05-25,16:20,3,4,7
17,2025-05-25T08:10:00+02:00,2025-05-25,16:10,0,6,6
17,2025-05-25T08:12:00+02:00,2025-05-25,16:12,2,2,4
17,2025-05-25T08:14:00+02:00,2025-05-25,16:14,0,3,3
17,2025-05-25T08:15:00+02:00,2025-05-25,16:15,3,3,6
17,2025-05-25T08:18:00+02:00,2025-05-25,16:18,5,5,10
17,2025-05-25T08:20:00+02:00,2025-05-25,16:20,2,3,5
17,2025-05-25T08:22:00+02:00,2025-05-25,16:22,2,6,8
18,2025-05-25T08:10:00+02:00,2025-05-25,16:10,0,1,1
18,2025-05-25T08:14:00+02:00,2025-05-25,16:14,5,0,5
18,2025-05-25T08:15:00+02:00,2025-05-25,16:15,2,0,2
18,2025-05-25T08:17:00+02:00,2025-05-25,16:17,6,5,11
18,2025-05-25T08:22:00+02:00,2025-05-25,16:22,0,3,3
19,2025-05-25T08:12:00+02:00,2025-05-25,16:12,18,11,29
19,2025-05-25T08:16:00+02:00,2025-05-25,16:16,10,9,19
19,2025-05-25T08:20:00+02:00,2025-05-25,16:20,6,0,6
19,2025-05-25T08:22:00+02:00,2025-05-25,16:22,8,3,11
19,2025-05-25T08:24:00+02:00,2025-05-25,16:24,11,5,16
20,2025-05-25T08:10:00+02:00,2025-05-25,16:10,5,7,12
20,2025-05-25T08:14:00+02:00,2025-05-25,16:14,2,6,8
20,2025-05-25T08:16:00+02:00,2025-05-25,16:16,3,0,3
20,2025-05-25T08:20:00+02:00,2025-05-25,16:20,1,8,9
20,2025-05-25T08:22:00+02:00,2025-05-25,16:22,1,3,4
20,2025-05-25T08:23:00+02:00,2025-05-25,16:23,8,3,11
23,2025-05-25T08:10:00+02:00,2025-05-25,16:10,0,6,6
23,2025-05-25T08:12:00+02:00,2025-05-25,16:12,1,7,8
23,2025-05-25T08:20:00+02:00,2025-05-25,16:20,7,16,23
23,2025-05-25T08:23:00+02:00,2025-05-25,16:23,2,8,10
24,2025-05-25T08:11:00+02:00,2025-05-25,16:11,7,7,14
24,2025-05-25T08:12:00+02:00,2025-05-25,16:12,9,6,15
24,2025-05-25T08:14:00+02:00,2025-05-25,16:14,11,8,19
24,2025-05-25T08:18:00+02:00,2025-05-25,16:18,1,4,5
24,2025-05-25T08:21:00+02:00,2025-05-25,16:21,10,19,29
24,2025-05-25T08:24:00+02:00,2025-05-25,16:24,7,9,16
27,2025-05-25T08:12:00+02:00,2025-05-25,16:12,8,2,10
27,2025-05-25T08:13:00+02:00,2025-05-25,16:13,5,2,7
27,2025-05-25T08:23:00+02:00,2025-05-25,16:23,0,5,5
30,2025-05-25T08:10:00+02:00,2025-05-25,16:10,11,9,20
30,2025-05-25T08:12:00+02:00,2025-05-25,16:12,5,11,16
30,2025-05-25T08:13:00+02:00,2025-05-25,16:13,2,3,5
30,2025-05-25T08:15:00+02:00,2025-05-25,16:15,3,11,14
30,2025-05-25T08:16:00+02:00,2025-05-25,16:16,2,7,9
30,2025-05-25T08:17:00+02:00,2025-05-25,16:17,1,11,12
30,2025-05-25T08:20:00+02:00,2025-05-25,16:20,6,8,14
35,2025-05-25T08:11:00+02:00,2025-05-25,16:11,10,29,39
35,2025-05-25T08:20:00+02:00,2025-05-25,16:20,32,33,65
35,2025-05-25T08:23:00+02:00,2025-05-25,16:23,8,28,36
46,2025-05-25T08:20:00+02:00,2025-05-25,16:20,2,10,12
48,2025-05-25T08:11:00+02:00,2025-05-25,16:11,11,5,16
48,2025-05-25T08:12:00+02:00,2025-05-25,16:12,11,6,17
48,2025-05-25T08:19:00+02:00,2025-05-25,16:19,7,3,10
48,2025-05-25T08:24:00+02:00,2025-05-25,16:24,4,3,7
49,2025-05-25T08:11:00+02:00,2025-05-25,16:11,0,16,16
49,2025-05-25T08:16:00+02:00,2025-05-25,16:16,2,11,13
49,2025-05-25T08:18:00+02:00,2025-05-25,16:18,9,3,12
49,2025-05-25T08:20:00+02:00,2025-05-25,16:20,8,5,13
49,2025-05-25T08:23:00+02:00,2025-05-25,16:23,5,9,14
51,2025-05-25T08:10:00+02:00,2025-05-25,16:10,1,6,7
51,2025-05-25T08:11:00+02:00,2025-05-25,16:11,1,3,4
51,2025-05-25T08:12:00+02:00,2025-05-25,16:12,4,1,5
51,2025-05-25T08:18:00+02:00,2025-05-25,16:18,5,0,5
51,2025-05-25T08:20:00+02:00,2025-05-25,16:20,0,1,1
52,2025-05-25T08:11:00+02:00,2025-05-25,16:11,9,7,16
52,2025-05-25T08:12:00+02:00,2025-05-25,16:12,3,12,15
52,2025-05-25T08:13:00+02:00,2025-05-25,16:13,4,2,6
52,2025-05-25T08:14:00+02:00,2025-05-25,16:14,8,6,14
52,2025-05-25T08:17:00+02:00,2025-05-25,16:17,7,1,8
52,2025-05-25T08:18:00+02:00,2025-05-25,16:18,9,4,13
52,2025-05-25T08:19:00+02:00,2025-05-25,16:19,4,7,11
52,2025-05-25T08:20:00+02:00,2025-05-25,16:20,6,2,8
52,2025-05-25T08:24:00+02:00,2025-05-25,16:24,11,6,17
53,2025-05-25T08:11:00+02:00,2025-05-25,16:11,12,6,18
53,2025-05-25T08:14:00+02:00,2025-05-25,16:14,11,4,15
53,2025-05-25T08:18:00+02:00,2025-05-25,16:18,9,5,14
53,2025-05-25T08:21:00+02:00,2025-05-25,16:21,9,9,18
53,2025-05-25T08:23:00+02:00,2025-05-25,16:23,4,5,9
56,2025-05-25T08:11:00+02:00,2025-05-25,16:11,11,15,26
56,2025-05-25T08:12:00+02:00,2025-05-25,16:12,10,9,19
56,2025-05-25T08:14:00+02:00,2025-05-25,16:14,4,11,15
56,2025-05-25T08:16:00+02:00,2025-05-25,16:16,12,3,15
56,2025-05-25T08:18:00+02:00,2025-05-25,16:18,11,7,18
56,2025-05-25T08:22:00+02:00,2025-05-25,16:22,4,5,9
58,2025-05-25T08:14:00+02:00,2025-05-25,16:14,9,3,12
58,2025-05-25T08:15:00+02:00,2025-05-25,16:15,6,11,17
58,2025-05-25T08:16:00+02:00,2025-05-25,16:16,4,17,21
58,2025-05-25T08:17:00+02:00,2025-05-25,16:17,12,8,20
58,2025-05-25T08:19:00+02:00,2025-05-25,16:19,6,10,16
58,2025-05-25T08:20:00+02:00,2025-05-25,16:20,5,9,14
62,2025-05-25T08:10:00+02:00,2025-05-25,16:10,4,2,6
62,2025-05-25T08:11:00+02:00,2025-05-25,16:11,4,2,6
62,2025-05-25T08:12:00+02:00,2025-05-25,16:12,4,3,7
62,2025-05-25T08:14:00+02:00,2025-05-25,16:14,2,5,7
62,2025-05-25T08:17:00+02:00,2025-05-25,16:17,11,1,12
62,2025-05-25T08:18:00+02:00,2025-05-25,16:18,4,1,5
62,2025-05-25T08:19:00+02:00,2025-05-25,16:19,0,1,1
63,2025-05-25T08:10:00+02:00,2025-05-25,16:10,12,9,21
63,2025-05-25T08:15:00+02:00,2025-05-25,16:15,6,6,12
63,2025-05-25T08:16:00+02:00,2025-05-25,16:16,8,17,25
63,2025-05-25T08:17:00+02:00,2025-05-25,16:17,9,1,10
63,2025-05-25T08:18:00+02:00,2025-05-25,16:18,7,2,9
63,2025-05-25T08:19:00+02:00,2025-05-25,16:19,5,4,9
63,2025-05-25T08:20:00+02:00,2025-05-25,16:20,5,4,9
63,2025-05-25T08:21:00+02:00,2025-05-25,16:21,4,4,8
63,2025-05-25T08:22:00+02:00,2025-05-25,16:22,3,11,14
67,2025-05-25T08:11:00+02:00,2025-05-25,16:11,7,5,12
67,2025-05-25T08:12:00+02:00,2025-05-25,16:12,11,9,20
67,2025-05-25T08:16:00+02:00,2025-05-25,16:16,12,8,20
67,2025-05-25T08:17:00+02:00,2025-05-25,16:17,5,2,7
67,2025-05-25T08:20:00+02:00,2025-05-25,16:20,4,2,6
67,2025-05-25T08:21:00+02:00,2025-05-25,16:21,3,3,6
67,2025-05-25T08:23:00+02:00,2025-05-25,16:23,5,10,15
68,2025-05-25T08:13:00+02:00,2025-05-25,16:13,0,3,3
68,2025-05-25T08:16:00+02:00,2025-05-25,16:16,8,8,16
68,2025-05-25T08:17:00+02:00,2025-05-25,16:17,8,5,13
68,2025-05-25T08:18:00+02:00,2025-05-25,16:18,2,12,14
68,2025-05-25T08:21:00+02:00,2025-05-25,16:21,6,2,8
68,2025-05-25T08:24:00+02:00,2025-05-25,16:24,2,1,3
72,2025-05-25T08:10:00+02:00,2025-05-25,16:10,16,10,26
72,2025-05-25T08:16:00+02:00,2025-05-25,16:16,11,11,22
72,2025-05-25T08:18:00+02:00,2025-05-25,16:18,2,14,16
72,2025-05-25T08:24:00+02:00,2025-05-25,16:24,11,18,29
76,2025-05-25T08:10:00+02:00,2025-05-25,16:10,0,1,1
76,2025-05-25T08:18:00+02:00,2025-05-25,16:18,1,0,1
76,2025-05-25T08:21:00+02:00,2025-05-25,16:21,4,0,4
76,2025-05-25T08:24:00+02:00,2025-05-25,16:24,2,0,2
79,2025-05-25T08:12:00+02:00,2025-05-25,16:12,5,18,23
79,2025-05-25T08:19:00+02:00,2025-05-25,16:19,17,7,24
79,2025-05-25T08:20:00+02:00,2025-05-25,16:20,10,11,21
79,2025-05-25T08:23:00+02:00,2025-05-25,16:23,9,22,31
79,2025-05-25T08:24:00+02:00,2025-05-25,16:24,12,16,28
85,2025-05-25T08:11:00+02:00,2025-05-25,16:11,2,1,3
85,2025-05-25T08:12:00+02:00,2025-05-25,16:12,0,3,3
85,2025-05-25T08:13:00+02:00,2025-05-25,16:13,1,2,3
85,2025-05-25T08:15:00+02:00,2025-05-25,16:15,1,0,1
85,2025-05-25T08:21:00+02:00,2025-05-25,16:21,2,1,3
85,2025-05-25T08:23:00+02:00,2025-05-25,16:23,0,4,4
86,2025-05-25T08:10:00+02:00,2025-05-25,16:10,0,2,2
86,2025-05-25T08:12:00+02:00,2025-05-25,16:12,0,3,3
86,2025-05-25T08:18:00+02:00,2025-05-25,16:18,0,1,1
86,2025-05-25T08:21:00+02:00,2025-05-25,16:21,0,4,4
109,2025-05-25T08:20:00+02:00,2025-05-25,16:20,4,15,19
117,2025-05-25T08:10:00+02:00,2025-05-25,16:10,23,26,49
123,2025-05-25T08:10:00+02:00,2025-05-25,16:10,32,2,34
130,2025-05-25T08:10:00+02:00,2025-05-25,16:10,36,0,36
130,2025-05-25T08:15:00+02:00,2025-05-25,16:15,4,1,5
136,2025-05-25T08:20:00+02:00,2025-05-25,16:20,6,5,11
137,2025-05-25T08:20:00+02:00,2025-05-25,16:20,2,5,7
139,2025-05-25T08:15:00+02:00,2025-05-25,16:15,2,9,11
139,2025-05-25T08:20:00+02:00,2025-05-25,16:20,5,11,16
141,2025-05-25T08:10:00+02:00,2025-05-25,16:10,5,16,21
141,2025-05-25T08:20:00+02:00,2025-05-25,16:20,11,5,16
142,2025-05-25T08:10:00+02:00,2025-05-25,16:10,56,49,105
142,2025-05-25T08:15:00+02:00,2025-05-25,16:15,49,64,113
161,2025-05-25T08:10:00+02:00,2025-05-25,16:10,13,165,178
164,2025-05-25T08:10:00+02:00,2025-05-25,16:10,5,4,9
181,2025-05-25T08:29:00+02:00,2025-05-25,16:29,12,25,37
181,2025-05-25T08:31:00+02:00,2025-05-25,16:31,14,22,36
181,2025-05-25T08:38:00+02:00,2025-05-25,16:38,16,13,29
181,2025-05-25T08:39:00+02:00,2025-05-25,16:39,18,12,30
180,2025-05-25T08:25:00+02:00,2025-05-25,16:25,4,2,6
180,2025-05-25T08:26:00+02:00,2025-05-25,16:26,2,3,5
180,2025-05-25T08:29:00+02:00,2025-05-25,16:29,1,0,1
180,2025-05-25T08:35:00+02:00,2025-05-25,16:35,3,0,3
180,2025-05-25T08:36:00+02:00,2025-05-25,16:36,2,0,2
3,2025-05-25T07:55:00+02:00,2025-05-25,15:55,26,24,50
3,2025-05-25T07:57:00+02:00,2025-05-25,15:57,23,17,40
3,2025-05-25T07:59:00+02:00,2025-05-25,15:59,29,17,46
3,2025-05-25T08:00:00+02:00,2025-05-25,16:00,24,10,34
3,2025-05-25T08:01:00+02:00,2025-05-25,16:01,22,27,49
3,2025-05-25T08:04:00+02:00,2025-05-25,16:04,26,24,50
3,2025-05-25T08:06:00+02:00,2025-05-25,16:06,22,28,50
3,2025-05-25T08:07:00+02:00,2025-05-25,16:07,37,22,59
3,2025-05-25T08:08:00+02:00,2025-05-25,16:08,23,35,58
3,2025-05-25T08:09:00+02:00,2025-05-25,16:09,32,21,53
4,2025-05-25T07:56:00+02:00,2025-05-25,15:56,36,23,59
4,2025-05-25T07:59:00+02:00,2025-05-25,15:59,16,23,39
4,2025-05-25T08:00:00+02:00,2025-05-25,16:00,33,26,59
4,2025-05-25T08:03:00+02:00,2025-05-25,16:03,35,31,66
4,2025-05-25T08:05:00+02:00,2025-05-25,16:05,22,25,47
4,2025-05-25T08:06:00+02:00,2025-05-25,16:06,23,22,45
5,2025-05-25T07:55:00+02:00,2025-05-25,15:55,56,96,152
6,2025-05-25T07:55:00+02:00,2025-05-25,15:55,14,11,25
6,2025-05-25T07:58:00+02:00,2025-05-25,15:58,14,22,36
6,2025-05-25T08:01:00+02:00,2025-05-25,16:01,12,23,35
6,2025-05-25T08:02:00+02:00,2025-05-25,16:02,13,7,20
6,2025-05-25T08:04:00+02:00,2025-05-25,16:04,15,9,24
6,2025-05-25T08:08:00+02:00,2025-05-25,16:08,12,17,29
6,2025-05-25T08:09:00+02:00,2025-05-25,16:09,16,19,35
8,2025-05-25T07:55:00+02:00,2025-05-25,15:55,5,4,9
8,2025-05-25T07:56:00+02:00,2025-05-25,15:56,1,5,6
8,2025-05-25T07:58:00+02:00,2025-05-25,15:58,6,4,10
8,2025-05-25T07:59:00+02:00,2025-05-25,15:59,5,3,8
8,2025-05-25T08:01:00+02:00,2025-05-25,16:01,12,0,12
8,2025-05-25T08:03:00+02:00,2025-05-25,16:03,1,4,5
8,2025-05-25T08:05:00+02:00,2025-05-25,16:05,0,1,1
8,2025-05-25T08:08:00+02:00,2025-05-25,16:08,2,2,4
28,2025-05-25T07:58:00+02:00,2025-05-25,15:58,8,3,11
28,2025-05-25T08:00:00+02:00,2025-05-25,16:00,7,3,10
28,2025-05-25T08:02:00+02:00,2025-05-25,16:02,13,2,15
28,2025-05-25T08:05:00+02:00,2025-05-25,16:05,5,6,11
28,2025-05-25T08:07:00+02:00,2025-05-25,16:07,10,4,14
29,2025-05-25T07:55:00+02:00,2025-05-25,15:55,17,17,34
29,2025-05-25T07:56:00+02:00,2025-05-25,15:56,7,10,17
29,2025-05-25T07:58:00+02:00,2025-05-25,15:58,3,7,10
29,2025-05-25T08:03:00+02:00,2025-05-25,16:03,16,13,29
29,2025-05-25T08:04:00+02:00,2025-05-25,16:04,12,8,20
29,2025-05-25T08:09:00+02:00,2025-05-25,16:09,8,14,22
31,2025-05-25T07:56:00+02:00,2025-05-25,15:56,3,4,7
31,2025-05-25T08:00:00+02:00,2025-05-25,16:00,4,4,8
36,2025-05-25T07:56:00+02:00,2025-05-25,15:56,1,1,2
36,2025-05-25T07:59:00+02:00,2025-05-25,15:59,1,1,2
36,2025-05-25T08:05:00+02:00,2025-05-25,16:05,0,3,3
36,2025-05-25T08:06:00+02:00,2025-05-25,16:06,1,5,6
36,2025-05-25T08:09:00+02:00,2025-05-25,16:09,0,4,4
39,2025-05-25T07:55:00+02:00,2025-05-25,15:55,3,0,3
39,2025-05-25T08:01:00+02:00,2025-05-25,16:01,1,0,1
39,2025-05-25T08:08:00+02:00,2025-05-25,16:08,0,1,1
40,2025-05-25T07:55:00+02:00,2025-05-25,15:55,2,3,5
40,2025-05-25T07:58:00+02:00,2025-05-25,15:58,2,0,2
40,2025-05-25T08:04:00+02:00,2025-05-25,16:04,1,2,3
41,2025-05-25T07:57:00+02:00,2025-05-25,15:57,6,19,25
41,2025-05-25T07:59:00+02:00,2025-05-25,15:59,4,16,20
41,2025-05-25T08:00:00+02:00,2025-05-25,16:00,14,5,19
41,2025-05-25T08:05:00+02:00,2025-05-25,16:05,4,12,16
45,2025-05-25T07:56:00+02:00,2025-05-25,15:56,11,17,28
45,2025-05-25T07:57:00+02:00,2025-05-25,15:57,21,30,51
45,2025-05-25T07:59:00+02:00,2025-05-25,15:59,20,22,42
45,2025-05-25T08:00:00+02:00,2025-05-25,16:00,16,14,30
45,2025-05-25T08:05:00+02:00,2025-05-25,16:05,17,22,39
45,2025-05-25T08:06:00+02:00,2025-05-25,16:06,16,24,40
45,2025-05-25T08:08:00+02:00,2025-05-25,16:08,18,15,33
47,2025-05-25T07:55:00+02:00,2025-05-25,15:55,15,20,35
47,2025-05-25T07:58:00+02:00,2025-05-25,15:58,17,39,56
47,2025-05-25T08:00:00+02:00,2025-05-25,16:00,21,16,37
47,2025-05-25T08:05:00+02:00,2025-05-25,16:05,29,15,44
47,2025-05-25T08:09:00+02:00,2025-05-25,16:09,18,29,47
50,2025-05-25T07:55:00+02:00,2025-05-25,15:55,6,5,11
50,2025-05-25T07:56:00+02:00,2025-05-25,15:56,8,9,17
50,2025-05-25T07:59:00+02:00,2025-05-25,15:59,7,2,9
50,2025-05-25T08:05:00+02:00,2025-05-25,16:05,7,3,10
50,2025-05-25T08:07:00+02:00,2025-05-25,16:07,4,0,4
54,2025-05-25T07:56:00+02:00,2025-05-25,15:56,3,4,7
54,2025-05-25T07:58:00+02:00,2025-05-25,15:58,3,1,4
54,2025-05-25T08:02:00+02:00,2025-05-25,16:02,3,0,3
59,2025-05-25T08:00:00+02:00,2025-05-25,16:00,21,32,53
61,2025-05-25T07:55:00+02:00,2025-05-25,15:55,8,4,12
61,2025-05-25T07:58:00+02:00,2025-05-25,15:58,13,3,16
61,2025-05-25T08:01:00+02:00,2025-05-25,16:01,16,10,26
61,2025-05-25T08:07:00+02:00,2025-05-25,16:07,2,25,27
66,2025-05-25T07:58:00+02:00,2025-05-25,15:58,17,37,54
66,2025-05-25T08:00:00+02:00,2025-05-25,16:00,21,44,65
66,2025-05-25T08:06:00+02:00,2025-05-25,16:06,42,23,65
66,2025-05-25T08:08:00+02:00,2025-05-25,16:08,28,28,56
69,2025-05-25T07:57:00+02:00,2025-05-25,15:57,1,4,5
69,2025-05-25T07:58:00+02:00,2025-05-25,15:58,6,1,7
69,2025-05-25T08:00:00+02:00,2025-05-25,16:00,6,1,7
69,2025-05-25T08:02:00+02:00,2025-05-25,16:02,7,4,11
69,2025-05-25T08:04:00+02:00,2025-05-25,16:04,2,3,5
69,2025-05-25T08:05:00+02:00,2025-05-25,16:05,1,7,8
69,2025-05-25T08:07:00+02:00,2025-05-25,16:07,4,8,12
69,2025-05-25T08:08:00+02:00,2025-05-25,16:08,4,9,13
70,2025-05-25T07:55:00+02:00,2025-05-25,15:55,3,2,5
70,2025-05-25T07:56:00+02:00,2025-05-25,15:56,7,6,13
70,2025-05-25T07:57:00+02:00,2025-05-25,15:57,3,6,9
70,2025-05-25T08:01:00+02:00,2025-05-25,16:01,1,4,5
70,2025-05-25T08:02:00+02:00,2025-05-25,16:02,1,3,4
70,2025-05-25T08:03:00+02:00,2025-05-25,16:03,1,6,7
70,2025-05-25T08:07:00+02:00,2025-05-25,16:07,2,0,2
70,2025-05-25T08:09:00+02:00,2025-05-25,16:09,1,3,4
71,2025-05-25T07:58:00+02:00,2025-05-25,15:58,1,0,1
71,2025-05-25T08:07:00+02:00,2025-05-25,16:07,1,0,1
75,2025-05-25T07:57:00+02:00,2025-05-25,15:57,1,3,4
75,2025-05-25T08:04:00+02:00,2025-05-25,16:04,3,3,6
75,2025-05-25T08:09:00+02:00,2025-05-25,16:09,0,2,2
77,2025-05-25T07:55:00+02:00,2025-05-25,15:55,14,20,34
77,2025-05-25T08:05:00+02:00,2025-05-25,16:05,14,26,40
78,2025-05-25T07:59:00+02:00,2025-05-25,15:59,2,1,3
78,2025-05-25T08:01:00+02:00,2025-05-25,16:01,1,2,3
78,2025-05-25T08:02:00+02:00,2025-05-25,16:02,0,1,1
78,2025-05-25T08:06:00+02:00,2025-05-25,16:06,1,0,1
78,2025-05-25T08:07:00+02:00,2025-05-25,16:07,7,3,10
78,2025-05-25T08:09:00+02:00,2025-05-25,16:09,2,0,2
84,2025-05-25T08:05:00+02:00,2025-05-25,16:05,106,104,210
87,2025-05-25T07:56:00+02:00,2025-05-25,15:56,1,2,3
87,2025-05-25T07:57:00+02:00,2025-05-25,15:57,3,1,4
87,2025-05-25T08:07:00+02:00,2025-05-25,16:07,0,1,1
87,2025-05-25T08:08:00+02:00,2025-05-25,16:08,0,2,2
87,2025-05-25T08:09:00+02:00,2025-05-25,16:09,1,1,2
108,2025-05-25T07:58:00+02:00,2025-05-25,15:58,3,2,5
108,2025-05-25T08:00:00+02:00,2025-05-25,16:00,3,0,3
108,2025-05-25T08:06:00+02:00,2025-05-25,16:06,3,6,9
108,2025-05-25T08:07:00+02:00,2025-05-25,16:07,5,3,8
108,2025-05-25T08:09:00+02:00,2025-05-25,16:09,2,2,4
118,2025-05-25T08:00:00+02:00,2025-05-25,16:00,3,1,4
118,2025-05-25T08:05:00+02:00,2025-05-25,16:05,2,1,3
131,2025-05-25T07:55:00+02:00,2025-05-25,15:55,10,6,16
131,2025-05-25T08:00:00+02:00,2025-05-25,16:00,6,6,12
131,2025-05-25T08:05:00+02:00,2025-05-25,16:05,5,3,8
132,2025-05-25T08:05:00+02:00,2025-05-25,16:05,13,16,29
133,2025-05-25T07:55:00+02:00,2025-05-25,15:55,20,19,39
134,2025-05-25T08:00:00+02:00,2025-05-25,16:00,33,26,59
134,2025-05-25T08:05:00+02:00,2025-05-25,16:05,29,22,51
135,2025-05-25T08:00:00+02:00,2025-05-25,16:00,31,30,61
140,2025-05-25T07:55:00+02:00,2025-05-25,15:55,14,8,22
140,2025-05-25T08:00:00+02:00,2025-05-25,16:00,8,5,13
179,2025-05-25T08:05:00+02:00,2025-05-25,16:05,9,1,10
1,2025-05-25T08:05:00+02:00,2025-05-25,16:05,18,25,43
1,2025-05-25T08:06:00+02:00,2025-05-25,16:06,26,23,49
1,2025-05-25T08:08:00+02:00,2025-05-25,16:08,27,18,45
1,2025-05-25T08:09:00+02:00,2025-05-25,16:09,24,13,37
2,2025-05-25T07:59:00+02:00,2025-05-25,15:59,4,6,10
2,2025-05-25T08:01:00+02:00,2025-05-25,16:01,23,9,32
2,2025-05-25T08:02:00+02:00,2025-05-25,16:02,11,7,18
2,2025-05-25T08:04:00+02:00,2025-05-25,16:04,10,14,24
2,2025-05-25T08:08:00+02:00,2025-05-25,16:08,11,8,19
9,2025-05-25T07:55:00+02:00,2025-05-25,15:55,0,1,1
9,2025-05-25T07:56:00+02:00,2025-05-25,15:56,0,1,1
9,2025-05-25T07:57:00+02:00,2025-05-25,15:57,1,3,4
9,2025-05-25T08:01:00+02:00,2025-05-25,16:01,0,1,1
9,2025-05-25T08:05:00+02:00,2025-05-25,16:05,2,1,3
10,2025-05-25T08:02:00+02:00,2025-05-25,16:02,0,1,1
11,2025-05-25T07:57:00+02:00,2025-05-25,15:57,0,4,4
11,2025-05-25T07:58:00+02:00,2025-05-25,15:58,7,0,7
11,2025-05-25T07:59:00+02:00,2025-05-25,15:59,1,0,1
11,2025-05-25T08:00:00+02:00,2025-05-25,16:00,6,4,10
11,2025-05-25T08:02:00+02:00,2025-05-25,16:02,0,1,1
11,2025-05-25T08:04:00+02:00,2025-05-25,16:04,1,2,3
11,2025-05-25T08:06:00+02:00,2025-05-25,16:06,3,0,3
11,2025-05-25T08:07:00+02:00,2025-05-25,16:07,0,1,1
12,2025-05-25T07:58:00+02:00,2025-05-25,15:58,10,1,11
12,2025-05-25T08:00:00+02:00,2025-05-25,16:00,16,1,17
12,2025-05-25T08:05:00+02:00,2025-05-25,16:05,17,0,17
12,2025-05-25T08:06:00+02:00,2025-05-25,16:06,3,3,6
12,2025-05-25T08:07:00+02:00,2025-05-25,16:07,14,1,15
17,2025-05-25T07:55:00+02:00,2025-05-25,15:55,1,14,15
17,2025-05-25T07:56:00+02:00,2025-05-25,15:56,3,6,9
17,2025-05-25T07:57:00+02:00,2025-05-25,15:57,2,3,5
17,2025-05-25T07:58:00+02:00,2025-05-25,15:58,3,3,6
17,2025-05-25T08:04:00+02:00,2025-05-25,16:04,1,2,3
17,2025-05-25T08:08:00+02:00,2025-05-25,16:08,0,5,5
17,2025-05-25T08:09:00+02:00,2025-05-25,16:09,6,4,10
18,2025-05-25T08:02:00+02:00,2025-05-25,16:02,1,0,1
19,2025-05-25T07:58:00+02:00,2025-05-25,15:58,18,4,22
19,2025-05-25T08:01:00+02:00,2025-05-25,16:01,8,21,29
19,2025-05-25T08:02:00+02:00,2025-05-25,16:02,11,6,17
19,2025-05-25T08:03:00+02:00,2025-05-25,16:03,12,5,17
19,2025-05-25T08:06:00+02:00,2025-05-25,16:06,9,6,15
19,2025-05-25T08:07:00+02:00,2025-05-25,16:07,12,6,18
20,2025-05-25T07:56:00+02:00,2025-05-25,15:56,2,3,5
20,2025-05-25T08:01:00+02:00,2025-05-25,16:01,1,3,4
20,2025-05-25T08:02:00+02:00,2025-05-25,16:02,12,0,12
20,2025-05-25T08:05:00+02:00,2025-05-25,16:05,2,1,3
20,2025-05-25T08:09:00+02:00,2025-05-25,16:09,5,4,9
23,2025-05-25T07:57:00+02:00,2025-05-25,15:57,3,0,3
23,2025-05-25T08:00:00+02:00,2025-05-25,16:00,0,2,2
23,2025-05-25T08:01:00+02:00,2025-05-25,16:01,2,0,2
23,2025-05-25T08:05:00+02:00,2025-05-25,16:05,6,3,9
23,2025-05-25T08:08:00+02:00,2025-05-25,16:08,1,3,4
23,2025-05-25T08:09:00+02:00,2025-05-25,16:09,0,9,9
24,2025-05-25T07:55:00+02:00,2025-05-25,15:55,2,29,31
24,2025-05-25T07:58:00+02:00,2025-05-25,15:58,1,13,14
24,2025-05-25T08:02:00+02:00,2025-05-25,16:02,15,23,38
24,2025-05-25T08:04:00+02:00,2025-05-25,16:04,5,9,14
24,2025-05-25T08:06:00+02:00,2025-05-25,16:06,7,18,25
25,2025-05-25T08:05:00+02:00,2025-05-25,16:05,77,39,116
27,2025-05-25T07:56:00+02:00,2025-05-25,15:56,1,8,9
27,2025-05-25T07:57:00+02:00,2025-05-25,15:57,2,2,4
27,2025-05-25T07:58:00+02:00,2025-05-25,15:58,1,1,2
27,2025-05-25T08:02:00+02:00,2025-05-25,16:02,5,1,6
27,2025-05-25T08:05:00+02:00,2025-05-25,16:05,9,0,9
27,2025-05-25T08:09:00+02:00,2025-05-25,16:09,5,3,8
30,2025-05-25T08:02:00+02:00,2025-05-25,16:02,4,4,8
30,2025-05-25T08:03:00+02:00,2025-05-25,16:03,2,5,7
30,2025-05-25T08:04:00+02:00,2025-05-25,16:04,0,8,8
30,2025-05-25T08:06:00+02:00,2025-05-25,16:06,3,4,7
35,2025-05-25T08:01:00+02:00,2025-05-25,16:01,15,41,56
35,2025-05-25T08:02:00+02:00,2025-05-25,16:02,14,40,54
35,2025-05-25T08:04:00+02:00,2025-05-25,16:04,15,19,34
35,2025-05-25T08:05:00+02:00,2025-05-25,16:05,25,16,41
35,2025-05-25T08:06:00+02:00,2025-05-25,16:06,24,17,41
35,2025-05-25T08:07:00+02:00,2025-05-25,16:07,22,34,56
46,2025-05-25T07:55:00+02:00,2025-05-25,15:55,5,4,9
46,2025-05-25T08:05:00+02:00,2025-05-25,16:05,2,10,12
48,2025-05-25T07:56:00+02:00,2025-05-25,15:56,24,4,28
48,2025-05-25T07:58:00+02:00,2025-05-25,15:58,8,2,10
48,2025-05-25T08:00:00+02:00,2025-05-25,16:00,5,2,7
48,2025-05-25T08:03:00+02:00,2025-05-25,16:03,5,1,6
48,2025-05-25T08:07:00+02:00,2025-05-25,16:07,8,5,13
48,2025-05-25T08:09:00+02:00,2025-05-25,16:09,6,2,8
49,2025-05-25T07:59:00+02:00,2025-05-25,15:59,12,8,20
49,2025-05-25T08:01:00+02:00,2025-05-25,16:01,5,4,9
49,2025-05-25T08:03:00+02:00,2025-05-25,16:03,2,6,8
49,2025-05-25T08:05:00+02:00,2025-05-25,16:05,16,0,16
51,2025-05-25T07:57:00+02:00,2025-05-25,15:57,2,3,5
51,2025-05-25T07:58:00+02:00,2025-05-25,15:58,4,0,4
51,2025-05-25T07:59:00+02:00,2025-05-25,15:59,2,6,8
51,2025-05-25T08:05:00+02:00,2025-05-25,16:05,0,2,2
51,2025-05-25T08:07:00+02:00,2025-05-25,16:07,3,2,5
51,2025-05-25T08:08:00+02:00,2025-05-25,16:08,5,1,6
52,2025-05-25T07:56:00+02:00,2025-05-25,15:56,4,2,6
52,2025-05-25T07:58:00+02:00,2025-05-25,15:58,4,5,9
52,2025-05-25T07:59:00+02:00,2025-05-25,15:59,3,5,8
52,2025-05-25T08:08:00+02:00,2025-05-25,16:08,3,11,14
53,2025-05-25T08:01:00+02:00,2025-05-25,16:01,14,4,18
53,2025-05-25T08:02:00+02:00,2025-05-25,16:02,9,13,22
53,2025-05-25T08:04:00+02:00,2025-05-25,16:04,19,7,26
53,2025-05-25T08:05:00+02:00,2025-05-25,16:05,6,1,7
53,2025-05-25T08:07:00+02:00,2025-05-25,16:07,8,10,18
53,2025-05-25T08:08:00+02:00,2025-05-25,16:08,7,2,9
53,2025-05-25T08:09:00+02:00,2025-05-25,16:09,7,11,18
56,2025-05-25T07:58:00+02:00,2025-05-25,15:58,2,2,4
56,2025-05-25T08:06:00+02:00,2025-05-25,16:06,10,5,15
56,2025-05-25T08:09:00+02:00,2025-05-25,16:09,10,3,13
58,2025-05-25T07:56:00+02:00,2025-05-25,15:56,8,16,24
58,2025-05-25T07:58:00+02:00,2025-05-25,15:58,14,12,26
58,2025-05-25T08:04:00+02:00,2025-05-25,16:04,8,13,21
58,2025-05-25T08:06:00+02:00,2025-05-25,16:06,13,7,20
62,2025-05-25T07:58:00+02:00,2025-05-25,15:58,5,3,8
62,2025-05-25T08:03:00+02:00,2025-05-25,16:03,4,1,5
62,2025-05-25T08:04:00+02:00,2025-05-25,16:04,5,2,7
62,2025-05-25T08:06:00+02:00,2025-05-25,16:06,2,4,6
62,2025-05-25T08:08:00+02:00,2025-05-25,16:08,4,1,5
63,2025-05-25T08:00:00+02:00,2025-05-25,16:00,4,5,9
63,2025-05-25T08:03:00+02:00,2025-05-25,16:03,8,6,14
63,2025-05-25T08:04:00+02:00,2025-05-25,16:04,5,5,10
63,2025-05-25T08:05:00+02:00,2025-05-25,16:05,5,2,7
63,2025-05-25T08:08:00+02:00,2025-05-25,16:08,9,6,15
67,2025-05-25T07:56:00+02:00,2025-05-25,15:56,3,11,14
67,2025-05-25T07:58:00+02:00,2025-05-25,15:58,0,8,8
67,2025-05-25T07:59:00+02:00,2025-05-25,15:59,7,12,19
67,2025-05-25T08:00:00+02:00,2025-05-25,16:00,7,6,13
67,2025-05-25T08:01:00+02:00,2025-05-25,16:01,4,12,16
68,2025-05-25T07:57:00+02:00,2025-05-25,15:57,4,5,9
68,2025-05-25T08:01:00+02:00,2025-05-25,16:01,5,4,9
68,2025-05-25T08:05:00+02:00,2025-05-25,16:05,2,5,7
68,2025-05-25T08:08:00+02:00,2025-05-25,16:08,8,10,18
68,2025-05-25T08:09:00+02:00,2025-05-25,16:09,3,2,5
72,2025-05-25T07:55:00+02:00,2025-05-25,15:55,11,18,29
72,2025-05-25T07:56:00+02:00,2025-05-25,15:56,17,8,25
72,2025-05-25T07:57:00+02:00,2025-05-25,15:57,11,16,27
72,2025-05-25T07:58:00+02:00,2025-05-25,15:58,7,12,19
72,2025-05-25T07:59:00+02:00,2025-05-25,15:59,3,5,8
72,2025-05-25T08:00:00+02:00,2025-05-25,16:00,11,12,23
72,2025-05-25T08:04:00+02:00,2025-05-25,16:04,7,18,25
72,2025-05-25T08:05:00+02:00,2025-05-25,16:05,5,24,29
76,2025-05-25T07:55:00+02:00,2025-05-25,15:55,1,0,1
76,2025-05-25T07:56:00+02:00,2025-05-25,15:56,3,0,3
76,2025-05-25T08:02:00+02:00,2025-05-25,16:02,2,0,2
76,2025-05-25T08:06:00+02:00,2025-05-25,16:06,0,1,1
79,2025-05-25T07:55:00+02:00,2025-05-25,15:55,15,5,20
79,2025-05-25T07:56:00+02:00,2025-05-25,15:56,7,5,12
79,2025-05-25T08:00:00+02:00,2025-05-25,16:00,15,10,25
79,2025-05-25T08:01:00+02:00,2025-05-25,16:01,9,13,22
79,2025-05-25T08:05:00+02:00,2025-05-25,16:05,10,3,13
79,2025-05-25T08:07:00+02:00,2025-05-25,16:07,13,20,33
79,2025-05-25T08:08:00+02:00,2025-05-25,16:08,3,8,11
85,2025-05-25T07:56:00+02:00,2025-05-25,15:56,0,2,2
85,2025-05-25T07:58:00+02:00,2025-05-25,15:58,1,0,1
85,2025-05-25T08:05:00+02:00,2025-05-25,16:05,1,0,1
86,2025-05-25T08:03:00+02:00,2025-05-25,16:03,0,1,1
86,2025-05-25T08:04:00+02:00,2025-05-25,16:04,0,3,3
86,2025-05-25T08:05:00+02:00,2025-05-25,16:05,2,2,4
86,2025-05-25T08:06:00+02:00,2025-05-25,16:06,1,0,1
86,2025-05-25T08:08:00+02:00,2025-05-25,16:08,0,1,1
86,2025-05-25T08:09:00+02:00,2025-05-25,16:09,2,1,3
109,2025-05-25T07:55:00+02:00,2025-05-25,15:55,2,19,21
109,2025-05-25T08:05:00+02:00,2025-05-25,16:05,3,10,13
117,2025-05-25T08:00:00+02:00,2025-05-25,16:00,18,20,38
123,2025-05-25T08:00:00+02:00,2025-05-25,16:00,26,1,27
123,2025-05-25T08:05:00+02:00,2025-05-25,16:05,36,5,41
130,2025-05-25T07:55:00+02:00,2025-05-25,15:55,3,9,12
136,2025-05-25T08:00:00+02:00,2025-05-25,16:00,15,56,71
137,2025-05-25T07:55:00+02:00,2025-05-25,15:55,0,1,1
137,2025-05-25T08:00:00+02:00,2025-05-25,16:00,0,8,8
137,2025-05-25T08:05:00+02:00,2025-05-25,16:05,0,4,4
139,2025-05-25T08:00:00+02:00,2025-05-25,16:00,1,9,10
141,2025-05-25T08:05:00+02:00,2025-05-25,16:05,17,8,25
142,2025-05-25T08:00:00+02:00,2025-05-25,16:00,56,63,119
161,2025-05-25T08:00:00+02:00,2025-05-25,16:00,14,247,261
181,2025-05-25T08:12:00+02:00,2025-05-25,16:12,8,17,25
181,2025-05-25T08:13:00+02:00,2025-05-25,16:13,13,13,26
181,2025-05-25T08:23:00+02:00,2025-05-25,16:23,24,16,40
180,2025-05-25T08:10:00+02:00,2025-05-25,16:10,0,1,1
180,2025-05-25T08:14:00+02:00,2025-05-25,16:14,1,0,1
180,2025-05-25T08:16:00+02:00,2025-05-25,16:16,1,0,1
181,2025-05-25T07:55:00+02:00,2025-05-25,15:55,9,17,26
181,2025-05-25T07:56:00+02:00,2025-05-25,15:56,13,16,29
181,2025-05-25T08:07:00+02:00,2025-05-25,16:07,9,22,31
182,2025-05-25T07:55:00+02:00,2025-05-25,15:55,9,16,25
180,2025-05-25T07:56:00+02:00,2025-05-25,15:56,1,0,1
180,2025-05-25T08:05:00+02:00,2025-05-25,16:05,0,2,2
180,2025-05-25T08:09:00+02:00,2025-05-25,16:09,1,0,1
3,2025-05-25T10:15:00+02:00,2025-05-25,18:15,5,18,23
3,2025-05-25T10:18:00+02:00,2025-05-25,18:18,15,18,33
4,2025-05-25T10:13:00+02:00,2025-05-25,18:13,17,16,33
4,2025-05-25T10:16:00+02:00,2025-05-25,18:16,17,23,40
4,2025-05-25T10:20:00+02:00,2025-05-25,18:20,10,10,20
6,2025-05-25T10:14:00+02:00,2025-05-25,18:14,14,6,20
6,2025-05-25T10:15:00+02:00,2025-05-25,18:15,12,19,31
6,2025-05-25T10:17:00+02:00,2025-05-25,18:17,19,7,26
6,2025-05-25T10:19:00+02:00,2025-05-25,18:19,10,11,21
6,2025-05-25T10:21:00+02:00,2025-05-25,18:21,7,9,16
6,2025-05-25T10:24:00+02:00,2025-05-25,18:24,10,10,20
8,2025-05-25T10:16:00+02:00,2025-05-25,18:16,1,1,2
8,2025-05-25T10:17:00+02:00,2025-05-25,18:17,2,0,2
8,2025-05-25T10:19:00+02:00,2025-05-25,18:19,0,2,2
28,2025-05-25T10:10:00+02:00,2025-05-25,18:10,9,37,46
28,2025-05-25T10:11:00+02:00,2025-05-25,18:11,8,20,28
28,2025-05-25T10:13:00+02:00,2025-05-25,18:13,7,15,22
28,2025-05-25T10:16:00+02:00,2025-05-25,18:16,8,5,13
28,2025-05-25T10:21:00+02:00,2025-05-25,18:21,2,4,6
28,2025-05-25T10:22:00+02:00,2025-05-25,18:22,3,4,7
28,2025-05-25T10:24:00+02:00,2025-05-25,18:24,0,5,5
29,2025-05-25T10:10:00+02:00,2025-05-25,18:10,4,3,7
29,2025-05-25T10:14:00+02:00,2025-05-25,18:14,9,15,24
29,2025-05-25T10:19:00+02:00,2025-05-25,18:19,3,11,14
29,2025-05-25T10:21:00+02:00,2025-05-25,18:21,5,2,7
29,2025-05-25T10:23:00+02:00,2025-05-25,18:23,6,7,13
31,2025-05-25T10:10:00+02:00,2025-05-25,18:10,6,0,6
31,2025-05-25T10:13:00+02:00,2025-05-25,18:13,6,3,9
31,2025-05-25T10:14:00+02:00,2025-05-25,18:14,5,0,5
31,2025-05-25T10:18:00+02:00,2025-05-25,18:18,5,2,7
31,2025-05-25T10:20:00+02:00,2025-05-25,18:20,4,2,6
36,2025-05-25T10:14:00+02:00,2025-05-25,18:14,1,2,3
36,2025-05-25T10:15:00+02:00,2025-05-25,18:15,0,1,1
36,2025-05-25T10:19:00+02:00,2025-05-25,18:19,2,0,2
36,2025-05-25T10:24:00+02:00,2025-05-25,18:24,2,1,3
40,2025-05-25T10:12:00+02:00,2025-05-25,18:12,1,3,4
40,2025-05-25T10:14:00+02:00,2025-05-25,18:14,1,0,1
40,2025-05-25T10:21:00+02:00,2025-05-25,18:21,3,0,3
40,2025-05-25T10:22:00+02:00,2025-05-25,18:22,3,0,3
40,2025-05-25T10:23:00+02:00,2025-05-25,18:23,1,1,2
41,2025-05-25T10:12:00+02:00,2025-05-25,18:12,22,6,28
41,2025-05-25T10:13:00+02:00,2025-05-25,18:13,7,2,9
41,2025-05-25T10:14:00+02:00,2025-05-25,18:14,3,10,13
41,2025-05-25T10:22:00+02:00,2025-05-25,18:22,8,0,8
43,2025-05-25T10:15:00+02:00,2025-05-25,18:15,3,6,9
43,2025-05-25T10:20:00+02:00,2025-05-25,18:20,2,2,4
44,2025-05-25T10:20:00+02:00,2025-05-25,18:20,0,6,6
45,2025-05-25T10:16:00+02:00,2025-05-25,18:16,12,11,23
45,2025-05-25T10:23:00+02:00,2025-05-25,18:23,24,10,34
47,2025-05-25T10:10:00+02:00,2025-05-25,18:10,16,13,29
47,2025-05-25T10:11:00+02:00,2025-05-25,18:11,15,6,21
47,2025-05-25T10:16:00+02:00,2025-05-25,18:16,17,8,25
47,2025-05-25T10:24:00+02:00,2025-05-25,18:24,22,5,27
50,2025-05-25T10:10:00+02:00,2025-05-25,18:10,3,2,5
50,2025-05-25T10:13:00+02:00,2025-05-25,18:13,2,3,5
50,2025-05-25T10:20:00+02:00,2025-05-25,18:20,6,2,8
50,2025-05-25T10:22:00+02:00,2025-05-25,18:22,3,2,5
54,2025-05-25T10:11:00+02:00,2025-05-25,18:11,0,4,4
54,2025-05-25T10:20:00+02:00,2025-05-25,18:20,1,0,1
54,2025-05-25T10:23:00+02:00,2025-05-25,18:23,1,1,2
54,2025-05-25T10:24:00+02:00,2025-05-25,18:24,0,2,2
59,2025-05-25T10:10:00+02:00,2025-05-25,18:10,17,17,34
59,2025-05-25T10:20:00+02:00,2025-05-25,18:20,10,16,26
61,2025-05-25T10:10:00+02:00,2025-05-25,18:10,4,0,4
61,2025-05-25T10:11:00+02:00,2025-05-25,18:11,5,2,7
61,2025-05-25T10:14:00+02:00,2025-05-25,18:14,10,10,20
61,2025-05-25T10:16:00+02:00,2025-05-25,18:16,10,1,11
61,2025-05-25T10:17:00+02:00,2025-05-25,18:17,2,7,9
61,2025-05-25T10:20:00+02:00,2025-05-25,18:20,9,3,12
61,2025-05-25T10:23:00+02:00,2025-05-25,18:23,4,1,5
66,2025-05-25T10:15:00+02:00,2025-05-25,18:15,26,15,41
66,2025-05-25T10:16:00+02:00,2025-05-25,18:16,9,25,34
66,2025-05-25T10:17:00+02:00,2025-05-25,18:17,14,23,37
66,2025-05-25T10:24:00+02:00,2025-05-25,18:24,36,33,69
69,2025-05-25T10:14:00+02:00,2025-05-25,18:14,1,0,1
69,2025-05-25T10:24:00+02:00,2025-05-25,18:24,0,1,1
70,2025-05-25T10:10:00+02:00,2025-05-25,18:10,3,3,6
70,2025-05-25T10:13:00+02:00,2025-05-25,18:13,2,10,12
70,2025-05-25T10:15:00+02:00,2025-05-25,18:15,6,2,8
70,2025-05-25T10:18:00+02:00,2025-05-25,18:18,3,9,12
70,2025-05-25T10:20:00+02:00,2025-05-25,18:20,4,0,4
70,2025-05-25T10:24:00+02:00,2025-05-25,18:24,0,4,4
71,2025-05-25T10:20:00+02:00,2025-05-25,18:20,1,0,1
75,2025-05-25T10:11:00+02:00,2025-05-25,18:11,1,0,1
75,2025-05-25T10:17:00+02:00,2025-05-25,18:17,1,0,1
75,2025-05-25T10:21:00+02:00,2025-05-25,18:21,1,0,1
75,2025-05-25T10:23:00+02:00,2025-05-25,18:23,0,1,1
77,2025-05-25T10:20:00+02:00,2025-05-25,18:20,20,11,31
84,2025-05-25T10:15:00+02:00,2025-05-25,18:15,60,89,149
84,2025-05-25T10:20:00+02:00,2025-05-25,18:20,74,82,156
87,2025-05-25T10:10:00+02:00,2025-05-25,18:10,1,0,1
87,2025-05-25T10:14:00+02:00,2025-05-25,18:14,0,3,3
87,2025-05-25T10:15:00+02:00,2025-05-25,18:15,1,2,3
87,2025-05-25T10:18:00+02:00,2025-05-25,18:18,0,2,2
87,2025-05-25T10:19:00+02:00,2025-05-25,18:19,1,3,4
107,2025-05-25T10:20:00+02:00,2025-05-25,18:20,6,17,23
108,2025-05-25T10:11:00+02:00,2025-05-25,18:11,7,3,10
108,2025-05-25T10:14:00+02:00,2025-05-25,18:14,0,3,3
108,2025-05-25T10:19:00+02:00,2025-05-25,18:19,2,2,4
118,2025-05-25T10:10:00+02:00,2025-05-25,18:10,6,3,9
131,2025-05-25T10:15:00+02:00,2025-05-25,18:15,5,3,8
132,2025-05-25T10:10:00+02:00,2025-05-25,18:10,13,16,29
134,2025-05-25T10:20:00+02:00,2025-05-25,18:20,38,32,70
135,2025-05-25T10:15:00+02:00,2025-05-25,18:15,28,19,47
165,2025-05-25T10:10:00+02:00,2025-05-25,18:10,1,3,4
165,2025-05-25T10:15:00+02:00,2025-05-25,18:15,1,2,3
166,2025-05-25T10:10:00+02:00,2025-05-25,18:10,1,2,3
166,2025-05-25T10:15:00+02:00,2025-05-25,18:15,2,2,4
166,2025-05-25T10:20:00+02:00,2025-05-25,18:20,4,2,6
167,2025-05-25T10:10:00+02:00,2025-05-25,18:10,3,3,6
1,2025-05-25T10:10:00+02:00,2025-05-25,18:10,14,5,19
1,2025-05-25T10:13:00+02:00,2025-05-25,18:13,10,3,13
1,2025-05-25T10:14:00+02:00,2025-05-25,18:14,12,9,21
1,2025-05-25T10:15:00+02:00,2025-05-25,18:15,6,13,19
1,2025-05-25T10:16:00+02:00,2025-05-25,18:16,7,12,19
1,2025-05-25T10:18:00+02:00,2025-05-25,18:18,7,12,19
1,2025-05-25T10:21:00+02:00,2025-05-25,18:21,8,9,17
1,2025-05-25T10:24:00+02:00,2025-05-25,18:24,6,3,9
2,2025-05-25T10:11:00+02:00,2025-05-25,18:11,4,7,11
9,2025-05-25T10:17:00+02:00,2025-05-25,18:17,2,0,2
10,2025-05-25T10:11:00+02:00,2025-05-25,18:11,1,1,2
10,2025-05-25T10:14:00+02:00,2025-05-25,18:14,2,0,2
10,2025-05-25T10:16:00+02:00,2025-05-25,18:16,3,0,3
10,2025-05-25T10:21:00+02:00,2025-05-25,18:21,2,0,2
10,2025-05-25T10:22:00+02:00,2025-05-25,18:22,0,1,1
10,2025-05-25T10:23:00+02:00,2025-05-25,18:23,0,2,2
12,2025-05-25T10:16:00+02:00,2025-05-25,18:16,1,4,5
12,2025-05-25T10:20:00+02:00,2025-05-25,18:20,2,4,6
12,2025-05-25T10:21:00+02:00,2025-05-25,18:21,6,4,10
17,2025-05-25T10:10:00+02:00,2025-05-25,18:10,4,3,7
17,2025-05-25T10:11:00+02:00,2025-05-25,18:11,2,0,2
17,2025-05-25T10:16:00+02:00,2025-05-25,18:16,4,0,4
17,2025-05-25T10:17:00+02:00,2025-05-25,18:17,1,3,4
18,2025-05-25T10:15:00+02:00,2025-05-25,18:15,1,0,1
18,2025-05-25T10:24:00+02:00,2025-05-25,18:24,1,0,1
19,2025-05-25T10:10:00+02:00,2025-05-25,18:10,26,3,29
19,2025-05-25T10:13:00+02:00,2025-05-25,18:13,11,9,20
19,2025-05-25T10:14:00+02:00,2025-05-25,18:14,17,13,30
19,2025-05-25T10:19:00+02:00,2025-05-25,18:19,18,8,26
19,2025-05-25T10:21:00+02:00,2025-05-25,18:21,8,2,10
19,2025-05-25T10:23:00+02:00,2025-05-25,18:23,6,7,13
20,2025-05-25T10:11:00+02:00,2025-05-25,18:11,14,13,27
20,2025-05-25T10:13:00+02:00,2025-05-25,18:13,6,9,15
20,2025-05-25T10:14:00+02:00,2025-05-25,18:14,1,4,5
20,2025-05-25T10:17:00+02:00,2025-05-25,18:17,4,3,7
20,2025-05-25T10:18:00+02:00,2025-05-25,18:18,7,10,17
20,2025-05-25T10:22:00+02:00,2025-05-25,18:22,7,6,13
23,2025-05-25T10:10:00+02:00,2025-05-25,18:10,1,2,3
23,2025-05-25T10:11:00+02:00,2025-05-25,18:11,3,5,8
23,2025-05-25T10:14:00+02:00,2025-05-25,18:14,6,3,9
23,2025-05-25T10:15:00+02:00,2025-05-25,18:15,2,6,8
23,2025-05-25T10:17:00+02:00,2025-05-25,18:17,5,2,7
23,2025-05-25T10:18:00+02:00,2025-05-25,18:18,1,1,2
23,2025-05-25T10:20:00+02:00,2025-05-25,18:20,1,2,3
23,2025-05-25T10:21:00+02:00,2025-05-25,18:21,3,5,8
23,2025-05-25T10:22:00+02:00,2025-05-25,18:22,2,2,4
23,2025-05-25T10:23:00+02:00,2025-05-25,18:23,4,2,6
24,2025-05-25T10:11:00+02:00,2025-05-25,18:11,9,8,17
24,2025-05-25T10:14:00+02:00,2025-05-25,18:14,4,0,4
24,2025-05-25T10:17:00+02:00,2025-05-25,18:17,2,21,23
24,2025-05-25T10:18:00+02:00,2025-05-25,18:18,6,4,10
24,2025-05-25T10:20:00+02:00,2025-05-25,18:20,9,11,20
24,2025-05-25T10:23:00+02:00,2025-05-25,18:23,5,6,11
25,2025-05-25T10:10:00+02:00,2025-05-25,18:10,83,32,115
27,2025-05-25T10:11:00+02:00,2025-05-25,18:11,2,0,2
27,2025-05-25T10:14:00+02:00,2025-05-25,18:14,3,2,5
27,2025-05-25T10:15:00+02:00,2025-05-25,18:15,0,4,4
27,2025-05-25T10:17:00+02:00,2025-05-25,18:17,3,2,5
27,2025-05-25T10:22:00+02:00,2025-05-25,18:22,7,1,8
27,2025-05-25T10:23:00+02:00,2025-05-25,18:23,2,0,2
27,2025-05-25T10:24:00+02:00,2025-05-25,18:24,1,7,8
30,2025-05-25T10:23:00+02:00,2025-05-25,18:23,4,7,11
35,2025-05-25T10:10:00+02:00,2025-05-25,18:10,9,12,21
35,2025-05-25T10:11:00+02:00,2025-05-25,18:11,7,24,31
35,2025-05-25T10:12:00+02:00,2025-05-25,18:12,8,11,19
35,2025-05-25T10:15:00+02:00,2025-05-25,18:15,14,14,28
48,2025-05-25T10:12:00+02:00,2025-05-25,18:12,1,0,1
48,2025-05-25T10:15:00+02:00,2025-05-25,18:15,2,5,7
48,2025-05-25T10:16:00+02:00,2025-05-25,18:16,2,0,2
48,2025-05-25T10:17:00+02:00,2025-05-25,18:17,5,3,8
48,2025-05-25T10:19:00+02:00,2025-05-25,18:19,4,1,5
48,2025-05-25T10:20:00+02:00,2025-05-25,18:20,4,1,5
48,2025-05-25T10:21:00+02:00,2025-05-25,18:21,0,1,1
49,2025-05-25T10:12:00+02:00,2025-05-25,18:12,3,6,9
49,2025-05-25T10:13:00+02:00,2025-05-25,18:13,4,4,8
49,2025-05-25T10:14:00+02:00,2025-05-25,18:14,2,5,7
49,2025-05-25T10:21:00+02:00,2025-05-25,18:21,4,8,12
49,2025-05-25T10:23:00+02:00,2025-05-25,18:23,12,5,17
51,2025-05-25T10:10:00+02:00,2025-05-25,18:10,1,0,1
51,2025-05-25T10:13:00+02:00,2025-05-25,18:13,0,4,4
51,2025-05-25T10:17:00+02:00,2025-05-25,18:17,2,1,3
51,2025-05-25T10:18:00+02:00,2025-05-25,18:18,2,0,2
51,2025-05-25T10:23:00+02:00,2025-05-25,18:23,1,0,1
52,2025-05-25T10:14:00+02:00,2025-05-25,18:14,3,2,5
52,2025-05-25T10:16:00+02:00,2025-05-25,18:16,2,9,11
52,2025-05-25T10:18:00+02:00,2025-05-25,18:18,0,1,1
52,2025-05-25T10:19:00+02:00,2025-05-25,18:19,5,6,11
52,2025-05-25T10:20:00+02:00,2025-05-25,18:20,9,1,10
52,2025-05-25T10:23:00+02:00,2025-05-25,18:23,0,3,3
53,2025-05-25T10:11:00+02:00,2025-05-25,18:11,3,4,7
53,2025-05-25T10:15:00+02:00,2025-05-25,18:15,6,1,7
53,2025-05-25T10:17:00+02:00,2025-05-25,18:17,7,1,8
53,2025-05-25T10:19:00+02:00,2025-05-25,18:19,4,3,7
56,2025-05-25T10:11:00+02:00,2025-05-25,18:11,6,13,19
56,2025-05-25T10:13:00+02:00,2025-05-25,18:13,9,5,14
56,2025-05-25T10:14:00+02:00,2025-05-25,18:14,8,0,8
56,2025-05-25T10:15:00+02:00,2025-05-25,18:15,3,6,9
56,2025-05-25T10:17:00+02:00,2025-05-25,18:17,6,5,11
56,2025-05-25T10:21:00+02:00,2025-05-25,18:21,13,6,19
58,2025-05-25T10:10:00+02:00,2025-05-25,18:10,2,11,13
58,2025-05-25T10:13:00+02:00,2025-05-25,18:13,11,7,18
58,2025-05-25T10:14:00+02:00,2025-05-25,18:14,4,4,8
58,2025-05-25T10:19:00+02:00,2025-05-25,18:19,3,2,5
58,2025-05-25T10:20:00+02:00,2025-05-25,18:20,4,14,18
58,2025-05-25T10:23:00+02:00,2025-05-25,18:23,4,5,9
58,2025-05-25T10:24:00+02:00,2025-05-25,18:24,14,6,20
62,2025-05-25T10:10:00+02:00,2025-05-25,18:10,2,2,4
62,2025-05-25T10:13:00+02:00,2025-05-25,18:13,1,6,7
62,2025-05-25T10:14:00+02:00,2025-05-25,18:14,2,6,8
62,2025-05-25T10:15:00+02:00,2025-05-25,18:15,5,3,8
63,2025-05-25T10:14:00+02:00,2025-05-25,18:14,1,2,3
63,2025-05-25T10:18:00+02:00,2025-05-25,18:18,1,3,4
63,2025-05-25T10:21:00+02:00,2025-05-25,18:21,5,5,10
67,2025-05-25T10:13:00+02:00,2025-05-25,18:13,0,4,4
67,2025-05-25T10:14:00+02:00,2025-05-25,18:14,0,5,5
67,2025-05-25T10:15:00+02:00,2025-05-25,18:15,5,2,7
67,2025-05-25T10:19:00+02:00,2025-05-25,18:19,7,8,15
67,2025-05-25T10:22:00+02:00,2025-05-25,18:22,6,3,9
68,2025-05-25T10:19:00+02:00,2025-05-25,18:19,4,0,4
68,2025-05-25T10:20:00+02:00,2025-05-25,18:20,1,5,6
68,2025-05-25T10:22:00+02:00,2025-05-25,18:22,0,5,5
68,2025-05-25T10:24:00+02:00,2025-05-25,18:24,5,8,13
72,2025-05-25T10:11:00+02:00,2025-05-25,18:11,0,9,9
72,2025-05-25T10:14:00+02:00,2025-05-25,18:14,3,3,6
72,2025-05-25T10:16:00+02:00,2025-05-25,18:16,7,0,7
72,2025-05-25T10:20:00+02:00,2025-05-25,18:20,8,6,14
76,2025-05-25T10:10:00+02:00,2025-05-25,18:10,0,2,2
76,2025-05-25T10:20:00+02:00,2025-05-25,18:20,1,3,4
79,2025-05-25T10:11:00+02:00,2025-05-25,18:11,12,9,21
79,2025-05-25T10:16:00+02:00,2025-05-25,18:16,7,10,17
79,2025-05-25T10:18:00+02:00,2025-05-25,18:18,14,16,30
79,2025-05-25T10:19:00+02:00,2025-05-25,18:19,8,6,14
79,2025-05-25T10:20:00+02:00,2025-05-25,18:20,5,6,11
79,2025-05-25T10:22:00+02:00,2025-05-25,18:22,6,7,13
79,2025-05-25T10:23:00+02:00,2025-05-25,18:23,5,13,18
85,2025-05-25T10:14:00+02:00,2025-05-25,18:14,1,0,1
85,2025-05-25T10:20:00+02:00,2025-05-25,18:20,0,1,1
86,2025-05-25T10:11:00+02:00,2025-05-25,18:11,2,1,3
86,2025-05-25T10:16:00+02:00,2025-05-25,18:16,0,1,1
86,2025-05-25T10:17:00+02:00,2025-05-25,18:17,4,0,4
86,2025-05-25T10:18:00+02:00,2025-05-25,18:18,0,1,1
86,2025-05-25T10:21:00+02:00,2025-05-25,18:21,0,1,1
86,2025-05-25T10:22:00+02:00,2025-05-25,18:22,2,1,3
117,2025-05-25T10:15:00+02:00,2025-05-25,18:15,25,28,53
117,2025-05-25T10:20:00+02:00,2025-05-25,18:20,26,21,47
137,2025-05-25T10:20:00+02:00,2025-05-25,18:20,0,2,2
139,2025-05-25T10:15:00+02:00,2025-05-25,18:15,0,4,4
141,2025-05-25T10:10:00+02:00,2025-05-25,18:10,16,6,22
142,2025-05-25T10:20:00+02:00,2025-05-25,18:20,8,3,11
161,2025-05-25T10:10:00+02:00,2025-05-25,18:10,0,4,4
161,2025-05-25T10:20:00+02:00,2025-05-25,18:20,0,3,3
164,2025-05-25T10:15:00+02:00,2025-05-25,18:15,10,7,17
164,2025-05-25T10:20:00+02:00,2025-05-25,18:20,15,3,18
181,2025-05-25T10:16:00+02:00,2025-05-25,18:16,9,18,27
181,2025-05-25T10:22:00+02:00,2025-05-25,18:22,11,20,31
181,2025-05-25T10:23:00+02:00,2025-05-25,18:23,25,11,36
182,2025-05-25T10:10:00+02:00,2025-05-25,18:10,21,9,30
182,2025-05-25T10:15:00+02:00,2025-05-25,18:15,31,8,39
182,2025-05-25T10:20:00+02:00,2025-05-25,18:20,24,24,48
180,2025-05-25T10:23:00+02:00,2025-05-25,18:23,0,1,1
181,2025-05-25T10:26:00+02:00,2025-05-25,18:26,7,22,29
181,2025-05-25T10:28:00+02:00,2025-05-25,18:28,16,11,27
181,2025-05-25T10:29:00+02:00,2025-05-25,18:29,13,14,27
181,2025-05-25T10:32:00+02:00,2025-05-25,18:32,16,19,35
181,2025-05-25T10:37:00+02:00,2025-05-25,18:37,17,14,31
181,2025-05-25T10:38:00+02:00,2025-05-25,18:38,14,9,23
181,2025-05-25T10:39:00+02:00,2025-05-25,18:39,28,8,36
182,2025-05-25T10:25:00+02:00,2025-05-25,18:25,19,8,27
182,2025-05-25T10:30:00+02:00,2025-05-25,18:30,31,12,43
3,2025-05-25T09:55:00+02:00,2025-05-25,17:55,23,31,54
3,2025-05-25T09:56:00+02:00,2025-05-25,17:56,23,22,45
3,2025-05-25T09:58:00+02:00,2025-05-25,17:58,23,27,50
3,2025-05-25T10:00:00+02:00,2025-05-25,18:00,10,27,37
3,2025-05-25T10:02:00+02:00,2025-05-25,18:02,21,10,31
3,2025-05-25T10:04:00+02:00,2025-05-25,18:04,18,11,29
4,2025-05-25T09:56:00+02:00,2025-05-25,17:56,8,15,23
4,2025-05-25T10:06:00+02:00,2025-05-25,18:06,23,7,30
4,2025-05-25T10:09:00+02:00,2025-05-25,18:09,19,21,40
5,2025-05-25T09:55:00+02:00,2025-05-25,17:55,54,86,140
6,2025-05-25T09:55:00+02:00,2025-05-25,17:55,16,8,24
6,2025-05-25T09:57:00+02:00,2025-05-25,17:57,9,19,28
6,2025-05-25T10:00:00+02:00,2025-05-25,18:00,17,14,31
6,2025-05-25T10:06:00+02:00,2025-05-25,18:06,7,12,19
8,2025-05-25T09:55:00+02:00,2025-05-25,17:55,0,2,2
8,2025-05-25T09:59:00+02:00,2025-05-25,17:59,2,0,2
8,2025-05-25T10:01:00+02:00,2025-05-25,18:01,2,0,2
8,2025-05-25T10:08:00+02:00,2025-05-25,18:08,3,0,3
28,2025-05-25T09:58:00+02:00,2025-05-25,17:58,5,9,14
28,2025-05-25T09:59:00+02:00,2025-05-25,17:59,1,5,6
28,2025-05-25T10:05:00+02:00,2025-05-25,18:05,2,41,43
29,2025-05-25T09:56:00+02:00,2025-05-25,17:56,0,6,6
29,2025-05-25T09:58:00+02:00,2025-05-25,17:58,5,2,7
29,2025-05-25T09:59:00+02:00,2025-05-25,17:59,8,0,8
29,2025-05-25T10:02:00+02:00,2025-05-25,18:02,9,5,14
29,2025-05-25T10:03:00+02:00,2025-05-25,18:03,5,6,11
29,2025-05-25T10:08:00+02:00,2025-05-25,18:08,4,10,14
31,2025-05-25T09:56:00+02:00,2025-05-25,17:56,1,1,2
31,2025-05-25T10:00:00+02:00,2025-05-25,18:00,0,7,7
31,2025-05-25T10:03:00+02:00,2025-05-25,18:03,4,3,7
31,2025-05-25T10:06:00+02:00,2025-05-25,18:06,6,6,12
31,2025-05-25T10:09:00+02:00,2025-05-25,18:09,4,0,4
36,2025-05-25T09:56:00+02:00,2025-05-25,17:56,2,4,6
36,2025-05-25T09:57:00+02:00,2025-05-25,17:57,2,2,4
36,2025-05-25T09:58:00+02:00,2025-05-25,17:58,2,0,2
36,2025-05-25T09:59:00+02:00,2025-05-25,17:59,4,2,6
36,2025-05-25T10:05:00+02:00,2025-05-25,18:05,1,1,2
36,2025-05-25T10:07:00+02:00,2025-05-25,18:07,0,2,2
39,2025-05-25T09:56:00+02:00,2025-05-25,17:56,0,1,1
39,2025-05-25T10:09:00+02:00,2025-05-25,18:09,0,1,1
40,2025-05-25T09:55:00+02:00,2025-05-25,17:55,1,0,1
40,2025-05-25T10:00:00+02:00,2025-05-25,18:00,2,0,2
40,2025-05-25T10:04:00+02:00,2025-05-25,18:04,1,1,2
41,2025-05-25T10:01:00+02:00,2025-05-25,18:01,1,3,4
41,2025-05-25T10:02:00+02:00,2025-05-25,18:02,1,12,13
41,2025-05-25T10:06:00+02:00,2025-05-25,18:06,7,4,11
43,2025-05-25T10:00:00+02:00,2025-05-25,18:00,6,4,10
44,2025-05-25T10:00:00+02:00,2025-05-25,18:00,3,0,3
44,2025-05-25T10:05:00+02:00,2025-05-25,18:05,1,9,10
45,2025-05-25T09:55:00+02:00,2025-05-25,17:55,20,23,43
45,2025-05-25T09:56:00+02:00,2025-05-25,17:56,7,18,25
45,2025-05-25T10:03:00+02:00,2025-05-25,18:03,11,9,20
45,2025-05-25T10:08:00+02:00,2025-05-25,18:08,9,20,29
47,2025-05-25T10:02:00+02:00,2025-05-25,18:02,15,14,29
47,2025-05-25T10:04:00+02:00,2025-05-25,18:04,20,14,34
47,2025-05-25T10:07:00+02:00,2025-05-25,18:07,8,21,29
50,2025-05-25T09:56:00+02:00,2025-05-25,17:56,4,3,7
50,2025-05-25T09:58:00+02:00,2025-05-25,17:58,0,2,2
50,2025-05-25T10:00:00+02:00,2025-05-25,18:00,2,5,7
50,2025-05-25T10:03:00+02:00,2025-05-25,18:03,7,2,9
50,2025-05-25T10:08:00+02:00,2025-05-25,18:08,1,3,4
50,2025-05-25T10:09:00+02:00,2025-05-25,18:09,0,4,4
54,2025-05-25T09:57:00+02:00,2025-05-25,17:57,10,1,11
54,2025-05-25T10:00:00+02:00,2025-05-25,18:00,4,2,6
54,2025-05-25T10:08:00+02:00,2025-05-25,18:08,1,2,3
54,2025-05-25T10:09:00+02:00,2025-05-25,18:09,4,0,4
59,2025-05-25T10:05:00+02:00,2025-05-25,18:05,26,26,52
61,2025-05-25T09:55:00+02:00,2025-05-25,17:55,12,4,16
61,2025-05-25T09:58:00+02:00,2025-05-25,17:58,6,4,10
61,2025-05-25T10:00:00+02:00,2025-05-25,18:00,4,4,8
61,2025-05-25T10:02:00+02:00,2025-05-25,18:02,6,4,10
61,2025-05-25T10:05:00+02:00,2025-05-25,18:05,13,3,16
61,2025-05-25T10:06:00+02:00,2025-05-25,18:06,4,7,11
61,2025-05-25T10:08:00+02:00,2025-05-25,18:08,3,0,3
61,2025-05-25T10:09:00+02:00,2025-05-25,18:09,6,3,9
66,2025-05-25T10:01:00+02:00,2025-05-25,18:01,11,23,34
66,2025-05-25T10:03:00+02:00,2025-05-25,18:03,19,14,33
66,2025-05-25T10:04:00+02:00,2025-05-25,18:04,10,25,35
66,2025-05-25T10:05:00+02:00,2025-05-25,18:05,15,32,47
69,2025-05-25T09:57:00+02:00,2025-05-25,17:57,2,0,2
69,2025-05-25T10:05:00+02:00,2025-05-25,18:05,3,1,4
70,2025-05-25T09:56:00+02:00,2025-05-25,17:56,3,7,10
70,2025-05-25T09:57:00+02:00,2025-05-25,17:57,3,4,7
70,2025-05-25T09:59:00+02:00,2025-05-25,17:59,1,1,2
70,2025-05-25T10:00:00+02:00,2025-05-25,18:00,3,5,8
70,2025-05-25T10:01:00+02:00,2025-05-25,18:01,2,4,6
70,2025-05-25T10:02:00+02:00,2025-05-25,18:02,3,7,10
70,2025-05-25T10:03:00+02:00,2025-05-25,18:03,5,0,5
70,2025-05-25T10:05:00+02:00,2025-05-25,18:05,3,9,12
70,2025-05-25T10:06:00+02:00,2025-05-25,18:06,5,2,7
70,2025-05-25T10:08:00+02:00,2025-05-25,18:08,3,3,6
75,2025-05-25T09:57:00+02:00,2025-05-25,17:57,0,1,1
75,2025-05-25T09:58:00+02:00,2025-05-25,17:58,6,0,6
75,2025-05-25T10:00:00+02:00,2025-05-25,18:00,7,0,7
75,2025-05-25T10:03:00+02:00,2025-05-25,18:03,0,2,2
75,2025-05-25T10:06:00+02:00,2025-05-25,18:06,3,0,3
77,2025-05-25T10:00:00+02:00,2025-05-25,18:00,5,10,15
78,2025-05-25T10:03:00+02:00,2025-05-25,18:03,0,2,2
87,2025-05-25T09:58:00+02:00,2025-05-25,17:58,4,2,6
87,2025-05-25T10:01:00+02:00,2025-05-25,18:01,0,3,3
87,2025-05-25T10:02:00+02:00,2025-05-25,18:02,1,4,5
87,2025-05-25T10:07:00+02:00,2025-05-25,18:07,2,0,2
87,2025-05-25T10:08:00+02:00,2025-05-25,18:08,4,1,5
87,2025-05-25T10:09:00+02:00,2025-05-25,18:09,3,0,3
107,2025-05-25T10:00:00+02:00,2025-05-25,18:00,2,0,2
108,2025-05-25T09:59:00+02:00,2025-05-25,17:59,3,3,6
108,2025-05-25T10:01:00+02:00,2025-05-25,18:01,4,1,5
108,2025-05-25T10:06:00+02:00,2025-05-25,18:06,1,2,3
108,2025-05-25T10:07:00+02:00,2025-05-25,18:07,0,1,1
131,2025-05-25T09:55:00+02:00,2025-05-25,17:55,1,4,5
134,2025-05-25T10:00:00+02:00,2025-05-25,18:00,31,32,63
134,2025-05-25T10:05:00+02:00,2025-05-25,18:05,53,31,84
135,2025-05-25T09:55:00+02:00,2025-05-25,17:55,8,39,47
135,2025-05-25T10:05:00+02:00,2025-05-25,18:05,25,35,60
162,2025-05-25T09:55:00+02:00,2025-05-25,17:55,18,21,39
165,2025-05-25T09:55:00+02:00,2025-05-25,17:55,2,0,2
166,2025-05-25T10:05:00+02:00,2025-05-25,18:05,3,2,5
167,2025-05-25T10:00:00+02:00,2025-05-25,18:00,1,4,5
167,2025-05-25T10:05:00+02:00,2025-05-25,18:05,3,2,5
1,2025-05-25T09:56:00+02:00,2025-05-25,17:56,17,11,28
1,2025-05-25T09:57:00+02:00,2025-05-25,17:57,28,11,39
1,2025-05-25T09:58:00+02:00,2025-05-25,17:58,20,17,37
1,2025-05-25T09:59:00+02:00,2025-05-25,17:59,9,17,26
1,2025-05-25T10:00:00+02:00,2025-05-25,18:00,6,18,24
1,2025-05-25T10:02:00+02:00,2025-05-25,18:02,11,8,19
1,2025-05-25T10:05:00+02:00,2025-05-25,18:05,13,16,29
1,2025-05-25T10:07:00+02:00,2025-05-25,18:07,3,10,13
2,2025-05-25T09:55:00+02:00,2025-05-25,17:55,6,2,8
2,2025-05-25T09:57:00+02:00,2025-05-25,17:57,14,9,23
2,2025-05-25T09:58:00+02:00,2025-05-25,17:58,6,9,15
2,2025-05-25T09:59:00+02:00,2025-05-25,17:59,2,2,4
2,2025-05-25T10:00:00+02:00,2025-05-25,18:00,5,7,12
2,2025-05-25T10:03:00+02:00,2025-05-25,18:03,6,2,8
2,2025-05-25T10:05:00+02:00,2025-05-25,18:05,4,3,7
2,2025-05-25T10:06:00+02:00,2025-05-25,18:06,5,3,8
2,2025-05-25T10:07:00+02:00,2025-05-25,18:07,4,0,4
2,2025-05-25T10:09:00+02:00,2025-05-25,18:09,12,2,14
9,2025-05-25T10:02:00+02:00,2025-05-25,18:02,1,1,2
10,2025-05-25T10:02:00+02:00,2025-05-25,18:02,1,0,1
10,2025-05-25T10:06:00+02:00,2025-05-25,18:06,1,0,1
11,2025-05-25T09:55:00+02:00,2025-05-25,17:55,8,4,12
12,2025-05-25T09:55:00+02:00,2025-05-25,17:55,3,3,6
12,2025-05-25T09:56:00+02:00,2025-05-25,17:56,3,3,6
12,2025-05-25T09:57:00+02:00,2025-05-25,17:57,11,2,13
12,2025-05-25T09:58:00+02:00,2025-05-25,17:58,4,9,13
12,2025-05-25T09:59:00+02:00,2025-05-25,17:59,1,4,5
12,2025-05-25T10:00:00+02:00,2025-05-25,18:00,7,2,9
12,2025-05-25T10:03:00+02:00,2025-05-25,18:03,15,3,18
12,2025-05-25T10:06:00+02:00,2025-05-25,18:06,2,1,3
17,2025-05-25T09:58:00+02:00,2025-05-25,17:58,2,0,2
17,2025-05-25T09:59:00+02:00,2025-05-25,17:59,2,0,2
17,2025-05-25T10:01:00+02:00,2025-05-25,18:01,6,1,7
17,2025-05-25T10:05:00+02:00,2025-05-25,18:05,1,1,2
17,2025-05-25T10:06:00+02:00,2025-05-25,18:06,4,6,10
18,2025-05-25T09:56:00+02:00,2025-05-25,17:56,1,0,1
19,2025-05-25T09:57:00+02:00,2025-05-25,17:57,7,5,12
19,2025-05-25T09:58:00+02:00,2025-05-25,17:58,20,6,26
19,2025-05-25T10:01:00+02:00,2025-05-25,18:01,17,1,18
19,2025-05-25T10:02:00+02:00,2025-05-25,18:02,5,4,9
20,2025-05-25T09:55:00+02:00,2025-05-25,17:55,12,12,24
20,2025-05-25T09:56:00+02:00,2025-05-25,17:56,4,11,15
20,2025-05-25T09:58:00+02:00,2025-05-25,17:58,10,9,19
20,2025-05-25T09:59:00+02:00,2025-05-25,17:59,1,9,10
20,2025-05-25T10:02:00+02:00,2025-05-25,18:02,5,5,10
20,2025-05-25T10:05:00+02:00,2025-05-25,18:05,3,5,8
23,2025-05-25T09:55:00+02:00,2025-05-25,17:55,3,1,4
23,2025-05-25T09:56:00+02:00,2025-05-25,17:56,0,2,2
23,2025-05-25T09:57:00+02:00,2025-05-25,17:57,2,2,4
23,2025-05-25T09:58:00+02:00,2025-05-25,17:58,0,8,8
23,2025-05-25T10:01:00+02:00,2025-05-25,18:01,0,6,6
23,2025-05-25T10:04:00+02:00,2025-05-25,18:04,1,6,7
23,2025-05-25T10:05:00+02:00,2025-05-25,18:05,4,3,7
23,2025-05-25T10:06:00+02:00,2025-05-25,18:06,5,3,8
23,2025-05-25T10:07:00+02:00,2025-05-25,18:07,0,7,7
23,2025-05-25T10:08:00+02:00,2025-05-25,18:08,1,1,2
24,2025-05-25T09:57:00+02:00,2025-05-25,17:57,8,7,15
24,2025-05-25T09:58:00+02:00,2025-05-25,17:58,9,12,21
24,2025-05-25T10:03:00+02:00,2025-05-25,18:03,7,22,29
24,2025-05-25T10:05:00+02:00,2025-05-25,18:05,5,11,16
25,2025-05-25T09:55:00+02:00,2025-05-25,17:55,96,50,146
27,2025-05-25T10:06:00+02:00,2025-05-25,18:06,3,4,7
30,2025-05-25T10:01:00+02:00,2025-05-25,18:01,8,5,13
30,2025-05-25T10:04:00+02:00,2025-05-25,18:04,16,1,17
30,2025-05-25T10:06:00+02:00,2025-05-25,18:06,7,9,16
30,2025-05-25T10:07:00+02:00,2025-05-25,18:07,0,9,9
30,2025-05-25T10:08:00+02:00,2025-05-25,18:08,8,1,9
35,2025-05-25T09:59:00+02:00,2025-05-25,17:59,8,17,25
35,2025-05-25T10:00:00+02:00,2025-05-25,18:00,21,19,40
35,2025-05-25T10:04:00+02:00,2025-05-25,18:04,13,13,26
46,2025-05-25T10:00:00+02:00,2025-05-25,18:00,1,0,1
48,2025-05-25T09:59:00+02:00,2025-05-25,17:59,1,0,1
48,2025-05-25T10:03:00+02:00,2025-05-25,18:03,3,4,7
48,2025-05-25T10:05:00+02:00,2025-05-25,18:05,3,2,5
48,2025-05-25T10:09:00+02:00,2025-05-25,18:09,2,1,3
49,2025-05-25T09:55:00+02:00,2025-05-25,17:55,2,1,3
49,2025-05-25T09:58:00+02:00,2025-05-25,17:58,4,1,5
49,2025-05-25T09:59:00+02:00,2025-05-25,17:59,4,2,6
49,2025-05-25T10:01:00+02:00,2025-05-25,18:01,6,2,8
49,2025-05-25T10:03:00+02:00,2025-05-25,18:03,3,4,7
49,2025-05-25T10:04:00+02:00,2025-05-25,18:04,0,5,5
49,2025-05-25T10:05:00+02:00,2025-05-25,18:05,3,8,11
49,2025-05-25T10:06:00+02:00,2025-05-25,18:06,2,5,7
51,2025-05-25T09:55:00+02:00,2025-05-25,17:55,1,0,1
51,2025-05-25T09:56:00+02:00,2025-05-25,17:56,2,1,3
51,2025-05-25T10:05:00+02:00,2025-05-25,18:05,1,3,4
51,2025-05-25T10:06:00+02:00,2025-05-25,18:06,1,1,2
51,2025-05-25T10:09:00+02:00,2025-05-25,18:09,2,3,5
52,2025-05-25T09:56:00+02:00,2025-05-25,17:56,7,2,9
52,2025-05-25T09:57:00+02:00,2025-05-25,17:57,3,9,12
52,2025-05-25T09:58:00+02:00,2025-05-25,17:58,0,5,5
53,2025-05-25T09:55:00+02:00,2025-05-25,17:55,3,4,7
53,2025-05-25T09:56:00+02:00,2025-05-25,17:56,9,3,12
53,2025-05-25T09:57:00+02:00,2025-05-25,17:57,27,1,28
53,2025-05-25T10:00:00+02:00,2025-05-25,18:00,0,3,3
53,2025-05-25T10:01:00+02:00,2025-05-25,18:01,6,6,12
53,2025-05-25T10:05:00+02:00,2025-05-25,18:05,6,1,7
53,2025-05-25T10:06:00+02:00,2025-05-25,18:06,0,1,1
53,2025-05-25T10:07:00+02:00,2025-05-25,18:07,6,2,8
53,2025-05-25T10:08:00+02:00,2025-05-25,18:08,5,3,8
56,2025-05-25T09:56:00+02:00,2025-05-25,17:56,9,16,25
56,2025-05-25T09:59:00+02:00,2025-05-25,17:59,13,9,22
56,2025-05-25T10:09:00+02:00,2025-05-25,18:09,12,9,21
58,2025-05-25T09:58:00+02:00,2025-05-25,17:58,12,1,13
58,2025-05-25T10:05:00+02:00,2025-05-25,18:05,11,5,16
58,2025-05-25T10:08:00+02:00,2025-05-25,18:08,7,7,14
62,2025-05-25T09:55:00+02:00,2025-05-25,17:55,4,2,6
62,2025-05-25T10:01:00+02:00,2025-05-25,18:01,1,5,6
62,2025-05-25T10:04:00+02:00,2025-05-25,18:04,4,7,11
62,2025-05-25T10:05:00+02:00,2025-05-25,18:05,1,5,6
63,2025-05-25T09:56:00+02:00,2025-05-25,17:56,0,4,4
67,2025-05-25T09:55:00+02:00,2025-05-25,17:55,5,9,14
67,2025-05-25T09:56:00+02:00,2025-05-25,17:56,1,1,2
67,2025-05-25T09:57:00+02:00,2025-05-25,17:57,2,2,4
67,2025-05-25T09:58:00+02:00,2025-05-25,17:58,6,7,13
67,2025-05-25T10:01:00+02:00,2025-05-25,18:01,3,5,8
67,2025-05-25T10:04:00+02:00,2025-05-25,18:04,0,18,18
67,2025-05-25T10:05:00+02:00,2025-05-25,18:05,6,9,15
67,2025-05-25T10:06:00+02:00,2025-05-25,18:06,2,6,8
67,2025-05-25T10:09:00+02:00,2025-05-25,18:09,3,13,16
68,2025-05-25T10:02:00+02:00,2025-05-25,18:02,3,2,5
68,2025-05-25T10:03:00+02:00,2025-05-25,18:03,1,0,1
68,2025-05-25T10:07:00+02:00,2025-05-25,18:07,3,2,5
72,2025-05-25T09:57:00+02:00,2025-05-25,17:57,5,5,10
72,2025-05-25T09:58:00+02:00,2025-05-25,17:58,5,5,10
72,2025-05-25T10:01:00+02:00,2025-05-25,18:01,2,5,7
72,2025-05-25T10:03:00+02:00,2025-05-25,18:03,2,4,6
72,2025-05-25T10:09:00+02:00,2025-05-25,18:09,4,4,8
76,2025-05-25T10:01:00+02:00,2025-05-25,18:01,1,0,1
79,2025-05-25T09:58:00+02:00,2025-05-25,17:58,2,11,13
79,2025-05-25T10:03:00+02:00,2025-05-25,18:03,15,5,20
79,2025-05-25T10:09:00+02:00,2025-05-25,18:09,27,5,32
85,2025-05-25T09:55:00+02:00,2025-05-25,17:55,0,2,2
85,2025-05-25T10:05:00+02:00,2025-05-25,18:05,1,0,1
85,2025-05-25T10:07:00+02:00,2025-05-25,18:07,1,2,3
86,2025-05-25T09:56:00+02:00,2025-05-25,17:56,1,1,2
86,2025-05-25T09:58:00+02:00,2025-05-25,17:58,0,2,2
86,2025-05-25T09:59:00+02:00,2025-05-25,17:59,2,1,3
86,2025-05-25T10:02:00+02:00,2025-05-25,18:02,4,0,4
86,2025-05-25T10:03:00+02:00,2025-05-25,18:03,1,1,2
86,2025-05-25T10:06:00+02:00,2025-05-25,18:06,0,1,1
109,2025-05-25T10:05:00+02:00,2025-05-25,18:05,7,11,18
117,2025-05-25T10:00:00+02:00,2025-05-25,18:00,36,26,62
117,2025-05-25T10:05:00+02:00,2025-05-25,18:05,12,26,38
130,2025-05-25T09:55:00+02:00,2025-05-25,17:55,2,0,2
136,2025-05-25T10:00:00+02:00,2025-05-25,18:00,10,28,38
139,2025-05-25T09:55:00+02:00,2025-05-25,17:55,3,0,3
139,2025-05-25T10:05:00+02:00,2025-05-25,18:05,0,9,9
141,2025-05-25T09:55:00+02:00,2025-05-25,17:55,3,9,12
141,2025-05-25T10:00:00+02:00,2025-05-25,18:00,12,10,22
142,2025-05-25T09:55:00+02:00,2025-05-25,17:55,8,6,14
142,2025-05-25T10:05:00+02:00,2025-05-25,18:05,3,5,8
161,2025-05-25T10:00:00+02:00,2025-05-25,18:00,0,1,1
164,2025-05-25T09:55:00+02:00,2025-05-25,17:55,11,16,27
164,2025-05-25T10:00:00+02:00,2025-05-25,18:00,13,4,17
3,2025-05-25T09:41:00+02:00,2025-05-25,17:41,14,25,39
3,2025-05-25T09:45:00+02:00,2025-05-25,17:45,7,18,25
3,2025-05-25T09:48:00+02:00,2025-05-25,17:48,13,21,34
3,2025-05-25T09:49:00+02:00,2025-05-25,17:49,20,20,40
3,2025-05-25T09:52:00+02:00,2025-05-25,17:52,17,18,35
3,2025-05-25T09:54:00+02:00,2025-05-25,17:54,11,11,22
4,2025-05-25T09:42:00+02:00,2025-05-25,17:42,23,18,41
4,2025-05-25T09:43:00+02:00,2025-05-25,17:43,29,12,41
4,2025-05-25T09:46:00+02:00,2025-05-25,17:46,8,45,53
4,2025-05-25T09:53:00+02:00,2025-05-25,17:53,28,16,44
5,2025-05-25T09:40:00+02:00,2025-05-25,17:40,43,59,102
6,2025-05-25T09:40:00+02:00,2025-05-25,17:40,17,9,26
6,2025-05-25T09:45:00+02:00,2025-05-25,17:45,24,11,35
6,2025-05-25T09:47:00+02:00,2025-05-25,17:47,11,8,19
8,2025-05-25T09:44:00+02:00,2025-05-25,17:44,2,0,2
8,2025-05-25T09:47:00+02:00,2025-05-25,17:47,1,0,1
8,2025-05-25T09:53:00+02:00,2025-05-25,17:53,1,0,1
28,2025-05-25T09:44:00+02:00,2025-05-25,17:44,2,9,11
28,2025-05-25T09:45:00+02:00,2025-05-25,17:45,5,11,16
28,2025-05-25T09:47:00+02:00,2025-05-25,17:47,2,11,13
28,2025-05-25T09:48:00+02:00,2025-05-25,17:48,2,3,5
28,2025-05-25T09:52:00+02:00,2025-05-25,17:52,6,5,11
28,2025-05-25T09:53:00+02:00,2025-05-25,17:53,9,6,15
28,2025-05-25T09:54:00+02:00,2025-05-25,17:54,5,7,12
29,2025-05-25T09:49:00+02:00,2025-05-25,17:49,3,7,10
29,2025-05-25T09:50:00+02:00,2025-05-25,17:50,2,4,6
31,2025-05-25T09:40:00+02:00,2025-05-25,17:40,3,2,5
31,2025-05-25T09:45:00+02:00,2025-05-25,17:45,2,8,10
31,2025-05-25T09:51:00+02:00,2025-05-25,17:51,3,3,6
31,2025-05-25T09:53:00+02:00,2025-05-25,17:53,3,0,3
31,2025-05-25T09:54:00+02:00,2025-05-25,17:54,6,1,7
36,2025-05-25T09:41:00+02:00,2025-05-25,17:41,1,4,5
36,2025-05-25T09:42:00+02:00,2025-05-25,17:42,1,0,1
36,2025-05-25T09:45:00+02:00,2025-05-25,17:45,0,1,1
36,2025-05-25T09:46:00+02:00,2025-05-25,17:46,2,3,5
36,2025-05-25T09:49:00+02:00,2025-05-25,17:49,3,1,4
36,2025-05-25T09:52:00+02:00,2025-05-25,17:52,1,0,1
36,2025-05-25T09:53:00+02:00,2025-05-25,17:53,0,3,3
40,2025-05-25T09:40:00+02:00,2025-05-25,17:40,6,4,10
40,2025-05-25T09:43:00+02:00,2025-05-25,17:43,4,3,7
40,2025-05-25T09:44:00+02:00,2025-05-25,17:44,4,2,6
40,2025-05-25T09:47:00+02:00,2025-05-25,17:47,1,5,6
40,2025-05-25T09:50:00+02:00,2025-05-25,17:50,2,5,7
40,2025-05-25T09:53:00+02:00,2025-05-25,17:53,1,4,5
41,2025-05-25T09:41:00+02:00,2025-05-25,17:41,1,0,1
41,2025-05-25T09:42:00+02:00,2025-05-25,17:42,5,4,9
41,2025-05-25T09:43:00+02:00,2025-05-25,17:43,9,3,12
41,2025-05-25T09:45:00+02:00,2025-05-25,17:45,10,14,24
41,2025-05-25T09:47:00+02:00,2025-05-25,17:47,6,5,11
41,2025-05-25T09:48:00+02:00,2025-05-25,17:48,3,2,5
43,2025-05-25T09:40:00+02:00,2025-05-25,17:40,5,6,11
44,2025-05-25T09:45:00+02:00,2025-05-25,17:45,2,5,7
44,2025-05-25T09:50:00+02:00,2025-05-25,17:50,1,1,2
45,2025-05-25T09:42:00+02:00,2025-05-25,17:42,10,14,24
45,2025-05-25T09:44:00+02:00,2025-05-25,17:44,12,22,34
45,2025-05-25T09:53:00+02:00,2025-05-25,17:53,5,10,15
47,2025-05-25T09:43:00+02:00,2025-05-25,17:43,18,18,36
47,2025-05-25T09:44:00+02:00,2025-05-25,17:44,30,21,51
47,2025-05-25T09:46:00+02:00,2025-05-25,17:46,14,24,38
47,2025-05-25T09:49:00+02:00,2025-05-25,17:49,31,19,50
47,2025-05-25T09:50:00+02:00,2025-05-25,17:50,25,14,39
47,2025-05-25T09:51:00+02:00,2025-05-25,17:51,19,8,27
50,2025-05-25T09:40:00+02:00,2025-05-25,17:40,5,6,11
50,2025-05-25T09:45:00+02:00,2025-05-25,17:45,6,0,6
50,2025-05-25T09:46:00+02:00,2025-05-25,17:46,2,5,7
50,2025-05-25T09:48:00+02:00,2025-05-25,17:48,2,2,4
50,2025-05-25T09:50:00+02:00,2025-05-25,17:50,1,4,5
50,2025-05-25T09:51:00+02:00,2025-05-25,17:51,3,7,10
54,2025-05-25T09:41:00+02:00,2025-05-25,17:41,0,2,2
54,2025-05-25T09:42:00+02:00,2025-05-25,17:42,4,1,5
54,2025-05-25T09:45:00+02:00,2025-05-25,17:45,1,6,7
54,2025-05-25T09:47:00+02:00,2025-05-25,17:47,2,6,8
54,2025-05-25T09:48:00+02:00,2025-05-25,17:48,1,5,6
54,2025-05-25T09:50:00+02:00,2025-05-25,17:50,4,2,6
61,2025-05-25T09:44:00+02:00,2025-05-25,17:44,3,7,10
61,2025-05-25T09:46:00+02:00,2025-05-25,17:46,7,1,8
61,2025-05-25T09:47:00+02:00,2025-05-25,17:47,2,3,5
61,2025-05-25T09:49:00+02:00,2025-05-25,17:49,9,4,13
61,2025-05-25T09:52:00+02:00,2025-05-25,17:52,7,1,8
66,2025-05-25T09:42:00+02:00,2025-05-25,17:42,28,8,36
66,2025-05-25T09:43:00+02:00,2025-05-25,17:43,13,32,45
66,2025-05-25T09:46:00+02:00,2025-05-25,17:46,23,19,42
66,2025-05-25T09:49:00+02:00,2025-05-25,17:49,16,41,57
66,2025-05-25T09:50:00+02:00,2025-05-25,17:50,7,18,25
66,2025-05-25T09:53:00+02:00,2025-05-25,17:53,25,15,40
66,2025-05-25T09:54:00+02:00,2025-05-25,17:54,20,36,56
69,2025-05-25T09:50:00+02:00,2025-05-25,17:50,1,2,3
69,2025-05-25T09:51:00+02:00,2025-05-25,17:51,6,1,7
69,2025-05-25T09:53:00+02:00,2025-05-25,17:53,1,5,6
70,2025-05-25T09:41:00+02:00,2025-05-25,17:41,8,5,13
70,2025-05-25T09:46:00+02:00,2025-05-25,17:46,0,1,1
70,2025-05-25T09:51:00+02:00,2025-05-25,17:51,3,4,7
75,2025-05-25T09:47:00+02:00,2025-05-25,17:47,1,0,1
75,2025-05-25T09:48:00+02:00,2025-05-25,17:48,0,2,2
75,2025-05-25T09:49:00+02:00,2025-05-25,17:49,1,0,1
75,2025-05-25T09:50:00+02:00,2025-05-25,17:50,0,1,1
75,2025-05-25T09:53:00+02:00,2025-05-25,17:53,0,2,2
77,2025-05-25T09:45:00+02:00,2025-05-25,17:45,17,8,25
87,2025-05-25T09:42:00+02:00,2025-05-25,17:42,4,1,5
87,2025-05-25T09:45:00+02:00,2025-05-25,17:45,0,4,4
87,2025-05-25T09:47:00+02:00,2025-05-25,17:47,2,5,7
87,2025-05-25T09:48:00+02:00,2025-05-25,17:48,3,2,5
87,2025-05-25T09:54:00+02:00,2025-05-25,17:54,1,1,2
107,2025-05-25T09:40:00+02:00,2025-05-25,17:40,3,6,9
107,2025-05-25T09:45:00+02:00,2025-05-25,17:45,1,11,12
107,2025-05-25T09:50:00+02:00,2025-05-25,17:50,3,6,9
108,2025-05-25T09:40:00+02:00,2025-05-25,17:40,2,0,2
108,2025-05-25T09:48:00+02:00,2025-05-25,17:48,7,3,10
118,2025-05-25T09:50:00+02:00,2025-05-25,17:50,3,4,7
131,2025-05-25T09:50:00+02:00,2025-05-25,17:50,7,5,12
132,2025-05-25T09:40:00+02:00,2025-05-25,17:40,10,8,18
132,2025-05-25T09:45:00+02:00,2025-05-25,17:45,10,5,15
132,2025-05-25T09:50:00+02:00,2025-05-25,17:50,8,22,30
133,2025-05-25T09:45:00+02:00,2025-05-25,17:45,53,28,81
133,2025-05-25T09:50:00+02:00,2025-05-25,17:50,40,43,83
134,2025-05-25T09:40:00+02:00,2025-05-25,17:40,34,24,58
134,2025-05-25T09:45:00+02:00,2025-05-25,17:45,31,26,57
134,2025-05-25T09:50:00+02:00,2025-05-25,17:50,29,21,50
162,2025-05-25T09:45:00+02:00,2025-05-25,17:45,20,16,36
165,2025-05-25T09:40:00+02:00,2025-05-25,17:40,2,1,3
165,2025-05-25T09:45:00+02:00,2025-05-25,17:45,2,2,4
166,2025-05-25T09:40:00+02:00,2025-05-25,17:40,0,8,8
167,2025-05-25T09:45:00+02:00,2025-05-25,17:45,5,5,10
167,2025-05-25T09:50:00+02:00,2025-05-25,17:50,1,1,2
179,2025-05-25T09:50:00+02:00,2025-05-25,17:50,7,3,10
1,2025-05-25T09:40:00+02:00,2025-05-25,17:40,15,14,29
1,2025-05-25T09:42:00+02:00,2025-05-25,17:42,13,10,23
1,2025-05-25T09:48:00+02:00,2025-05-25,17:48,10,11,21
1,2025-05-25T09:51:00+02:00,2025-05-25,17:51,19,12,31
1,2025-05-25T09:54:00+02:00,2025-05-25,17:54,6,13,19
2,2025-05-25T09:40:00+02:00,2025-05-25,17:40,4,0,4
2,2025-05-25T09:43:00+02:00,2025-05-25,17:43,10,3,13
2,2025-05-25T09:44:00+02:00,2025-05-25,17:44,1,9,10
2,2025-05-25T09:48:00+02:00,2025-05-25,17:48,3,12,15
2,2025-05-25T09:50:00+02:00,2025-05-25,17:50,4,1,5
2,2025-05-25T09:52:00+02:00,2025-05-25,17:52,1,10,11
2,2025-05-25T09:53:00+02:00,2025-05-25,17:53,6,14,20
9,2025-05-25T09:44:00+02:00,2025-05-25,17:44,0,1,1
9,2025-05-25T09:47:00+02:00,2025-05-25,17:47,0,2,2
9,2025-05-25T09:49:00+02:00,2025-05-25,17:49,0,1,1
9,2025-05-25T09:51:00+02:00,2025-05-25,17:51,4,1,5
10,2025-05-25T09:41:00+02:00,2025-05-25,17:41,3,1,4
10,2025-05-25T09:44:00+02:00,2025-05-25,17:44,2,1,3
10,2025-05-25T09:53:00+02:00,2025-05-25,17:53,2,0,2
12,2025-05-25T09:41:00+02:00,2025-05-25,17:41,3,0,3
12,2025-05-25T09:45:00+02:00,2025-05-25,17:45,1,7,8
12,2025-05-25T09:46:00+02:00,2025-05-25,17:46,1,5,6
12,2025-05-25T09:47:00+02:00,2025-05-25,17:47,1,0,1
12,2025-05-25T09:48:00+02:00,2025-05-25,17:48,4,1,5
12,2025-05-25T09:49:00+02:00,2025-05-25,17:49,0,4,4
12,2025-05-25T09:50:00+02:00,2025-05-25,17:50,2,3,5
12,2025-05-25T09:54:00+02:00,2025-05-25,17:54,7,7,14
17,2025-05-25T09:41:00+02:00,2025-05-25,17:41,2,1,3
17,2025-05-25T09:42:00+02:00,2025-05-25,17:42,3,3,6
17,2025-05-25T09:44:00+02:00,2025-05-25,17:44,5,0,5
17,2025-05-25T09:45:00+02:00,2025-05-25,17:45,6,1,7
17,2025-05-25T09:51:00+02:00,2025-05-25,17:51,5,0,5
18,2025-05-25T09:45:00+02:00,2025-05-25,17:45,0,3,3
18,2025-05-25T09:53:00+02:00,2025-05-25,17:53,0,2,2
19,2025-05-25T09:43:00+02:00,2025-05-25,17:43,11,5,16
19,2025-05-25T09:45:00+02:00,2025-05-25,17:45,4,8,12
19,2025-05-25T09:46:00+02:00,2025-05-25,17:46,8,7,15
19,2025-05-25T09:48:00+02:00,2025-05-25,17:48,5,18,23
20,2025-05-25T09:47:00+02:00,2025-05-25,17:47,1,19,20
20,2025-05-25T09:52:00+02:00,2025-05-25,17:52,14,13,27
23,2025-05-25T09:40:00+02:00,2025-05-25,17:40,1,2,3
23,2025-05-25T09:42:00+02:00,2025-05-25,17:42,2,3,5
23,2025-05-25T09:45:00+02:00,2025-05-25,17:45,0,2,2
23,2025-05-25T09:46:00+02:00,2025-05-25,17:46,3,3,6
23,2025-05-25T09:51:00+02:00,2025-05-25,17:51,8,3,11
23,2025-05-25T09:52:00+02:00,2025-05-25,17:52,0,2,2
24,2025-05-25T09:42:00+02:00,2025-05-25,17:42,7,6,13
24,2025-05-25T09:43:00+02:00,2025-05-25,17:43,13,20,33
24,2025-05-25T09:45:00+02:00,2025-05-25,17:45,18,2,20
24,2025-05-25T09:48:00+02:00,2025-05-25,17:48,9,3,12
24,2025-05-25T09:52:00+02:00,2025-05-25,17:52,8,6,14
24,2025-05-25T09:54:00+02:00,2025-05-25,17:54,15,20,35
25,2025-05-25T09:45:00+02:00,2025-05-25,17:45,85,31,116
27,2025-05-25T09:40:00+02:00,2025-05-25,17:40,1,1,2
27,2025-05-25T09:42:00+02:00,2025-05-25,17:42,2,3,5
27,2025-05-25T09:45:00+02:00,2025-05-25,17:45,1,0,1
27,2025-05-25T09:48:00+02:00,2025-05-25,17:48,2,0,2
30,2025-05-25T09:40:00+02:00,2025-05-25,17:40,15,0,15
30,2025-05-25T09:43:00+02:00,2025-05-25,17:43,2,10,12
30,2025-05-25T09:44:00+02:00,2025-05-25,17:44,4,7,11
30,2025-05-25T09:48:00+02:00,2025-05-25,17:48,4,6,10
30,2025-05-25T09:49:00+02:00,2025-05-25,17:49,2,6,8
35,2025-05-25T09:40:00+02:00,2025-05-25,17:40,10,13,23
35,2025-05-25T09:41:00+02:00,2025-05-25,17:41,16,11,27
35,2025-05-25T09:44:00+02:00,2025-05-25,17:44,6,17,23
35,2025-05-25T09:46:00+02:00,2025-05-25,17:46,18,20,38
35,2025-05-25T09:47:00+02:00,2025-05-25,17:47,8,19,27
35,2025-05-25T09:49:00+02:00,2025-05-25,17:49,8,24,32
35,2025-05-25T09:50:00+02:00,2025-05-25,17:50,7,23,30
48,2025-05-25T09:42:00+02:00,2025-05-25,17:42,1,1,2
48,2025-05-25T09:45:00+02:00,2025-05-25,17:45,1,1,2
48,2025-05-25T09:53:00+02:00,2025-05-25,17:53,0,1,1
48,2025-05-25T09:54:00+02:00,2025-05-25,17:54,2,4,6
49,2025-05-25T09:43:00+02:00,2025-05-25,17:43,7,3,10
49,2025-05-25T09:46:00+02:00,2025-05-25,17:46,0,2,2
49,2025-05-25T09:48:00+02:00,2025-05-25,17:48,2,3,5
49,2025-05-25T09:51:00+02:00,2025-05-25,17:51,2,1,3
49,2025-05-25T09:52:00+02:00,2025-05-25,17:52,3,12,15
49,2025-05-25T09:54:00+02:00,2025-05-25,17:54,5,5,10
51,2025-05-25T09:44:00+02:00,2025-05-25,17:44,0,1,1
51,2025-05-25T09:45:00+02:00,2025-05-25,17:45,1,1,2
51,2025-05-25T09:47:00+02:00,2025-05-25,17:47,3,0,3
51,2025-05-25T09:49:00+02:00,2025-05-25,17:49,1,0,1
51,2025-05-25T09:50:00+02:00,2025-05-25,17:50,1,3,4
51,2025-05-25T09:51:00+02:00,2025-05-25,17:51,3,4,7
52,2025-05-25T09:41:00+02:00,2025-05-25,17:41,5,9,14
52,2025-05-25T09:44:00+02:00,2025-05-25,17:44,2,8,10
52,2025-05-25T09:48:00+02:00,2025-05-25,17:48,4,3,7
52,2025-05-25T09:49:00+02:00,2025-05-25,17:49,4,4,8
52,2025-05-25T09:50:00+02:00,2025-05-25,17:50,5,2,7
53,2025-05-25T09:43:00+02:00,2025-05-25,17:43,3,3,6
53,2025-05-25T09:46:00+02:00,2025-05-25,17:46,6,2,8
53,2025-05-25T09:48:00+02:00,2025-05-25,17:48,6,1,7
53,2025-05-25T09:50:00+02:00,2025-05-25,17:50,12,6,18
53,2025-05-25T09:52:00+02:00,2025-05-25,17:52,2,2,4
56,2025-05-25T09:42:00+02:00,2025-05-25,17:42,2,12,14
56,2025-05-25T09:45:00+02:00,2025-05-25,17:45,7,10,17
56,2025-05-25T09:48:00+02:00,2025-05-25,17:48,8,16,24
56,2025-05-25T09:51:00+02:00,2025-05-25,17:51,12,5,17
56,2025-05-25T09:52:00+02:00,2025-05-25,17:52,13,1,14
58,2025-05-25T09:45:00+02:00,2025-05-25,17:45,6,0,6
58,2025-05-25T09:51:00+02:00,2025-05-25,17:51,5,4,9
58,2025-05-25T09:52:00+02:00,2025-05-25,17:52,7,2,9
62,2025-05-25T09:40:00+02:00,2025-05-25,17:40,1,5,6
62,2025-05-25T09:41:00+02:00,2025-05-25,17:41,0,1,1
62,2025-05-25T09:43:00+02:00,2025-05-25,17:43,4,6,10
62,2025-05-25T09:45:00+02:00,2025-05-25,17:45,3,5,8
62,2025-05-25T09:52:00+02:00,2025-05-25,17:52,3,3,6
63,2025-05-25T09:45:00+02:00,2025-05-25,17:45,0,7,7
63,2025-05-25T09:46:00+02:00,2025-05-25,17:46,2,11,13
63,2025-05-25T09:47:00+02:00,2025-05-25,17:47,0,4,4
63,2025-05-25T09:48:00+02:00,2025-05-25,17:48,5,3,8
63,2025-05-25T09:51:00+02:00,2025-05-25,17:51,6,4,10
67,2025-05-25T09:42:00+02:00,2025-05-25,17:42,1,3,4
67,2025-05-25T09:50:00+02:00,2025-05-25,17:50,9,7,16
68,2025-05-25T09:41:00+02:00,2025-05-25,17:41,4,3,7
68,2025-05-25T09:46:00+02:00,2025-05-25,17:46,1,1,2
68,2025-05-25T09:48:00+02:00,2025-05-25,17:48,3,1,4
68,2025-05-25T09:49:00+02:00,2025-05-25,17:49,1,2,3
72,2025-05-25T09:45:00+02:00,2025-05-25,17:45,2,11,13
72,2025-05-25T09:46:00+02:00,2025-05-25,17:46,2,4,6
72,2025-05-25T09:49:00+02:00,2025-05-25,17:49,11,3,14
72,2025-05-25T09:53:00+02:00,2025-05-25,17:53,9,12,21
76,2025-05-25T09:41:00+02:00,2025-05-25,17:41,3,0,3
76,2025-05-25T09:54:00+02:00,2025-05-25,17:54,1,0,1
79,2025-05-25T09:40:00+02:00,2025-05-25,17:40,12,3,15
79,2025-05-25T09:42:00+02:00,2025-05-25,17:42,17,11,28
85,2025-05-25T09:41:00+02:00,2025-05-25,17:41,0,1,1
85,2025-05-25T09:47:00+02:00,2025-05-25,17:47,0,1,1
85,2025-05-25T09:49:00+02:00,2025-05-25,17:49,0,3,3
85,2025-05-25T09:51:00+02:00,2025-05-25,17:51,1,0,1
86,2025-05-25T09:43:00+02:00,2025-05-25,17:43,0,1,1
86,2025-05-25T09:44:00+02:00,2025-05-25,17:44,1,0,1
86,2025-05-25T09:46:00+02:00,2025-05-25,17:46,0,1,1
86,2025-05-25T09:52:00+02:00,2025-05-25,17:52,2,0,2
109,2025-05-25T09:40:00+02:00,2025-05-25,17:40,12,6,18
117,2025-05-25T09:50:00+02:00,2025-05-25,17:50,26,27,53
137,2025-05-25T09:40:00+02:00,2025-05-25,17:40,0,1,1
139,2025-05-25T09:40:00+02:00,2025-05-25,17:40,2,0,2
141,2025-05-25T09:45:00+02:00,2025-05-25,17:45,8,3,11
142,2025-05-25T09:40:00+02:00,2025-05-25,17:40,12,17,29
142,2025-05-25T09:45:00+02:00,2025-05-25,17:45,12,2,14
142,2025-05-25T09:50:00+02:00,2025-05-25,17:50,4,2,6
161,2025-05-25T09:45:00+02:00,2025-05-25,17:45,0,1,1
164,2025-05-25T09:45:00+02:00,2025-05-25,17:45,9,5,14
181,2025-05-25T09:59:00+02:00,2025-05-25,17:59,16,12,28
181,2025-05-25T10:04:00+02:00,2025-05-25,18:04,14,18,32
181,2025-05-25T10:05:00+02:00,2025-05-25,18:05,11,15,26
3,2025-05-25T12:40:00+02:00,2025-05-25,20:40,15,12,27
3,2025-05-25T12:41:00+02:00,2025-05-25,20:41,7,8,15
3,2025-05-25T12:43:00+02:00,2025-05-25,20:43,13,9,22
3,2025-05-25T12:44:00+02:00,2025-05-25,20:44,3,2,5
3,2025-05-25T12:45:00+02:00,2025-05-25,20:45,22,10,32
3,2025-05-25T12:46:00+02:00,2025-05-25,20:46,3,6,9
3,2025-05-25T12:47:00+02:00,2025-05-25,20:47,6,9,15
3,2025-05-25T12:50:00+02:00,2025-05-25,20:50,8,12,20
3,2025-05-25T12:54:00+02:00,2025-05-25,20:54,8,6,14
4,2025-05-25T12:41:00+02:00,2025-05-25,20:41,14,6,20
4,2025-05-25T12:43:00+02:00,2025-05-25,20:43,3,5,8
4,2025-05-25T12:44:00+02:00,2025-05-25,20:44,6,3,9
4,2025-05-25T12:49:00+02:00,2025-05-25,20:49,6,14,20
4,2025-05-25T12:52:00+02:00,2025-05-25,20:52,15,18,33
5,2025-05-25T12:40:00+02:00,2025-05-25,20:40,13,22,35
5,2025-05-25T12:45:00+02:00,2025-05-25,20:45,13,20,33
6,2025-05-25T12:42:00+02:00,2025-05-25,20:42,5,9,14
6,2025-05-25T12:48:00+02:00,2025-05-25,20:48,4,19,23
6,2025-05-25T12:52:00+02:00,2025-05-25,20:52,2,6,8
8,2025-05-25T12:42:00+02:00,2025-05-25,20:42,1,0,1
8,2025-05-25T12:51:00+02:00,2025-05-25,20:51,0,1,1
21,2025-05-25T12:40:00+02:00,2025-05-25,20:40,12,18,30
28,2025-05-25T12:41:00+02:00,2025-05-25,20:41,8,4,12
28,2025-05-25T12:44:00+02:00,2025-05-25,20:44,2,0,2
28,2025-05-25T12:45:00+02:00,2025-05-25,20:45,3,2,5
28,2025-05-25T12:48:00+02:00,2025-05-25,20:48,2,1,3
28,2025-05-25T12:49:00+02:00,2025-05-25,20:49,1,0,1
28,2025-05-25T12:50:00+02:00,2025-05-25,20:50,3,3,6
28,2025-05-25T12:52:00+02:00,2025-05-25,20:52,3,3,6
29,2025-05-25T12:41:00+02:00,2025-05-25,20:41,2,5,7
29,2025-05-25T12:42:00+02:00,2025-05-25,20:42,0,2,2
29,2025-05-25T12:44:00+02:00,2025-05-25,20:44,1,3,4
29,2025-05-25T12:47:00+02:00,2025-05-25,20:47,0,3,3
29,2025-05-25T12:49:00+02:00,2025-05-25,20:49,4,4,8
31,2025-05-25T12:42:00+02:00,2025-05-25,20:42,1,8,9
31,2025-05-25T12:43:00+02:00,2025-05-25,20:43,0,6,6
31,2025-05-25T12:46:00+02:00,2025-05-25,20:46,3,0,3
31,2025-05-25T12:47:00+02:00,2025-05-25,20:47,2,10,12
31,2025-05-25T12:52:00+02:00,2025-05-25,20:52,0,3,3
31,2025-05-25T12:53:00+02:00,2025-05-25,20:53,3,6,9
36,2025-05-25T12:40:00+02:00,2025-05-25,20:40,0,2,2
36,2025-05-25T12:43:00+02:00,2025-05-25,20:43,1,0,1
36,2025-05-25T12:44:00+02:00,2025-05-25,20:44,1,6,7
36,2025-05-25T12:51:00+02:00,2025-05-25,20:51,0,1,1
39,2025-05-25T12:42:00+02:00,2025-05-25,20:42,1,0,1
40,2025-05-25T12:42:00+02:00,2025-05-25,20:42,1,0,1
40,2025-05-25T12:48:00+02:00,2025-05-25,20:48,0,1,1
40,2025-05-25T12:52:00+02:00,2025-05-25,20:52,1,0,1
41,2025-05-25T12:44:00+02:00,2025-05-25,20:44,0,1,1
41,2025-05-25T12:46:00+02:00,2025-05-25,20:46,0,3,3
41,2025-05-25T12:49:00+02:00,2025-05-25,20:49,2,0,2
41,2025-05-25T12:51:00+02:00,2025-05-25,20:51,1,1,2
41,2025-05-25T12:54:00+02:00,2025-05-25,20:54,0,3,3
43,2025-05-25T12:40:00+02:00,2025-05-25,20:40,3,0,3
44,2025-05-25T12:40:00+02:00,2025-05-25,20:40,2,1,3
44,2025-05-25T12:50:00+02:00,2025-05-25,20:50,1,0,1
45,2025-05-25T12:40:00+02:00,2025-05-25,20:40,7,14,21
45,2025-05-25T12:44:00+02:00,2025-05-25,20:44,10,1,11
45,2025-05-25T12:45:00+02:00,2025-05-25,20:45,6,10,16
45,2025-05-25T12:48:00+02:00,2025-05-25,20:48,7,14,21
45,2025-05-25T12:52:00+02:00,2025-05-25,20:52,3,6,9
45,2025-05-25T12:54:00+02:00,2025-05-25,20:54,3,8,11
47,2025-05-25T12:43:00+02:00,2025-05-25,20:43,11,10,21
47,2025-05-25T12:45:00+02:00,2025-05-25,20:45,9,7,16
47,2025-05-25T12:46:00+02:00,2025-05-25,20:46,8,13,21
47,2025-05-25T12:48:00+02:00,2025-05-25,20:48,10,8,18
50,2025-05-25T12:41:00+02:00,2025-05-25,20:41,2,1,3
50,2025-05-25T12:49:00+02:00,2025-05-25,20:49,5,8,13
50,2025-05-25T12:50:00+02:00,2025-05-25,20:50,1,1,2
54,2025-05-25T12:42:00+02:00,2025-05-25,20:42,0,1,1
54,2025-05-25T12:44:00+02:00,2025-05-25,20:44,0,1,1
54,2025-05-25T12:45:00+02:00,2025-05-25,20:45,1,3,4
54,2025-05-25T12:49:00+02:00,2025-05-25,20:49,0,3,3
54,2025-05-25T12:52:00+02:00,2025-05-25,20:52,2,3,5
59,2025-05-25T12:45:00+02:00,2025-05-25,20:45,18,14,32
61,2025-05-25T12:40:00+02:00,2025-05-25,20:40,19,1,20
61,2025-05-25T12:43:00+02:00,2025-05-25,20:43,7,1,8
61,2025-05-25T12:44:00+02:00,2025-05-25,20:44,4,0,4
61,2025-05-25T12:45:00+02:00,2025-05-25,20:45,5,5,10
61,2025-05-25T12:48:00+02:00,2025-05-25,20:48,3,0,3
61,2025-05-25T12:50:00+02:00,2025-05-25,20:50,7,3,10
61,2025-05-25T12:51:00+02:00,2025-05-25,20:51,1,0,1
66,2025-05-25T12:40:00+02:00,2025-05-25,20:40,22,3,25
66,2025-05-25T12:41:00+02:00,2025-05-25,20:41,21,8,29
66,2025-05-25T12:42:00+02:00,2025-05-25,20:42,7,12,19
66,2025-05-25T12:44:00+02:00,2025-05-25,20:44,16,4,20
66,2025-05-25T12:45:00+02:00,2025-05-25,20:45,14,2,16
66,2025-05-25T12:46:00+02:00,2025-05-25,20:46,11,8,19
66,2025-05-25T12:48:00+02:00,2025-05-25,20:48,19,18,37
66,2025-05-25T12:49:00+02:00,2025-05-25,20:49,19,7,26
66,2025-05-25T12:54:00+02:00,2025-05-25,20:54,21,19,40
69,2025-05-25T12:53:00+02:00,2025-05-25,20:53,1,0,1
70,2025-05-25T12:42:00+02:00,2025-05-25,20:42,0,1,1
70,2025-05-25T12:43:00+02:00,2025-05-25,20:43,2,3,5
70,2025-05-25T12:44:00+02:00,2025-05-25,20:44,2,0,2
70,2025-05-25T12:53:00+02:00,2025-05-25,20:53,7,0,7
78,2025-05-25T12:48:00+02:00,2025-05-25,20:48,2,0,2
84,2025-05-25T12:45:00+02:00,2025-05-25,20:45,40,52,92
87,2025-05-25T12:44:00+02:00,2025-05-25,20:44,2,0,2
107,2025-05-25T12:40:00+02:00,2025-05-25,20:40,1,3,4
108,2025-05-25T12:47:00+02:00,2025-05-25,20:47,1,0,1
108,2025-05-25T12:49:00+02:00,2025-05-25,20:49,1,0,1
118,2025-05-25T12:50:00+02:00,2025-05-25,20:50,1,0,1
132,2025-05-25T12:50:00+02:00,2025-05-25,20:50,8,7,15
133,2025-05-25T12:45:00+02:00,2025-05-25,20:45,32,20,52
134,2025-05-25T12:45:00+02:00,2025-05-25,20:45,12,12,24
134,2025-05-25T12:50:00+02:00,2025-05-25,20:50,16,8,24
162,2025-05-25T12:40:00+02:00,2025-05-25,20:40,3,4,7
179,2025-05-25T12:40:00+02:00,2025-05-25,20:40,3,3,6
1,2025-05-25T12:41:00+02:00,2025-05-25,20:41,2,5,7
1,2025-05-25T12:45:00+02:00,2025-05-25,20:45,2,4,6
1,2025-05-25T12:47:00+02:00,2025-05-25,20:47,2,3,5
1,2025-05-25T12:48:00+02:00,2025-05-25,20:48,5,4,9
1,2025-05-25T12:50:00+02:00,2025-05-25,20:50,3,0,3
1,2025-05-25T12:51:00+02:00,2025-05-25,20:51,0,3,3
1,2025-05-25T12:53:00+02:00,2025-05-25,20:53,4,3,7
2,2025-05-25T12:40:00+02:00,2025-05-25,20:40,2,6,8
2,2025-05-25T12:42:00+02:00,2025-05-25,20:42,0,1,1
2,2025-05-25T12:43:00+02:00,2025-05-25,20:43,3,2,5
2,2025-05-25T12:46:00+02:00,2025-05-25,20:46,2,3,5
2,2025-05-25T12:47:00+02:00,2025-05-25,20:47,1,0,1
2,2025-05-25T12:48:00+02:00,2025-05-25,20:48,4,3,7
2,2025-05-25T12:53:00+02:00,2025-05-25,20:53,0,2,2
9,2025-05-25T12:44:00+02:00,2025-05-25,20:44,4,0,4
9,2025-05-25T12:46:00+02:00,2025-05-25,20:46,1,6,7
9,2025-05-25T12:51:00+02:00,2025-05-25,20:51,0,1,1
11,2025-05-25T12:40:00+02:00,2025-05-25,20:40,0,3,3
12,2025-05-25T12:41:00+02:00,2025-05-25,20:41,4,5,9
12,2025-05-25T12:45:00+02:00,2025-05-25,20:45,3,1,4
12,2025-05-25T12:46:00+02:00,2025-05-25,20:46,6,4,10
12,2025-05-25T12:48:00+02:00,2025-05-25,20:48,2,1,3
12,2025-05-25T12:50:00+02:00,2025-05-25,20:50,4,4,8
17,2025-05-25T12:49:00+02:00,2025-05-25,20:49,0,3,3
17,2025-05-25T12:53:00+02:00,2025-05-25,20:53,1,0,1
17,2025-05-25T12:54:00+02:00,2025-05-25,20:54,2,1,3
18,2025-05-25T12:51:00+02:00,2025-05-25,20:51,0,2,2
19,2025-05-25T12:42:00+02:00,2025-05-25,20:42,2,9,11
19,2025-05-25T12:43:00+02:00,2025-05-25,20:43,13,13,26
19,2025-05-25T12:49:00+02:00,2025-05-25,20:49,2,5,7
19,2025-05-25T12:50:00+02:00,2025-05-25,20:50,7,2,9
19,2025-05-25T12:51:00+02:00,2025-05-25,20:51,4,1,5
20,2025-05-25T12:50:00+02:00,2025-05-25,20:50,0,5,5
20,2025-05-25T12:52:00+02:00,2025-05-25,20:52,4,9,13
20,2025-05-25T12:54:00+02:00,2025-05-25,20:54,7,12,19
23,2025-05-25T12:41:00+02:00,2025-05-25,20:41,1,2,3
23,2025-05-25T12:46:00+02:00,2025-05-25,20:46,0,2,2
23,2025-05-25T12:47:00+02:00,2025-05-25,20:47,0,3,3
23,2025-05-25T12:49:00+02:00,2025-05-25,20:49,1,2,3
24,2025-05-25T12:41:00+02:00,2025-05-25,20:41,2,7,9
24,2025-05-25T12:44:00+02:00,2025-05-25,20:44,1,7,8
24,2025-05-25T12:46:00+02:00,2025-05-25,20:46,0,3,3
24,2025-05-25T12:49:00+02:00,2025-05-25,20:49,6,10,16
24,2025-05-25T12:51:00+02:00,2025-05-25,20:51,0,6,6
24,2025-05-25T12:52:00+02:00,2025-05-25,20:52,2,9,11
24,2025-05-25T12:53:00+02:00,2025-05-25,20:53,3,5,8
27,2025-05-25T12:40:00+02:00,2025-05-25,20:40,5,0,5
27,2025-05-25T12:48:00+02:00,2025-05-25,20:48,2,0,2
27,2025-05-25T12:49:00+02:00,2025-05-25,20:49,0,1,1
30,2025-05-25T12:52:00+02:00,2025-05-25,20:52,2,1,3
35,2025-05-25T12:41:00+02:00,2025-05-25,20:41,5,6,11
35,2025-05-25T12:42:00+02:00,2025-05-25,20:42,8,6,14
35,2025-05-25T12:43:00+02:00,2025-05-25,20:43,2,6,8
35,2025-05-25T12:44:00+02:00,2025-05-25,20:44,1,9,10
35,2025-05-25T12:45:00+02:00,2025-05-25,20:45,3,2,5
35,2025-05-25T12:47:00+02:00,2025-05-25,20:47,0,4,4
48,2025-05-25T12:42:00+02:00,2025-05-25,20:42,0,2,2
48,2025-05-25T12:47:00+02:00,2025-05-25,20:47,0,4,4
49,2025-05-25T12:42:00+02:00,2025-05-25,20:42,5,1,6
49,2025-05-25T12:48:00+02:00,2025-05-25,20:48,0,6,6
49,2025-05-25T12:49:00+02:00,2025-05-25,20:49,0,3,3
49,2025-05-25T12:51:00+02:00,2025-05-25,20:51,2,6,8
51,2025-05-25T12:42:00+02:00,2025-05-25,20:42,0,1,1
51,2025-05-25T12:45:00+02:00,2025-05-25,20:45,0,1,1
51,2025-05-25T12:47:00+02:00,2025-05-25,20:47,0,3,3
51,2025-05-25T12:48:00+02:00,2025-05-25,20:48,0,12,12
52,2025-05-25T12:44:00+02:00,2025-05-25,20:44,3,3,6
52,2025-05-25T12:45:00+02:00,2025-05-25,20:45,3,0,3
52,2025-05-25T12:46:00+02:00,2025-05-25,20:46,4,3,7
52,2025-05-25T12:47:00+02:00,2025-05-25,20:47,2,3,5
52,2025-05-25T12:49:00+02:00,2025-05-25,20:49,3,2,5
52,2025-05-25T12:51:00+02:00,2025-05-25,20:51,0,4,4
52,2025-05-25T12:54:00+02:00,2025-05-25,20:54,3,4,7
53,2025-05-25T12:46:00+02:00,2025-05-25,20:46,0,1,1
53,2025-05-25T12:50:00+02:00,2025-05-25,20:50,0,2,2
53,2025-05-25T12:51:00+02:00,2025-05-25,20:51,0,1,1
53,2025-05-25T12:54:00+02:00,2025-05-25,20:54,3,3,6
56,2025-05-25T12:40:00+02:00,2025-05-25,20:40,2,5,7
56,2025-05-25T12:41:00+02:00,2025-05-25,20:41,14,6,20
56,2025-05-25T12:44:00+02:00,2025-05-25,20:44,2,3,5
56,2025-05-25T12:53:00+02:00,2025-05-25,20:53,2,0,2
56,2025-05-25T12:54:00+02:00,2025-05-25,20:54,3,1,4
58,2025-05-25T12:41:00+02:00,2025-05-25,20:41,5,2,7
58,2025-05-25T12:43:00+02:00,2025-05-25,20:43,5,6,11
58,2025-05-25T12:45:00+02:00,2025-05-25,20:45,5,2,7
62,2025-05-25T12:42:00+02:00,2025-05-25,20:42,0,4,4
62,2025-05-25T12:43:00+02:00,2025-05-25,20:43,1,4,5
62,2025-05-25T12:46:00+02:00,2025-05-25,20:46,2,0,2
62,2025-05-25T12:50:00+02:00,2025-05-25,20:50,1,3,4
62,2025-05-25T12:51:00+02:00,2025-05-25,20:51,1,0,1
63,2025-05-25T12:44:00+02:00,2025-05-25,20:44,1,3,4
63,2025-05-25T12:47:00+02:00,2025-05-25,20:47,0,2,2
63,2025-05-25T12:51:00+02:00,2025-05-25,20:51,0,3,3
63,2025-05-25T12:52:00+02:00,2025-05-25,20:52,2,2,4
63,2025-05-25T12:53:00+02:00,2025-05-25,20:53,0,3,3
67,2025-05-25T12:40:00+02:00,2025-05-25,20:40,1,0,1
67,2025-05-25T12:42:00+02:00,2025-05-25,20:42,4,5,9
67,2025-05-25T12:47:00+02:00,2025-05-25,20:47,0,6,6
67,2025-05-25T12:48:00+02:00,2025-05-25,20:48,1,0,1
67,2025-05-25T12:50:00+02:00,2025-05-25,20:50,0,4,4
67,2025-05-25T12:54:00+02:00,2025-05-25,20:54,0,4,4
68,2025-05-25T12:45:00+02:00,2025-05-25,20:45,0,4,4
68,2025-05-25T12:48:00+02:00,2025-05-25,20:48,3,3,6
68,2025-05-25T12:53:00+02:00,2025-05-25,20:53,1,0,1
72,2025-05-25T12:40:00+02:00,2025-05-25,20:40,4,0,4
72,2025-05-25T12:48:00+02:00,2025-05-25,20:48,8,0,8
72,2025-05-25T12:50:00+02:00,2025-05-25,20:50,2,0,2
72,2025-05-25T12:51:00+02:00,2025-05-25,20:51,3,1,4
79,2025-05-25T12:41:00+02:00,2025-05-25,20:41,9,2,11
79,2025-05-25T12:43:00+02:00,2025-05-25,20:43,5,4,9
79,2025-05-25T12:48:00+02:00,2025-05-25,20:48,2,2,4
79,2025-05-25T12:54:00+02:00,2025-05-25,20:54,2,2,4
86,2025-05-25T12:47:00+02:00,2025-05-25,20:47,0,2,2
109,2025-05-25T12:40:00+02:00,2025-05-25,20:40,5,8,13
109,2025-05-25T12:45:00+02:00,2025-05-25,20:45,3,6,9
117,2025-05-25T12:40:00+02:00,2025-05-25,20:40,12,5,17
130,2025-05-25T12:40:00+02:00,2025-05-25,20:40,0,1,1
136,2025-05-25T12:45:00+02:00,2025-05-25,20:45,1,0,1
139,2025-05-25T12:40:00+02:00,2025-05-25,20:40,2,5,7
139,2025-05-25T12:50:00+02:00,2025-05-25,20:50,2,0,2
141,2025-05-25T12:45:00+02:00,2025-05-25,20:45,11,3,14
141,2025-05-25T12:50:00+02:00,2025-05-25,20:50,4,4,8
142,2025-05-25T12:40:00+02:00,2025-05-25,20:40,1,3,4
142,2025-05-25T12:45:00+02:00,2025-05-25,20:45,3,3,6
142,2025-05-25T12:50:00+02:00,2025-05-25,20:50,0,1,1
164,2025-05-25T12:45:00+02:00,2025-05-25,20:45,0,17,17
164,2025-05-25T12:50:00+02:00,2025-05-25,20:50,2,5,7
181,2025-05-25T12:45:00+02:00,2025-05-25,20:45,12,21,33
181,2025-05-25T12:47:00+02:00,2025-05-25,20:47,12,5,17
181,2025-05-25T12:49:00+02:00,2025-05-25,20:49,8,10,18
181,2025-05-25T12:52:00+02:00,2025-05-25,20:52,8,7,15
181,2025-05-25T12:54:00+02:00,2025-05-25,20:54,18,6,24
3,2025-05-25T13:10:00+02:00,2025-05-25,21:10,18,13,31
3,2025-05-25T13:11:00+02:00,2025-05-25,21:11,4,14,18
3,2025-05-25T13:12:00+02:00,2025-05-25,21:12,8,9,17
3,2025-05-25T13:13:00+02:00,2025-05-25,21:13,2,13,15
3,2025-05-25T13:15:00+02:00,2025-05-25,21:15,7,4,11
3,2025-05-25T13:16:00+02:00,2025-05-25,21:16,11,13,24
3,2025-05-25T13:18:00+02:00,2025-05-25,21:18,6,1,7
4,2025-05-25T13:13:00+02:00,2025-05-25,21:13,7,12,19
4,2025-05-25T13:16:00+02:00,2025-05-25,21:16,8,12,20
4,2025-05-25T13:21:00+02:00,2025-05-25,21:21,6,8,14
4,2025-05-25T13:22:00+02:00,2025-05-25,21:22,10,4,14
5,2025-05-25T13:10:00+02:00,2025-05-25,21:10,21,34,55
5,2025-05-25T13:15:00+02:00,2025-05-25,21:15,19,30,49
6,2025-05-25T13:15:00+02:00,2025-05-25,21:15,5,14,19
6,2025-05-25T13:21:00+02:00,2025-05-25,21:21,15,10,25
6,2025-05-25T13:24:00+02:00,2025-05-25,21:24,12,9,21
8,2025-05-25T13:19:00+02:00,2025-05-25,21:19,1,0,1
21,2025-05-25T13:10:00+02:00,2025-05-25,21:10,8,13,21
21,2025-05-25T13:15:00+02:00,2025-05-25,21:15,25,27,52
28,2025-05-25T13:12:00+02:00,2025-05-25,21:12,2,0,2
28,2025-05-25T13:14:00+02:00,2025-05-25,21:14,7,1,8
28,2025-05-25T13:16:00+02:00,2025-05-25,21:16,4,0,4
28,2025-05-25T13:17:00+02:00,2025-05-25,21:17,5,1,6
28,2025-05-25T13:18:00+02:00,2025-05-25,21:18,2,1,3
28,2025-05-25T13:20:00+02:00,2025-05-25,21:20,2,3,5
28,2025-05-25T13:22:00+02:00,2025-05-25,21:22,2,1,3
29,2025-05-25T13:10:00+02:00,2025-05-25,21:10,3,5,8
29,2025-05-25T13:13:00+02:00,2025-05-25,21:13,2,1,3
29,2025-05-25T13:19:00+02:00,2025-05-25,21:19,1,2,3
31,2025-05-25T13:18:00+02:00,2025-05-25,21:18,7,5,12
31,2025-05-25T13:20:00+02:00,2025-05-25,21:20,0,6,6
31,2025-05-25T13:23:00+02:00,2025-05-25,21:23,12,3,15
36,2025-05-25T13:11:00+02:00,2025-05-25,21:11,0,4,4
36,2025-05-25T13:19:00+02:00,2025-05-25,21:19,1,0,1
36,2025-05-25T13:21:00+02:00,2025-05-25,21:21,4,0,4
36,2025-05-25T13:22:00+02:00,2025-05-25,21:22,1,1,2
36,2025-05-25T13:24:00+02:00,2025-05-25,21:24,2,1,3
40,2025-05-25T13:16:00+02:00,2025-05-25,21:16,1,0,1
40,2025-05-25T13:20:00+02:00,2025-05-25,21:20,0,2,2
41,2025-05-25T13:10:00+02:00,2025-05-25,21:10,1,6,7
41,2025-05-25T13:12:00+02:00,2025-05-25,21:12,2,0,2
41,2025-05-25T13:15:00+02:00,2025-05-25,21:15,7,8,15
41,2025-05-25T13:19:00+02:00,2025-05-25,21:19,6,2,8
45,2025-05-25T13:11:00+02:00,2025-05-25,21:11,4,7,11
45,2025-05-25T13:12:00+02:00,2025-05-25,21:12,18,2,20
45,2025-05-25T13:17:00+02:00,2025-05-25,21:17,10,11,21
45,2025-05-25T13:21:00+02:00,2025-05-25,21:21,5,3,8
45,2025-05-25T13:23:00+02:00,2025-05-25,21:23,3,6,9
47,2025-05-25T13:10:00+02:00,2025-05-25,21:10,5,8,13
47,2025-05-25T13:12:00+02:00,2025-05-25,21:12,8,5,13
47,2025-05-25T13:13:00+02:00,2025-05-25,21:13,7,4,11
47,2025-05-25T13:14:00+02:00,2025-05-25,21:14,14,11,25
47,2025-05-25T13:17:00+02:00,2025-05-25,21:17,10,3,13
47,2025-05-25T13:19:00+02:00,2025-05-25,21:19,9,0,9
47,2025-05-25T13:23:00+02:00,2025-05-25,21:23,11,2,13
47,2025-05-25T13:24:00+02:00,2025-05-25,21:24,7,11,18
50,2025-05-25T13:12:00+02:00,2025-05-25,21:12,1,0,1
50,2025-05-25T13:20:00+02:00,2025-05-25,21:20,2,1,3
54,2025-05-25T13:14:00+02:00,2025-05-25,21:14,2,0,2
54,2025-05-25T13:16:00+02:00,2025-05-25,21:16,0,1,1
54,2025-05-25T13:18:00+02:00,2025-05-25,21:18,2,0,2
54,2025-05-25T13:20:00+02:00,2025-05-25,21:20,5,1,6
54,2025-05-25T13:21:00+02:00,2025-05-25,21:21,0,1,1
54,2025-05-25T13:24:00+02:00,2025-05-25,21:24,0,5,5
59,2025-05-25T13:10:00+02:00,2025-05-25,21:10,10,11,21
61,2025-05-25T13:13:00+02:00,2025-05-25,21:13,5,1,6
61,2025-05-25T13:14:00+02:00,2025-05-25,21:14,7,4,11
61,2025-05-25T13:16:00+02:00,2025-05-25,21:16,0,3,3
61,2025-05-25T13:17:00+02:00,2025-05-25,21:17,6,1,7
61,2025-05-25T13:23:00+02:00,2025-05-25,21:23,4,0,4
66,2025-05-25T13:11:00+02:00,2025-05-25,21:11,8,15,23
66,2025-05-25T13:16:00+02:00,2025-05-25,21:16,13,4,17
66,2025-05-25T13:22:00+02:00,2025-05-25,21:22,18,12,30
69,2025-05-25T13:16:00+02:00,2025-05-25,21:16,0,1,1
70,2025-05-25T13:10:00+02:00,2025-05-25,21:10,0,2,2
70,2025-05-25T13:11:00+02:00,2025-05-25,21:11,1,0,1
70,2025-05-25T13:15:00+02:00,2025-05-25,21:15,1,0,1
70,2025-05-25T13:18:00+02:00,2025-05-25,21:18,2,0,2
70,2025-05-25T13:19:00+02:00,2025-05-25,21:19,1,3,4
70,2025-05-25T13:20:00+02:00,2025-05-25,21:20,2,0,2
70,2025-05-25T13:22:00+02:00,2025-05-25,21:22,1,0,1
71,2025-05-25T13:14:00+02:00,2025-05-25,21:14,0,1,1
71,2025-05-25T13:17:00+02:00,2025-05-25,21:17,2,0,2
87,2025-05-25T13:15:00+02:00,2025-05-25,21:15,5,0,5
87,2025-05-25T13:19:00+02:00,2025-05-25,21:19,0,4,4
87,2025-05-25T13:22:00+02:00,2025-05-25,21:22,0,1,1
108,2025-05-25T13:13:00+02:00,2025-05-25,21:13,1,0,1
108,2025-05-25T13:15:00+02:00,2025-05-25,21:15,0,3,3
108,2025-05-25T13:19:00+02:00,2025-05-25,21:19,1,0,1
108,2025-05-25T13:21:00+02:00,2025-05-25,21:21,3,5,8
108,2025-05-25T13:24:00+02:00,2025-05-25,21:24,3,5,8
131,2025-05-25T13:10:00+02:00,2025-05-25,21:10,15,1,16
132,2025-05-25T13:15:00+02:00,2025-05-25,21:15,13,6,19
133,2025-05-25T13:15:00+02:00,2025-05-25,21:15,19,16,35
133,2025-05-25T13:20:00+02:00,2025-05-25,21:20,19,16,35
162,2025-05-25T13:10:00+02:00,2025-05-25,21:10,6,1,7
165,2025-05-25T13:20:00+02:00,2025-05-25,21:20,4,0,4
167,2025-05-25T13:10:00+02:00,2025-05-25,21:10,2,0,2
167,2025-05-25T13:15:00+02:00,2025-05-25,21:15,0,2,2
179,2025-05-25T13:10:00+02:00,2025-05-25,21:10,0,4,4
1,2025-05-25T13:12:00+02:00,2025-05-25,21:12,0,10,10
1,2025-05-25T13:17:00+02:00,2025-05-25,21:17,4,3,7
1,2025-05-25T13:18:00+02:00,2025-05-25,21:18,0,2,2
2,2025-05-25T13:11:00+02:00,2025-05-25,21:11,0,3,3
2,2025-05-25T13:18:00+02:00,2025-05-25,21:18,0,3,3
2,2025-05-25T13:19:00+02:00,2025-05-25,21:19,3,0,3
2,2025-05-25T13:24:00+02:00,2025-05-25,21:24,1,5,6
9,2025-05-25T13:17:00+02:00,2025-05-25,21:17,0,2,2
9,2025-05-25T13:18:00+02:00,2025-05-25,21:18,0,2,2
9,2025-05-25T13:24:00+02:00,2025-05-25,21:24,2,1,3
10,2025-05-25T13:10:00+02:00,2025-05-25,21:10,1,1,2
10,2025-05-25T13:15:00+02:00,2025-05-25,21:15,0,1,1
10,2025-05-25T13:18:00+02:00,2025-05-25,21:18,0,1,1
10,2025-05-25T13:20:00+02:00,2025-05-25,21:20,1,0,1
10,2025-05-25T13:21:00+02:00,2025-05-25,21:21,2,0,2
10,2025-05-25T13:24:00+02:00,2025-05-25,21:24,0,1,1
12,2025-05-25T13:10:00+02:00,2025-05-25,21:10,8,1,9
12,2025-05-25T13:15:00+02:00,2025-05-25,21:15,2,0,2
12,2025-05-25T13:22:00+02:00,2025-05-25,21:22,3,8,11
12,2025-05-25T13:24:00+02:00,2025-05-25,21:24,3,0,3
17,2025-05-25T13:12:00+02:00,2025-05-25,21:12,1,2,3
17,2025-05-25T13:20:00+02:00,2025-05-25,21:20,1,0,1
17,2025-05-25T13:21:00+02:00,2025-05-25,21:21,0,2,2
18,2025-05-25T13:22:00+02:00,2025-05-25,21:22,1,0,1
19,2025-05-25T13:10:00+02:00,2025-05-25,21:10,10,13,23
19,2025-05-25T13:11:00+02:00,2025-05-25,21:11,5,8,13
19,2025-05-25T13:13:00+02:00,2025-05-25,21:13,1,8,9
19,2025-05-25T13:20:00+02:00,2025-05-25,21:20,2,5,7
19,2025-05-25T13:21:00+02:00,2025-05-25,21:21,1,7,8
19,2025-05-25T13:22:00+02:00,2025-05-25,21:22,4,4,8
20,2025-05-25T13:11:00+02:00,2025-05-25,21:11,0,6,6
20,2025-05-25T13:13:00+02:00,2025-05-25,21:13,1,3,4
20,2025-05-25T13:18:00+02:00,2025-05-25,21:18,1,7,8
20,2025-05-25T13:22:00+02:00,2025-05-25,21:22,1,2,3
20,2025-05-25T13:23:00+02:00,2025-05-25,21:23,0,6,6
23,2025-05-25T13:11:00+02:00,2025-05-25,21:11,0,3,3
23,2025-05-25T13:13:00+02:00,2025-05-25,21:13,1,1,2
23,2025-05-25T13:15:00+02:00,2025-05-25,21:15,3,0,3
23,2025-05-25T13:22:00+02:00,2025-05-25,21:22,0,4,4
24,2025-05-25T13:10:00+02:00,2025-05-25,21:10,4,3,7
24,2025-05-25T13:13:00+02:00,2025-05-25,21:13,4,10,14
24,2025-05-25T13:14:00+02:00,2025-05-25,21:14,2,0,2
24,2025-05-25T13:16:00+02:00,2025-05-25,21:16,4,2,6
24,2025-05-25T13:18:00+02:00,2025-05-25,21:18,5,2,7
24,2025-05-25T13:21:00+02:00,2025-05-25,21:21,2,14,16
27,2025-05-25T13:11:00+02:00,2025-05-25,21:11,2,1,3
27,2025-05-25T13:24:00+02:00,2025-05-25,21:24,1,0,1
30,2025-05-25T13:15:00+02:00,2025-05-25,21:15,10,6,16
30,2025-05-25T13:17:00+02:00,2025-05-25,21:17,0,3,3
30,2025-05-25T13:19:00+02:00,2025-05-25,21:19,2,1,3
30,2025-05-25T13:20:00+02:00,2025-05-25,21:20,2,4,6
30,2025-05-25T13:24:00+02:00,2025-05-25,21:24,2,2,4
35,2025-05-25T13:12:00+02:00,2025-05-25,21:12,2,4,6
35,2025-05-25T13:17:00+02:00,2025-05-25,21:17,3,4,7
35,2025-05-25T13:19:00+02:00,2025-05-25,21:19,7,1,8
35,2025-05-25T13:21:00+02:00,2025-05-25,21:21,2,2,4
35,2025-05-25T13:22:00+02:00,2025-05-25,21:22,4,4,8
48,2025-05-25T13:15:00+02:00,2025-05-25,21:15,1,0,1
48,2025-05-25T13:16:00+02:00,2025-05-25,21:16,1,2,3
48,2025-05-25T13:24:00+02:00,2025-05-25,21:24,2,0,2
49,2025-05-25T13:11:00+02:00,2025-05-25,21:11,0,2,2
49,2025-05-25T13:15:00+02:00,2025-05-25,21:15,4,7,11
49,2025-05-25T13:19:00+02:00,2025-05-25,21:19,2,2,4
49,2025-05-25T13:21:00+02:00,2025-05-25,21:21,6,1,7
51,2025-05-25T13:10:00+02:00,2025-05-25,21:10,1,0,1
51,2025-05-25T13:12:00+02:00,2025-05-25,21:12,0,1,1
51,2025-05-25T13:16:00+02:00,2025-05-25,21:16,0,2,2
51,2025-05-25T13:24:00+02:00,2025-05-25,21:24,1,2,3
52,2025-05-25T13:10:00+02:00,2025-05-25,21:10,2,1,3
52,2025-05-25T13:12:00+02:00,2025-05-25,21:12,0,3,3
52,2025-05-25T13:13:00+02:00,2025-05-25,21:13,12,4,16
52,2025-05-25T13:15:00+02:00,2025-05-25,21:15,9,4,13
52,2025-05-25T13:20:00+02:00,2025-05-25,21:20,0,1,1
53,2025-05-25T13:10:00+02:00,2025-05-25,21:10,0,2,2
53,2025-05-25T13:12:00+02:00,2025-05-25,21:12,1,3,4
53,2025-05-25T13:13:00+02:00,2025-05-25,21:13,2,3,5
53,2025-05-25T13:18:00+02:00,2025-05-25,21:18,2,3,5
53,2025-05-25T13:19:00+02:00,2025-05-25,21:19,3,5,8
53,2025-05-25T13:24:00+02:00,2025-05-25,21:24,2,3,5
56,2025-05-25T13:10:00+02:00,2025-05-25,21:10,0,2,2
56,2025-05-25T13:13:00+02:00,2025-05-25,21:13,2,4,6
56,2025-05-25T13:16:00+02:00,2025-05-25,21:16,4,2,6
56,2025-05-25T13:19:00+02:00,2025-05-25,21:19,1,2,3
56,2025-05-25T13:24:00+02:00,2025-05-25,21:24,0,10,10
58,2025-05-25T13:13:00+02:00,2025-05-25,21:13,8,9,17
58,2025-05-25T13:14:00+02:00,2025-05-25,21:14,3,17,20
58,2025-05-25T13:19:00+02:00,2025-05-25,21:19,6,1,7
58,2025-05-25T13:23:00+02:00,2025-05-25,21:23,4,0,4
58,2025-05-25T13:24:00+02:00,2025-05-25,21:24,1,1,2
62,2025-05-25T13:11:00+02:00,2025-05-25,21:11,1,0,1
62,2025-05-25T13:14:00+02:00,2025-05-25,21:14,2,4,6
62,2025-05-25T13:20:00+02:00,2025-05-25,21:20,1,4,5
63,2025-05-25T13:12:00+02:00,2025-05-25,21:12,1,6,7
63,2025-05-25T13:15:00+02:00,2025-05-25,21:15,0,4,4
63,2025-05-25T13:23:00+02:00,2025-05-25,21:23,0,4,4
67,2025-05-25T13:10:00+02:00,2025-05-25,21:10,2,1,3
67,2025-05-25T13:11:00+02:00,2025-05-25,21:11,0,3,3
67,2025-05-25T13:12:00+02:00,2025-05-25,21:12,0,8,8
67,2025-05-25T13:14:00+02:00,2025-05-25,21:14,3,3,6
67,2025-05-25T13:15:00+02:00,2025-05-25,21:15,0,13,13
67,2025-05-25T13:16:00+02:00,2025-05-25,21:16,0,5,5
67,2025-05-25T13:17:00+02:00,2025-05-25,21:17,0,5,5
68,2025-05-25T13:11:00+02:00,2025-05-25,21:11,1,4,5
68,2025-05-25T13:18:00+02:00,2025-05-25,21:18,4,4,8
68,2025-05-25T13:19:00+02:00,2025-05-25,21:19,0,4,4
72,2025-05-25T13:12:00+02:00,2025-05-25,21:12,1,0,1
72,2025-05-25T13:15:00+02:00,2025-05-25,21:15,3,5,8
72,2025-05-25T13:19:00+02:00,2025-05-25,21:19,5,3,8
72,2025-05-25T13:20:00+02:00,2025-05-25,21:20,1,2,3
72,2025-05-25T13:22:00+02:00,2025-05-25,21:22,5,3,8
72,2025-05-25T13:23:00+02:00,2025-05-25,21:23,0,1,1
79,2025-05-25T13:10:00+02:00,2025-05-25,21:10,6,3,9
79,2025-05-25T13:12:00+02:00,2025-05-25,21:12,1,4,5
79,2025-05-25T13:17:00+02:00,2025-05-25,21:17,2,3,5
79,2025-05-25T13:18:00+02:00,2025-05-25,21:18,0,5,5
79,2025-05-25T13:23:00+02:00,2025-05-25,21:23,2,6,8
79,2025-05-25T13:24:00+02:00,2025-05-25,21:24,1,10,11
85,2025-05-25T13:11:00+02:00,2025-05-25,21:11,1,0,1
109,2025-05-25T13:10:00+02:00,2025-05-25,21:10,18,5,23
139,2025-05-25T13:10:00+02:00,2025-05-25,21:10,2,0,2
139,2025-05-25T13:15:00+02:00,2025-05-25,21:15,2,0,2
141,2025-05-25T13:10:00+02:00,2025-05-25,21:10,1,6,7
141,2025-05-25T13:15:00+02:00,2025-05-25,21:15,1,8,9
142,2025-05-25T13:20:00+02:00,2025-05-25,21:20,6,2,8
164,2025-05-25T13:10:00+02:00,2025-05-25,21:10,1,16,17
164,2025-05-25T13:15:00+02:00,2025-05-25,21:15,7,2,9
164,2025-05-25T13:20:00+02:00,2025-05-25,21:20,1,1,2
3,2025-05-25T12:56:00+02:00,2025-05-25,20:56,10,11,21
3,2025-05-25T12:58:00+02:00,2025-05-25,20:58,9,14,23
3,2025-05-25T12:59:00+02:00,2025-05-25,20:59,6,6,12
3,2025-05-25T13:04:00+02:00,2025-05-25,21:04,4,5,9
3,2025-05-25T13:06:00+02:00,2025-05-25,21:06,2,6,8
3,2025-05-25T13:09:00+02:00,2025-05-25,21:09,9,8,17
4,2025-05-25T12:55:00+02:00,2025-05-25,20:55,7,8,15
4,2025-05-25T12:57:00+02:00,2025-05-25,20:57,4,13,17
4,2025-05-25T12:58:00+02:00,2025-05-25,20:58,13,7,20
4,2025-05-25T13:00:00+02:00,2025-05-25,21:00,7,14,21
4,2025-05-25T13:01:00+02:00,2025-05-25,21:01,10,8,18
4,2025-05-25T13:03:00+02:00,2025-05-25,21:03,43,6,49
4,2025-05-25T13:04:00+02:00,2025-05-25,21:04,18,12,30
4,2025-05-25T13:08:00+02:00,2025-05-25,21:08,11,3,14
4,2025-05-25T13:09:00+02:00,2025-05-25,21:09,10,7,17
6,2025-05-25T12:55:00+02:00,2025-05-25,20:55,11,6,17
6,2025-05-25T13:00:00+02:00,2025-05-25,21:00,22,13,35
6,2025-05-25T13:01:00+02:00,2025-05-25,21:01,9,5,14
6,2025-05-25T13:03:00+02:00,2025-05-25,21:03,13,2,15
6,2025-05-25T13:05:00+02:00,2025-05-25,21:05,14,2,16
6,2025-05-25T13:08:00+02:00,2025-05-25,21:08,1,6,7
8,2025-05-25T12:59:00+02:00,2025-05-25,20:59,0,2,2
28,2025-05-25T12:59:00+02:00,2025-05-25,20:59,3,2,5
28,2025-05-25T13:01:00+02:00,2025-05-25,21:01,3,2,5
28,2025-05-25T13:02:00+02:00,2025-05-25,21:02,2,3,5
28,2025-05-25T13:06:00+02:00,2025-05-25,21:06,1,3,4
28,2025-05-25T13:09:00+02:00,2025-05-25,21:09,4,0,4
29,2025-05-25T12:55:00+02:00,2025-05-25,20:55,1,10,11
29,2025-05-25T12:56:00+02:00,2025-05-25,20:56,0,11,11
29,2025-05-25T12:57:00+02:00,2025-05-25,20:57,0,3,3
29,2025-05-25T13:01:00+02:00,2025-05-25,21:01,0,3,3
29,2025-05-25T13:06:00+02:00,2025-05-25,21:06,1,0,1
29,2025-05-25T13:09:00+02:00,2025-05-25,21:09,0,4,4
31,2025-05-25T12:55:00+02:00,2025-05-25,20:55,1,2,3
31,2025-05-25T12:57:00+02:00,2025-05-25,20:57,1,8,9
31,2025-05-25T13:03:00+02:00,2025-05-25,21:03,2,4,6
31,2025-05-25T13:07:00+02:00,2025-05-25,21:07,4,1,5
36,2025-05-25T13:06:00+02:00,2025-05-25,21:06,2,0,2
40,2025-05-25T13:09:00+02:00,2025-05-25,21:09,0,2,2
41,2025-05-25T12:57:00+02:00,2025-05-25,20:57,0,2,2
41,2025-05-25T13:03:00+02:00,2025-05-25,21:03,0,1,1
41,2025-05-25T13:07:00+02:00,2025-05-25,21:07,0,3,3
41,2025-05-25T13:09:00+02:00,2025-05-25,21:09,6,6,12
43,2025-05-25T12:55:00+02:00,2025-05-25,20:55,1,1,2
44,2025-05-25T12:55:00+02:00,2025-05-25,20:55,1,1,2
44,2025-05-25T13:00:00+02:00,2025-05-25,21:00,3,3,6
44,2025-05-25T13:05:00+02:00,2025-05-25,21:05,2,5,7
45,2025-05-25T12:55:00+02:00,2025-05-25,20:55,16,8,24
45,2025-05-25T12:56:00+02:00,2025-05-25,20:56,9,16,25
45,2025-05-25T13:01:00+02:00,2025-05-25,21:01,8,11,19
45,2025-05-25T13:03:00+02:00,2025-05-25,21:03,7,13,20
45,2025-05-25T13:04:00+02:00,2025-05-25,21:04,14,8,22
45,2025-05-25T13:09:00+02:00,2025-05-25,21:09,4,21,25
47,2025-05-25T13:03:00+02:00,2025-05-25,21:03,2,0,2
47,2025-05-25T13:08:00+02:00,2025-05-25,21:08,8,7,15
50,2025-05-25T12:55:00+02:00,2025-05-25,20:55,0,2,2
50,2025-05-25T12:58:00+02:00,2025-05-25,20:58,2,0,2
50,2025-05-25T13:02:00+02:00,2025-05-25,21:02,3,15,18
50,2025-05-25T13:09:00+02:00,2025-05-25,21:09,5,7,12
54,2025-05-25T12:58:00+02:00,2025-05-25,20:58,1,4,5
59,2025-05-25T13:05:00+02:00,2025-05-25,21:05,13,11,24
61,2025-05-25T12:58:00+02:00,2025-05-25,20:58,4,1,5
61,2025-05-25T12:59:00+02:00,2025-05-25,20:59,8,0,8
61,2025-05-25T13:01:00+02:00,2025-05-25,21:01,9,7,16
61,2025-05-25T13:02:00+02:00,2025-05-25,21:02,1,0,1
61,2025-05-25T13:03:00+02:00,2025-05-25,21:03,4,5,9
61,2025-05-25T13:05:00+02:00,2025-05-25,21:05,6,6,12
61,2025-05-25T13:09:00+02:00,2025-05-25,21:09,11,0,11
66,2025-05-25T12:55:00+02:00,2025-05-25,20:55,6,8,14
66,2025-05-25T12:58:00+02:00,2025-05-25,20:58,11,14,25
66,2025-05-25T12:59:00+02:00,2025-05-25,20:59,11,2,13
66,2025-05-25T13:02:00+02:00,2025-05-25,21:02,8,13,21
66,2025-05-25T13:03:00+02:00,2025-05-25,21:03,8,16,24
66,2025-05-25T13:05:00+02:00,2025-05-25,21:05,29,3,32
66,2025-05-25T13:06:00+02:00,2025-05-25,21:06,14,15,29
66,2025-05-25T13:09:00+02:00,2025-05-25,21:09,23,18,41
69,2025-05-25T13:06:00+02:00,2025-05-25,21:06,1,0,1
70,2025-05-25T12:55:00+02:00,2025-05-25,20:55,0,1,1
70,2025-05-25T12:59:00+02:00,2025-05-25,20:59,1,0,1
70,2025-05-25T13:00:00+02:00,2025-05-25,21:00,1,0,1
70,2025-05-25T13:05:00+02:00,2025-05-25,21:05,0,1,1
70,2025-05-25T13:06:00+02:00,2025-05-25,21:06,2,3,5
77,2025-05-25T12:55:00+02:00,2025-05-25,20:55,3,2,5
77,2025-05-25T13:00:00+02:00,2025-05-25,21:00,12,5,17
77,2025-05-25T13:05:00+02:00,2025-05-25,21:05,6,8,14
78,2025-05-25T13:02:00+02:00,2025-05-25,21:02,1,0,1
84,2025-05-25T12:55:00+02:00,2025-05-25,20:55,47,50,97
84,2025-05-25T13:00:00+02:00,2025-05-25,21:00,38,55,93
87,2025-05-25T13:01:00+02:00,2025-05-25,21:01,0,2,2
87,2025-05-25T13:03:00+02:00,2025-05-25,21:03,2,1,3
87,2025-05-25T13:08:00+02:00,2025-05-25,21:08,0,1,1
108,2025-05-25T12:55:00+02:00,2025-05-25,20:55,0,2,2
108,2025-05-25T12:56:00+02:00,2025-05-25,20:56,4,0,4
108,2025-05-25T13:04:00+02:00,2025-05-25,21:04,0,1,1
118,2025-05-25T12:55:00+02:00,2025-05-25,20:55,0,1,1
131,2025-05-25T13:00:00+02:00,2025-05-25,21:00,1,4,5
133,2025-05-25T12:55:00+02:00,2025-05-25,20:55,22,20,42
133,2025-05-25T13:05:00+02:00,2025-05-25,21:05,17,6,23
134,2025-05-25T12:55:00+02:00,2025-05-25,20:55,36,10,46
165,2025-05-25T13:00:00+02:00,2025-05-25,21:00,1,1,2
166,2025-05-25T12:55:00+02:00,2025-05-25,20:55,1,0,1
166,2025-05-25T13:00:00+02:00,2025-05-25,21:00,0,1,1
167,2025-05-25T12:55:00+02:00,2025-05-25,20:55,2,2,4
1,2025-05-25T12:55:00+02:00,2025-05-25,20:55,2,8,10
1,2025-05-25T13:05:00+02:00,2025-05-25,21:05,1,4,5
1,2025-05-25T13:06:00+02:00,2025-05-25,21:06,2,1,3
1,2025-05-25T13:09:00+02:00,2025-05-25,21:09,3,6,9
2,2025-05-25T12:56:00+02:00,2025-05-25,20:56,1,4,5
2,2025-05-25T12:57:00+02:00,2025-05-25,20:57,0,3,3
2,2025-05-25T13:08:00+02:00,2025-05-25,21:08,1,1,2
9,2025-05-25T12:57:00+02:00,2025-05-25,20:57,3,0,3
9,2025-05-25T13:04:00+02:00,2025-05-25,21:04,0,1,1
9,2025-05-25T13:06:00+02:00,2025-05-25,21:06,4,0,4
9,2025-05-25T13:08:00+02:00,2025-05-25,21:08,0,1,1
10,2025-05-25T12:55:00+02:00,2025-05-25,20:55,4,0,4
10,2025-05-25T12:57:00+02:00,2025-05-25,20:57,0,1,1
10,2025-05-25T13:03:00+02:00,2025-05-25,21:03,0,2,2
12,2025-05-25T12:59:00+02:00,2025-05-25,20:59,1,1,2
12,2025-05-25T13:00:00+02:00,2025-05-25,21:00,1,0,1
17,2025-05-25T13:01:00+02:00,2025-05-25,21:01,1,0,1
17,2025-05-25T13:07:00+02:00,2025-05-25,21:07,2,2,4
17,2025-05-25T13:08:00+02:00,2025-05-25,21:08,3,1,4
17,2025-05-25T13:09:00+02:00,2025-05-25,21:09,5,0,5
18,2025-05-25T12:59:00+02:00,2025-05-25,20:59,2,0,2
19,2025-05-25T12:57:00+02:00,2025-05-25,20:57,0,8,8
19,2025-05-25T12:58:00+02:00,2025-05-25,20:58,0,2,2
19,2025-05-25T13:03:00+02:00,2025-05-25,21:03,3,7,10
19,2025-05-25T13:07:00+02:00,2025-05-25,21:07,5,4,9
19,2025-05-25T13:08:00+02:00,2025-05-25,21:08,11,12,23
20,2025-05-25T12:56:00+02:00,2025-05-25,20:56,1,10,11
20,2025-05-25T12:59:00+02:00,2025-05-25,20:59,1,0,1
20,2025-05-25T13:02:00+02:00,2025-05-25,21:02,9,5,14
20,2025-05-25T13:07:00+02:00,2025-05-25,21:07,1,2,3
20,2025-05-25T13:09:00+02:00,2025-05-25,21:09,0,4,4
23,2025-05-25T12:57:00+02:00,2025-05-25,20:57,1,1,2
23,2025-05-25T12:58:00+02:00,2025-05-25,20:58,1,0,1
23,2025-05-25T13:01:00+02:00,2025-05-25,21:01,3,2,5
23,2025-05-25T13:09:00+02:00,2025-05-25,21:09,3,0,3
24,2025-05-25T12:56:00+02:00,2025-05-25,20:56,3,3,6
24,2025-05-25T13:04:00+02:00,2025-05-25,21:04,1,5,6
24,2025-05-25T13:07:00+02:00,2025-05-25,21:07,0,9,9
25,2025-05-25T12:55:00+02:00,2025-05-25,20:55,7,8,15
27,2025-05-25T12:57:00+02:00,2025-05-25,20:57,4,0,4
30,2025-05-25T12:56:00+02:00,2025-05-25,20:56,2,7,9
30,2025-05-25T12:57:00+02:00,2025-05-25,20:57,5,3,8
30,2025-05-25T12:58:00+02:00,2025-05-25,20:58,3,1,4
30,2025-05-25T13:01:00+02:00,2025-05-25,21:01,2,9,11
30,2025-05-25T13:02:00+02:00,2025-05-25,21:02,3,8,11
30,2025-05-25T13:03:00+02:00,2025-05-25,21:03,7,2,9
35,2025-05-25T13:01:00+02:00,2025-05-25,21:01,6,5,11
35,2025-05-25T13:07:00+02:00,2025-05-25,21:07,2,5,7
35,2025-05-25T13:08:00+02:00,2025-05-25,21:08,3,9,12
35,2025-05-25T13:09:00+02:00,2025-05-25,21:09,0,2,2
48,2025-05-25T12:58:00+02:00,2025-05-25,20:58,2,1,3
48,2025-05-25T13:05:00+02:00,2025-05-25,21:05,0,1,1
48,2025-05-25T13:09:00+02:00,2025-05-25,21:09,0,2,2
49,2025-05-25T12:56:00+02:00,2025-05-25,20:56,5,9,14
49,2025-05-25T12:57:00+02:00,2025-05-25,20:57,2,3,5
49,2025-05-25T12:58:00+02:00,2025-05-25,20:58,0,4,4
49,2025-05-25T13:00:00+02:00,2025-05-25,21:00,1,0,1
49,2025-05-25T13:01:00+02:00,2025-05-25,21:01,5,3,8
49,2025-05-25T13:03:00+02:00,2025-05-25,21:03,6,6,12
49,2025-05-25T13:09:00+02:00,2025-05-25,21:09,2,4,6
51,2025-05-25T13:06:00+02:00,2025-05-25,21:06,2,1,3
51,2025-05-25T13:07:00+02:00,2025-05-25,21:07,1,2,3
51,2025-05-25T13:08:00+02:00,2025-05-25,21:08,4,1,5
52,2025-05-25T12:55:00+02:00,2025-05-25,20:55,0,3,3
52,2025-05-25T12:57:00+02:00,2025-05-25,20:57,2,2,4
52,2025-05-25T12:58:00+02:00,2025-05-25,20:58,0,1,1
52,2025-05-25T13:01:00+02:00,2025-05-25,21:01,3,3,6
52,2025-05-25T13:05:00+02:00,2025-05-25,21:05,2,3,5
52,2025-05-25T13:06:00+02:00,2025-05-25,21:06,6,0,6
52,2025-05-25T13:08:00+02:00,2025-05-25,21:08,1,3,4
52,2025-05-25T13:09:00+02:00,2025-05-25,21:09,1,2,3
53,2025-05-25T12:56:00+02:00,2025-05-25,20:56,2,5,7
53,2025-05-25T12:57:00+02:00,2025-05-25,20:57,0,5,5
53,2025-05-25T12:59:00+02:00,2025-05-25,20:59,0,5,5
53,2025-05-25T13:01:00+02:00,2025-05-25,21:01,2,14,16
53,2025-05-25T13:03:00+02:00,2025-05-25,21:03,0,3,3
53,2025-05-25T13:05:00+02:00,2025-05-25,21:05,0,7,7
53,2025-05-25T13:07:00+02:00,2025-05-25,21:07,0,6,6
53,2025-05-25T13:08:00+02:00,2025-05-25,21:08,2,9,11
53,2025-05-25T13:09:00+02:00,2025-05-25,21:09,0,2,2
56,2025-05-25T13:08:00+02:00,2025-05-25,21:08,5,3,8
58,2025-05-25T12:58:00+02:00,2025-05-25,20:58,5,7,12
58,2025-05-25T13:00:00+02:00,2025-05-25,21:00,2,6,8
58,2025-05-25T13:02:00+02:00,2025-05-25,21:02,6,1,7
58,2025-05-25T13:03:00+02:00,2025-05-25,21:03,1,2,3
58,2025-05-25T13:04:00+02:00,2025-05-25,21:04,1,3,4
58,2025-05-25T13:07:00+02:00,2025-05-25,21:07,2,3,5
62,2025-05-25T12:59:00+02:00,2025-05-25,20:59,5,0,5
62,2025-05-25T13:00:00+02:00,2025-05-25,21:00,2,6,8
62,2025-05-25T13:03:00+02:00,2025-05-25,21:03,2,2,4
62,2025-05-25T13:04:00+02:00,2025-05-25,21:04,1,1,2
62,2025-05-25T13:06:00+02:00,2025-05-25,21:06,13,2,15
63,2025-05-25T13:02:00+02:00,2025-05-25,21:02,0,3,3
63,2025-05-25T13:03:00+02:00,2025-05-25,21:03,0,1,1
63,2025-05-25T13:04:00+02:00,2025-05-25,21:04,1,0,1
63,2025-05-25T13:05:00+02:00,2025-05-25,21:05,0,4,4
63,2025-05-25T13:06:00+02:00,2025-05-25,21:06,0,1,1
63,2025-05-25T13:08:00+02:00,2025-05-25,21:08,0,3,3
67,2025-05-25T13:05:00+02:00,2025-05-25,21:05,3,5,8
67,2025-05-25T13:08:00+02:00,2025-05-25,21:08,2,0,2
68,2025-05-25T12:55:00+02:00,2025-05-25,20:55,2,1,3
68,2025-05-25T13:05:00+02:00,2025-05-25,21:05,2,2,4
68,2025-05-25T13:06:00+02:00,2025-05-25,21:06,8,3,11
68,2025-05-25T13:08:00+02:00,2025-05-25,21:08,1,2,3
72,2025-05-25T12:55:00+02:00,2025-05-25,20:55,0,4,4
72,2025-05-25T12:58:00+02:00,2025-05-25,20:58,6,0,6
72,2025-05-25T13:00:00+02:00,2025-05-25,21:00,3,0,3
72,2025-05-25T13:08:00+02:00,2025-05-25,21:08,1,3,4
76,2025-05-25T13:01:00+02:00,2025-05-25,21:01,1,0,1
79,2025-05-25T13:05:00+02:00,2025-05-25,21:05,1,0,1
79,2025-05-25T13:08:00+02:00,2025-05-25,21:08,0,1,1
85,2025-05-25T12:55:00+02:00,2025-05-25,20:55,1,0,1
85,2025-05-25T13:09:00+02:00,2025-05-25,21:09,0,2,2
86,2025-05-25T12:58:00+02:00,2025-05-25,20:58,0,1,1
86,2025-05-25T13:03:00+02:00,2025-05-25,21:03,0,1,1
86,2025-05-25T13:07:00+02:00,2025-05-25,21:07,1,0,1
109,2025-05-25T13:00:00+02:00,2025-05-25,21:00,4,9,13
109,2025-05-25T13:05:00+02:00,2025-05-25,21:05,2,6,8
130,2025-05-25T12:55:00+02:00,2025-05-25,20:55,2,0,2
136,2025-05-25T13:00:00+02:00,2025-05-25,21:00,1,0,1
139,2025-05-25T13:00:00+02:00,2025-05-25,21:00,1,0,1
141,2025-05-25T13:00:00+02:00,2025-05-25,21:00,3,5,8
142,2025-05-25T12:55:00+02:00,2025-05-25,20:55,0,2,2
181,2025-05-25T13:11:00+02:00,2025-05-25,21:11,12,5,17
181,2025-05-25T13:12:00+02:00,2025-05-25,21:12,5,8,13
181,2025-05-25T13:14:00+02:00,2025-05-25,21:14,7,1,8
181,2025-05-25T13:15:00+02:00,2025-05-25,21:15,9,14,23
181,2025-05-25T13:17:00+02:00,2025-05-25,21:17,6,9,15
181,2025-05-25T13:20:00+02:00,2025-05-25,21:20,10,8,18
182,2025-05-25T13:10:00+02:00,2025-05-25,21:10,11,9,20
182,2025-05-25T13:20:00+02:00,2025-05-25,21:20,8,16,24
3,2025-05-25T13:46:00+02:00,2025-05-25,21:46,5,6,11
3,2025-05-25T13:53:00+02:00,2025-05-25,21:53,7,3,10
4,2025-05-25T13:41:00+02:00,2025-05-25,21:41,0,6,6
4,2025-05-25T13:44:00+02:00,2025-05-25,21:44,6,12,18
4,2025-05-25T13:47:00+02:00,2025-05-25,21:47,12,14,26
4,2025-05-25T13:50:00+02:00,2025-05-25,21:50,7,14,21
4,2025-05-25T13:53:00+02:00,2025-05-25,21:53,19,23,42
5,2025-05-25T13:40:00+02:00,2025-05-25,21:40,23,42,65
5,2025-05-25T13:45:00+02:00,2025-05-25,21:45,21,49,70
6,2025-05-25T13:44:00+02:00,2025-05-25,21:44,4,8,12
6,2025-05-25T13:50:00+02:00,2025-05-25,21:50,6,8,14
21,2025-05-25T13:45:00+02:00,2025-05-25,21:45,10,18,28
21,2025-05-25T13:50:00+02:00,2025-05-25,21:50,13,14,27
28,2025-05-25T13:40:00+02:00,2025-05-25,21:40,5,1,6
28,2025-05-25T13:42:00+02:00,2025-05-25,21:42,3,1,4
28,2025-05-25T13:49:00+02:00,2025-05-25,21:49,3,2,5
28,2025-05-25T13:53:00+02:00,2025-05-25,21:53,1,3,4
28,2025-05-25T13:54:00+02:00,2025-05-25,21:54,3,0,3
29,2025-05-25T13:41:00+02:00,2025-05-25,21:41,0,12,12
29,2025-05-25T13:42:00+02:00,2025-05-25,21:42,1,4,5
31,2025-05-25T13:42:00+02:00,2025-05-25,21:42,1,6,7
31,2025-05-25T13:44:00+02:00,2025-05-25,21:44,9,1,10
31,2025-05-25T13:47:00+02:00,2025-05-25,21:47,3,0,3
31,2025-05-25T13:48:00+02:00,2025-05-25,21:48,5,4,9
31,2025-05-25T13:50:00+02:00,2025-05-25,21:50,1,5,6
31,2025-05-25T13:51:00+02:00,2025-05-25,21:51,3,4,7
31,2025-05-25T13:52:00+02:00,2025-05-25,21:52,8,5,13
36,2025-05-25T13:47:00+02:00,2025-05-25,21:47,1,3,4
36,2025-05-25T13:49:00+02:00,2025-05-25,21:49,0,2,2
36,2025-05-25T13:52:00+02:00,2025-05-25,21:52,1,4,5
36,2025-05-25T13:54:00+02:00,2025-05-25,21:54,1,0,1
39,2025-05-25T13:52:00+02:00,2025-05-25,21:52,0,2,2
40,2025-05-25T13:42:00+02:00,2025-05-25,21:42,1,0,1
41,2025-05-25T13:41:00+02:00,2025-05-25,21:41,0,2,2
41,2025-05-25T13:42:00+02:00,2025-05-25,21:42,2,0,2
41,2025-05-25T13:53:00+02:00,2025-05-25,21:53,2,0,2
43,2025-05-25T13:40:00+02:00,2025-05-25,21:40,1,2,3
43,2025-05-25T13:50:00+02:00,2025-05-25,21:50,2,1,3
45,2025-05-25T13:46:00+02:00,2025-05-25,21:46,16,6,22
45,2025-05-25T13:48:00+02:00,2025-05-25,21:48,6,4,10
45,2025-05-25T13:49:00+02:00,2025-05-25,21:49,5,2,7
45,2025-05-25T13:52:00+02:00,2025-05-25,21:52,11,1,12
45,2025-05-25T13:53:00+02:00,2025-05-25,21:53,7,6,13
45,2025-05-25T13:54:00+02:00,2025-05-25,21:54,6,7,13
47,2025-05-25T13:43:00+02:00,2025-05-25,21:43,1,2,3
47,2025-05-25T13:47:00+02:00,2025-05-25,21:47,2,1,3
47,2025-05-25T13:49:00+02:00,2025-05-25,21:49,9,6,15
47,2025-05-25T13:50:00+02:00,2025-05-25,21:50,8,3,11
47,2025-05-25T13:53:00+02:00,2025-05-25,21:53,5,0,5
47,2025-05-25T13:54:00+02:00,2025-05-25,21:54,4,3,7
50,2025-05-25T13:41:00+02:00,2025-05-25,21:41,4,1,5
50,2025-05-25T13:47:00+02:00,2025-05-25,21:47,1,1,2
50,2025-05-25T13:52:00+02:00,2025-05-25,21:52,0,3,3
54,2025-05-25T13:40:00+02:00,2025-05-25,21:40,0,2,2
54,2025-05-25T13:42:00+02:00,2025-05-25,21:42,4,0,4
54,2025-05-25T13:45:00+02:00,2025-05-25,21:45,4,0,4
54,2025-05-25T13:50:00+02:00,2025-05-25,21:50,0,4,4
54,2025-05-25T13:52:00+02:00,2025-05-25,21:52,0,1,1
59,2025-05-25T13:45:00+02:00,2025-05-25,21:45,13,12,25
61,2025-05-25T13:43:00+02:00,2025-05-25,21:43,2,1,3
61,2025-05-25T13:46:00+02:00,2025-05-25,21:46,3,3,6
61,2025-05-25T13:47:00+02:00,2025-05-25,21:47,3,0,3
61,2025-05-25T13:51:00+02:00,2025-05-25,21:51,1,1,2
66,2025-05-25T13:43:00+02:00,2025-05-25,21:43,13,7,20
66,2025-05-25T13:44:00+02:00,2025-05-25,21:44,12,5,17
66,2025-05-25T13:46:00+02:00,2025-05-25,21:46,5,0,5
66,2025-05-25T13:47:00+02:00,2025-05-25,21:47,13,3,16
66,2025-05-25T13:48:00+02:00,2025-05-25,21:48,7,8,15
66,2025-05-25T13:51:00+02:00,2025-05-25,21:51,20,6,26
66,2025-05-25T13:53:00+02:00,2025-05-25,21:53,9,5,14
69,2025-05-25T13:40:00+02:00,2025-05-25,21:40,2,0,2
69,2025-05-25T13:48:00+02:00,2025-05-25,21:48,1,0,1
70,2025-05-25T13:42:00+02:00,2025-05-25,21:42,1,0,1
70,2025-05-25T13:43:00+02:00,2025-05-25,21:43,6,2,8
71,2025-05-25T13:46:00+02:00,2025-05-25,21:46,0,1,1
71,2025-05-25T13:53:00+02:00,2025-05-25,21:53,1,0,1
75,2025-05-25T13:42:00+02:00,2025-05-25,21:42,2,0,2
84,2025-05-25T13:40:00+02:00,2025-05-25,21:40,59,39,98
84,2025-05-25T13:45:00+02:00,2025-05-25,21:45,34,43,77
87,2025-05-25T13:41:00+02:00,2025-05-25,21:41,0,3,3
107,2025-05-25T13:50:00+02:00,2025-05-25,21:50,4,2,6
108,2025-05-25T13:42:00+02:00,2025-05-25,21:42,2,0,2
108,2025-05-25T13:47:00+02:00,2025-05-25,21:47,1,0,1
133,2025-05-25T13:40:00+02:00,2025-05-25,21:40,28,13,41
134,2025-05-25T13:50:00+02:00,2025-05-25,21:50,16,6,22
135,2025-05-25T13:40:00+02:00,2025-05-25,21:40,5,10,15
162,2025-05-25T13:45:00+02:00,2025-05-25,21:45,0,1,1
179,2025-05-25T13:45:00+02:00,2025-05-25,21:45,2,2,4
1,2025-05-25T13:40:00+02:00,2025-05-25,21:40,4,3,7
1,2025-05-25T13:42:00+02:00,2025-05-25,21:42,2,2,4
1,2025-05-25T13:45:00+02:00,2025-05-25,21:45,0,2,2
1,2025-05-25T13:47:00+02:00,2025-05-25,21:47,2,4,6
1,2025-05-25T13:49:00+02:00,2025-05-25,21:49,0,2,2
1,2025-05-25T13:50:00+02:00,2025-05-25,21:50,2,6,8
1,2025-05-25T13:52:00+02:00,2025-05-25,21:52,2,4,6
1,2025-05-25T13:53:00+02:00,2025-05-25,21:53,1,1,2
2,2025-05-25T13:42:00+02:00,2025-05-25,21:42,0,4,4
2,2025-05-25T13:44:00+02:00,2025-05-25,21:44,2,2,4
2,2025-05-25T13:45:00+02:00,2025-05-25,21:45,0,3,3
2,2025-05-25T13:47:00+02:00,2025-05-25,21:47,1,2,3
2,2025-05-25T13:53:00+02:00,2025-05-25,21:53,1,0,1
9,2025-05-25T13:45:00+02:00,2025-05-25,21:45,1,0,1
9,2025-05-25T13:51:00+02:00,2025-05-25,21:51,0,1,1
10,2025-05-25T13:52:00+02:00,2025-05-25,21:52,0,1,1
11,2025-05-25T13:40:00+02:00,2025-05-25,21:40,0,4,4
11,2025-05-25T13:45:00+02:00,2025-05-25,21:45,4,0,4
12,2025-05-25T13:41:00+02:00,2025-05-25,21:41,1,3,4
12,2025-05-25T13:43:00+02:00,2025-05-25,21:43,2,1,3
12,2025-05-25T13:44:00+02:00,2025-05-25,21:44,1,5,6
12,2025-05-25T13:47:00+02:00,2025-05-25,21:47,2,6,8
12,2025-05-25T13:49:00+02:00,2025-05-25,21:49,5,0,5
17,2025-05-25T13:42:00+02:00,2025-05-25,21:42,3,8,11
17,2025-05-25T13:43:00+02:00,2025-05-25,21:43,1,0,1
17,2025-05-25T13:47:00+02:00,2025-05-25,21:47,1,0,1
17,2025-05-25T13:51:00+02:00,2025-05-25,21:51,0,1,1
18,2025-05-25T13:51:00+02:00,2025-05-25,21:51,0,1,1
19,2025-05-25T13:40:00+02:00,2025-05-25,21:40,4,4,8
19,2025-05-25T13:41:00+02:00,2025-05-25,21:41,0,10,10
19,2025-05-25T13:43:00+02:00,2025-05-25,21:43,2,12,14
19,2025-05-25T13:50:00+02:00,2025-05-25,21:50,0,3,3
19,2025-05-25T13:52:00+02:00,2025-05-25,21:52,5,7,12
19,2025-05-25T13:54:00+02:00,2025-05-25,21:54,6,13,19
20,2025-05-25T13:40:00+02:00,2025-05-25,21:40,11,1,12
20,2025-05-25T13:50:00+02:00,2025-05-25,21:50,0,5,5
20,2025-05-25T13:51:00+02:00,2025-05-25,21:51,0,3,3
20,2025-05-25T13:53:00+02:00,2025-05-25,21:53,1,7,8
23,2025-05-25T13:40:00+02:00,2025-05-25,21:40,1,2,3
23,2025-05-25T13:41:00+02:00,2025-05-25,21:41,2,3,5
23,2025-05-25T13:49:00+02:00,2025-05-25,21:49,1,4,5
24,2025-05-25T13:41:00+02:00,2025-05-25,21:41,6,5,11
24,2025-05-25T13:44:00+02:00,2025-05-25,21:44,2,8,10
24,2025-05-25T13:47:00+02:00,2025-05-25,21:47,2,3,5
24,2025-05-25T13:49:00+02:00,2025-05-25,21:49,2,6,8
24,2025-05-25T13:51:00+02:00,2025-05-25,21:51,4,14,18
25,2025-05-25T13:45:00+02:00,2025-05-25,21:45,12,15,27
25,2025-05-25T13:50:00+02:00,2025-05-25,21:50,3,11,14
27,2025-05-25T13:42:00+02:00,2025-05-25,21:42,1,0,1
27,2025-05-25T13:43:00+02:00,2025-05-25,21:43,0,2,2
27,2025-05-25T13:50:00+02:00,2025-05-25,21:50,3,0,3
27,2025-05-25T13:54:00+02:00,2025-05-25,21:54,0,2,2
30,2025-05-25T13:40:00+02:00,2025-05-25,21:40,1,10,11
30,2025-05-25T13:43:00+02:00,2025-05-25,21:43,0,4,4
30,2025-05-25T13:49:00+02:00,2025-05-25,21:49,1,0,1
30,2025-05-25T13:53:00+02:00,2025-05-25,21:53,2,14,16
35,2025-05-25T13:42:00+02:00,2025-05-25,21:42,9,1,10
35,2025-05-25T13:43:00+02:00,2025-05-25,21:43,1,8,9
35,2025-05-25T13:45:00+02:00,2025-05-25,21:45,7,8,15
35,2025-05-25T13:46:00+02:00,2025-05-25,21:46,11,9,20
35,2025-05-25T13:47:00+02:00,2025-05-25,21:47,1,10,11
35,2025-05-25T13:52:00+02:00,2025-05-25,21:52,8,10,18
35,2025-05-25T13:54:00+02:00,2025-05-25,21:54,0,10,10
48,2025-05-25T13:41:00+02:00,2025-05-25,21:41,4,0,4
48,2025-05-25T13:43:00+02:00,2025-05-25,21:43,1,0,1
48,2025-05-25T13:45:00+02:00,2025-05-25,21:45,1,3,4
48,2025-05-25T13:47:00+02:00,2025-05-25,21:47,0,3,3
48,2025-05-25T13:49:00+02:00,2025-05-25,21:49,0,2,2
48,2025-05-25T13:50:00+02:00,2025-05-25,21:50,0,2,2
48,2025-05-25T13:51:00+02:00,2025-05-25,21:51,4,0,4
49,2025-05-25T13:41:00+02:00,2025-05-25,21:41,0,4,4
49,2025-05-25T13:43:00+02:00,2025-05-25,21:43,4,1,5
49,2025-05-25T13:45:00+02:00,2025-05-25,21:45,6,1,7
49,2025-05-25T13:47:00+02:00,2025-05-25,21:47,3,7,10
49,2025-05-25T13:49:00+02:00,2025-05-25,21:49,4,2,6
49,2025-05-25T13:52:00+02:00,2025-05-25,21:52,3,2,5
49,2025-05-25T13:53:00+02:00,2025-05-25,21:53,1,1,2
51,2025-05-25T13:41:00+02:00,2025-05-25,21:41,1,0,1
51,2025-05-25T13:50:00+02:00,2025-05-25,21:50,1,0,1
52,2025-05-25T13:44:00+02:00,2025-05-25,21:44,1,4,5
52,2025-05-25T13:51:00+02:00,2025-05-25,21:51,1,4,5
52,2025-05-25T13:53:00+02:00,2025-05-25,21:53,4,5,9
53,2025-05-25T13:41:00+02:00,2025-05-25,21:41,3,1,4
53,2025-05-25T13:46:00+02:00,2025-05-25,21:46,0,4,4
53,2025-05-25T13:47:00+02:00,2025-05-25,21:47,0,1,1
53,2025-05-25T13:49:00+02:00,2025-05-25,21:49,0,2,2
53,2025-05-25T13:50:00+02:00,2025-05-25,21:50,0,2,2
53,2025-05-25T13:52:00+02:00,2025-05-25,21:52,0,1,1
53,2025-05-25T13:53:00+02:00,2025-05-25,21:53,1,2,3
56,2025-05-25T13:41:00+02:00,2025-05-25,21:41,11,6,17
56,2025-05-25T13:44:00+02:00,2025-05-25,21:44,5,7,12
56,2025-05-25T13:49:00+02:00,2025-05-25,21:49,2,2,4
56,2025-05-25T13:51:00+02:00,2025-05-25,21:51,6,1,7
56,2025-05-25T13:52:00+02:00,2025-05-25,21:52,1,0,1
56,2025-05-25T13:53:00+02:00,2025-05-25,21:53,2,3,5
58,2025-05-25T13:51:00+02:00,2025-05-25,21:51,1,6,7
58,2025-05-25T13:52:00+02:00,2025-05-25,21:52,1,3,4
62,2025-05-25T13:43:00+02:00,2025-05-25,21:43,0,1,1
62,2025-05-25T13:47:00+02:00,2025-05-25,21:47,2,2,4
62,2025-05-25T13:48:00+02:00,2025-05-25,21:48,6,6,12
62,2025-05-25T13:49:00+02:00,2025-05-25,21:49,3,2,5
62,2025-05-25T13:51:00+02:00,2025-05-25,21:51,4,2,6
62,2025-05-25T13:54:00+02:00,2025-05-25,21:54,3,2,5
63,2025-05-25T13:43:00+02:00,2025-05-25,21:43,0,3,3
63,2025-05-25T13:53:00+02:00,2025-05-25,21:53,0,1,1
67,2025-05-25T13:46:00+02:00,2025-05-25,21:46,2,6,8
67,2025-05-25T13:50:00+02:00,2025-05-25,21:50,3,1,4
68,2025-05-25T13:40:00+02:00,2025-05-25,21:40,2,1,3
68,2025-05-25T13:53:00+02:00,2025-05-25,21:53,3,0,3
72,2025-05-25T13:42:00+02:00,2025-05-25,21:42,2,5,7
72,2025-05-25T13:53:00+02:00,2025-05-25,21:53,1,0,1
79,2025-05-25T13:40:00+02:00,2025-05-25,21:40,2,8,10
79,2025-05-25T13:45:00+02:00,2025-05-25,21:45,3,5,8
79,2025-05-25T13:46:00+02:00,2025-05-25,21:46,3,11,14
79,2025-05-25T13:47:00+02:00,2025-05-25,21:47,3,13,16
79,2025-05-25T13:50:00+02:00,2025-05-25,21:50,2,5,7
79,2025-05-25T13:51:00+02:00,2025-05-25,21:51,3,8,11
79,2025-05-25T13:52:00+02:00,2025-05-25,21:52,1,4,5
79,2025-05-25T13:53:00+02:00,2025-05-25,21:53,3,11,14
79,2025-05-25T13:54:00+02:00,2025-05-25,21:54,7,15,22
86,2025-05-25T13:41:00+02:00,2025-05-25,21:41,0,1,1
86,2025-05-25T13:47:00+02:00,2025-05-25,21:47,1,0,1
86,2025-05-25T13:48:00+02:00,2025-05-25,21:48,0,1,1
86,2025-05-25T13:52:00+02:00,2025-05-25,21:52,0,1,1
117,2025-05-25T13:45:00+02:00,2025-05-25,21:45,11,13,24
123,2025-05-25T13:40:00+02:00,2025-05-25,21:40,2,0,2
136,2025-05-25T13:40:00+02:00,2025-05-25,21:40,0,9,9
136,2025-05-25T13:45:00+02:00,2025-05-25,21:45,0,2,2
136,2025-05-25T13:50:00+02:00,2025-05-25,21:50,1,0,1
141,2025-05-25T13:45:00+02:00,2025-05-25,21:45,1,14,15
142,2025-05-25T13:45:00+02:00,2025-05-25,21:45,2,0,2
142,2025-05-25T13:50:00+02:00,2025-05-25,21:50,2,0,2
181,2025-05-25T13:56:00+02:00,2025-05-25,21:56,8,2,10
181,2025-05-25T13:58:00+02:00,2025-05-25,21:58,10,3,13
181,2025-05-25T14:01:00+02:00,2025-05-25,22:01,12,11,23
180,2025-05-25T13:58:00+02:00,2025-05-25,21:58,1,0,1
3,2025-05-25T13:25:00+02:00,2025-05-25,21:25,5,6,11
3,2025-05-25T13:32:00+02:00,2025-05-25,21:32,12,2,14
3,2025-05-25T13:37:00+02:00,2025-05-25,21:37,1,9,10
4,2025-05-25T13:27:00+02:00,2025-05-25,21:27,24,2,26
4,2025-05-25T13:29:00+02:00,2025-05-25,21:29,8,10,18
4,2025-05-25T13:31:00+02:00,2025-05-25,21:31,3,9,12
4,2025-05-25T13:35:00+02:00,2025-05-25,21:35,6,5,11
4,2025-05-25T13:36:00+02:00,2025-05-25,21:36,2,13,15
4,2025-05-25T13:38:00+02:00,2025-05-25,21:38,11,2,13
5,2025-05-25T13:25:00+02:00,2025-05-25,21:25,25,28,53
5,2025-05-25T13:35:00+02:00,2025-05-25,21:35,17,54,71
6,2025-05-25T13:26:00+02:00,2025-05-25,21:26,12,5,17
6,2025-05-25T13:27:00+02:00,2025-05-25,21:27,4,3,7
6,2025-05-25T13:37:00+02:00,2025-05-25,21:37,9,2,11
21,2025-05-25T13:30:00+02:00,2025-05-25,21:30,15,25,40
21,2025-05-25T13:35:00+02:00,2025-05-25,21:35,11,12,23
28,2025-05-25T13:25:00+02:00,2025-05-25,21:25,2,1,3
28,2025-05-25T13:27:00+02:00,2025-05-25,21:27,1,1,2
28,2025-05-25T13:28:00+02:00,2025-05-25,21:28,0,2,2
28,2025-05-25T13:30:00+02:00,2025-05-25,21:30,3,0,3
28,2025-05-25T13:32:00+02:00,2025-05-25,21:32,6,4,10
29,2025-05-25T13:31:00+02:00,2025-05-25,21:31,0,6,6
29,2025-05-25T13:32:00+02:00,2025-05-25,21:32,0,2,2
29,2025-05-25T13:33:00+02:00,2025-05-25,21:33,1,4,5
29,2025-05-25T13:38:00+02:00,2025-05-25,21:38,2,1,3
31,2025-05-25T13:25:00+02:00,2025-05-25,21:25,6,4,10
31,2025-05-25T13:26:00+02:00,2025-05-25,21:26,2,12,14
31,2025-05-25T13:30:00+02:00,2025-05-25,21:30,5,11,16
31,2025-05-25T13:32:00+02:00,2025-05-25,21:32,1,2,3
31,2025-05-25T13:38:00+02:00,2025-05-25,21:38,6,5,11
36,2025-05-25T13:26:00+02:00,2025-05-25,21:26,0,1,1
36,2025-05-25T13:27:00+02:00,2025-05-25,21:27,5,0,5
36,2025-05-25T13:29:00+02:00,2025-05-25,21:29,0,2,2
36,2025-05-25T13:36:00+02:00,2025-05-25,21:36,0,1,1
36,2025-05-25T13:37:00+02:00,2025-05-25,21:37,1,0,1
36,2025-05-25T13:38:00+02:00,2025-05-25,21:38,0,2,2
36,2025-05-25T13:39:00+02:00,2025-05-25,21:39,3,1,4
40,2025-05-25T13:26:00+02:00,2025-05-25,21:26,1,2,3
41,2025-05-25T13:27:00+02:00,2025-05-25,21:27,1,1,2
41,2025-05-25T13:30:00+02:00,2025-05-25,21:30,1,2,3
41,2025-05-25T13:31:00+02:00,2025-05-25,21:31,0,1,1
41,2025-05-25T13:35:00+02:00,2025-05-25,21:35,1,2,3
41,2025-05-25T13:37:00+02:00,2025-05-25,21:37,1,0,1
43,2025-05-25T13:30:00+02:00,2025-05-25,21:30,7,3,10
45,2025-05-25T13:29:00+02:00,2025-05-25,21:29,0,16,16
45,2025-05-25T13:30:00+02:00,2025-05-25,21:30,7,5,12
45,2025-05-25T13:32:00+02:00,2025-05-25,21:32,8,4,12
45,2025-05-25T13:35:00+02:00,2025-05-25,21:35,3,3,6
45,2025-05-25T13:37:00+02:00,2025-05-25,21:37,10,11,21
47,2025-05-25T13:27:00+02:00,2025-05-25,21:27,3,2,5
47,2025-05-25T13:31:00+02:00,2025-05-25,21:31,3,2,5
50,2025-05-25T13:26:00+02:00,2025-05-25,21:26,6,5,11
50,2025-05-25T13:27:00+02:00,2025-05-25,21:27,10,1,11
50,2025-05-25T13:33:00+02:00,2025-05-25,21:33,1,1,2
50,2025-05-25T13:34:00+02:00,2025-05-25,21:34,10,0,10
50,2025-05-25T13:36:00+02:00,2025-05-25,21:36,1,3,4
54,2025-05-25T13:29:00+02:00,2025-05-25,21:29,11,1,12
54,2025-05-25T13:31:00+02:00,2025-05-25,21:31,4,0,4
54,2025-05-25T13:34:00+02:00,2025-05-25,21:34,0,1,1
54,2025-05-25T13:35:00+02:00,2025-05-25,21:35,1,1,2
54,2025-05-25T13:36:00+02:00,2025-05-25,21:36,1,7,8
54,2025-05-25T13:38:00+02:00,2025-05-25,21:38,5,2,7
61,2025-05-25T13:27:00+02:00,2025-05-25,21:27,8,1,9
61,2025-05-25T13:28:00+02:00,2025-05-25,21:28,2,2,4
61,2025-05-25T13:29:00+02:00,2025-05-25,21:29,1,6,7
61,2025-05-25T13:31:00+02:00,2025-05-25,21:31,4,1,5
61,2025-05-25T13:32:00+02:00,2025-05-25,21:32,2,0,2
61,2025-05-25T13:35:00+02:00,2025-05-25,21:35,4,1,5
61,2025-05-25T13:37:00+02:00,2025-05-25,21:37,3,0,3
66,2025-05-25T13:27:00+02:00,2025-05-25,21:27,17,0,17
66,2025-05-25T13:31:00+02:00,2025-05-25,21:31,15,11,26
66,2025-05-25T13:32:00+02:00,2025-05-25,21:32,8,1,9
66,2025-05-25T13:33:00+02:00,2025-05-25,21:33,22,6,28
66,2025-05-25T13:34:00+02:00,2025-05-25,21:34,14,5,19
66,2025-05-25T13:35:00+02:00,2025-05-25,21:35,7,16,23
66,2025-05-25T13:36:00+02:00,2025-05-25,21:36,10,3,13
66,2025-05-25T13:38:00+02:00,2025-05-25,21:38,8,10,18
69,2025-05-25T13:27:00+02:00,2025-05-25,21:27,0,1,1
70,2025-05-25T13:26:00+02:00,2025-05-25,21:26,1,4,5
70,2025-05-25T13:27:00+02:00,2025-05-25,21:27,0,6,6
70,2025-05-25T13:29:00+02:00,2025-05-25,21:29,33,0,33
70,2025-05-25T13:32:00+02:00,2025-05-25,21:32,30,3,33
70,2025-05-25T13:35:00+02:00,2025-05-25,21:35,18,2,20
70,2025-05-25T13:38:00+02:00,2025-05-25,21:38,0,1,1
70,2025-05-25T13:39:00+02:00,2025-05-25,21:39,1,4,5
77,2025-05-25T13:25:00+02:00,2025-05-25,21:25,1,5,6
77,2025-05-25T13:35:00+02:00,2025-05-25,21:35,11,4,15
84,2025-05-25T13:25:00+02:00,2025-05-25,21:25,41,47,88
84,2025-05-25T13:35:00+02:00,2025-05-25,21:35,35,60,95
87,2025-05-25T13:27:00+02:00,2025-05-25,21:27,0,1,1
107,2025-05-25T13:30:00+02:00,2025-05-25,21:30,4,5,9
107,2025-05-25T13:35:00+02:00,2025-05-25,21:35,1,2,3
108,2025-05-25T13:25:00+02:00,2025-05-25,21:25,0,3,3
108,2025-05-25T13:29:00+02:00,2025-05-25,21:29,2,0,2
108,2025-05-25T13:32:00+02:00,2025-05-25,21:32,2,2,4
108,2025-05-25T13:34:00+02:00,2025-05-25,21:34,1,7,8
108,2025-05-25T13:37:00+02:00,2025-05-25,21:37,1,0,1
108,2025-05-25T13:38:00+02:00,2025-05-25,21:38,1,2,3
118,2025-05-25T13:30:00+02:00,2025-05-25,21:30,1,1,2
118,2025-05-25T13:35:00+02:00,2025-05-25,21:35,1,0,1
133,2025-05-25T13:25:00+02:00,2025-05-25,21:25,17,18,35
134,2025-05-25T13:25:00+02:00,2025-05-25,21:25,22,13,35
134,2025-05-25T13:30:00+02:00,2025-05-25,21:30,14,28,42
135,2025-05-25T13:25:00+02:00,2025-05-25,21:25,10,6,16
135,2025-05-25T13:30:00+02:00,2025-05-25,21:30,1,25,26
135,2025-05-25T13:35:00+02:00,2025-05-25,21:35,9,9,18
165,2025-05-25T13:25:00+02:00,2025-05-25,21:25,3,0,3
167,2025-05-25T13:35:00+02:00,2025-05-25,21:35,1,2,3
179,2025-05-25T13:30:00+02:00,2025-05-25,21:30,4,5,9
1,2025-05-25T13:26:00+02:00,2025-05-25,21:26,3,2,5
1,2025-05-25T13:28:00+02:00,2025-05-25,21:28,3,0,3
1,2025-05-25T13:29:00+02:00,2025-05-25,21:29,0,3,3
1,2025-05-25T13:30:00+02:00,2025-05-25,21:30,1,2,3
1,2025-05-25T13:33:00+02:00,2025-05-25,21:33,0,5,5
1,2025-05-25T13:35:00+02:00,2025-05-25,21:35,1,2,3
1,2025-05-25T13:39:00+02:00,2025-05-25,21:39,4,1,5
2,2025-05-25T13:27:00+02:00,2025-05-25,21:27,5,0,5
2,2025-05-25T13:28:00+02:00,2025-05-25,21:28,4,4,8
2,2025-05-25T13:29:00+02:00,2025-05-25,21:29,1,0,1
2,2025-05-25T13:30:00+02:00,2025-05-25,21:30,1,2,3
2,2025-05-25T13:36:00+02:00,2025-05-25,21:36,4,1,5
2,2025-05-25T13:38:00+02:00,2025-05-25,21:38,0,4,4
9,2025-05-25T13:26:00+02:00,2025-05-25,21:26,2,2,4
9,2025-05-25T13:31:00+02:00,2025-05-25,21:31,1,0,1
9,2025-05-25T13:32:00+02:00,2025-05-25,21:32,2,1,3
10,2025-05-25T13:27:00+02:00,2025-05-25,21:27,0,6,6
11,2025-05-25T13:35:00+02:00,2025-05-25,21:35,1,1,2
12,2025-05-25T13:27:00+02:00,2025-05-25,21:27,1,3,4
12,2025-05-25T13:30:00+02:00,2025-05-25,21:30,4,0,4
17,2025-05-25T13:27:00+02:00,2025-05-25,21:27,0,3,3
17,2025-05-25T13:32:00+02:00,2025-05-25,21:32,0,1,1
17,2025-05-25T13:35:00+02:00,2025-05-25,21:35,0,1,1
17,2025-05-25T13:37:00+02:00,2025-05-25,21:37,2,1,3
19,2025-05-25T13:27:00+02:00,2025-05-25,21:27,3,6,9
19,2025-05-25T13:29:00+02:00,2025-05-25,21:29,6,9,15
19,2025-05-25T13:30:00+02:00,2025-05-25,21:30,1,5,6
19,2025-05-25T13:31:00+02:00,2025-05-25,21:31,5,6,11
19,2025-05-25T13:33:00+02:00,2025-05-25,21:33,8,11,19
19,2025-05-25T13:34:00+02:00,2025-05-25,21:34,2,10,12
19,2025-05-25T13:36:00+02:00,2025-05-25,21:36,5,4,9
19,2025-05-25T13:38:00+02:00,2025-05-25,21:38,6,5,11
19,2025-05-25T13:39:00+02:00,2025-05-25,21:39,7,14,21
20,2025-05-25T13:25:00+02:00,2025-05-25,21:25,4,21,25
20,2025-05-25T13:26:00+02:00,2025-05-25,21:26,2,16,18
20,2025-05-25T13:30:00+02:00,2025-05-25,21:30,0,6,6
20,2025-05-25T13:32:00+02:00,2025-05-25,21:32,3,11,14
20,2025-05-25T13:38:00+02:00,2025-05-25,21:38,0,4,4
23,2025-05-25T13:28:00+02:00,2025-05-25,21:28,2,6,8
23,2025-05-25T13:30:00+02:00,2025-05-25,21:30,7,2,9
23,2025-05-25T13:31:00+02:00,2025-05-25,21:31,1,0,1
23,2025-05-25T13:33:00+02:00,2025-05-25,21:33,0,1,1
24,2025-05-25T13:25:00+02:00,2025-05-25,21:25,2,5,7
24,2025-05-25T13:30:00+02:00,2025-05-25,21:30,2,3,5
24,2025-05-25T13:31:00+02:00,2025-05-25,21:31,4,2,6
24,2025-05-25T13:33:00+02:00,2025-05-25,21:33,6,2,8
24,2025-05-25T13:34:00+02:00,2025-05-25,21:34,7,12,19
27,2025-05-25T13:30:00+02:00,2025-05-25,21:30,1,0,1
27,2025-05-25T13:36:00+02:00,2025-05-25,21:36,3,0,3
30,2025-05-25T13:26:00+02:00,2025-05-25,21:26,7,1,8
30,2025-05-25T13:27:00+02:00,2025-05-25,21:27,10,2,12
30,2025-05-25T13:29:00+02:00,2025-05-25,21:29,5,8,13
30,2025-05-25T13:34:00+02:00,2025-05-25,21:34,3,19,22
30,2025-05-25T13:39:00+02:00,2025-05-25,21:39,5,4,9
35,2025-05-25T13:29:00+02:00,2025-05-25,21:29,6,10,16
35,2025-05-25T13:31:00+02:00,2025-05-25,21:31,3,9,12
35,2025-05-25T13:38:00+02:00,2025-05-25,21:38,2,4,6
48,2025-05-25T13:34:00+02:00,2025-05-25,21:34,0,1,1
48,2025-05-25T13:35:00+02:00,2025-05-25,21:35,0,5,5
49,2025-05-25T13:29:00+02:00,2025-05-25,21:29,7,7,14
49,2025-05-25T13:37:00+02:00,2025-05-25,21:37,2,5,7
51,2025-05-25T13:25:00+02:00,2025-05-25,21:25,1,2,3
51,2025-05-25T13:27:00+02:00,2025-05-25,21:27,2,0,2
52,2025-05-25T13:35:00+02:00,2025-05-25,21:35,0,2,2
52,2025-05-25T13:38:00+02:00,2025-05-25,21:38,4,3,7
53,2025-05-25T13:27:00+02:00,2025-05-25,21:27,0,5,5
56,2025-05-25T13:30:00+02:00,2025-05-25,21:30,6,7,13
56,2025-05-25T13:31:00+02:00,2025-05-25,21:31,6,8,14
56,2025-05-25T13:34:00+02:00,2025-05-25,21:34,3,2,5
56,2025-05-25T13:35:00+02:00,2025-05-25,21:35,1,5,6
58,2025-05-25T13:34:00+02:00,2025-05-25,21:34,5,4,9
58,2025-05-25T13:35:00+02:00,2025-05-25,21:35,5,14,19
62,2025-05-25T13:27:00+02:00,2025-05-25,21:27,5,2,7
62,2025-05-25T13:31:00+02:00,2025-05-25,21:31,1,0,1
62,2025-05-25T13:36:00+02:00,2025-05-25,21:36,0,2,2
63,2025-05-25T13:27:00+02:00,2025-05-25,21:27,1,3,4
63,2025-05-25T13:29:00+02:00,2025-05-25,21:29,0,3,3
63,2025-05-25T13:33:00+02:00,2025-05-25,21:33,0,2,2
63,2025-05-25T13:37:00+02:00,2025-05-25,21:37,0,1,1
67,2025-05-25T13:25:00+02:00,2025-05-25,21:25,1,5,6
67,2025-05-25T13:31:00+02:00,2025-05-25,21:31,0,2,2
67,2025-05-25T13:32:00+02:00,2025-05-25,21:32,0,4,4
67,2025-05-25T13:34:00+02:00,2025-05-25,21:34,0,4,4
67,2025-05-25T13:39:00+02:00,2025-05-25,21:39,0,1,1
68,2025-05-25T13:39:00+02:00,2025-05-25,21:39,0,2,2
72,2025-05-25T13:26:00+02:00,2025-05-25,21:26,0,2,2
72,2025-05-25T13:30:00+02:00,2025-05-25,21:30,0,1,1
72,2025-05-25T13:34:00+02:00,2025-05-25,21:34,1,3,4
72,2025-05-25T13:37:00+02:00,2025-05-25,21:37,4,1,5
79,2025-05-25T13:27:00+02:00,2025-05-25,21:27,1,2,3
79,2025-05-25T13:28:00+02:00,2025-05-25,21:28,1,3,4
79,2025-05-25T13:34:00+02:00,2025-05-25,21:34,1,10,11
79,2025-05-25T13:35:00+02:00,2025-05-25,21:35,1,10,11
79,2025-05-25T13:36:00+02:00,2025-05-25,21:36,0,1,1
86,2025-05-25T13:39:00+02:00,2025-05-25,21:39,0,2,2
117,2025-05-25T13:25:00+02:00,2025-05-25,21:25,2,2,4
136,2025-05-25T13:25:00+02:00,2025-05-25,21:25,0,2,2
136,2025-05-25T13:35:00+02:00,2025-05-25,21:35,0,17,17
141,2025-05-25T13:35:00+02:00,2025-05-25,21:35,4,14,18
142,2025-05-25T13:35:00+02:00,2025-05-25,21:35,1,0,1
164,2025-05-25T13:30:00+02:00,2025-05-25,21:30,5,1,6
181,2025-05-25T12:57:00+02:00,2025-05-25,20:57,10,9,19
181,2025-05-25T13:03:00+02:00,2025-05-25,21:03,4,3,7
181,2025-05-25T13:06:00+02:00,2025-05-25,21:06,9,6,15
181,2025-05-25T13:08:00+02:00,2025-05-25,21:08,8,2,10
180,2025-05-25T13:06:00+02:00,2025-05-25,21:06,0,1,1
181,2025-05-25T13:26:00+02:00,2025-05-25,21:26,1,3,4
181,2025-05-25T13:27:00+02:00,2025-05-25,21:27,17,2,19
181,2025-05-25T13:28:00+02:00,2025-05-25,21:28,6,8,14
181,2025-05-25T13:31:00+02:00,2025-05-25,21:31,7,5,12
181,2025-05-25T13:34:00+02:00,2025-05-25,21:34,13,3,16
181,2025-05-25T13:38:00+02:00,2025-05-25,21:38,13,9,22
182,2025-05-25T13:25:00+02:00,2025-05-25,21:25,20,16,36
181,2025-05-25T13:46:00+02:00,2025-05-25,21:46,10,3,13
181,2025-05-25T13:47:00+02:00,2025-05-25,21:47,5,11,16
181,2025-05-25T13:54:00+02:00,2025-05-25,21:54,2,15,17
182,2025-05-25T13:40:00+02:00,2025-05-25,21:40,11,6,17
182,2025-05-25T13:45:00+02:00,2025-05-25,21:45,7,6,13
182,2025-05-25T13:50:00+02:00,2025-05-25,21:50,7,26,33
180,2025-05-25T13:53:00+02:00,2025-05-25,21:53,0,1,1
3,2025-05-25T14:15:00+02:00,2025-05-25,22:15,12,3,15
4,2025-05-25T14:12:00+02:00,2025-05-25,22:12,3,0,3
4,2025-05-25T14:14:00+02:00,2025-05-25,22:14,9,8,17
4,2025-05-25T14:16:00+02:00,2025-05-25,22:16,6,12,18
4,2025-05-25T14:17:00+02:00,2025-05-25,22:17,2,4,6
4,2025-05-25T14:18:00+02:00,2025-05-25,22:18,2,3,5
4,2025-05-25T14:24:00+02:00,2025-05-25,22:24,1,4,5
5,2025-05-25T14:15:00+02:00,2025-05-25,22:15,28,12,40
6,2025-05-25T14:17:00+02:00,2025-05-25,22:17,3,9,12
6,2025-05-25T14:22:00+02:00,2025-05-25,22:22,2,12,14
8,2025-05-25T14:24:00+02:00,2025-05-25,22:24,1,0,1
21,2025-05-25T14:10:00+02:00,2025-05-25,22:10,8,21,29
28,2025-05-25T14:11:00+02:00,2025-05-25,22:11,3,0,3
28,2025-05-25T14:12:00+02:00,2025-05-25,22:12,1,0,1
28,2025-05-25T14:15:00+02:00,2025-05-25,22:15,10,2,12
28,2025-05-25T14:17:00+02:00,2025-05-25,22:17,12,2,14
28,2025-05-25T14:18:00+02:00,2025-05-25,22:18,7,1,8
28,2025-05-25T14:22:00+02:00,2025-05-25,22:22,2,3,5
29,2025-05-25T14:12:00+02:00,2025-05-25,22:12,0,1,1
29,2025-05-25T14:15:00+02:00,2025-05-25,22:15,1,0,1
29,2025-05-25T14:18:00+02:00,2025-05-25,22:18,0,2,2
31,2025-05-25T14:13:00+02:00,2025-05-25,22:13,2,2,4
31,2025-05-25T14:21:00+02:00,2025-05-25,22:21,0,6,6
31,2025-05-25T14:22:00+02:00,2025-05-25,22:22,0,1,1
36,2025-05-25T14:10:00+02:00,2025-05-25,22:10,1,0,1
39,2025-05-25T14:16:00+02:00,2025-05-25,22:16,0,1,1
39,2025-05-25T14:22:00+02:00,2025-05-25,22:22,1,0,1
40,2025-05-25T14:10:00+02:00,2025-05-25,22:10,0,1,1
40,2025-05-25T14:13:00+02:00,2025-05-25,22:13,2,0,2
40,2025-05-25T14:19:00+02:00,2025-05-25,22:19,0,1,1
41,2025-05-25T14:10:00+02:00,2025-05-25,22:10,1,0,1
41,2025-05-25T14:11:00+02:00,2025-05-25,22:11,2,0,2
41,2025-05-25T14:12:00+02:00,2025-05-25,22:12,0,5,5
41,2025-05-25T14:13:00+02:00,2025-05-25,22:13,1,0,1
41,2025-05-25T14:16:00+02:00,2025-05-25,22:16,1,0,1
41,2025-05-25T14:22:00+02:00,2025-05-25,22:22,2,7,9
43,2025-05-25T14:10:00+02:00,2025-05-25,22:10,0,6,6
44,2025-05-25T14:15:00+02:00,2025-05-25,22:15,0,1,1
44,2025-05-25T14:20:00+02:00,2025-05-25,22:20,2,3,5
45,2025-05-25T14:10:00+02:00,2025-05-25,22:10,5,7,12
45,2025-05-25T14:16:00+02:00,2025-05-25,22:16,3,7,10
45,2025-05-25T14:18:00+02:00,2025-05-25,22:18,3,4,7
45,2025-05-25T14:20:00+02:00,2025-05-25,22:20,1,0,1
45,2025-05-25T14:22:00+02:00,2025-05-25,22:22,5,0,5
47,2025-05-25T14:10:00+02:00,2025-05-25,22:10,1,3,4
47,2025-05-25T14:11:00+02:00,2025-05-25,22:11,2,4,6
47,2025-05-25T14:15:00+02:00,2025-05-25,22:15,5,2,7
47,2025-05-25T14:17:00+02:00,2025-05-25,22:17,1,13,14
47,2025-05-25T14:24:00+02:00,2025-05-25,22:24,3,2,5
50,2025-05-25T14:10:00+02:00,2025-05-25,22:10,4,0,4
50,2025-05-25T14:13:00+02:00,2025-05-25,22:13,2,2,4
50,2025-05-25T14:15:00+02:00,2025-05-25,22:15,2,0,2
50,2025-05-25T14:19:00+02:00,2025-05-25,22:19,1,0,1
50,2025-05-25T14:20:00+02:00,2025-05-25,22:20,3,0,3
50,2025-05-25T14:22:00+02:00,2025-05-25,22:22,1,3,4
54,2025-05-25T14:23:00+02:00,2025-05-25,22:23,1,0,1
59,2025-05-25T14:10:00+02:00,2025-05-25,22:10,5,12,17
59,2025-05-25T14:20:00+02:00,2025-05-25,22:20,5,6,11
61,2025-05-25T14:11:00+02:00,2025-05-25,22:11,4,1,5
61,2025-05-25T14:12:00+02:00,2025-05-25,22:12,2,0,2
61,2025-05-25T14:13:00+02:00,2025-05-25,22:13,4,3,7
61,2025-05-25T14:16:00+02:00,2025-05-25,22:16,2,2,4
61,2025-05-25T14:20:00+02:00,2025-05-25,22:20,3,2,5
61,2025-05-25T14:21:00+02:00,2025-05-25,22:21,3,0,3
61,2025-05-25T14:23:00+02:00,2025-05-25,22:23,2,1,3
66,2025-05-25T14:12:00+02:00,2025-05-25,22:12,9,3,12
66,2025-05-25T14:16:00+02:00,2025-05-25,22:16,6,8,14
66,2025-05-25T14:17:00+02:00,2025-05-25,22:17,12,5,17
66,2025-05-25T14:20:00+02:00,2025-05-25,22:20,7,10,17
66,2025-05-25T14:22:00+02:00,2025-05-25,22:22,9,10,19
69,2025-05-25T14:24:00+02:00,2025-05-25,22:24,0,1,1
77,2025-05-25T14:15:00+02:00,2025-05-25,22:15,1,0,1
78,2025-05-25T14:16:00+02:00,2025-05-25,22:16,0,3,3
78,2025-05-25T14:21:00+02:00,2025-05-25,22:21,1,0,1
84,2025-05-25T14:15:00+02:00,2025-05-25,22:15,22,25,47
107,2025-05-25T14:15:00+02:00,2025-05-25,22:15,2,0,2
107,2025-05-25T14:20:00+02:00,2025-05-25,22:20,5,0,5
108,2025-05-25T14:11:00+02:00,2025-05-25,22:11,0,1,1
108,2025-05-25T14:13:00+02:00,2025-05-25,22:13,2,2,4
108,2025-05-25T14:18:00+02:00,2025-05-25,22:18,1,1,2
108,2025-05-25T14:21:00+02:00,2025-05-25,22:21,3,0,3
108,2025-05-25T14:24:00+02:00,2025-05-25,22:24,0,1,1
132,2025-05-25T14:15:00+02:00,2025-05-25,22:15,7,2,9
134,2025-05-25T14:15:00+02:00,2025-05-25,22:15,13,7,20
135,2025-05-25T14:10:00+02:00,2025-05-25,22:10,12,11,23
165,2025-05-25T14:15:00+02:00,2025-05-25,22:15,1,0,1
167,2025-05-25T14:10:00+02:00,2025-05-25,22:10,1,2,3
1,2025-05-25T14:10:00+02:00,2025-05-25,22:10,4,0,4
1,2025-05-25T14:15:00+02:00,2025-05-25,22:15,1,0,1
1,2025-05-25T14:16:00+02:00,2025-05-25,22:16,2,10,12
1,2025-05-25T14:21:00+02:00,2025-05-25,22:21,1,0,1
2,2025-05-25T14:16:00+02:00,2025-05-25,22:16,0,5,5
2,2025-05-25T14:21:00+02:00,2025-05-25,22:21,0,1,1
2,2025-05-25T14:24:00+02:00,2025-05-25,22:24,0,2,2
9,2025-05-25T14:12:00+02:00,2025-05-25,22:12,2,0,2
11,2025-05-25T14:10:00+02:00,2025-05-25,22:10,1,7,8
12,2025-05-25T14:19:00+02:00,2025-05-25,22:19,2,0,2
12,2025-05-25T14:21:00+02:00,2025-05-25,22:21,0,2,2
17,2025-05-25T14:11:00+02:00,2025-05-25,22:11,1,3,4
18,2025-05-25T14:12:00+02:00,2025-05-25,22:12,1,0,1
18,2025-05-25T14:15:00+02:00,2025-05-25,22:15,1,0,1
18,2025-05-25T14:22:00+02:00,2025-05-25,22:22,0,1,1
19,2025-05-25T14:10:00+02:00,2025-05-25,22:10,1,4,5
19,2025-05-25T14:11:00+02:00,2025-05-25,22:11,5,5,10
19,2025-05-25T14:13:00+02:00,2025-05-25,22:13,2,2,4
19,2025-05-25T14:23:00+02:00,2025-05-25,22:23,3,7,10
19,2025-05-25T14:24:00+02:00,2025-05-25,22:24,5,3,8
20,2025-05-25T14:18:00+02:00,2025-05-25,22:18,0,1,1
20,2025-05-25T14:19:00+02:00,2025-05-25,22:19,0,4,4
20,2025-05-25T14:20:00+02:00,2025-05-25,22:20,1,0,1
20,2025-05-25T14:23:00+02:00,2025-05-25,22:23,1,1,2
23,2025-05-25T14:10:00+02:00,2025-05-25,22:10,0,4,4
23,2025-05-25T14:20:00+02:00,2025-05-25,22:20,0,3,3
23,2025-05-25T14:24:00+02:00,2025-05-25,22:24,0,6,6
24,2025-05-25T14:11:00+02:00,2025-05-25,22:11,0,1,1
24,2025-05-25T14:12:00+02:00,2025-05-25,22:12,1,1,2
24,2025-05-25T14:14:00+02:00,2025-05-25,22:14,0,1,1
24,2025-05-25T14:16:00+02:00,2025-05-25,22:16,4,4,8
24,2025-05-25T14:22:00+02:00,2025-05-25,22:22,0,4,4
24,2025-05-25T14:24:00+02:00,2025-05-25,22:24,3,6,9
25,2025-05-25T14:10:00+02:00,2025-05-25,22:10,7,8,15
27,2025-05-25T14:10:00+02:00,2025-05-25,22:10,0,2,2
27,2025-05-25T14:16:00+02:00,2025-05-25,22:16,2,0,2
30,2025-05-25T14:14:00+02:00,2025-05-25,22:14,1,3,4
30,2025-05-25T14:20:00+02:00,2025-05-25,22:20,1,0,1
35,2025-05-25T14:10:00+02:00,2025-05-25,22:10,8,8,16
35,2025-05-25T14:12:00+02:00,2025-05-25,22:12,7,8,15
35,2025-05-25T14:18:00+02:00,2025-05-25,22:18,1,0,1
35,2025-05-25T14:21:00+02:00,2025-05-25,22:21,2,5,7
35,2025-05-25T14:24:00+02:00,2025-05-25,22:24,4,5,9
48,2025-05-25T14:18:00+02:00,2025-05-25,22:18,2,0,2
48,2025-05-25T14:22:00+02:00,2025-05-25,22:22,4,1,5
48,2025-05-25T14:23:00+02:00,2025-05-25,22:23,2,0,2
51,2025-05-25T14:20:00+02:00,2025-05-25,22:20,0,2,2
52,2025-05-25T14:10:00+02:00,2025-05-25,22:10,3,1,4
52,2025-05-25T14:14:00+02:00,2025-05-25,22:14,3,1,4
52,2025-05-25T14:18:00+02:00,2025-05-25,22:18,0,6,6
52,2025-05-25T14:23:00+02:00,2025-05-25,22:23,0,4,4
53,2025-05-25T14:15:00+02:00,2025-05-25,22:15,1,0,1
56,2025-05-25T14:11:00+02:00,2025-05-25,22:11,0,5,5
56,2025-05-25T14:14:00+02:00,2025-05-25,22:14,0,1,1
56,2025-05-25T14:19:00+02:00,2025-05-25,22:19,5,2,7
56,2025-05-25T14:21:00+02:00,2025-05-25,22:21,6,9,15
56,2025-05-25T14:23:00+02:00,2025-05-25,22:23,4,4,8
58,2025-05-25T14:10:00+02:00,2025-05-25,22:10,0,2,2
58,2025-05-25T14:13:00+02:00,2025-05-25,22:13,1,3,4
58,2025-05-25T14:18:00+02:00,2025-05-25,22:18,1,4,5
58,2025-05-25T14:19:00+02:00,2025-05-25,22:19,1,1,2
58,2025-05-25T14:20:00+02:00,2025-05-25,22:20,6,6,12
58,2025-05-25T14:23:00+02:00,2025-05-25,22:23,0,2,2
58,2025-05-25T14:24:00+02:00,2025-05-25,22:24,3,0,3
62,2025-05-25T14:14:00+02:00,2025-05-25,22:14,2,1,3
62,2025-05-25T14:22:00+02:00,2025-05-25,22:22,2,2,4
62,2025-05-25T14:23:00+02:00,2025-05-25,22:23,0,1,1
63,2025-05-25T14:14:00+02:00,2025-05-25,22:14,1,1,2
63,2025-05-25T14:19:00+02:00,2025-05-25,22:19,0,2,2
63,2025-05-25T14:24:00+02:00,2025-05-25,22:24,0,1,1
67,2025-05-25T14:12:00+02:00,2025-05-25,22:12,0,8,8
67,2025-05-25T14:13:00+02:00,2025-05-25,22:13,1,2,3
67,2025-05-25T14:24:00+02:00,2025-05-25,22:24,0,3,3
68,2025-05-25T14:14:00+02:00,2025-05-25,22:14,0,3,3
68,2025-05-25T14:16:00+02:00,2025-05-25,22:16,1,0,1
68,2025-05-25T14:19:00+02:00,2025-05-25,22:19,0,1,1
72,2025-05-25T14:12:00+02:00,2025-05-25,22:12,2,0,2
72,2025-05-25T14:13:00+02:00,2025-05-25,22:13,0,2,2
72,2025-05-25T14:18:00+02:00,2025-05-25,22:18,1,0,1
72,2025-05-25T14:19:00+02:00,2025-05-25,22:19,2,0,2
76,2025-05-25T14:16:00+02:00,2025-05-25,22:16,0,1,1
79,2025-05-25T14:12:00+02:00,2025-05-25,22:12,2,10,12
79,2025-05-25T14:17:00+02:00,2025-05-25,22:17,0,3,3
79,2025-05-25T14:18:00+02:00,2025-05-25,22:18,2,3,5
79,2025-05-25T14:19:00+02:00,2025-05-25,22:19,0,6,6
79,2025-05-25T14:20:00+02:00,2025-05-25,22:20,1,2,3
79,2025-05-25T14:23:00+02:00,2025-05-25,22:23,0,2,2
85,2025-05-25T14:10:00+02:00,2025-05-25,22:10,0,1,1
86,2025-05-25T14:15:00+02:00,2025-05-25,22:15,0,1,1
117,2025-05-25T14:20:00+02:00,2025-05-25,22:20,8,3,11
139,2025-05-25T14:10:00+02:00,2025-05-25,22:10,1,0,1
142,2025-05-25T14:10:00+02:00,2025-05-25,22:10,1,0,1
142,2025-05-25T14:20:00+02:00,2025-05-25,22:20,0,1,1
181,2025-05-25T14:25:00+02:00,2025-05-25,22:25,5,7,12
181,2025-05-25T14:26:00+02:00,2025-05-25,22:26,16,2,18
181,2025-05-25T14:29:00+02:00,2025-05-25,22:29,5,8,13
181,2025-05-25T14:30:00+02:00,2025-05-25,22:30,13,4,17
181,2025-05-25T14:33:00+02:00,2025-05-25,22:33,8,0,8
181,2025-05-25T14:34:00+02:00,2025-05-25,22:34,8,4,12
181,2025-05-25T14:36:00+02:00,2025-05-25,22:36,5,4,9
182,2025-05-25T14:25:00+02:00,2025-05-25,22:25,9,1,10
182,2025-05-25T14:30:00+02:00,2025-05-25,22:30,2,8,10
182,2025-05-25T14:35:00+02:00,2025-05-25,22:35,11,9,20
3,2025-05-25T14:27:00+02:00,2025-05-25,22:27,0,9,9
3,2025-05-25T14:32:00+02:00,2025-05-25,22:32,12,7,19
3,2025-05-25T14:34:00+02:00,2025-05-25,22:34,9,2,11
3,2025-05-25T14:37:00+02:00,2025-05-25,22:37,9,2,11
3,2025-05-25T14:38:00+02:00,2025-05-25,22:38,7,3,10
4,2025-05-25T14:25:00+02:00,2025-05-25,22:25,1,10,11
4,2025-05-25T14:29:00+02:00,2025-05-25,22:29,5,6,11
4,2025-05-25T14:30:00+02:00,2025-05-25,22:30,1,4,5
4,2025-05-25T14:31:00+02:00,2025-05-25,22:31,2,1,3
5,2025-05-25T14:25:00+02:00,2025-05-25,22:25,22,13,35
5,2025-05-25T14:35:00+02:00,2025-05-25,22:35,8,10,18
6,2025-05-25T14:30:00+02:00,2025-05-25,22:30,2,10,12
6,2025-05-25T14:31:00+02:00,2025-05-25,22:31,1,4,5
6,2025-05-25T14:32:00+02:00,2025-05-25,22:32,1,1,2
6,2025-05-25T14:36:00+02:00,2025-05-25,22:36,6,1,7
8,2025-05-25T14:39:00+02:00,2025-05-25,22:39,0,1,1
21,2025-05-25T14:25:00+02:00,2025-05-25,22:25,12,16,28
21,2025-05-25T14:35:00+02:00,2025-05-25,22:35,7,11,18
28,2025-05-25T14:30:00+02:00,2025-05-25,22:30,1,1,2
28,2025-05-25T14:32:00+02:00,2025-05-25,22:32,0,1,1
28,2025-05-25T14:34:00+02:00,2025-05-25,22:34,2,0,2
28,2025-05-25T14:39:00+02:00,2025-05-25,22:39,2,1,3
29,2025-05-25T14:35:00+02:00,2025-05-25,22:35,2,5,7
29,2025-05-25T14:36:00+02:00,2025-05-25,22:36,1,4,5
31,2025-05-25T14:26:00+02:00,2025-05-25,22:26,3,3,6
31,2025-05-25T14:27:00+02:00,2025-05-25,22:27,0,3,3
31,2025-05-25T14:28:00+02:00,2025-05-25,22:28,0,1,1
31,2025-05-25T14:29:00+02:00,2025-05-25,22:29,0,1,1
31,2025-05-25T14:30:00+02:00,2025-05-25,22:30,1,3,4
36,2025-05-25T14:26:00+02:00,2025-05-25,22:26,3,0,3
36,2025-05-25T14:28:00+02:00,2025-05-25,22:28,0,2,2
36,2025-05-25T14:30:00+02:00,2025-05-25,22:30,0,1,1
36,2025-05-25T14:33:00+02:00,2025-05-25,22:33,0,2,2
36,2025-05-25T14:36:00+02:00,2025-05-25,22:36,1,0,1
37,2025-05-25T14:28:00+02:00,2025-05-25,22:28,2,13,15
37,2025-05-25T14:30:00+02:00,2025-05-25,22:30,2,2,4
37,2025-05-25T14:34:00+02:00,2025-05-25,22:34,3,5,8
37,2025-05-25T14:37:00+02:00,2025-05-25,22:37,4,2,6
40,2025-05-25T14:29:00+02:00,2025-05-25,22:29,1,2,3
40,2025-05-25T14:32:00+02:00,2025-05-25,22:32,1,0,1
41,2025-05-25T14:26:00+02:00,2025-05-25,22:26,1,0,1
41,2025-05-25T14:39:00+02:00,2025-05-25,22:39,0,1,1
43,2025-05-25T14:25:00+02:00,2025-05-25,22:25,0,2,2
44,2025-05-25T14:30:00+02:00,2025-05-25,22:30,0,1,1
45,2025-05-25T14:25:00+02:00,2025-05-25,22:25,1,9,10
45,2025-05-25T14:27:00+02:00,2025-05-25,22:27,0,6,6
45,2025-05-25T14:28:00+02:00,2025-05-25,22:28,2,0,2
45,2025-05-25T14:31:00+02:00,2025-05-25,22:31,3,9,12
45,2025-05-25T14:32:00+02:00,2025-05-25,22:32,4,1,5
45,2025-05-25T14:36:00+02:00,2025-05-25,22:36,3,3,6
45,2025-05-25T14:37:00+02:00,2025-05-25,22:37,3,3,6
45,2025-05-25T14:38:00+02:00,2025-05-25,22:38,0,3,3
47,2025-05-25T14:27:00+02:00,2025-05-25,22:27,6,4,10
47,2025-05-25T14:38:00+02:00,2025-05-25,22:38,6,2,8
50,2025-05-25T14:36:00+02:00,2025-05-25,22:36,3,1,4
50,2025-05-25T14:39:00+02:00,2025-05-25,22:39,2,0,2
54,2025-05-25T14:25:00+02:00,2025-05-25,22:25,0,1,1
54,2025-05-25T14:30:00+02:00,2025-05-25,22:30,0,4,4
54,2025-05-25T14:34:00+02:00,2025-05-25,22:34,3,3,6
54,2025-05-25T14:36:00+02:00,2025-05-25,22:36,1,1,2
59,2025-05-25T14:35:00+02:00,2025-05-25,22:35,5,4,9
61,2025-05-25T14:27:00+02:00,2025-05-25,22:27,6,6,12
61,2025-05-25T14:29:00+02:00,2025-05-25,22:29,1,2,3
61,2025-05-25T14:30:00+02:00,2025-05-25,22:30,3,1,4
61,2025-05-25T14:33:00+02:00,2025-05-25,22:33,5,0,5
61,2025-05-25T14:37:00+02:00,2025-05-25,22:37,5,1,6
66,2025-05-25T14:27:00+02:00,2025-05-25,22:27,10,4,14
66,2025-05-25T14:29:00+02:00,2025-05-25,22:29,5,5,10
66,2025-05-25T14:30:00+02:00,2025-05-25,22:30,6,6,12
66,2025-05-25T14:33:00+02:00,2025-05-25,22:33,6,7,13
70,2025-05-25T14:39:00+02:00,2025-05-25,22:39,0,1,1
75,2025-05-25T14:36:00+02:00,2025-05-25,22:36,0,1,1
75,2025-05-25T14:37:00+02:00,2025-05-25,22:37,1,0,1
77,2025-05-25T14:25:00+02:00,2025-05-25,22:25,4,5,9
77,2025-05-25T14:30:00+02:00,2025-05-25,22:30,2,5,7
78,2025-05-25T14:26:00+02:00,2025-05-25,22:26,0,1,1
78,2025-05-25T14:31:00+02:00,2025-05-25,22:31,0,1,1
84,2025-05-25T14:30:00+02:00,2025-05-25,22:30,17,30,47
84,2025-05-25T14:35:00+02:00,2025-05-25,22:35,18,14,32
107,2025-05-25T14:30:00+02:00,2025-05-25,22:30,6,1,7
107,2025-05-25T14:35:00+02:00,2025-05-25,22:35,2,3,5
108,2025-05-25T14:30:00+02:00,2025-05-25,22:30,1,1,2
108,2025-05-25T14:31:00+02:00,2025-05-25,22:31,1,0,1
108,2025-05-25T14:33:00+02:00,2025-05-25,22:33,6,0,6
108,2025-05-25T14:35:00+02:00,2025-05-25,22:35,0,1,1
108,2025-05-25T14:37:00+02:00,2025-05-25,22:37,2,3,5
131,2025-05-25T14:25:00+02:00,2025-05-25,22:25,5,6,11
131,2025-05-25T14:30:00+02:00,2025-05-25,22:30,1,3,4
132,2025-05-25T14:30:00+02:00,2025-05-25,22:30,4,6,10
134,2025-05-25T14:30:00+02:00,2025-05-25,22:30,27,6,33
162,2025-05-25T14:35:00+02:00,2025-05-25,22:35,6,1,7
179,2025-05-25T14:30:00+02:00,2025-05-25,22:30,2,3,5
1,2025-05-25T14:30:00+02:00,2025-05-25,22:30,1,0,1
1,2025-05-25T14:36:00+02:00,2025-05-25,22:36,0,1,1
1,2025-05-25T14:37:00+02:00,2025-05-25,22:37,0,2,2
1,2025-05-25T14:38:00+02:00,2025-05-25,22:38,3,0,3
2,2025-05-25T14:29:00+02:00,2025-05-25,22:29,1,11,12
2,2025-05-25T14:31:00+02:00,2025-05-25,22:31,0,6,6
9,2025-05-25T14:33:00+02:00,2025-05-25,22:33,0,1,1
9,2025-05-25T14:34:00+02:00,2025-05-25,22:34,1,0,1
9,2025-05-25T14:35:00+02:00,2025-05-25,22:35,1,0,1
10,2025-05-25T14:29:00+02:00,2025-05-25,22:29,0,4,4
12,2025-05-25T14:26:00+02:00,2025-05-25,22:26,3,0,3
12,2025-05-25T14:27:00+02:00,2025-05-25,22:27,1,0,1
12,2025-05-25T14:28:00+02:00,2025-05-25,22:28,1,2,3
12,2025-05-25T14:29:00+02:00,2025-05-25,22:29,3,0,3
12,2025-05-25T14:37:00+02:00,2025-05-25,22:37,5,0,5
17,2025-05-25T14:29:00+02:00,2025-05-25,22:29,4,0,4
19,2025-05-25T14:25:00+02:00,2025-05-25,22:25,1,1,2
19,2025-05-25T14:27:00+02:00,2025-05-25,22:27,0,8,8
19,2025-05-25T14:28:00+02:00,2025-05-25,22:28,6,12,18
19,2025-05-25T14:31:00+02:00,2025-05-25,22:31,1,11,12
19,2025-05-25T14:32:00+02:00,2025-05-25,22:32,6,0,6
19,2025-05-25T14:37:00+02:00,2025-05-25,22:37,0,2,2
19,2025-05-25T14:38:00+02:00,2025-05-25,22:38,3,6,9
20,2025-05-25T14:28:00+02:00,2025-05-25,22:28,2,1,3
20,2025-05-25T14:30:00+02:00,2025-05-25,22:30,3,1,4
20,2025-05-25T14:33:00+02:00,2025-05-25,22:33,7,10,17
20,2025-05-25T14:39:00+02:00,2025-05-25,22:39,1,6,7
23,2025-05-25T14:25:00+02:00,2025-05-25,22:25,0,4,4
23,2025-05-25T14:26:00+02:00,2025-05-25,22:26,1,0,1
24,2025-05-25T14:27:00+02:00,2025-05-25,22:27,3,0,3
24,2025-05-25T14:38:00+02:00,2025-05-25,22:38,4,2,6
24,2025-05-25T14:39:00+02:00,2025-05-25,22:39,6,1,7
25,2025-05-25T14:30:00+02:00,2025-05-25,22:30,2,6,8
25,2025-05-25T14:35:00+02:00,2025-05-25,22:35,9,4,13
27,2025-05-25T14:25:00+02:00,2025-05-25,22:25,2,0,2
27,2025-05-25T14:32:00+02:00,2025-05-25,22:32,1,0,1
27,2025-05-25T14:38:00+02:00,2025-05-25,22:38,0,3,3
30,2025-05-25T14:32:00+02:00,2025-05-25,22:32,6,3,9
30,2025-05-25T14:33:00+02:00,2025-05-25,22:33,0,4,4
30,2025-05-25T14:36:00+02:00,2025-05-25,22:36,3,7,10
30,2025-05-25T14:37:00+02:00,2025-05-25,22:37,1,9,10
30,2025-05-25T14:38:00+02:00,2025-05-25,22:38,5,4,9
35,2025-05-25T14:28:00+02:00,2025-05-25,22:28,1,1,2
35,2025-05-25T14:29:00+02:00,2025-05-25,22:29,0,2,2
35,2025-05-25T14:37:00+02:00,2025-05-25,22:37,1,11,12
48,2025-05-25T14:27:00+02:00,2025-05-25,22:27,0,3,3
48,2025-05-25T14:28:00+02:00,2025-05-25,22:28,0,3,3
48,2025-05-25T14:32:00+02:00,2025-05-25,22:32,0,2,2
48,2025-05-25T14:34:00+02:00,2025-05-25,22:34,6,0,6
48,2025-05-25T14:37:00+02:00,2025-05-25,22:37,0,1,1
49,2025-05-25T14:29:00+02:00,2025-05-25,22:29,0,4,4
49,2025-05-25T14:30:00+02:00,2025-05-25,22:30,6,6,12
49,2025-05-25T14:31:00+02:00,2025-05-25,22:31,1,0,1
49,2025-05-25T14:38:00+02:00,2025-05-25,22:38,1,0,1
51,2025-05-25T14:26:00+02:00,2025-05-25,22:26,4,0,4
51,2025-05-25T14:31:00+02:00,2025-05-25,22:31,1,0,1
51,2025-05-25T14:32:00+02:00,2025-05-25,22:32,0,3,3
51,2025-05-25T14:33:00+02:00,2025-05-25,22:33,3,0,3
52,2025-05-25T14:35:00+02:00,2025-05-25,22:35,2,0,2
53,2025-05-25T14:25:00+02:00,2025-05-25,22:25,2,2,4
53,2025-05-25T14:27:00+02:00,2025-05-25,22:27,0,2,2
53,2025-05-25T14:31:00+02:00,2025-05-25,22:31,3,0,3
53,2025-05-25T14:35:00+02:00,2025-05-25,22:35,0,6,6
53,2025-05-25T14:36:00+02:00,2025-05-25,22:36,0,2,2
56,2025-05-25T14:27:00+02:00,2025-05-25,22:27,2,0,2
56,2025-05-25T14:31:00+02:00,2025-05-25,22:31,7,2,9
56,2025-05-25T14:35:00+02:00,2025-05-25,22:35,2,0,2
56,2025-05-25T14:39:00+02:00,2025-05-25,22:39,2,4,6
58,2025-05-25T14:26:00+02:00,2025-05-25,22:26,1,1,2
58,2025-05-25T14:37:00+02:00,2025-05-25,22:37,0,1,1
58,2025-05-25T14:38:00+02:00,2025-05-25,22:38,13,0,13
58,2025-05-25T14:39:00+02:00,2025-05-25,22:39,3,0,3
62,2025-05-25T14:26:00+02:00,2025-05-25,22:26,0,1,1
62,2025-05-25T14:29:00+02:00,2025-05-25,22:29,0,2,2
62,2025-05-25T14:38:00+02:00,2025-05-25,22:38,1,0,1
63,2025-05-25T14:26:00+02:00,2025-05-25,22:26,0,3,3
67,2025-05-25T14:33:00+02:00,2025-05-25,22:33,0,1,1
68,2025-05-25T14:27:00+02:00,2025-05-25,22:27,2,0,2
68,2025-05-25T14:32:00+02:00,2025-05-25,22:32,1,0,1
72,2025-05-25T14:37:00+02:00,2025-05-25,22:37,1,0,1
79,2025-05-25T14:25:00+02:00,2025-05-25,22:25,3,0,3
79,2025-05-25T14:26:00+02:00,2025-05-25,22:26,9,0,9
79,2025-05-25T14:27:00+02:00,2025-05-25,22:27,1,2,3
79,2025-05-25T14:28:00+02:00,2025-05-25,22:28,0,2,2
79,2025-05-25T14:29:00+02:00,2025-05-25,22:29,0,2,2
79,2025-05-25T14:31:00+02:00,2025-05-25,22:31,0,5,5
79,2025-05-25T14:32:00+02:00,2025-05-25,22:32,6,0,6
79,2025-05-25T14:36:00+02:00,2025-05-25,22:36,0,3,3
79,2025-05-25T14:38:00+02:00,2025-05-25,22:38,1,0,1
117,2025-05-25T14:35:00+02:00,2025-05-25,22:35,5,0,5
139,2025-05-25T14:30:00+02:00,2025-05-25,22:30,1,0,1
141,2025-05-25T14:25:00+02:00,2025-05-25,22:25,1,3,4
141,2025-05-25T14:35:00+02:00,2025-05-25,22:35,5,1,6
142,2025-05-25T14:25:00+02:00,2025-05-25,22:25,0,1,1
142,2025-05-25T14:30:00+02:00,2025-05-25,22:30,1,0,1
142,2025-05-25T14:35:00+02:00,2025-05-25,22:35,2,2,4
164,2025-05-25T14:25:00+02:00,2025-05-25,22:25,0,2,2
164,2025-05-25T14:35:00+02:00,2025-05-25,22:35,4,0,4
3,2025-05-25T13:56:00+02:00,2025-05-25,21:56,2,13,15
3,2025-05-25T13:57:00+02:00,2025-05-25,21:57,0,3,3
3,2025-05-25T13:58:00+02:00,2025-05-25,21:58,15,4,19
3,2025-05-25T13:59:00+02:00,2025-05-25,21:59,18,9,27
4,2025-05-25T14:00:00+02:00,2025-05-25,22:00,7,6,13
4,2025-05-25T14:01:00+02:00,2025-05-25,22:01,7,14,21
4,2025-05-25T14:02:00+02:00,2025-05-25,22:02,2,8,10
4,2025-05-25T14:04:00+02:00,2025-05-25,22:04,7,9,16
4,2025-05-25T14:05:00+02:00,2025-05-25,22:05,6,3,9
4,2025-05-25T14:07:00+02:00,2025-05-25,22:07,6,15,21
4,2025-05-25T14:08:00+02:00,2025-05-25,22:08,3,7,10
6,2025-05-25T14:01:00+02:00,2025-05-25,22:01,6,1,7
6,2025-05-25T14:03:00+02:00,2025-05-25,22:03,8,5,13
28,2025-05-25T13:56:00+02:00,2025-05-25,21:56,2,1,3
28,2025-05-25T14:00:00+02:00,2025-05-25,22:00,74,5,79
28,2025-05-25T14:07:00+02:00,2025-05-25,22:07,22,0,22
28,2025-05-25T14:09:00+02:00,2025-05-25,22:09,8,1,9
29,2025-05-25T13:56:00+02:00,2025-05-25,21:56,2,1,3
29,2025-05-25T13:59:00+02:00,2025-05-25,21:59,2,6,8
29,2025-05-25T14:02:00+02:00,2025-05-25,22:02,0,1,1
29,2025-05-25T14:05:00+02:00,2025-05-25,22:05,1,0,1
29,2025-05-25T14:06:00+02:00,2025-05-25,22:06,3,0,3
29,2025-05-25T14:08:00+02:00,2025-05-25,22:08,1,0,1
31,2025-05-25T13:56:00+02:00,2025-05-25,21:56,6,1,7
31,2025-05-25T13:59:00+02:00,2025-05-25,21:59,0,2,2
31,2025-05-25T14:09:00+02:00,2025-05-25,22:09,4,3,7
36,2025-05-25T13:56:00+02:00,2025-05-25,21:56,1,0,1
36,2025-05-25T13:58:00+02:00,2025-05-25,21:58,3,7,10
36,2025-05-25T14:06:00+02:00,2025-05-25,22:06,1,1,2
39,2025-05-25T13:57:00+02:00,2025-05-25,21:57,2,0,2
39,2025-05-25T14:04:00+02:00,2025-05-25,22:04,1,0,1
41,2025-05-25T13:55:00+02:00,2025-05-25,21:55,0,2,2
41,2025-05-25T13:57:00+02:00,2025-05-25,21:57,0,2,2
41,2025-05-25T14:02:00+02:00,2025-05-25,22:02,0,4,4
41,2025-05-25T14:08:00+02:00,2025-05-25,22:08,1,4,5
44,2025-05-25T13:55:00+02:00,2025-05-25,21:55,2,0,2
45,2025-05-25T14:02:00+02:00,2025-05-25,22:02,5,4,9
45,2025-05-25T14:06:00+02:00,2025-05-25,22:06,8,7,15
47,2025-05-25T13:55:00+02:00,2025-05-25,21:55,4,4,8
47,2025-05-25T13:59:00+02:00,2025-05-25,21:59,8,5,13
47,2025-05-25T14:02:00+02:00,2025-05-25,22:02,7,0,7
47,2025-05-25T14:03:00+02:00,2025-05-25,22:03,0,10,10
47,2025-05-25T14:04:00+02:00,2025-05-25,22:04,11,1,12
47,2025-05-25T14:05:00+02:00,2025-05-25,22:05,1,6,7
47,2025-05-25T14:07:00+02:00,2025-05-25,22:07,5,7,12
50,2025-05-25T13:58:00+02:00,2025-05-25,21:58,1,1,2
50,2025-05-25T14:00:00+02:00,2025-05-25,22:00,0,5,5
50,2025-05-25T14:02:00+02:00,2025-05-25,22:02,1,1,2
50,2025-05-25T14:06:00+02:00,2025-05-25,22:06,2,0,2
50,2025-05-25T14:09:00+02:00,2025-05-25,22:09,2,0,2
54,2025-05-25T13:57:00+02:00,2025-05-25,21:57,1,3,4
54,2025-05-25T13:59:00+02:00,2025-05-25,21:59,1,1,2
54,2025-05-25T14:02:00+02:00,2025-05-25,22:02,0,4,4
54,2025-05-25T14:03:00+02:00,2025-05-25,22:03,1,0,1
54,2025-05-25T14:04:00+02:00,2025-05-25,22:04,5,2,7
61,2025-05-25T13:55:00+02:00,2025-05-25,21:55,5,3,8
61,2025-05-25T13:56:00+02:00,2025-05-25,21:56,2,1,3
61,2025-05-25T13:58:00+02:00,2025-05-25,21:58,3,1,4
61,2025-05-25T14:04:00+02:00,2025-05-25,22:04,8,2,10
61,2025-05-25T14:05:00+02:00,2025-05-25,22:05,1,1,2
61,2025-05-25T14:08:00+02:00,2025-05-25,22:08,3,0,3
66,2025-05-25T13:57:00+02:00,2025-05-25,21:57,26,8,34
66,2025-05-25T13:59:00+02:00,2025-05-25,21:59,13,0,13
66,2025-05-25T14:04:00+02:00,2025-05-25,22:04,7,2,9
66,2025-05-25T14:08:00+02:00,2025-05-25,22:08,6,9,15
69,2025-05-25T14:07:00+02:00,2025-05-25,22:07,3,3,6
70,2025-05-25T13:59:00+02:00,2025-05-25,21:59,2,0,2
70,2025-05-25T14:06:00+02:00,2025-05-25,22:06,2,4,6
70,2025-05-25T14:07:00+02:00,2025-05-25,22:07,1,1,2
77,2025-05-25T14:00:00+02:00,2025-05-25,22:00,3,0,3
78,2025-05-25T13:56:00+02:00,2025-05-25,21:56,0,1,1
78,2025-05-25T14:01:00+02:00,2025-05-25,22:01,1,0,1
84,2025-05-25T14:00:00+02:00,2025-05-25,22:00,22,36,58
87,2025-05-25T14:00:00+02:00,2025-05-25,22:00,0,2,2
107,2025-05-25T14:00:00+02:00,2025-05-25,22:00,5,6,11
107,2025-05-25T14:05:00+02:00,2025-05-25,22:05,3,6,9
108,2025-05-25T13:57:00+02:00,2025-05-25,21:57,3,4,7
108,2025-05-25T13:58:00+02:00,2025-05-25,21:58,0,2,2
118,2025-05-25T13:55:00+02:00,2025-05-25,21:55,1,0,1
131,2025-05-25T13:55:00+02:00,2025-05-25,21:55,12,1,13
133,2025-05-25T13:55:00+02:00,2025-05-25,21:55,26,20,46
134,2025-05-25T13:55:00+02:00,2025-05-25,21:55,19,10,29
135,2025-05-25T14:05:00+02:00,2025-05-25,22:05,3,6,9
162,2025-05-25T13:55:00+02:00,2025-05-25,21:55,4,8,12
162,2025-05-25T14:05:00+02:00,2025-05-25,22:05,6,9,15
179,2025-05-25T14:00:00+02:00,2025-05-25,22:00,5,0,5
179,2025-05-25T14:05:00+02:00,2025-05-25,22:05,4,4,8
1,2025-05-25T13:57:00+02:00,2025-05-25,21:57,1,4,5
1,2025-05-25T13:58:00+02:00,2025-05-25,21:58,3,0,3
1,2025-05-25T14:00:00+02:00,2025-05-25,22:00,1,5,6
1,2025-05-25T14:07:00+02:00,2025-05-25,22:07,0,1,1
1,2025-05-25T14:09:00+02:00,2025-05-25,22:09,1,0,1
2,2025-05-25T13:55:00+02:00,2025-05-25,21:55,1,2,3
11,2025-05-25T13:55:00+02:00,2025-05-25,21:55,2,1,3
12,2025-05-25T13:55:00+02:00,2025-05-25,21:55,5,2,7
12,2025-05-25T14:02:00+02:00,2025-05-25,22:02,4,1,5
12,2025-05-25T14:04:00+02:00,2025-05-25,22:04,1,0,1
12,2025-05-25T14:05:00+02:00,2025-05-25,22:05,1,1,2
12,2025-05-25T14:09:00+02:00,2025-05-25,22:09,2,4,6
17,2025-05-25T13:56:00+02:00,2025-05-25,21:56,0,2,2
17,2025-05-25T13:58:00+02:00,2025-05-25,21:58,4,0,4
17,2025-05-25T14:02:00+02:00,2025-05-25,22:02,2,0,2
17,2025-05-25T14:09:00+02:00,2025-05-25,22:09,1,0,1
18,2025-05-25T14:07:00+02:00,2025-05-25,22:07,0,1,1
18,2025-05-25T14:08:00+02:00,2025-05-25,22:08,1,0,1
19,2025-05-25T13:57:00+02:00,2025-05-25,21:57,6,3,9
19,2025-05-25T13:59:00+02:00,2025-05-25,21:59,2,8,10
19,2025-05-25T14:00:00+02:00,2025-05-25,22:00,10,7,17
19,2025-05-25T14:04:00+02:00,2025-05-25,22:04,10,7,17
19,2025-05-25T14:05:00+02:00,2025-05-25,22:05,3,3,6
19,2025-05-25T14:07:00+02:00,2025-05-25,22:07,2,1,3
20,2025-05-25T14:00:00+02:00,2025-05-25,22:00,0,3,3
20,2025-05-25T14:08:00+02:00,2025-05-25,22:08,0,1,1
23,2025-05-25T13:57:00+02:00,2025-05-25,21:57,0,2,2
23,2025-05-25T13:59:00+02:00,2025-05-25,21:59,0,2,2
23,2025-05-25T14:05:00+02:00,2025-05-25,22:05,1,10,11
24,2025-05-25T13:56:00+02:00,2025-05-25,21:56,1,14,15
24,2025-05-25T13:58:00+02:00,2025-05-25,21:58,2,4,6
24,2025-05-25T13:59:00+02:00,2025-05-25,21:59,4,8,12
24,2025-05-25T14:03:00+02:00,2025-05-25,22:03,5,0,5
24,2025-05-25T14:07:00+02:00,2025-05-25,22:07,3,3,6
30,2025-05-25T13:55:00+02:00,2025-05-25,21:55,2,4,6
30,2025-05-25T14:01:00+02:00,2025-05-25,22:01,8,1,9
30,2025-05-25T14:02:00+02:00,2025-05-25,22:02,1,4,5
30,2025-05-25T14:04:00+02:00,2025-05-25,22:04,6,1,7
30,2025-05-25T14:09:00+02:00,2025-05-25,22:09,3,2,5
35,2025-05-25T13:55:00+02:00,2025-05-25,21:55,4,4,8
35,2025-05-25T13:57:00+02:00,2025-05-25,21:57,4,2,6
35,2025-05-25T14:00:00+02:00,2025-05-25,22:00,3,8,11
35,2025-05-25T14:01:00+02:00,2025-05-25,22:01,7,1,8
35,2025-05-25T14:07:00+02:00,2025-05-25,22:07,0,6,6
48,2025-05-25T13:56:00+02:00,2025-05-25,21:56,2,1,3
48,2025-05-25T14:03:00+02:00,2025-05-25,22:03,1,1,2
48,2025-05-25T14:05:00+02:00,2025-05-25,22:05,0,4,4
48,2025-05-25T14:06:00+02:00,2025-05-25,22:06,1,1,2
48,2025-05-25T14:09:00+02:00,2025-05-25,22:09,1,2,3
49,2025-05-25T13:56:00+02:00,2025-05-25,21:56,9,0,9
49,2025-05-25T13:58:00+02:00,2025-05-25,21:58,2,1,3
49,2025-05-25T14:05:00+02:00,2025-05-25,22:05,3,2,5
51,2025-05-25T14:01:00+02:00,2025-05-25,22:01,1,7,8
51,2025-05-25T14:03:00+02:00,2025-05-25,22:03,0,1,1
51,2025-05-25T14:08:00+02:00,2025-05-25,22:08,5,1,6
52,2025-05-25T14:00:00+02:00,2025-05-25,22:00,1,2,3
52,2025-05-25T14:02:00+02:00,2025-05-25,22:02,1,0,1
52,2025-05-25T14:03:00+02:00,2025-05-25,22:03,2,3,5
52,2025-05-25T14:04:00+02:00,2025-05-25,22:04,1,1,2
52,2025-05-25T14:06:00+02:00,2025-05-25,22:06,2,3,5
52,2025-05-25T14:07:00+02:00,2025-05-25,22:07,0,9,9
52,2025-05-25T14:08:00+02:00,2025-05-25,22:08,1,1,2
52,2025-05-25T14:09:00+02:00,2025-05-25,22:09,1,0,1
53,2025-05-25T13:59:00+02:00,2025-05-25,21:59,0,3,3
53,2025-05-25T14:06:00+02:00,2025-05-25,22:06,0,4,4
53,2025-05-25T14:09:00+02:00,2025-05-25,22:09,0,1,1
56,2025-05-25T14:07:00+02:00,2025-05-25,22:07,0,4,4
56,2025-05-25T14:08:00+02:00,2025-05-25,22:08,5,0,5
58,2025-05-25T13:56:00+02:00,2025-05-25,21:56,1,3,4
58,2025-05-25T13:59:00+02:00,2025-05-25,21:59,2,8,10
58,2025-05-25T14:01:00+02:00,2025-05-25,22:01,1,1,2
58,2025-05-25T14:02:00+02:00,2025-05-25,22:02,2,1,3
58,2025-05-25T14:03:00+02:00,2025-05-25,22:03,3,0,3
62,2025-05-25T13:59:00+02:00,2025-05-25,21:59,5,0,5
62,2025-05-25T14:00:00+02:00,2025-05-25,22:00,1,2,3
62,2025-05-25T14:01:00+02:00,2025-05-25,22:01,1,3,4
62,2025-05-25T14:04:00+02:00,2025-05-25,22:04,1,0,1
63,2025-05-25T13:58:00+02:00,2025-05-25,21:58,1,1,2
63,2025-05-25T13:59:00+02:00,2025-05-25,21:59,1,0,1
63,2025-05-25T14:01:00+02:00,2025-05-25,22:01,0,1,1
63,2025-05-25T14:08:00+02:00,2025-05-25,22:08,0,2,2
63,2025-05-25T14:09:00+02:00,2025-05-25,22:09,1,0,1
67,2025-05-25T13:56:00+02:00,2025-05-25,21:56,0,1,1
67,2025-05-25T14:00:00+02:00,2025-05-25,22:00,7,2,9
67,2025-05-25T14:01:00+02:00,2025-05-25,22:01,1,3,4
67,2025-05-25T14:07:00+02:00,2025-05-25,22:07,6,2,8
67,2025-05-25T14:08:00+02:00,2025-05-25,22:08,0,2,2
68,2025-05-25T14:00:00+02:00,2025-05-25,22:00,1,0,1
68,2025-05-25T14:06:00+02:00,2025-05-25,22:06,0,1,1
72,2025-05-25T13:55:00+02:00,2025-05-25,21:55,4,5,9
72,2025-05-25T13:56:00+02:00,2025-05-25,21:56,0,1,1
72,2025-05-25T14:00:00+02:00,2025-05-25,22:00,2,1,3
72,2025-05-25T14:02:00+02:00,2025-05-25,22:02,2,4,6
72,2025-05-25T14:09:00+02:00,2025-05-25,22:09,1,10,11
76,2025-05-25T13:58:00+02:00,2025-05-25,21:58,0,1,1
79,2025-05-25T13:56:00+02:00,2025-05-25,21:56,0,4,4
79,2025-05-25T14:01:00+02:00,2025-05-25,22:01,1,7,8
79,2025-05-25T14:03:00+02:00,2025-05-25,22:03,1,5,6
79,2025-05-25T14:05:00+02:00,2025-05-25,22:05,3,1,4
79,2025-05-25T14:08:00+02:00,2025-05-25,22:08,3,5,8
85,2025-05-25T13:55:00+02:00,2025-05-25,21:55,1,0,1
86,2025-05-25T14:06:00+02:00,2025-05-25,22:06,1,0,1
86,2025-05-25T14:08:00+02:00,2025-05-25,22:08,0,1,1
117,2025-05-25T13:55:00+02:00,2025-05-25,21:55,11,8,19
117,2025-05-25T14:05:00+02:00,2025-05-25,22:05,14,9,23
141,2025-05-25T14:05:00+02:00,2025-05-25,22:05,3,16,19
142,2025-05-25T13:55:00+02:00,2025-05-25,21:55,0,2,2
142,2025-05-25T14:05:00+02:00,2025-05-25,22:05,3,3,6
161,2025-05-25T14:05:00+02:00,2025-05-25,22:05,1,0,1
164,2025-05-25T13:55:00+02:00,2025-05-25,21:55,1,10,11
181,2025-05-25T14:11:00+02:00,2025-05-25,22:11,7,2,9
181,2025-05-25T14:12:00+02:00,2025-05-25,22:12,8,4,12
181,2025-05-25T14:17:00+02:00,2025-05-25,22:17,8,0,8
181,2025-05-25T14:21:00+02:00,2025-05-25,22:21,13,11,24
3,2025-05-25T14:41:00+02:00,2025-05-25,22:41,13,2,15
3,2025-05-25T14:42:00+02:00,2025-05-25,22:42,5,3,8
3,2025-05-25T14:45:00+02:00,2025-05-25,22:45,4,5,9
3,2025-05-25T14:47:00+02:00,2025-05-25,22:47,5,2,7
3,2025-05-25T14:48:00+02:00,2025-05-25,22:48,3,6,9
3,2025-05-25T14:49:00+02:00,2025-05-25,22:49,3,2,5
3,2025-05-25T14:51:00+02:00,2025-05-25,22:51,0,10,10
3,2025-05-25T14:52:00+02:00,2025-05-25,22:52,6,4,10
3,2025-05-25T14:53:00+02:00,2025-05-25,22:53,8,5,13
4,2025-05-25T14:40:00+02:00,2025-05-25,22:40,1,4,5
4,2025-05-25T14:42:00+02:00,2025-05-25,22:42,3,2,5
4,2025-05-25T14:44:00+02:00,2025-05-25,22:44,5,0,5
4,2025-05-25T14:45:00+02:00,2025-05-25,22:45,3,2,5
4,2025-05-25T14:54:00+02:00,2025-05-25,22:54,2,10,12
5,2025-05-25T14:40:00+02:00,2025-05-25,22:40,4,13,17
5,2025-05-25T14:45:00+02:00,2025-05-25,22:45,13,5,18
5,2025-05-25T14:50:00+02:00,2025-05-25,22:50,4,6,10
6,2025-05-25T14:40:00+02:00,2025-05-25,22:40,4,4,8
6,2025-05-25T14:42:00+02:00,2025-05-25,22:42,4,1,5
6,2025-05-25T14:44:00+02:00,2025-05-25,22:44,2,2,4
6,2025-05-25T14:49:00+02:00,2025-05-25,22:49,5,2,7
6,2025-05-25T14:50:00+02:00,2025-05-25,22:50,0,4,4
6,2025-05-25T14:54:00+02:00,2025-05-25,22:54,12,7,19
28,2025-05-25T14:45:00+02:00,2025-05-25,22:45,1,0,1
28,2025-05-25T14:54:00+02:00,2025-05-25,22:54,3,3,6
29,2025-05-25T14:46:00+02:00,2025-05-25,22:46,0,1,1
29,2025-05-25T14:51:00+02:00,2025-05-25,22:51,0,2,2
29,2025-05-25T14:52:00+02:00,2025-05-25,22:52,0,2,2
31,2025-05-25T14:40:00+02:00,2025-05-25,22:40,1,0,1
31,2025-05-25T14:42:00+02:00,2025-05-25,22:42,0,4,4
31,2025-05-25T14:43:00+02:00,2025-05-25,22:43,0,1,1
31,2025-05-25T14:51:00+02:00,2025-05-25,22:51,3,0,3
31,2025-05-25T14:54:00+02:00,2025-05-25,22:54,0,1,1
36,2025-05-25T14:42:00+02:00,2025-05-25,22:42,1,0,1
37,2025-05-25T14:42:00+02:00,2025-05-25,22:42,1,0,1
37,2025-05-25T14:43:00+02:00,2025-05-25,22:43,8,1,9
37,2025-05-25T14:47:00+02:00,2025-05-25,22:47,0,2,2
37,2025-05-25T14:49:00+02:00,2025-05-25,22:49,3,1,4
37,2025-05-25T14:54:00+02:00,2025-05-25,22:54,2,3,5
40,2025-05-25T14:44:00+02:00,2025-05-25,22:44,1,0,1
40,2025-05-25T14:50:00+02:00,2025-05-25,22:50,2,0,2
40,2025-05-25T14:53:00+02:00,2025-05-25,22:53,2,0,2
41,2025-05-25T14:45:00+02:00,2025-05-25,22:45,1,2,3
41,2025-05-25T14:48:00+02:00,2025-05-25,22:48,0,1,1
41,2025-05-25T14:49:00+02:00,2025-05-25,22:49,3,0,3
41,2025-05-25T14:50:00+02:00,2025-05-25,22:50,0,1,1
41,2025-05-25T14:52:00+02:00,2025-05-25,22:52,0,2,2
43,2025-05-25T14:50:00+02:00,2025-05-25,22:50,0,1,1
44,2025-05-25T14:50:00+02:00,2025-05-25,22:50,0,1,1
45,2025-05-25T14:40:00+02:00,2025-05-25,22:40,0,4,4
45,2025-05-25T14:41:00+02:00,2025-05-25,22:41,2,5,7
45,2025-05-25T14:44:00+02:00,2025-05-25,22:44,3,6,9
45,2025-05-25T14:45:00+02:00,2025-05-25,22:45,3,1,4
45,2025-05-25T14:46:00+02:00,2025-05-25,22:46,4,3,7
47,2025-05-25T14:40:00+02:00,2025-05-25,22:40,0,1,1
47,2025-05-25T14:43:00+02:00,2025-05-25,22:43,2,5,7
47,2025-05-25T14:45:00+02:00,2025-05-25,22:45,5,0,5
47,2025-05-25T14:47:00+02:00,2025-05-25,22:47,1,2,3
47,2025-05-25T14:49:00+02:00,2025-05-25,22:49,3,2,5
47,2025-05-25T14:50:00+02:00,2025-05-25,22:50,5,6,11
47,2025-05-25T14:51:00+02:00,2025-05-25,22:51,1,3,4
50,2025-05-25T14:47:00+02:00,2025-05-25,22:47,0,1,1
50,2025-05-25T14:52:00+02:00,2025-05-25,22:52,1,0,1
50,2025-05-25T14:53:00+02:00,2025-05-25,22:53,3,0,3
54,2025-05-25T14:41:00+02:00,2025-05-25,22:41,1,4,5
54,2025-05-25T14:42:00+02:00,2025-05-25,22:42,1,1,2
54,2025-05-25T14:44:00+02:00,2025-05-25,22:44,3,0,3
54,2025-05-25T14:45:00+02:00,2025-05-25,22:45,1,2,3
54,2025-05-25T14:50:00+02:00,2025-05-25,22:50,3,0,3
54,2025-05-25T14:54:00+02:00,2025-05-25,22:54,2,1,3
59,2025-05-25T14:50:00+02:00,2025-05-25,22:50,4,7,11
61,2025-05-25T14:40:00+02:00,2025-05-25,22:40,1,0,1
61,2025-05-25T14:41:00+02:00,2025-05-25,22:41,1,0,1
61,2025-05-25T14:47:00+02:00,2025-05-25,22:47,2,2,4
61,2025-05-25T14:48:00+02:00,2025-05-25,22:48,1,1,2
61,2025-05-25T14:53:00+02:00,2025-05-25,22:53,1,1,2
66,2025-05-25T14:45:00+02:00,2025-05-25,22:45,8,3,11
66,2025-05-25T14:46:00+02:00,2025-05-25,22:46,4,2,6
66,2025-05-25T14:47:00+02:00,2025-05-25,22:47,2,1,3
66,2025-05-25T14:52:00+02:00,2025-05-25,22:52,5,4,9
66,2025-05-25T14:53:00+02:00,2025-05-25,22:53,0,2,2
70,2025-05-25T14:52:00+02:00,2025-05-25,22:52,2,0,2
75,2025-05-25T14:43:00+02:00,2025-05-25,22:43,2,0,2
75,2025-05-25T14:51:00+02:00,2025-05-25,22:51,1,0,1
77,2025-05-25T14:40:00+02:00,2025-05-25,22:40,3,6,9
77,2025-05-25T14:50:00+02:00,2025-05-25,22:50,4,5,9
78,2025-05-25T14:43:00+02:00,2025-05-25,22:43,0,1,1
87,2025-05-25T14:41:00+02:00,2025-05-25,22:41,0,1,1
87,2025-05-25T14:51:00+02:00,2025-05-25,22:51,0,1,1
107,2025-05-25T14:40:00+02:00,2025-05-25,22:40,0,6,6
108,2025-05-25T14:46:00+02:00,2025-05-25,22:46,1,0,1
131,2025-05-25T14:40:00+02:00,2025-05-25,22:40,3,0,3
133,2025-05-25T14:45:00+02:00,2025-05-25,22:45,16,16,32
135,2025-05-25T14:40:00+02:00,2025-05-25,22:40,7,6,13
135,2025-05-25T14:50:00+02:00,2025-05-25,22:50,3,8,11
165,2025-05-25T14:50:00+02:00,2025-05-25,22:50,1,0,1
179,2025-05-25T14:50:00+02:00,2025-05-25,22:50,0,1,1
1,2025-05-25T14:44:00+02:00,2025-05-25,22:44,1,0,1
1,2025-05-25T14:49:00+02:00,2025-05-25,22:49,0,1,1
1,2025-05-25T14:54:00+02:00,2025-05-25,22:54,1,3,4
2,2025-05-25T14:40:00+02:00,2025-05-25,22:40,0,6,6
2,2025-05-25T14:51:00+02:00,2025-05-25,22:51,0,1,1
9,2025-05-25T14:46:00+02:00,2025-05-25,22:46,0,3,3
9,2025-05-25T14:48:00+02:00,2025-05-25,22:48,0,2,2
12,2025-05-25T14:49:00+02:00,2025-05-25,22:49,1,0,1
12,2025-05-25T14:51:00+02:00,2025-05-25,22:51,4,0,4
12,2025-05-25T14:53:00+02:00,2025-05-25,22:53,4,1,5
17,2025-05-25T14:47:00+02:00,2025-05-25,22:47,1,2,3
19,2025-05-25T14:40:00+02:00,2025-05-25,22:40,0,3,3
19,2025-05-25T14:41:00+02:00,2025-05-25,22:41,3,5,8
19,2025-05-25T14:42:00+02:00,2025-05-25,22:42,2,4,6
19,2025-05-25T14:47:00+02:00,2025-05-25,22:47,2,0,2
19,2025-05-25T14:50:00+02:00,2025-05-25,22:50,4,10,14
20,2025-05-25T14:45:00+02:00,2025-05-25,22:45,7,1,8
20,2025-05-25T14:47:00+02:00,2025-05-25,22:47,3,0,3
20,2025-05-25T14:51:00+02:00,2025-05-25,22:51,10,2,12
23,2025-05-25T14:41:00+02:00,2025-05-25,22:41,0,1,1
23,2025-05-25T14:42:00+02:00,2025-05-25,22:42,1,0,1
23,2025-05-25T14:43:00+02:00,2025-05-25,22:43,0,3,3
23,2025-05-25T14:44:00+02:00,2025-05-25,22:44,0,5,5
23,2025-05-25T14:50:00+02:00,2025-05-25,22:50,1,0,1
23,2025-05-25T14:52:00+02:00,2025-05-25,22:52,0,7,7
23,2025-05-25T14:54:00+02:00,2025-05-25,22:54,2,1,3
24,2025-05-25T14:40:00+02:00,2025-05-25,22:40,0,17,17
24,2025-05-25T14:42:00+02:00,2025-05-25,22:42,1,3,4
24,2025-05-25T14:50:00+02:00,2025-05-25,22:50,1,2,3
25,2025-05-25T14:40:00+02:00,2025-05-25,22:40,2,2,4
27,2025-05-25T14:40:00+02:00,2025-05-25,22:40,1,1,2
27,2025-05-25T14:42:00+02:00,2025-05-25,22:42,1,2,3
30,2025-05-25T14:42:00+02:00,2025-05-25,22:42,2,7,9
30,2025-05-25T14:43:00+02:00,2025-05-25,22:43,3,9,12
30,2025-05-25T14:49:00+02:00,2025-05-25,22:49,3,4,7
30,2025-05-25T14:52:00+02:00,2025-05-25,22:52,4,3,7
30,2025-05-25T14:54:00+02:00,2025-05-25,22:54,0,9,9
35,2025-05-25T14:40:00+02:00,2025-05-25,22:40,2,1,3
35,2025-05-25T14:43:00+02:00,2025-05-25,22:43,3,0,3
35,2025-05-25T14:45:00+02:00,2025-05-25,22:45,1,1,2
35,2025-05-25T14:49:00+02:00,2025-05-25,22:49,5,5,10
35,2025-05-25T14:51:00+02:00,2025-05-25,22:51,5,2,7
35,2025-05-25T14:52:00+02:00,2025-05-25,22:52,5,1,6
48,2025-05-25T14:46:00+02:00,2025-05-25,22:46,0,2,2
48,2025-05-25T14:49:00+02:00,2025-05-25,22:49,1,0,1
48,2025-05-25T14:53:00+02:00,2025-05-25,22:53,1,0,1
49,2025-05-25T14:43:00+02:00,2025-05-25,22:43,1,0,1
49,2025-05-25T14:44:00+02:00,2025-05-25,22:44,0,4,4
49,2025-05-25T14:46:00+02:00,2025-05-25,22:46,3,1,4
49,2025-05-25T14:52:00+02:00,2025-05-25,22:52,1,3,4
49,2025-05-25T14:54:00+02:00,2025-05-25,22:54,1,3,4
51,2025-05-25T14:40:00+02:00,2025-05-25,22:40,2,4,6
51,2025-05-25T14:43:00+02:00,2025-05-25,22:43,1,0,1
51,2025-05-25T14:49:00+02:00,2025-05-25,22:49,0,1,1
52,2025-05-25T14:41:00+02:00,2025-05-25,22:41,0,2,2
52,2025-05-25T14:42:00+02:00,2025-05-25,22:42,0,4,4
52,2025-05-25T14:48:00+02:00,2025-05-25,22:48,0,3,3
52,2025-05-25T14:53:00+02:00,2025-05-25,22:53,3,2,5
53,2025-05-25T14:47:00+02:00,2025-05-25,22:47,0,1,1
53,2025-05-25T14:53:00+02:00,2025-05-25,22:53,1,0,1
56,2025-05-25T14:50:00+02:00,2025-05-25,22:50,1,3,4
56,2025-05-25T14:51:00+02:00,2025-05-25,22:51,0,4,4
58,2025-05-25T14:41:00+02:00,2025-05-25,22:41,3,0,3
58,2025-05-25T14:42:00+02:00,2025-05-25,22:42,0,1,1
58,2025-05-25T14:43:00+02:00,2025-05-25,22:43,1,1,2
58,2025-05-25T14:44:00+02:00,2025-05-25,22:44,1,0,1
58,2025-05-25T14:45:00+02:00,2025-05-25,22:45,3,1,4
58,2025-05-25T14:48:00+02:00,2025-05-25,22:48,1,1,2
58,2025-05-25T14:51:00+02:00,2025-05-25,22:51,0,3,3
62,2025-05-25T14:46:00+02:00,2025-05-25,22:46,3,0,3
62,2025-05-25T14:47:00+02:00,2025-05-25,22:47,1,2,3
62,2025-05-25T14:53:00+02:00,2025-05-25,22:53,0,1,1
63,2025-05-25T14:43:00+02:00,2025-05-25,22:43,0,1,1
63,2025-05-25T14:47:00+02:00,2025-05-25,22:47,0,2,2
63,2025-05-25T14:50:00+02:00,2025-05-25,22:50,3,0,3
63,2025-05-25T14:53:00+02:00,2025-05-25,22:53,2,0,2
67,2025-05-25T14:40:00+02:00,2025-05-25,22:40,0,2,2
67,2025-05-25T14:46:00+02:00,2025-05-25,22:46,0,1,1
68,2025-05-25T14:40:00+02:00,2025-05-25,22:40,1,0,1
68,2025-05-25T14:41:00+02:00,2025-05-25,22:41,1,0,1
72,2025-05-25T14:40:00+02:00,2025-05-25,22:40,2,0,2
72,2025-05-25T14:42:00+02:00,2025-05-25,22:42,0,1,1
72,2025-05-25T14:45:00+02:00,2025-05-25,22:45,1,0,1
72,2025-05-25T14:47:00+02:00,2025-05-25,22:47,0,2,2
72,2025-05-25T14:49:00+02:00,2025-05-25,22:49,1,0,1
79,2025-05-25T14:42:00+02:00,2025-05-25,22:42,1,1,2
85,2025-05-25T14:43:00+02:00,2025-05-25,22:43,1,0,1
85,2025-05-25T14:45:00+02:00,2025-05-25,22:45,0,1,1
86,2025-05-25T14:45:00+02:00,2025-05-25,22:45,0,1,1
109,2025-05-25T14:45:00+02:00,2025-05-25,22:45,3,1,4
109,2025-05-25T14:50:00+02:00,2025-05-25,22:50,3,4,7
117,2025-05-25T14:50:00+02:00,2025-05-25,22:50,12,2,14
137,2025-05-25T14:45:00+02:00,2025-05-25,22:45,1,0,1
139,2025-05-25T14:50:00+02:00,2025-05-25,22:50,3,0,3
141,2025-05-25T14:40:00+02:00,2025-05-25,22:40,1,7,8
141,2025-05-25T14:45:00+02:00,2025-05-25,22:45,1,1,2
164,2025-05-25T14:45:00+02:00,2025-05-25,22:45,1,0,1
164,2025-05-25T14:50:00+02:00,2025-05-25,22:50,0,2,2
181,2025-05-25T14:46:00+02:00,2025-05-25,22:46,5,2,7
181,2025-05-25T14:48:00+02:00,2025-05-25,22:48,13,13,26
181,2025-05-25T14:49:00+02:00,2025-05-25,22:49,9,10,19
181,2025-05-25T14:50:00+02:00,2025-05-25,22:50,8,5,13
181,2025-05-25T14:51:00+02:00,2025-05-25,22:51,5,2,7
182,2025-05-25T14:50:00+02:00,2025-05-25,22:50,6,8,14
181,2025-05-25T14:56:00+02:00,2025-05-25,22:56,4,4,8
181,2025-05-25T14:58:00+02:00,2025-05-25,22:58,2,8,10
181,2025-05-25T15:03:00+02:00,2025-05-25,23:03,4,9,13
181,2025-05-25T15:08:00+02:00,2025-05-25,23:08,1,13,14
181,2025-05-25T15:09:00+02:00,2025-05-25,23:09,9,2,11
181,2025-05-25T15:10:00+02:00,2025-05-25,23:10,6,6,12
181,2025-05-25T15:11:00+02:00,2025-05-25,23:11,11,4,15
181,2025-05-25T15:12:00+02:00,2025-05-25,23:12,10,6,16
181,2025-05-25T15:13:00+02:00,2025-05-25,23:13,12,1,13
181,2025-05-25T15:17:00+02:00,2025-05-25,23:17,1,6,7
181,2025-05-25T15:23:00+02:00,2025-05-25,23:23,3,2,5
181,2025-05-25T15:25:00+02:00,2025-05-25,23:25,3,5,8
181,2025-05-25T15:29:00+02:00,2025-05-25,23:29,1,3,4
181,2025-05-25T15:30:00+02:00,2025-05-25,23:30,6,7,13
181,2025-05-25T15:31:00+02:00,2025-05-25,23:31,6,0,6
181,2025-05-25T15:35:00+02:00,2025-05-25,23:35,9,2,11
181,2025-05-25T15:36:00+02:00,2025-05-25,23:36,2,4,6
181,2025-05-25T15:38:00+02:00,2025-05-25,23:38,9,2,11
181,2025-05-25T15:45:00+02:00,2025-05-25,23:45,10,3,13
181,2025-05-25T15:46:00+02:00,2025-05-25,23:46,3,3,6
182,2025-05-25T15:00:00+02:00,2025-05-25,23:00,3,5,8
182,2025-05-25T15:10:00+02:00,2025-05-25,23:10,5,6,11
182,2025-05-25T15:25:00+02:00,2025-05-25,23:25,6,4,10
182,2025-05-25T15:30:00+02:00,2025-05-25,23:30,10,8,18
182,2025-05-25T15:45:00+02:00,2025-05-25,23:45,4,5,9
3,2025-05-25T14:56:00+02:00,2025-05-25,22:56,4,3,7
3,2025-05-25T15:00:00+02:00,2025-05-25,23:00,7,10,17
3,2025-05-25T15:02:00+02:00,2025-05-25,23:02,1,4,5
3,2025-05-25T15:03:00+02:00,2025-05-25,23:03,1,2,3
3,2025-05-25T15:07:00+02:00,2025-05-25,23:07,1,4,5
3,2025-05-25T15:11:00+02:00,2025-05-25,23:11,1,4,5
3,2025-05-25T15:15:00+02:00,2025-05-25,23:15,9,1,10
3,2025-05-25T15:17:00+02:00,2025-05-25,23:17,6,0,6
3,2025-05-25T15:20:00+02:00,2025-05-25,23:20,1,4,5
3,2025-05-25T15:23:00+02:00,2025-05-25,23:23,4,1,5
3,2025-05-25T15:24:00+02:00,2025-05-25,23:24,4,0,4
3,2025-05-25T15:34:00+02:00,2025-05-25,23:34,3,2,5
3,2025-05-25T15:37:00+02:00,2025-05-25,23:37,3,0,3
3,2025-05-25T15:40:00+02:00,2025-05-25,23:40,1,7,8
3,2025-05-25T15:54:00+02:00,2025-05-25,23:54,2,5,7
4,2025-05-25T14:56:00+02:00,2025-05-25,22:56,3,5,8
4,2025-05-25T15:02:00+02:00,2025-05-25,23:02,0,2,2
4,2025-05-25T15:10:00+02:00,2025-05-25,23:10,1,5,6
4,2025-05-25T15:12:00+02:00,2025-05-25,23:12,2,0,2
4,2025-05-25T15:15:00+02:00,2025-05-25,23:15,4,6,10
4,2025-05-25T15:19:00+02:00,2025-05-25,23:19,0,1,1
4,2025-05-25T15:24:00+02:00,2025-05-25,23:24,2,10,12
4,2025-05-25T15:28:00+02:00,2025-05-25,23:28,1,4,5
4,2025-05-25T15:32:00+02:00,2025-05-25,23:32,3,0,3
4,2025-05-25T15:35:00+02:00,2025-05-25,23:35,3,6,9
4,2025-05-25T15:37:00+02:00,2025-05-25,23:37,0,3,3
4,2025-05-25T15:39:00+02:00,2025-05-25,23:39,1,3,4
4,2025-05-25T15:40:00+02:00,2025-05-25,23:40,1,12,13
4,2025-05-25T15:46:00+02:00,2025-05-25,23:46,5,3,8
4,2025-05-25T15:47:00+02:00,2025-05-25,23:47,0,4,4
4,2025-05-25T15:53:00+02:00,2025-05-25,23:53,2,0,2
5,2025-05-25T15:15:00+02:00,2025-05-25,23:15,7,2,9
5,2025-05-25T15:25:00+02:00,2025-05-25,23:25,2,8,10
5,2025-05-25T15:35:00+02:00,2025-05-25,23:35,4,4,8
5,2025-05-25T15:45:00+02:00,2025-05-25,23:45,0,7,7
5,2025-05-25T15:50:00+02:00,2025-05-25,23:50,4,2,6
5,2025-05-25T15:55:00+02:00,2025-05-25,23:55,2,5,7
6,2025-05-25T14:55:00+02:00,2025-05-25,22:55,3,6,9
6,2025-05-25T14:56:00+02:00,2025-05-25,22:56,1,2,3
6,2025-05-25T14:59:00+02:00,2025-05-25,22:59,10,1,11
6,2025-05-25T15:10:00+02:00,2025-05-25,23:10,5,1,6
6,2025-05-25T15:13:00+02:00,2025-05-25,23:13,3,4,7
6,2025-05-25T15:14:00+02:00,2025-05-25,23:14,1,2,3
6,2025-05-25T15:20:00+02:00,2025-05-25,23:20,4,3,7
6,2025-05-25T15:25:00+02:00,2025-05-25,23:25,4,1,5
6,2025-05-25T15:32:00+02:00,2025-05-25,23:32,6,4,10
6,2025-05-25T15:33:00+02:00,2025-05-25,23:33,2,1,3
6,2025-05-25T15:35:00+02:00,2025-05-25,23:35,0,7,7
6,2025-05-25T15:42:00+02:00,2025-05-25,23:42,3,1,4
6,2025-05-25T15:52:00+02:00,2025-05-25,23:52,4,0,4
6,2025-05-25T15:55:00+02:00,2025-05-25,23:55,1,0,1
8,2025-05-25T15:07:00+02:00,2025-05-25,23:07,1,0,1
8,2025-05-25T15:08:00+02:00,2025-05-25,23:08,2,0,2
21,2025-05-25T15:00:00+02:00,2025-05-25,23:00,9,15,24
21,2025-05-25T15:20:00+02:00,2025-05-25,23:20,2,8,10
21,2025-05-25T15:25:00+02:00,2025-05-25,23:25,4,5,9
21,2025-05-25T15:30:00+02:00,2025-05-25,23:30,2,7,9
21,2025-05-25T15:35:00+02:00,2025-05-25,23:35,1,7,8
21,2025-05-25T15:45:00+02:00,2025-05-25,23:45,3,4,7
21,2025-05-25T15:55:00+02:00,2025-05-25,23:55,1,5,6
28,2025-05-25T14:55:00+02:00,2025-05-25,22:55,1,0,1
28,2025-05-25T14:58:00+02:00,2025-05-25,22:58,1,0,1
28,2025-05-25T14:59:00+02:00,2025-05-25,22:59,0,2,2
28,2025-05-25T15:09:00+02:00,2025-05-25,23:09,1,1,2
28,2025-05-25T15:12:00+02:00,2025-05-25,23:12,4,0,4
28,2025-05-25T15:18:00+02:00,2025-05-25,23:18,1,0,1
28,2025-05-25T15:25:00+02:00,2025-05-25,23:25,0,1,1
28,2025-05-25T15:27:00+02:00,2025-05-25,23:27,0,1,1
28,2025-05-25T15:30:00+02:00,2025-05-25,23:30,1,0,1
28,2025-05-25T15:45:00+02:00,2025-05-25,23:45,1,0,1
28,2025-05-25T15:55:00+02:00,2025-05-25,23:55,2,0,2
29,2025-05-25T15:00:00+02:00,2025-05-25,23:00,0,1,1
29,2025-05-25T15:06:00+02:00,2025-05-25,23:06,1,0,1
29,2025-05-25T15:09:00+02:00,2025-05-25,23:09,0,2,2
29,2025-05-25T15:26:00+02:00,2025-05-25,23:26,1,1,2
31,2025-05-25T15:00:00+02:00,2025-05-25,23:00,0,1,1
31,2025-05-25T15:06:00+02:00,2025-05-25,23:06,1,0,1
31,2025-05-25T15:15:00+02:00,2025-05-25,23:15,0,6,6
31,2025-05-25T15:19:00+02:00,2025-05-25,23:19,1,1,2
31,2025-05-25T15:23:00+02:00,2025-05-25,23:23,0,1,1
31,2025-05-25T15:26:00+02:00,2025-05-25,23:26,0,2,2
31,2025-05-25T15:30:00+02:00,2025-05-25,23:30,0,1,1
31,2025-05-25T15:32:00+02:00,2025-05-25,23:32,0,1,1
31,2025-05-25T15:45:00+02:00,2025-05-25,23:45,0,5,5
31,2025-05-25T15:50:00+02:00,2025-05-25,23:50,0,3,3
36,2025-05-25T15:11:00+02:00,2025-05-25,23:11,2,0,2
36,2025-05-25T15:13:00+02:00,2025-05-25,23:13,0,1,1
36,2025-05-25T15:16:00+02:00,2025-05-25,23:16,2,0,2
36,2025-05-25T15:19:00+02:00,2025-05-25,23:19,0,2,2
36,2025-05-25T15:23:00+02:00,2025-05-25,23:23,1,0,1
36,2025-05-25T15:25:00+02:00,2025-05-25,23:25,1,0,1
36,2025-05-25T15:29:00+02:00,2025-05-25,23:29,0,1,1
36,2025-05-25T15:30:00+02:00,2025-05-25,23:30,1,0,1
36,2025-05-25T15:33:00+02:00,2025-05-25,23:33,2,2,4
37,2025-05-25T14:55:00+02:00,2025-05-25,22:55,2,0,2
37,2025-05-25T15:00:00+02:00,2025-05-25,23:00,0,2,2
37,2025-05-25T15:03:00+02:00,2025-05-25,23:03,0,2,2
37,2025-05-25T15:27:00+02:00,2025-05-25,23:27,2,0,2
37,2025-05-25T15:42:00+02:00,2025-05-25,23:42,0,1,1
37,2025-05-25T15:46:00+02:00,2025-05-25,23:46,0,1,1
37,2025-05-25T15:52:00+02:00,2025-05-25,23:52,2,0,2
37,2025-05-25T15:53:00+02:00,2025-05-25,23:53,4,0,4
37,2025-05-25T15:55:00+02:00,2025-05-25,23:55,1,0,1
39,2025-05-25T15:37:00+02:00,2025-05-25,23:37,1,0,1
39,2025-05-25T15:45:00+02:00,2025-05-25,23:45,0,1,1
40,2025-05-25T15:05:00+02:00,2025-05-25,23:05,1,0,1
40,2025-05-25T15:13:00+02:00,2025-05-25,23:13,0,3,3
40,2025-05-25T15:19:00+02:00,2025-05-25,23:19,1,1,2
40,2025-05-25T15:21:00+02:00,2025-05-25,23:21,1,0,1
40,2025-05-25T15:35:00+02:00,2025-05-25,23:35,0,2,2
40,2025-05-25T15:40:00+02:00,2025-05-25,23:40,1,0,1
41,2025-05-25T15:01:00+02:00,2025-05-25,23:01,1,3,4
41,2025-05-25T15:07:00+02:00,2025-05-25,23:07,0,1,1
41,2025-05-25T15:13:00+02:00,2025-05-25,23:13,2,0,2
41,2025-05-25T15:16:00+02:00,2025-05-25,23:16,3,0,3
41,2025-05-25T15:31:00+02:00,2025-05-25,23:31,2,0,2
41,2025-05-25T15:43:00+02:00,2025-05-25,23:43,1,2,3
41,2025-05-25T15:45:00+02:00,2025-05-25,23:45,1,0,1
41,2025-05-25T15:48:00+02:00,2025-05-25,23:48,0,1,1
41,2025-05-25T15:54:00+02:00,2025-05-25,23:54,3,4,7
43,2025-05-25T14:55:00+02:00,2025-05-25,22:55,4,2,6
43,2025-05-25T15:10:00+02:00,2025-05-25,23:10,0,1,1
43,2025-05-25T15:20:00+02:00,2025-05-25,23:20,2,0,2
43,2025-05-25T15:25:00+02:00,2025-05-25,23:25,1,5,6
43,2025-05-25T15:50:00+02:00,2025-05-25,23:50,1,0,1
43,2025-05-25T15:55:00+02:00,2025-05-25,23:55,1,0,1
44,2025-05-25T15:05:00+02:00,2025-05-25,23:05,1,2,3
44,2025-05-25T15:35:00+02:00,2025-05-25,23:35,0,1,1
45,2025-05-25T14:57:00+02:00,2025-05-25,22:57,4,6,10
45,2025-05-25T15:02:00+02:00,2025-05-25,23:02,0,3,3
45,2025-05-25T15:05:00+02:00,2025-05-25,23:05,7,7,14
45,2025-05-25T15:08:00+02:00,2025-05-25,23:08,1,2,3
45,2025-05-25T15:13:00+02:00,2025-05-25,23:13,5,4,9
45,2025-05-25T15:15:00+02:00,2025-05-25,23:15,0,2,2
45,2025-05-25T15:22:00+02:00,2025-05-25,23:22,1,0,1
45,2025-05-25T15:28:00+02:00,2025-05-25,23:28,3,4,7
45,2025-05-25T15:32:00+02:00,2025-05-25,23:32,0,5,5
45,2025-05-25T15:50:00+02:00,2025-05-25,23:50,0,2,2
45,2025-05-25T15:51:00+02:00,2025-05-25,23:51,1,4,5
45,2025-05-25T15:54:00+02:00,2025-05-25,23:54,0,3,3
45,2025-05-25T15:55:00+02:00,2025-05-25,23:55,0,1,1
47,2025-05-25T14:56:00+02:00,2025-05-25,22:56,1,1,2
47,2025-05-25T14:57:00+02:00,2025-05-25,22:57,3,3,6
47,2025-05-25T15:01:00+02:00,2025-05-25,23:01,1,0,1
47,2025-05-25T15:03:00+02:00,2025-05-25,23:03,2,0,2
47,2025-05-25T15:09:00+02:00,2025-05-25,23:09,1,3,4
47,2025-05-25T15:12:00+02:00,2025-05-25,23:12,3,0,3
47,2025-05-25T15:16:00+02:00,2025-05-25,23:16,5,1,6
47,2025-05-25T15:28:00+02:00,2025-05-25,23:28,12,2,14
47,2025-05-25T15:29:00+02:00,2025-05-25,23:29,0,1,1
47,2025-05-25T15:31:00+02:00,2025-05-25,23:31,0,1,1
47,2025-05-25T15:32:00+02:00,2025-05-25,23:32,2,0,2
47,2025-05-25T15:39:00+02:00,2025-05-25,23:39,1,0,1
47,2025-05-25T15:40:00+02:00,2025-05-25,23:40,3,3,6
47,2025-05-25T15:41:00+02:00,2025-05-25,23:41,1,5,6
47,2025-05-25T15:53:00+02:00,2025-05-25,23:53,2,2,4
50,2025-05-25T15:16:00+02:00,2025-05-25,23:16,1,0,1
50,2025-05-25T15:21:00+02:00,2025-05-25,23:21,3,0,3
50,2025-05-25T15:38:00+02:00,2025-05-25,23:38,1,0,1
50,2025-05-25T15:41:00+02:00,2025-05-25,23:41,1,0,1
50,2025-05-25T15:44:00+02:00,2025-05-25,23:44,0,1,1
54,2025-05-25T14:55:00+02:00,2025-05-25,22:55,0,1,1
54,2025-05-25T14:57:00+02:00,2025-05-25,22:57,2,5,7
54,2025-05-25T14:59:00+02:00,2025-05-25,22:59,1,6,7
54,2025-05-25T15:04:00+02:00,2025-05-25,23:04,1,4,5
54,2025-05-25T15:13:00+02:00,2025-05-25,23:13,2,0,2
54,2025-05-25T15:18:00+02:00,2025-05-25,23:18,0,1,1
54,2025-05-25T15:19:00+02:00,2025-05-25,23:19,0,1,1
54,2025-05-25T15:25:00+02:00,2025-05-25,23:25,0,1,1
54,2025-05-25T15:28:00+02:00,2025-05-25,23:28,0,2,2
54,2025-05-25T15:31:00+02:00,2025-05-25,23:31,0,5,5
54,2025-05-25T15:35:00+02:00,2025-05-25,23:35,1,0,1
54,2025-05-25T15:48:00+02:00,2025-05-25,23:48,0,6,6
59,2025-05-25T15:05:00+02:00,2025-05-25,23:05,4,6,10
59,2025-05-25T15:15:00+02:00,2025-05-25,23:15,3,2,5
59,2025-05-25T15:35:00+02:00,2025-05-25,23:35,2,0,2
61,2025-05-25T14:56:00+02:00,2025-05-25,22:56,2,0,2
61,2025-05-25T14:57:00+02:00,2025-05-25,22:57,2,0,2
61,2025-05-25T15:00:00+02:00,2025-05-25,23:00,3,0,3
61,2025-05-25T15:06:00+02:00,2025-05-25,23:06,4,2,6
61,2025-05-25T15:13:00+02:00,2025-05-25,23:13,1,1,2
61,2025-05-25T15:14:00+02:00,2025-05-25,23:14,0,2,2
61,2025-05-25T15:18:00+02:00,2025-05-25,23:18,3,1,4
61,2025-05-25T15:23:00+02:00,2025-05-25,23:23,1,2,3
61,2025-05-25T15:31:00+02:00,2025-05-25,23:31,2,0,2
61,2025-05-25T15:33:00+02:00,2025-05-25,23:33,2,0,2
61,2025-05-25T15:42:00+02:00,2025-05-25,23:42,0,1,1
66,2025-05-25T14:55:00+02:00,2025-05-25,22:55,9,0,9
66,2025-05-25T14:57:00+02:00,2025-05-25,22:57,8,2,10
66,2025-05-25T15:00:00+02:00,2025-05-25,23:00,4,1,5
66,2025-05-25T15:03:00+02:00,2025-05-25,23:03,7,3,10
66,2025-05-25T15:07:00+02:00,2025-05-25,23:07,6,9,15
66,2025-05-25T15:09:00+02:00,2025-05-25,23:09,3,0,3
66,2025-05-25T15:12:00+02:00,2025-05-25,23:12,4,3,7
66,2025-05-25T15:14:00+02:00,2025-05-25,23:14,0,5,5
66,2025-05-25T15:16:00+02:00,2025-05-25,23:16,5,2,7
66,2025-05-25T15:25:00+02:00,2025-05-25,23:25,6,0,6
66,2025-05-25T15:26:00+02:00,2025-05-25,23:26,4,3,7
66,2025-05-25T15:28:00+02:00,2025-05-25,23:28,2,2,4
66,2025-05-25T15:30:00+02:00,2025-05-25,23:30,0,6,6
66,2025-05-25T15:31:00+02:00,2025-05-25,23:31,0,3,3
66,2025-05-25T15:36:00+02:00,2025-05-25,23:36,2,0,2
66,2025-05-25T15:39:00+02:00,2025-05-25,23:39,3,0,3
66,2025-05-25T15:40:00+02:00,2025-05-25,23:40,0,4,4
66,2025-05-25T15:45:00+02:00,2025-05-25,23:45,1,1,2
66,2025-05-25T15:50:00+02:00,2025-05-25,23:50,1,1,2
66,2025-05-25T15:54:00+02:00,2025-05-25,23:54,2,0,2
69,2025-05-25T15:31:00+02:00,2025-05-25,23:31,0,1,1
70,2025-05-25T14:58:00+02:00,2025-05-25,22:58,0,1,1
71,2025-05-25T15:28:00+02:00,2025-05-25,23:28,1,1,2
71,2025-05-25T15:29:00+02:00,2025-05-25,23:29,2,0,2
75,2025-05-25T14:58:00+02:00,2025-05-25,22:58,0,1,1
75,2025-05-25T15:17:00+02:00,2025-05-25,23:17,0,1,1
77,2025-05-25T14:55:00+02:00,2025-05-25,22:55,0,3,3
77,2025-05-25T15:00:00+02:00,2025-05-25,23:00,1,4,5
77,2025-05-25T15:05:00+02:00,2025-05-25,23:05,8,3,11
77,2025-05-25T15:10:00+02:00,2025-05-25,23:10,1,0,1
77,2025-05-25T15:25:00+02:00,2025-05-25,23:25,2,2,4
77,2025-05-25T15:55:00+02:00,2025-05-25,23:55,0,1,1
78,2025-05-25T15:38:00+02:00,2025-05-25,23:38,0,1,1
84,2025-05-25T15:00:00+02:00,2025-05-25,23:00,8,15,23
84,2025-05-25T15:10:00+02:00,2025-05-25,23:10,8,8,16
84,2025-05-25T15:20:00+02:00,2025-05-25,23:20,11,4,15
84,2025-05-25T15:25:00+02:00,2025-05-25,23:25,11,13,24
84,2025-05-25T15:40:00+02:00,2025-05-25,23:40,8,8,16
84,2025-05-25T15:55:00+02:00,2025-05-25,23:55,6,2,8
87,2025-05-25T14:56:00+02:00,2025-05-25,22:56,1,0,1
107,2025-05-25T14:55:00+02:00,2025-05-25,22:55,2,2,4
107,2025-05-25T15:00:00+02:00,2025-05-25,23:00,8,0,8
107,2025-05-25T15:10:00+02:00,2025-05-25,23:10,1,2,3
107,2025-05-25T15:30:00+02:00,2025-05-25,23:30,0,5,5
107,2025-05-25T15:50:00+02:00,2025-05-25,23:50,1,0,1
108,2025-05-25T14:59:00+02:00,2025-05-25,22:59,2,1,3
108,2025-05-25T15:00:00+02:00,2025-05-25,23:00,0,4,4
108,2025-05-25T15:11:00+02:00,2025-05-25,23:11,0,2,2
108,2025-05-25T15:12:00+02:00,2025-05-25,23:12,3,1,4
108,2025-05-25T15:15:00+02:00,2025-05-25,23:15,3,0,3
108,2025-05-25T15:16:00+02:00,2025-05-25,23:16,0,2,2
108,2025-05-25T15:17:00+02:00,2025-05-25,23:17,1,1,2
108,2025-05-25T15:20:00+02:00,2025-05-25,23:20,2,0,2
108,2025-05-25T15:21:00+02:00,2025-05-25,23:21,0,2,2
108,2025-05-25T15:25:00+02:00,2025-05-25,23:25,1,0,1
108,2025-05-25T15:28:00+02:00,2025-05-25,23:28,0,1,1
108,2025-05-25T15:29:00+02:00,2025-05-25,23:29,8,0,8
108,2025-05-25T15:31:00+02:00,2025-05-25,23:31,2,3,5
108,2025-05-25T15:33:00+02:00,2025-05-25,23:33,0,2,2
108,2025-05-25T15:38:00+02:00,2025-05-25,23:38,1,0,1
108,2025-05-25T15:50:00+02:00,2025-05-25,23:50,0,1,1
131,2025-05-25T15:00:00+02:00,2025-05-25,23:00,3,2,5
131,2025-05-25T15:05:00+02:00,2025-05-25,23:05,3,0,3
131,2025-05-25T15:15:00+02:00,2025-05-25,23:15,6,3,9
131,2025-05-25T15:40:00+02:00,2025-05-25,23:40,2,2,4
131,2025-05-25T15:45:00+02:00,2025-05-25,23:45,2,1,3
132,2025-05-25T15:25:00+02:00,2025-05-25,23:25,3,1,4
132,2025-05-25T15:30:00+02:00,2025-05-25,23:30,1,5,6
132,2025-05-25T15:50:00+02:00,2025-05-25,23:50,1,2,3
133,2025-05-25T15:10:00+02:00,2025-05-25,23:10,2,3,5
133,2025-05-25T15:25:00+02:00,2025-05-25,23:25,4,1,5
133,2025-05-25T15:40:00+02:00,2025-05-25,23:40,6,1,7
134,2025-05-25T14:55:00+02:00,2025-05-25,22:55,6,6,12
134,2025-05-25T15:15:00+02:00,2025-05-25,23:15,3,21,24
134,2025-05-25T15:25:00+02:00,2025-05-25,23:25,6,8,14
134,2025-05-25T15:35:00+02:00,2025-05-25,23:35,13,7,20
134,2025-05-25T15:45:00+02:00,2025-05-25,23:45,6,3,9
135,2025-05-25T14:55:00+02:00,2025-05-25,22:55,3,5,8
135,2025-05-25T15:15:00+02:00,2025-05-25,23:15,2,10,12
135,2025-05-25T15:30:00+02:00,2025-05-25,23:30,3,2,5
135,2025-05-25T15:40:00+02:00,2025-05-25,23:40,5,8,13
162,2025-05-25T15:00:00+02:00,2025-05-25,23:00,1,0,1
162,2025-05-25T15:10:00+02:00,2025-05-25,23:10,1,3,4
162,2025-05-25T15:50:00+02:00,2025-05-25,23:50,1,4,5
162,2025-05-25T15:55:00+02:00,2025-05-25,23:55,2,1,3
165,2025-05-25T15:00:00+02:00,2025-05-25,23:00,1,1,2
166,2025-05-25T14:55:00+02:00,2025-05-25,22:55,0,1,1
167,2025-05-25T15:10:00+02:00,2025-05-25,23:10,0,1,1
179,2025-05-25T15:15:00+02:00,2025-05-25,23:15,2,0,2
1,2025-05-25T15:03:00+02:00,2025-05-25,23:03,1,0,1
1,2025-05-25T15:05:00+02:00,2025-05-25,23:05,0,1,1
1,2025-05-25T15:10:00+02:00,2025-05-25,23:10,2,3,5
1,2025-05-25T15:21:00+02:00,2025-05-25,23:21,0,2,2
1,2025-05-25T15:25:00+02:00,2025-05-25,23:25,0,1,1
1,2025-05-25T15:27:00+02:00,2025-05-25,23:27,0,1,1
1,2025-05-25T15:43:00+02:00,2025-05-25,23:43,0,1,1
1,2025-05-25T15:50:00+02:00,2025-05-25,23:50,1,0,1
2,2025-05-25T15:02:00+02:00,2025-05-25,23:02,1,0,1
2,2025-05-25T15:44:00+02:00,2025-05-25,23:44,0,2,2
2,2025-05-25T15:55:00+02:00,2025-05-25,23:55,0,5,5
9,2025-05-25T14:57:00+02:00,2025-05-25,22:57,1,0,1
9,2025-05-25T15:02:00+02:00,2025-05-25,23:02,0,2,2
9,2025-05-25T15:13:00+02:00,2025-05-25,23:13,2,0,2
9,2025-05-25T15:18:00+02:00,2025-05-25,23:18,1,0,1
9,2025-05-25T15:22:00+02:00,2025-05-25,23:22,0,1,1
9,2025-05-25T15:33:00+02:00,2025-05-25,23:33,0,2,2
9,2025-05-25T15:55:00+02:00,2025-05-25,23:55,0,1,1
10,2025-05-25T15:04:00+02:00,2025-05-25,23:04,0,1,1
10,2025-05-25T15:08:00+02:00,2025-05-25,23:08,0,1,1
10,2025-05-25T15:22:00+02:00,2025-05-25,23:22,2,1,3
10,2025-05-25T15:32:00+02:00,2025-05-25,23:32,1,0,1
10,2025-05-25T15:42:00+02:00,2025-05-25,23:42,1,0,1
11,2025-05-25T15:15:00+02:00,2025-05-25,23:15,0,1,1
11,2025-05-25T15:25:00+02:00,2025-05-25,23:25,2,0,2
11,2025-05-25T15:50:00+02:00,2025-05-25,23:50,0,1,1
12,2025-05-25T14:55:00+02:00,2025-05-25,22:55,2,0,2
12,2025-05-25T15:03:00+02:00,2025-05-25,23:03,1,0,1
12,2025-05-25T15:15:00+02:00,2025-05-25,23:15,1,0,1
12,2025-05-25T15:17:00+02:00,2025-05-25,23:17,1,2,3
12,2025-05-25T15:23:00+02:00,2025-05-25,23:23,1,0,1
12,2025-05-25T15:32:00+02:00,2025-05-25,23:32,1,0,1
12,2025-05-25T15:53:00+02:00,2025-05-25,23:53,1,1,2
19,2025-05-25T14:56:00+02:00,2025-05-25,22:56,3,0,3
19,2025-05-25T14:57:00+02:00,2025-05-25,22:57,2,11,13
19,2025-05-25T14:59:00+02:00,2025-05-25,22:59,0,4,4
19,2025-05-25T15:05:00+02:00,2025-05-25,23:05,2,6,8
19,2025-05-25T15:06:00+02:00,2025-05-25,23:06,3,2,5
19,2025-05-25T15:07:00+02:00,2025-05-25,23:07,1,9,10
19,2025-05-25T15:09:00+02:00,2025-05-25,23:09,2,3,5
19,2025-05-25T15:11:00+02:00,2025-05-25,23:11,3,6,9
19,2025-05-25T15:14:00+02:00,2025-05-25,23:14,0,6,6
19,2025-05-25T15:15:00+02:00,2025-05-25,23:15,1,2,3
19,2025-05-25T15:16:00+02:00,2025-05-25,23:16,2,0,2
19,2025-05-25T15:17:00+02:00,2025-05-25,23:17,2,4,6
19,2025-05-25T15:18:00+02:00,2025-05-25,23:18,3,5,8
19,2025-05-25T15:20:00+02:00,2025-05-25,23:20,2,2,4
19,2025-05-25T15:26:00+02:00,2025-05-25,23:26,0,1,1
19,2025-05-25T15:35:00+02:00,2025-05-25,23:35,2,2,4
19,2025-05-25T15:37:00+02:00,2025-05-25,23:37,1,0,1
19,2025-05-25T15:41:00+02:00,2025-05-25,23:41,0,9,9
19,2025-05-25T15:42:00+02:00,2025-05-25,23:42,3,0,3
19,2025-05-25T15:43:00+02:00,2025-05-25,23:43,3,0,3
19,2025-05-25T15:49:00+02:00,2025-05-25,23:49,5,2,7
19,2025-05-25T15:54:00+02:00,2025-05-25,23:54,0,2,2
20,2025-05-25T14:57:00+02:00,2025-05-25,22:57,6,0,6
20,2025-05-25T14:59:00+02:00,2025-05-25,22:59,0,2,2
20,2025-05-25T15:04:00+02:00,2025-05-25,23:04,1,0,1
20,2025-05-25T15:09:00+02:00,2025-05-25,23:09,2,0,2
20,2025-05-25T15:12:00+02:00,2025-05-25,23:12,1,1,2
20,2025-05-25T15:24:00+02:00,2025-05-25,23:24,0,2,2
20,2025-05-25T15:25:00+02:00,2025-05-25,23:25,3,4,7
20,2025-05-25T15:27:00+02:00,2025-05-25,23:27,0,1,1
20,2025-05-25T15:29:00+02:00,2025-05-25,23:29,2,6,8
20,2025-05-25T15:38:00+02:00,2025-05-25,23:38,0,2,2
20,2025-05-25T15:48:00+02:00,2025-05-25,23:48,0,2,2
20,2025-05-25T15:54:00+02:00,2025-05-25,23:54,2,6,8
23,2025-05-25T14:57:00+02:00,2025-05-25,22:57,2,0,2
23,2025-05-25T15:04:00+02:00,2025-05-25,23:04,1,0,1
23,2025-05-25T15:10:00+02:00,2025-05-25,23:10,1,0,1
23,2025-05-25T15:14:00+02:00,2025-05-25,23:14,2,0,2
23,2025-05-25T15:25:00+02:00,2025-05-25,23:25,0,2,2
23,2025-05-25T15:29:00+02:00,2025-05-25,23:29,0,3,3
23,2025-05-25T15:33:00+02:00,2025-05-25,23:33,0,2,2
23,2025-05-25T15:43:00+02:00,2025-05-25,23:43,0,1,1
23,2025-05-25T15:52:00+02:00,2025-05-25,23:52,3,4,7
23,2025-05-25T15:53:00+02:00,2025-05-25,23:53,1,0,1
24,2025-05-25T14:55:00+02:00,2025-05-25,22:55,2,4,6
24,2025-05-25T15:01:00+02:00,2025-05-25,23:01,4,1,5
24,2025-05-25T15:07:00+02:00,2025-05-25,23:07,4,0,4
24,2025-05-25T15:14:00+02:00,2025-05-25,23:14,1,2,3
24,2025-05-25T15:17:00+02:00,2025-05-25,23:17,3,0,3
24,2025-05-25T15:18:00+02:00,2025-05-25,23:18,0,3,3
24,2025-05-25T15:21:00+02:00,2025-05-25,23:21,5,0,5
24,2025-05-25T15:22:00+02:00,2025-05-25,23:22,3,0,3
24,2025-05-25T15:23:00+02:00,2025-05-25,23:23,1,1,2
24,2025-05-25T15:24:00+02:00,2025-05-25,23:24,1,3,4
24,2025-05-25T15:31:00+02:00,2025-05-25,23:31,0,4,4
24,2025-05-25T15:33:00+02:00,2025-05-25,23:33,1,9,10
24,2025-05-25T15:34:00+02:00,2025-05-25,23:34,1,0,1
24,2025-05-25T15:38:00+02:00,2025-05-25,23:38,1,1,2
24,2025-05-25T15:39:00+02:00,2025-05-25,23:39,3,2,5
24,2025-05-25T15:41:00+02:00,2025-05-25,23:41,0,5,5
24,2025-05-25T15:47:00+02:00,2025-05-25,23:47,3,0,3
24,2025-05-25T15:49:00+02:00,2025-05-25,23:49,3,0,3
24,2025-05-25T15:53:00+02:00,2025-05-25,23:53,1,1,2
24,2025-05-25T15:55:00+02:00,2025-05-25,23:55,2,0,2
25,2025-05-25T15:05:00+02:00,2025-05-25,23:05,3,5,8
25,2025-05-25T15:20:00+02:00,2025-05-25,23:20,1,2,3
25,2025-05-25T15:50:00+02:00,2025-05-25,23:50,2,1,3
27,2025-05-25T15:00:00+02:00,2025-05-25,23:00,2,0,2
27,2025-05-25T15:07:00+02:00,2025-05-25,23:07,2,0,2
27,2025-05-25T15:10:00+02:00,2025-05-25,23:10,3,3,6
27,2025-05-25T15:14:00+02:00,2025-05-25,23:14,1,0,1
27,2025-05-25T15:15:00+02:00,2025-05-25,23:15,0,1,1
27,2025-05-25T15:19:00+02:00,2025-05-25,23:19,1,0,1
30,2025-05-25T14:57:00+02:00,2025-05-25,22:57,1,1,2
30,2025-05-25T15:00:00+02:00,2025-05-25,23:00,0,2,2
30,2025-05-25T15:04:00+02:00,2025-05-25,23:04,0,5,5
30,2025-05-25T15:12:00+02:00,2025-05-25,23:12,4,0,4
30,2025-05-25T15:15:00+02:00,2025-05-25,23:15,3,4,7
30,2025-05-25T15:22:00+02:00,2025-05-25,23:22,1,0,1
30,2025-05-25T15:26:00+02:00,2025-05-25,23:26,1,0,1
30,2025-05-25T15:31:00+02:00,2025-05-25,23:31,4,0,4
30,2025-05-25T15:33:00+02:00,2025-05-25,23:33,2,0,2
30,2025-05-25T15:34:00+02:00,2025-05-25,23:34,0,9,9
30,2025-05-25T15:35:00+02:00,2025-05-25,23:35,5,0,5
30,2025-05-25T15:48:00+02:00,2025-05-25,23:48,2,1,3
30,2025-05-25T15:49:00+02:00,2025-05-25,23:49,4,0,4
30,2025-05-25T15:52:00+02:00,2025-05-25,23:52,2,1,3
35,2025-05-25T14:57:00+02:00,2025-05-25,22:57,2,4,6
35,2025-05-25T15:07:00+02:00,2025-05-25,23:07,1,2,3
35,2025-05-25T15:20:00+02:00,2025-05-25,23:20,2,0,2
35,2025-05-25T15:21:00+02:00,2025-05-25,23:21,0,2,2
35,2025-05-25T15:24:00+02:00,2025-05-25,23:24,0,1,1
35,2025-05-25T15:26:00+02:00,2025-05-25,23:26,0,1,1
35,2025-05-25T15:32:00+02:00,2025-05-25,23:32,0,4,4
35,2025-05-25T15:34:00+02:00,2025-05-25,23:34,0,2,2
35,2025-05-25T15:37:00+02:00,2025-05-25,23:37,0,2,2
35,2025-05-25T15:44:00+02:00,2025-05-25,23:44,4,1,5
35,2025-05-25T15:45:00+02:00,2025-05-25,23:45,0,5,5
35,2025-05-25T15:48:00+02:00,2025-05-25,23:48,3,0,3
35,2025-05-25T15:51:00+02:00,2025-05-25,23:51,0,1,1
49,2025-05-25T14:56:00+02:00,2025-05-25,22:56,1,1,2
49,2025-05-25T15:02:00+02:00,2025-05-25,23:02,4,2,6
49,2025-05-25T15:05:00+02:00,2025-05-25,23:05,1,1,2
49,2025-05-25T15:07:00+02:00,2025-05-25,23:07,6,3,9
49,2025-05-25T15:09:00+02:00,2025-05-25,23:09,2,1,3
49,2025-05-25T15:11:00+02:00,2025-05-25,23:11,2,2,4
49,2025-05-25T15:13:00+02:00,2025-05-25,23:13,2,4,6
49,2025-05-25T15:15:00+02:00,2025-05-25,23:15,3,2,5
49,2025-05-25T15:18:00+02:00,2025-05-25,23:18,0,2,2
49,2025-05-25T15:19:00+02:00,2025-05-25,23:19,1,2,3
49,2025-05-25T15:21:00+02:00,2025-05-25,23:21,1,2,3
49,2025-05-25T15:24:00+02:00,2025-05-25,23:24,8,0,8
49,2025-05-25T15:25:00+02:00,2025-05-25,23:25,1,2,3
49,2025-05-25T15:34:00+02:00,2025-05-25,23:34,4,1,5
49,2025-05-25T15:36:00+02:00,2025-05-25,23:36,5,3,8
49,2025-05-25T15:38:00+02:00,2025-05-25,23:38,6,0,6
49,2025-05-25T15:39:00+02:00,2025-05-25,23:39,0,3,3
49,2025-05-25T15:43:00+02:00,2025-05-25,23:43,5,0,5
49,2025-05-25T15:44:00+02:00,2025-05-25,23:44,2,5,7
49,2025-05-25T15:45:00+02:00,2025-05-25,23:45,2,2,4
49,2025-05-25T15:48:00+02:00,2025-05-25,23:48,3,0,3
49,2025-05-25T15:52:00+02:00,2025-05-25,23:52,8,8,16
51,2025-05-25T14:56:00+02:00,2025-05-25,22:56,0,4,4
51,2025-05-25T14:57:00+02:00,2025-05-25,22:57,2,0,2
51,2025-05-25T15:00:00+02:00,2025-05-25,23:00,1,0,1
51,2025-05-25T15:05:00+02:00,2025-05-25,23:05,2,1,3
51,2025-05-25T15:15:00+02:00,2025-05-25,23:15,0,8,8
51,2025-05-25T15:21:00+02:00,2025-05-25,23:21,1,0,1
51,2025-05-25T15:23:00+02:00,2025-05-25,23:23,0,1,1
51,2025-05-25T15:26:00+02:00,2025-05-25,23:26,1,1,2
51,2025-05-25T15:27:00+02:00,2025-05-25,23:27,0,1,1
51,2025-05-25T15:34:00+02:00,2025-05-25,23:34,0,1,1
51,2025-05-25T15:41:00+02:00,2025-05-25,23:41,0,1,1
51,2025-05-25T15:42:00+02:00,2025-05-25,23:42,2,0,2
51,2025-05-25T15:45:00+02:00,2025-05-25,23:45,1,1,2
51,2025-05-25T15:48:00+02:00,2025-05-25,23:48,2,0,2
52,2025-05-25T15:06:00+02:00,2025-05-25,23:06,0,3,3
52,2025-05-25T15:12:00+02:00,2025-05-25,23:12,1,1,2
52,2025-05-25T15:14:00+02:00,2025-05-25,23:14,1,1,2
52,2025-05-25T15:16:00+02:00,2025-05-25,23:16,0,1,1
52,2025-05-25T15:24:00+02:00,2025-05-25,23:24,1,0,1
52,2025-05-25T15:29:00+02:00,2025-05-25,23:29,5,0,5
52,2025-05-25T15:30:00+02:00,2025-05-25,23:30,2,0,2
52,2025-05-25T15:32:00+02:00,2025-05-25,23:32,3,0,3
52,2025-05-25T15:34:00+02:00,2025-05-25,23:34,2,0,2
52,2025-05-25T15:50:00+02:00,2025-05-25,23:50,0,2,2
53,2025-05-25T15:00:00+02:00,2025-05-25,23:00,1,0,1
53,2025-05-25T15:09:00+02:00,2025-05-25,23:09,0,2,2
53,2025-05-25T15:24:00+02:00,2025-05-25,23:24,0,3,3
53,2025-05-25T15:39:00+02:00,2025-05-25,23:39,0,1,1
53,2025-05-25T15:48:00+02:00,2025-05-25,23:48,0,1,1
53,2025-05-25T15:50:00+02:00,2025-05-25,23:50,2,0,2
56,2025-05-25T14:55:00+02:00,2025-05-25,22:55,0,1,1
56,2025-05-25T14:56:00+02:00,2025-05-25,22:56,3,3,6
56,2025-05-25T14:57:00+02:00,2025-05-25,22:57,0,2,2
56,2025-05-25T15:07:00+02:00,2025-05-25,23:07,1,0,1
56,2025-05-25T15:09:00+02:00,2025-05-25,23:09,0,9,9
56,2025-05-25T15:20:00+02:00,2025-05-25,23:20,2,1,3
56,2025-05-25T15:32:00+02:00,2025-05-25,23:32,2,5,7
56,2025-05-25T15:50:00+02:00,2025-05-25,23:50,1,0,1
56,2025-05-25T15:52:00+02:00,2025-05-25,23:52,0,3,3
56,2025-05-25T15:53:00+02:00,2025-05-25,23:53,1,2,3
58,2025-05-25T14:55:00+02:00,2025-05-25,22:55,0,3,3
58,2025-05-25T15:01:00+02:00,2025-05-25,23:01,0,2,2
58,2025-05-25T15:03:00+02:00,2025-05-25,23:03,2,2,4
58,2025-05-25T15:05:00+02:00,2025-05-25,23:05,2,0,2
58,2025-05-25T15:11:00+02:00,2025-05-25,23:11,1,1,2
58,2025-05-25T15:17:00+02:00,2025-05-25,23:17,4,0,4
58,2025-05-25T15:20:00+02:00,2025-05-25,23:20,2,1,3
58,2025-05-25T15:24:00+02:00,2025-05-25,23:24,1,3,4
58,2025-05-25T15:28:00+02:00,2025-05-25,23:28,0,2,2
58,2025-05-25T15:29:00+02:00,2025-05-25,23:29,0,6,6
58,2025-05-25T15:30:00+02:00,2025-05-25,23:30,3,0,3
58,2025-05-25T15:31:00+02:00,2025-05-25,23:31,2,3,5
58,2025-05-25T15:37:00+02:00,2025-05-25,23:37,2,0,2
58,2025-05-25T15:39:00+02:00,2025-05-25,23:39,2,0,2
58,2025-05-25T15:43:00+02:00,2025-05-25,23:43,2,2,4
58,2025-05-25T15:49:00+02:00,2025-05-25,23:49,1,1,2
62,2025-05-25T14:55:00+02:00,2025-05-25,22:55,1,0,1
62,2025-05-25T14:58:00+02:00,2025-05-25,22:58,0,5,5
62,2025-05-25T14:59:00+02:00,2025-05-25,22:59,3,1,4
62,2025-05-25T15:01:00+02:00,2025-05-25,23:01,2,1,3
62,2025-05-25T15:06:00+02:00,2025-05-25,23:06,1,2,3
62,2025-05-25T15:13:00+02:00,2025-05-25,23:13,2,0,2
62,2025-05-25T15:23:00+02:00,2025-05-25,23:23,0,1,1
62,2025-05-25T15:24:00+02:00,2025-05-25,23:24,2,0,2
62,2025-05-25T15:29:00+02:00,2025-05-25,23:29,1,0,1
62,2025-05-25T15:33:00+02:00,2025-05-25,23:33,1,0,1
62,2025-05-25T15:37:00+02:00,2025-05-25,23:37,1,0,1
62,2025-05-25T15:38:00+02:00,2025-05-25,23:38,1,0,1
62,2025-05-25T15:44:00+02:00,2025-05-25,23:44,2,1,3
62,2025-05-25T15:45:00+02:00,2025-05-25,23:45,0,1,1
62,2025-05-25T15:49:00+02:00,2025-05-25,23:49,1,2,3
63,2025-05-25T15:10:00+02:00,2025-05-25,23:10,0,2,2
63,2025-05-25T15:17:00+02:00,2025-05-25,23:17,0,2,2
63,2025-05-25T15:27:00+02:00,2025-05-25,23:27,0,1,1
63,2025-05-25T15:28:00+02:00,2025-05-25,23:28,0,3,3
63,2025-05-25T15:52:00+02:00,2025-05-25,23:52,0,1,1
63,2025-05-25T15:55:00+02:00,2025-05-25,23:55,0,1,1
67,2025-05-25T14:55:00+02:00,2025-05-25,22:55,0,1,1
67,2025-05-25T15:20:00+02:00,2025-05-25,23:20,1,0,1
67,2025-05-25T15:22:00+02:00,2025-05-25,23:22,0,1,1
67,2025-05-25T15:25:00+02:00,2025-05-25,23:25,1,0,1
67,2025-05-25T15:33:00+02:00,2025-05-25,23:33,0,2,2
67,2025-05-25T15:39:00+02:00,2025-05-25,23:39,0,2,2
67,2025-05-25T15:46:00+02:00,2025-05-25,23:46,0,2,2
67,2025-05-25T15:50:00+02:00,2025-05-25,23:50,0,1,1
68,2025-05-25T14:56:00+02:00,2025-05-25,22:56,1,1,2
72,2025-05-25T14:59:00+02:00,2025-05-25,22:59,2,0,2
72,2025-05-25T15:00:00+02:00,2025-05-25,23:00,0,2,2
72,2025-05-25T15:01:00+02:00,2025-05-25,23:01,0,7,7
72,2025-05-25T15:09:00+02:00,2025-05-25,23:09,0,1,1
72,2025-05-25T15:14:00+02:00,2025-05-25,23:14,0,1,1
72,2025-05-25T15:32:00+02:00,2025-05-25,23:32,0,1,1
72,2025-05-25T15:36:00+02:00,2025-05-25,23:36,1,0,1
72,2025-05-25T15:44:00+02:00,2025-05-25,23:44,0,1,1
79,2025-05-25T14:55:00+02:00,2025-05-25,22:55,2,1,3
79,2025-05-25T14:58:00+02:00,2025-05-25,22:58,2,1,3
79,2025-05-25T14:59:00+02:00,2025-05-25,22:59,2,0,2
79,2025-05-25T15:02:00+02:00,2025-05-25,23:02,0,1,1
79,2025-05-25T15:04:00+02:00,2025-05-25,23:04,2,2,4
79,2025-05-25T15:05:00+02:00,2025-05-25,23:05,4,0,4
79,2025-05-25T15:06:00+02:00,2025-05-25,23:06,0,2,2
79,2025-05-25T15:11:00+02:00,2025-05-25,23:11,2,3,5
79,2025-05-25T15:16:00+02:00,2025-05-25,23:16,0,2,2
79,2025-05-25T15:17:00+02:00,2025-05-25,23:17,0,1,1
79,2025-05-25T15:23:00+02:00,2025-05-25,23:23,0,1,1
79,2025-05-25T15:31:00+02:00,2025-05-25,23:31,0,2,2
79,2025-05-25T15:43:00+02:00,2025-05-25,23:43,1,0,1
79,2025-05-25T15:46:00+02:00,2025-05-25,23:46,0,3,3
79,2025-05-25T15:51:00+02:00,2025-05-25,23:51,1,0,1
79,2025-05-25T15:52:00+02:00,2025-05-25,23:52,1,3,4
79,2025-05-25T15:54:00+02:00,2025-05-25,23:54,0,2,2
85,2025-05-25T14:59:00+02:00,2025-05-25,22:59,0,1,1
85,2025-05-25T15:05:00+02:00,2025-05-25,23:05,0,1,1
86,2025-05-25T15:15:00+02:00,2025-05-25,23:15,3,0,3
109,2025-05-25T15:10:00+02:00,2025-05-25,23:10,2,4,6
109,2025-05-25T15:15:00+02:00,2025-05-25,23:15,0,1,1
109,2025-05-25T15:45:00+02:00,2025-05-25,23:45,4,1,5
117,2025-05-25T15:15:00+02:00,2025-05-25,23:15,4,0,4
117,2025-05-25T15:25:00+02:00,2025-05-25,23:25,3,0,3
117,2025-05-25T15:30:00+02:00,2025-05-25,23:30,0,3,3
117,2025-05-25T15:40:00+02:00,2025-05-25,23:40,1,0,1
117,2025-05-25T15:45:00+02:00,2025-05-25,23:45,0,2,2
130,2025-05-25T14:55:00+02:00,2025-05-25,22:55,2,1,3
139,2025-05-25T15:05:00+02:00,2025-05-25,23:05,1,1,2
139,2025-05-25T15:25:00+02:00,2025-05-25,23:25,0,1,1
141,2025-05-25T15:10:00+02:00,2025-05-25,23:10,1,1,2
141,2025-05-25T15:35:00+02:00,2025-05-25,23:35,0,8,8
141,2025-05-25T15:40:00+02:00,2025-05-25,23:40,0,3,3
142,2025-05-25T15:05:00+02:00,2025-05-25,23:05,1,1,2
142,2025-05-25T15:20:00+02:00,2025-05-25,23:20,1,1,2
164,2025-05-25T15:45:00+02:00,2025-05-25,23:45,2,0,2
